LAUS Code,State,County,County Name/State Abbreviation,Period,Force,Employed,Unemployed,(%)
CN0100100000000,01,001,"Autauga County, AL",Nov-21,26474,25898,576,2.20000000
CN0100300000000,01,003,"Baldwin County, AL",Nov-21,99271,97017,2254,2.30000000
CN0100500000000,01,005,"Barbour County, AL",Nov-21,8081,7741,340,4.20000000
CN0100700000000,01,007,"Bibb County, AL",Nov-21,8638,8416,222,2.60000000
CN0100900000000,01,009,"Blount County, AL",Nov-21,25500,25016,484,1.90000000
CN0101100000000,01,011,"Bullock County, AL",Nov-21,4603,4470,133,2.90000000
CN0101300000000,01,013,"Butler County, AL",Nov-21,8626,8270,356,4.10000000
CN0101500000000,01,015,"Calhoun County, AL",Nov-21,45845,44403,1442,3.10000000
CN0101700000000,01,017,"Chambers County, AL",Nov-21,15816,15395,421,2.70000000
CN0101900000000,01,019,"Cherokee County, AL",Nov-21,11782,11543,239,2.00000000
CN0102100000000,01,021,"Chilton County, AL",Nov-21,20109,19659,450,2.20000000
CN0102300000000,01,023,"Choctaw County, AL",Nov-21,4479,4328,151,3.40000000
CN0102500000000,01,025,"Clarke County, AL",Nov-21,7736,7382,354,4.60000000
CN0102700000000,01,027,"Clay County, AL",Nov-21,6118,5999,119,1.90000000
CN0102900000000,01,029,"Cleburne County, AL",Nov-21,6001,5879,122,2.00000000
CN0103100000000,01,031,"Coffee County, AL",Nov-21,21899,21402,497,2.30000000
CN0103300000000,01,033,"Colbert County, AL",Nov-21,23665,22953,712,3.00000000
CN0103500000000,01,035,"Conecuh County, AL",Nov-21,4323,4169,154,3.60000000
CN0103700000000,01,037,"Coosa County, AL",Nov-21,4338,4234,104,2.40000000
CN0103900000000,01,039,"Covington County, AL",Nov-21,15319,14973,346,2.30000000
CN0104100000000,01,041,"Crenshaw County, AL",Nov-21,6182,6026,156,2.50000000
CN0104300000000,01,043,"Cullman County, AL",Nov-21,39381,38650,731,1.90000000
CN0104500000000,01,045,"Dale County, AL",Nov-21,21039,20517,522,2.50000000
CN0104700000000,01,047,"Dallas County, AL",Nov-21,13805,12973,832,6.00000000
CN0104900000000,01,049,"DeKalb County, AL",Nov-21,31266,30649,617,2.00000000
CN0105100000000,01,051,"Elmore County, AL",Nov-21,37745,36947,798,2.10000000
CN0105300000000,01,053,"Escambia County, AL",Nov-21,13755,13358,397,2.90000000
CN0105500000000,01,055,"Etowah County, AL",Nov-21,39164,37944,1220,3.10000000
CN0105700000000,01,057,"Fayette County, AL",Nov-21,6686,6517,169,2.50000000
CN0105900000000,01,059,"Franklin County, AL",Nov-21,14426,14151,275,1.90000000
CN0106100000000,01,061,"Geneva County, AL",Nov-21,11149,10909,240,2.20000000
CN0106300000000,01,063,"Greene County, AL",Nov-21,2810,2660,150,5.30000000
CN0106500000000,01,065,"Hale County, AL",Nov-21,5991,5730,261,4.40000000
CN0106700000000,01,067,"Henry County, AL",Nov-21,6932,6763,169,2.40000000
CN0106900000000,01,069,"Houston County, AL",Nov-21,47037,45843,1194,2.50000000
CN0107100000000,01,071,"Jackson County, AL",Nov-21,23138,22624,514,2.20000000
CN0107300000000,01,073,"Jefferson County, AL",Nov-21,319682,310965,8717,2.70000000
CN0107500000000,01,075,"Lamar County, AL",Nov-21,5675,5544,131,2.30000000
CN0107700000000,01,077,"Lauderdale County, AL",Nov-21,42520,41487,1033,2.40000000
CN0107900000000,01,079,"Lawrence County, AL",Nov-21,14395,14074,321,2.20000000
CN0108100000000,01,081,"Lee County, AL",Nov-21,77602,75875,1727,2.20000000
CN0108300000000,01,083,"Limestone County, AL",Nov-21,46869,45951,918,2.00000000
CN0108500000000,01,085,"Lowndes County, AL",Nov-21,3542,3301,241,6.80000000
CN0108700000000,01,087,"Macon County, AL",Nov-21,7939,7574,365,4.60000000
CN0108900000000,01,089,"Madison County, AL",Nov-21,192972,188944,4028,2.10000000
CN0109100000000,01,091,"Marengo County, AL",Nov-21,7618,7366,252,3.30000000
CN0109300000000,01,093,"Marion County, AL",Nov-21,13450,13158,292,2.20000000
CN0109500000000,01,095,"Marshall County, AL",Nov-21,44777,43923,854,1.90000000
CN0109700000000,01,097,"Mobile County, AL",Nov-21,192003,185435,6568,3.40000000
CN0109900000000,01,099,"Monroe County, AL",Nov-21,7368,7075,293,4.00000000
CN0110100000000,01,101,"Montgomery County, AL",Nov-21,106329,102590,3739,3.50000000
CN0110300000000,01,103,"Morgan County, AL",Nov-21,59262,58072,1190,2.00000000
CN0110500000000,01,105,"Perry County, AL",Nov-21,3185,2974,211,6.60000000
CN0110700000000,01,107,"Pickens County, AL",Nov-21,7588,7366,222,2.90000000
CN0110900000000,01,109,"Pike County, AL",Nov-21,16278,15862,416,2.60000000
CN0111100000000,01,111,"Randolph County, AL",Nov-21,9468,9262,206,2.20000000
CN0111300000000,01,113,"Russell County, AL",Nov-21,23463,22928,535,2.30000000
CN0111500000000,01,115,"St. Clair County, AL",Nov-21,41666,40807,859,2.10000000
CN0111700000000,01,117,"Shelby County, AL",Nov-21,119702,117639,2063,1.70000000
CN0111900000000,01,119,"Sumter County, AL",Nov-21,4494,4346,148,3.30000000
CN0112100000000,01,121,"Talladega County, AL",Nov-21,35763,34591,1172,3.30000000
CN0112300000000,01,123,"Tallapoosa County, AL",Nov-21,17598,17064,534,3.00000000
CN0112500000000,01,125,"Tuscaloosa County, AL",Nov-21,101860,99146,2714,2.70000000
CN0112700000000,01,127,"Walker County, AL",Nov-21,25309,24590,719,2.80000000
CN0112900000000,01,129,"Washington County, AL",Nov-21,6522,6289,233,3.60000000
CN0113100000000,01,131,"Wilcox County, AL",Nov-21,2572,2351,221,8.60000000
CN0113300000000,01,133,"Winston County, AL",Nov-21,10091,9869,222,2.20000000
CN0201300000000,02,013,"Aleutians East Borough, AK",Nov-21,1909,1852,57,3.00000000
CN0201600000000,02,016,"Aleutians West Census Area, AK",Nov-21,2947,2812,135,4.60000000
CN0202000000000,02,020,"Anchorage Borough/municipality, AK",Nov-21,154509,147512,6997,4.50000000
CN0205000000000,02,050,"Bethel Census Area, AK",Nov-21,7189,6393,796,11.10000000
CN0206000000000,02,060,"Bristol Bay Borough, AK",Nov-21,264,240,24,9.10000000
CN0206300000000,02,063,"Chugach Census Area, AK",Nov-21,3218,2987,231,7.20000000
CN0206600000000,02,066,"Copper River Census Area, AK",Nov-21,1280,1167,113,8.80000000
CN0206800000000,02,068,"Denali Borough, AK",Nov-21,805,712,93,11.60000000
CN0207000000000,02,070,"Dillingham Census Area, AK",Nov-21,1604,1494,110,6.90000000
CN0209000000000,02,090,"Fairbanks North Star Borough, AK",Nov-21,46547,44460,2087,4.50000000
CN0210000000000,02,100,"Haines Borough, AK",Nov-21,948,850,98,10.30000000
CN0210500000000,02,105,"Hoonah-Angoon Census Area, AK",Nov-21,1072,978,94,8.80000000
CN0211000000000,02,110,"Juneau Borough/city, AK",Nov-21,16602,15988,614,3.70000000
CN0212200000000,02,122,"Kenai Peninsula Borough, AK",Nov-21,28024,26279,1745,6.20000000
CN0213000000000,02,130,"Ketchikan Gateway Borough, AK",Nov-21,6500,6127,373,5.70000000
CN0215000000000,02,150,"Kodiak Island Borough, AK",Nov-21,5956,5572,384,6.40000000
CN0215800000000,02,158,"Kusilvak Census Area, AK",Nov-21,2299,1910,389,16.90000000
CN0216400000000,02,164,"Lake and Peninsula Borough, AK",Nov-21,593,548,45,7.60000000
CN0217000000000,02,170,"Matanuska-Susitna Borough, AK",Nov-21,51061,48152,2909,5.70000000
CN0218000000000,02,180,"Nome Census Area, AK",Nov-21,4368,3999,369,8.40000000
CN0218500000000,02,185,"North Slope Borough, AK",Nov-21,2976,2810,166,5.60000000
CN0218800000000,02,188,"Northwest Arctic Borough, AK",Nov-21,3064,2772,292,9.50000000
CN0219500000000,02,195,"Petersburg Borough, AK",Nov-21,1436,1331,105,7.30000000
CN0219800000000,02,198,"Prince of Wales-Hyder Census Area, AK",Nov-21,2800,2609,191,6.80000000
CN0222000000000,02,220,"Sitka Borough/city, AK",Nov-21,4475,4304,171,3.80000000
CN0223000000000,02,230,"Skagway Municipality, AK",Nov-21,544,465,79,14.50000000
CN0224000000000,02,240,"Southeast Fairbanks Census Area, AK",Nov-21,3303,3093,210,6.40000000
CN0227500000000,02,275,"Wrangell Borough/city, AK",Nov-21,944,878,66,7.00000000
CN0228200000000,02,282,"Yakutat Borough/city, AK",Nov-21,262,242,20,7.60000000
CN0229000000000,02,290,"Yukon-Koyukuk Census Area, AK",Nov-21,2385,2130,255,10.70000000
CN0400100000000,04,001,"Apache County, AZ",Nov-21,18375,17154,1221,6.60000000
CN0400300000000,04,003,"Cochise County, AZ",Nov-21,49242,47590,1652,3.40000000
CN0400500000000,04,005,"Coconino County, AZ",Nov-21,74128,71204,2924,3.90000000
CN0400700000000,04,007,"Gila County, AZ",Nov-21,20339,19664,675,3.30000000
CN0400900000000,04,009,"Graham County, AZ",Nov-21,15915,15512,403,2.50000000
CN0401100000000,04,011,"Greenlee County, AZ",Nov-21,4346,4234,112,2.60000000
CN0401200000000,04,012,"La Paz County, AZ",Nov-21,9035,8727,308,3.40000000
CN0401300000000,04,013,"Maricopa County, AZ",Nov-21,2329932,2265143,64789,2.80000000
CN0401500000000,04,015,"Mohave County, AZ",Nov-21,87955,84511,3444,3.90000000
CN0401700000000,04,017,"Navajo County, AZ",Nov-21,38986,37229,1757,4.50000000
CN0401900000000,04,019,"Pima County, AZ",Nov-21,483147,467844,15303,3.20000000
CN0402100000000,04,021,"Pinal County, AZ",Nov-21,195370,189460,5910,3.00000000
CN0402300000000,04,023,"Santa Cruz County, AZ",Nov-21,19176,17926,1250,6.50000000
CN0402500000000,04,025,"Yavapai County, AZ",Nov-21,106091,103305,2786,2.60000000
CN0402700000000,04,027,"Yuma County, AZ",Nov-21,97216,86224,10992,11.30000000
CN0500100000000,05,001,"Arkansas County, AR",Nov-21,9426,9183,243,2.60000000
CN0500300000000,05,003,"Ashley County, AR",Nov-21,6575,6236,339,5.20000000
CN0500500000000,05,005,"Baxter County, AR",Nov-21,16163,15781,382,2.40000000
CN0500700000000,05,007,"Benton County, AR",Nov-21,144638,142172,2466,1.70000000
CN0500900000000,05,009,"Boone County, AR",Nov-21,15750,15469,281,1.80000000
CN0501100000000,05,011,"Bradley County, AR",Nov-21,3910,3790,120,3.10000000
CN0501300000000,05,013,"Calhoun County, AR",Nov-21,2368,2322,46,1.90000000
CN0501500000000,05,015,"Carroll County, AR",Nov-21,12547,12311,236,1.90000000
CN0501700000000,05,017,"Chicot County, AR",Nov-21,2942,2764,178,6.10000000
CN0501900000000,05,019,"Clark County, AR",Nov-21,8820,8562,258,2.90000000
CN0502100000000,05,021,"Clay County, AR",Nov-21,5278,5150,128,2.40000000
CN0502300000000,05,023,"Cleburne County, AR",Nov-21,8854,8583,271,3.10000000
CN0502500000000,05,025,"Cleveland County, AR",Nov-21,3059,2982,77,2.50000000
CN0502700000000,05,027,"Columbia County, AR",Nov-21,8811,8516,295,3.30000000
CN0502900000000,05,029,"Conway County, AR",Nov-21,8187,7968,219,2.70000000
CN0503100000000,05,031,"Craighead County, AR",Nov-21,56100,55016,1084,1.90000000
CN0503300000000,05,033,"Crawford County, AR",Nov-21,25825,25225,600,2.30000000
CN0503500000000,05,035,"Crittenden County, AR",Nov-21,20415,19758,657,3.20000000
CN0503700000000,05,037,"Cross County, AR",Nov-21,6844,6648,196,2.90000000
CN0503900000000,05,039,"Dallas County, AR",Nov-21,2745,2663,82,3.00000000
CN0504100000000,05,041,"Desha County, AR",Nov-21,4923,4717,206,4.20000000
CN0504300000000,05,043,"Drew County, AR",Nov-21,7457,7212,245,3.30000000
CN0504500000000,05,045,"Faulkner County, AR",Nov-21,61389,60065,1324,2.20000000
CN0504700000000,05,047,"Franklin County, AR",Nov-21,7215,7042,173,2.40000000
CN0504900000000,05,049,"Fulton County, AR",Nov-21,4853,4744,109,2.20000000
CN0505100000000,05,051,"Garland County, AR",Nov-21,39896,38625,1271,3.20000000
CN0505300000000,05,053,"Grant County, AR",Nov-21,8206,8036,170,2.10000000
CN0505500000000,05,055,"Greene County, AR",Nov-21,19253,18862,391,2.00000000
CN0505700000000,05,057,"Hempstead County, AR",Nov-21,9052,8837,215,2.40000000
CN0505900000000,05,059,"Hot Spring County, AR",Nov-21,13714,13363,351,2.60000000
CN0506100000000,05,061,"Howard County, AR",Nov-21,5352,5226,126,2.40000000
CN0506300000000,05,063,"Independence County, AR",Nov-21,16257,15862,395,2.40000000
CN0506500000000,05,065,"Izard County, AR",Nov-21,4326,4163,163,3.80000000
CN0506700000000,05,067,"Jackson County, AR",Nov-21,5557,5367,190,3.40000000
CN0506900000000,05,069,"Jefferson County, AR",Nov-21,25740,24531,1209,4.70000000
CN0507100000000,05,071,"Johnson County, AR",Nov-21,9893,9579,314,3.20000000
CN0507300000000,05,073,"Lafayette County, AR",Nov-21,2280,2198,82,3.60000000
CN0507500000000,05,075,"Lawrence County, AR",Nov-21,6675,6497,178,2.70000000
CN0507700000000,05,077,"Lee County, AR",Nov-21,2448,2355,93,3.80000000
CN0507900000000,05,079,"Lincoln County, AR",Nov-21,3661,3549,112,3.10000000
CN0508100000000,05,081,"Little River County, AR",Nov-21,5269,5108,161,3.10000000
CN0508300000000,05,083,"Logan County, AR",Nov-21,8266,8042,224,2.70000000
CN0508500000000,05,085,"Lonoke County, AR",Nov-21,33318,32607,711,2.10000000
CN0508700000000,05,087,"Madison County, AR",Nov-21,7431,7289,142,1.90000000
CN0508900000000,05,089,"Marion County, AR",Nov-21,6015,5858,157,2.60000000
CN0509100000000,05,091,"Miller County, AR",Nov-21,18995,18375,620,3.30000000
CN0509300000000,05,093,"Mississippi County, AR",Nov-21,16031,15248,783,4.90000000
CN0509500000000,05,095,"Monroe County, AR",Nov-21,2539,2445,94,3.70000000
CN0509700000000,05,097,"Montgomery County, AR",Nov-21,2717,2616,101,3.70000000
CN0509900000000,05,099,"Nevada County, AR",Nov-21,3339,3235,104,3.10000000
CN0510100000000,05,101,"Newton County, AR",Nov-21,3159,3103,56,1.80000000
CN0510300000000,05,103,"Ouachita County, AR",Nov-21,9689,9424,265,2.70000000
CN0510500000000,05,105,"Perry County, AR",Nov-21,4104,3985,119,2.90000000
CN0510700000000,05,107,"Phillips County, AR",Nov-21,5649,5335,314,5.60000000
CN0510900000000,05,109,"Pike County, AR",Nov-21,4072,3946,126,3.10000000
CN0511100000000,05,111,"Poinsett County, AR",Nov-21,9688,9453,235,2.40000000
CN0511300000000,05,113,"Polk County, AR",Nov-21,7674,7460,214,2.80000000
CN0511500000000,05,115,"Pope County, AR",Nov-21,27330,26650,680,2.50000000
CN0511700000000,05,117,"Prairie County, AR",Nov-21,3482,3409,73,2.10000000
CN0511900000000,05,119,"Pulaski County, AR",Nov-21,185224,179432,5792,3.10000000
CN0512100000000,05,121,"Randolph County, AR",Nov-21,7216,7043,173,2.40000000
CN0512300000000,05,123,"St. Francis County, AR",Nov-21,7538,7224,314,4.20000000
CN0512500000000,05,125,"Saline County, AR",Nov-21,58393,57227,1166,2.00000000
CN0512700000000,05,127,"Scott County, AR",Nov-21,4170,4088,82,2.00000000
CN0512900000000,05,129,"Searcy County, AR",Nov-21,2874,2792,82,2.90000000
CN0513100000000,05,131,"Sebastian County, AR",Nov-21,54378,53110,1268,2.30000000
CN0513300000000,05,133,"Sevier County, AR",Nov-21,5305,5157,148,2.80000000
CN0513500000000,05,135,"Sharp County, AR",Nov-21,5592,5423,169,3.00000000
CN0513700000000,05,137,"Stone County, AR",Nov-21,4418,4283,135,3.10000000
CN0513900000000,05,139,"Union County, AR",Nov-21,14815,14174,641,4.30000000
CN0514100000000,05,141,"Van Buren County, AR",Nov-21,5745,5572,173,3.00000000
CN0514300000000,05,143,"Washington County, AR",Nov-21,127952,125706,2246,1.80000000
CN0514500000000,05,145,"White County, AR",Nov-21,33863,32997,866,2.60000000
CN0514700000000,05,147,"Woodruff County, AR",Nov-21,2770,2682,88,3.20000000
CN0514900000000,05,149,"Yell County, AR",Nov-21,7811,7610,201,2.60000000
CN0600100000000,06,001,"Alameda County, CA",Nov-21,818946,784398,34548,4.20000000
CN0600300000000,06,003,"Alpine County, CA",Nov-21,465,436,29,6.20000000
CN0600500000000,06,005,"Amador County, CA",Nov-21,14412,13655,757,5.30000000
CN0600700000000,06,007,"Butte County, CA",Nov-21,92737,88170,4567,4.90000000
CN0600900000000,06,009,"Calaveras County, CA",Nov-21,21394,20496,898,4.20000000
CN0601100000000,06,011,"Colusa County, CA",Nov-21,10765,9656,1109,10.30000000
CN0601300000000,06,013,"Contra Costa County, CA",Nov-21,548376,523626,24750,4.50000000
CN0601500000000,06,015,"Del Norte County, CA",Nov-21,9204,8678,526,5.70000000
CN0601700000000,06,017,"El Dorado County, CA",Nov-21,91941,88166,3775,4.10000000
CN0601900000000,06,019,"Fresno County, CA",Nov-21,444030,412517,31513,7.10000000
CN0602100000000,06,021,"Glenn County, CA",Nov-21,12463,11819,644,5.20000000
CN0602300000000,06,023,"Humboldt County, CA",Nov-21,59839,57204,2635,4.40000000
CN0602500000000,06,025,"Imperial County, CA",Nov-21,69827,59285,10542,15.10000000
CN0602700000000,06,027,"Inyo County, CA",Nov-21,8280,7927,353,4.30000000
CN0602900000000,06,029,"Kern County, CA",Nov-21,387242,358542,28700,7.40000000
CN0603100000000,06,031,"Kings County, CA",Nov-21,55676,51577,4099,7.40000000
CN0603300000000,06,033,"Lake County, CA",Nov-21,27707,26041,1666,6.00000000
CN0603500000000,06,035,"Lassen County, CA",Nov-21,9096,8716,380,4.20000000
CN0603700000000,06,037,"Los Angeles County, CA",Nov-21,5044623,4720492,324131,6.40000000
CN0603900000000,06,039,"Madera County, CA",Nov-21,61284,57140,4144,6.80000000
CN0604100000000,06,041,"Marin County, CA",Nov-21,131036,127099,3937,3.00000000
CN0604300000000,06,043,"Mariposa County, CA",Nov-21,6851,6458,393,5.70000000
CN0604500000000,06,045,"Mendocino County, CA",Nov-21,37143,35409,1734,4.70000000
CN0604700000000,06,047,"Merced County, CA",Nov-21,115369,106512,8857,7.70000000
CN0604900000000,06,049,"Modoc County, CA",Nov-21,3179,3022,157,4.90000000
CN0605100000000,06,051,"Mono County, CA",Nov-21,8322,7915,407,4.90000000
CN0605300000000,06,053,"Monterey County, CA",Nov-21,211826,199750,12076,5.70000000
CN0605500000000,06,055,"Napa County, CA",Nov-21,67640,64783,2857,4.20000000
CN0605700000000,06,057,"Nevada County, CA",Nov-21,47087,45184,1903,4.00000000
CN0605900000000,06,059,"Orange County, CA",Nov-21,1572253,1507915,64338,4.10000000
CN0606100000000,06,061,"Placer County, CA",Nov-21,189936,183324,6612,3.50000000
CN0606300000000,06,063,"Plumas County, CA",Nov-21,6879,6354,525,7.60000000
CN0606500000000,06,065,"Riverside County, CA",Nov-21,1149997,1088872,61125,5.30000000
CN0606700000000,06,067,"Sacramento County, CA",Nov-21,718131,681463,36668,5.10000000
CN0606900000000,06,069,"San Benito County, CA",Nov-21,32263,30545,1718,5.30000000
CN0607100000000,06,071,"San Bernardino County, CA",Nov-21,1006215,951758,54457,5.40000000
CN0607300000000,06,073,"San Diego County, CA",Nov-21,1575096,1504079,71017,4.50000000
CN0607500000000,06,075,"San Francisco County/city, CA",Nov-21,559022,540336,18686,3.30000000
CN0607700000000,06,077,"San Joaquin County, CA",Nov-21,334165,312365,21800,6.50000000
CN0607900000000,06,079,"San Luis Obispo County, CA",Nov-21,139177,134358,4819,3.50000000
CN0608100000000,06,081,"San Mateo County, CA",Nov-21,442313,428858,13455,3.00000000
CN0608300000000,06,083,"Santa Barbara County, CA",Nov-21,221252,212653,8599,3.90000000
CN0608500000000,06,085,"Santa Clara County, CA",Nov-21,1029979,997461,32518,3.20000000
CN0608700000000,06,087,"Santa Cruz County, CA",Nov-21,134151,127584,6567,4.90000000
CN0608900000000,06,089,"Shasta County, CA",Nov-21,73200,69505,3695,5.00000000
CN0609100000000,06,091,"Sierra County, CA",Nov-21,1295,1238,57,4.40000000
CN0609300000000,06,093,"Siskiyou County, CA",Nov-21,16614,15628,986,5.90000000
CN0609500000000,06,095,"Solano County, CA",Nov-21,200848,189849,10999,5.50000000
CN0609700000000,06,097,"Sonoma County, CA",Nov-21,244301,235089,9212,3.80000000
CN0609900000000,06,099,"Stanislaus County, CA",Nov-21,240177,225148,15029,6.30000000
CN0610100000000,06,101,"Sutter County, CA",Nov-21,45187,42093,3094,6.80000000
CN0610300000000,06,103,"Tehama County, CA",Nov-21,25383,24039,1344,5.30000000
CN0610500000000,06,105,"Trinity County, CA",Nov-21,4373,4165,208,4.80000000
CN0610700000000,06,107,"Tulare County, CA",Nov-21,203453,186861,16592,8.20000000
CN0610900000000,06,109,"Tuolumne County, CA",Nov-21,20083,19030,1053,5.20000000
CN0611100000000,06,111,"Ventura County, CA",Nov-21,406379,388020,18359,4.50000000
CN0611300000000,06,113,"Yolo County, CA",Nov-21,106348,101786,4562,4.30000000
CN0611500000000,06,115,"Yuba County, CA",Nov-21,31032,29075,1957,6.30000000
CN0800100000000,08,001,"Adams County, CO",Nov-21,278801,265908,12893,4.60000000
CN0800300000000,08,003,"Alamosa County, CO",Nov-21,8729,8386,343,3.90000000
CN0800500000000,08,005,"Arapahoe County, CO",Nov-21,371159,355399,15760,4.20000000
CN0800700000000,08,007,"Archuleta County, CO",Nov-21,7412,7142,270,3.60000000
CN0800900000000,08,009,"Baca County, CO",Nov-21,2132,2094,38,1.80000000
CN0801100000000,08,011,"Bent County, CO",Nov-21,1870,1783,87,4.70000000
CN0801300000000,08,013,"Boulder County, CO",Nov-21,199137,193065,6072,3.00000000
CN0801400000000,08,014,"Broomfield County/city, CO",Nov-21,41706,40374,1332,3.20000000
CN0801500000000,08,015,"Chaffee County, CO",Nov-21,10359,10051,308,3.00000000
CN0801700000000,08,017,"Cheyenne County, CO",Nov-21,1112,1091,21,1.90000000
CN0801900000000,08,019,"Clear Creek County, CO",Nov-21,6090,5843,247,4.10000000
CN0802100000000,08,021,"Conejos County, CO",Nov-21,4171,4031,140,3.40000000
CN0802300000000,08,023,"Costilla County, CO",Nov-21,1900,1815,85,4.50000000
CN0802500000000,08,025,"Crowley County, CO",Nov-21,1482,1421,61,4.10000000
CN0802700000000,08,027,"Custer County, CO",Nov-21,2346,2272,74,3.20000000
CN0802900000000,08,029,"Delta County, CO",Nov-21,14276,13714,562,3.90000000
CN0803100000000,08,031,"Denver County/city, CO",Nov-21,431732,413079,18653,4.30000000
CN0803300000000,08,033,"Dolores County, CO",Nov-21,1194,1148,46,3.90000000
CN0803500000000,08,035,"Douglas County, CO",Nov-21,203782,197778,6004,2.90000000
CN0803700000000,08,037,"Eagle County, CO",Nov-21,35581,34325,1256,3.50000000
CN0803900000000,08,039,"Elbert County, CO",Nov-21,15660,15216,444,2.80000000
CN0804100000000,08,041,"El Paso County, CO",Nov-21,352681,338051,14630,4.10000000
CN0804300000000,08,043,"Fremont County, CO",Nov-21,15930,15077,853,5.40000000
CN0804500000000,08,045,"Garfield County, CO",Nov-21,31651,30552,1099,3.50000000
CN0804700000000,08,047,"Gilpin County, CO",Nov-21,3909,3742,167,4.30000000
CN0804900000000,08,049,"Grand County, CO",Nov-21,9319,9033,286,3.10000000
CN0805100000000,08,051,"Gunnison County, CO",Nov-21,11543,11215,328,2.80000000
CN0805300000000,08,053,"Hinsdale County, CO",Nov-21,413,401,12,2.90000000
CN0805500000000,08,055,"Huerfano County, CO",Nov-21,2644,2476,168,6.40000000
CN0805700000000,08,057,"Jackson County, CO",Nov-21,963,939,24,2.50000000
CN0805900000000,08,059,"Jefferson County, CO",Nov-21,338199,325945,12254,3.60000000
CN0806100000000,08,061,"Kiowa County, CO",Nov-21,913,891,22,2.40000000
CN0806300000000,08,063,"Kit Carson County, CO",Nov-21,4212,4110,102,2.40000000
CN0806500000000,08,065,"Lake County, CO",Nov-21,5034,4865,169,3.40000000
CN0806700000000,08,067,"La Plata County, CO",Nov-21,32096,30932,1164,3.60000000
CN0806900000000,08,069,"Larimer County, CO",Nov-21,209056,202138,6918,3.30000000
CN0807100000000,08,071,"Las Animas County, CO",Nov-21,6576,6236,340,5.20000000
CN0807300000000,08,073,"Lincoln County, CO",Nov-21,2348,2276,72,3.10000000
CN0807500000000,08,075,"Logan County, CO",Nov-21,11166,10813,353,3.20000000
CN0807700000000,08,077,"Mesa County, CO",Nov-21,78215,75009,3206,4.10000000
CN0807900000000,08,079,"Mineral County, CO",Nov-21,416,401,15,3.60000000
CN0808100000000,08,081,"Moffat County, CO",Nov-21,7263,7016,247,3.40000000
CN0808300000000,08,083,"Montezuma County, CO",Nov-21,13536,12993,543,4.00000000
CN0808500000000,08,085,"Montrose County, CO",Nov-21,22814,21984,830,3.60000000
CN0808700000000,08,087,"Morgan County, CO",Nov-21,16275,15680,595,3.70000000
CN0808900000000,08,089,"Otero County, CO",Nov-21,8401,8008,393,4.70000000
CN0809100000000,08,091,"Ouray County, CO",Nov-21,2718,2627,91,3.30000000
CN0809300000000,08,093,"Park County, CO",Nov-21,11446,11105,341,3.00000000
CN0809500000000,08,095,"Phillips County, CO",Nov-21,2472,2418,54,2.20000000
CN0809700000000,08,097,"Pitkin County, CO",Nov-21,11054,10473,581,5.30000000
CN0809900000000,08,099,"Prowers County, CO",Nov-21,6332,6123,209,3.30000000
CN0810100000000,08,101,"Pueblo County, CO",Nov-21,78042,73323,4719,6.00000000
CN0810300000000,08,103,"Rio Blanco County, CO",Nov-21,2939,2810,129,4.40000000
CN0810500000000,08,105,"Rio Grande County, CO",Nov-21,5448,5167,281,5.20000000
CN0810700000000,08,107,"Routt County, CO",Nov-21,15951,15435,516,3.20000000
CN0810900000000,08,109,"Saguache County, CO",Nov-21,3491,3337,154,4.40000000
CN0811100000000,08,111,"San Juan County, CO",Nov-21,539,523,16,3.00000000
CN0811300000000,08,113,"San Miguel County, CO",Nov-21,5575,5290,285,5.10000000
CN0811500000000,08,115,"Sedgwick County, CO",Nov-21,1165,1129,36,3.10000000
CN0811700000000,08,117,"Summit County, CO",Nov-21,22998,22342,656,2.90000000
CN0811900000000,08,119,"Teller County, CO",Nov-21,13199,12720,479,3.60000000
CN0812100000000,08,121,"Washington County, CO",Nov-21,2802,2729,73,2.60000000
CN0812300000000,08,123,"Weld County, CO",Nov-21,166758,159847,6911,4.10000000
CN0812500000000,08,125,"Yuma County, CO",Nov-21,5582,5456,126,2.30000000
CN0900100000000,09,001,"Fairfield County, CT",Nov-21,468468,448706,19762,4.20000000
CN0900300000000,09,003,"Hartford County, CT",Nov-21,472813,451287,21526,4.60000000
CN0900500000000,09,005,"Litchfield County, CT",Nov-21,102079,98254,3825,3.70000000
CN0900700000000,09,007,"Middlesex County, CT",Nov-21,92240,89032,3208,3.50000000
CN0900900000000,09,009,"New Haven County, CT",Nov-21,459570,438348,21222,4.60000000
CN0901100000000,09,011,"New London County, CT",Nov-21,129716,123493,6223,4.80000000
CN0901300000000,09,013,"Tolland County, CT",Nov-21,85046,81953,3093,3.60000000
CN0901500000000,09,015,"Windham County, CT",Nov-21,62260,59607,2653,4.30000000
CN1000100000000,10,001,"Kent County, DE",Nov-21,81330,77622,3708,4.60000000
CN1000300000000,10,003,"New Castle County, DE",Nov-21,305689,293413,12276,4.00000000
CN1000500000000,10,005,"Sussex County, DE",Nov-21,110809,106606,4203,3.80000000
CN1100100000000,11,001,District of Columbia,Nov-21,383699,360212,23487,6.10000000
CN1200100000000,12,001,"Alachua County, FL",Nov-21,140855,137109,3746,2.70000000
CN1200300000000,12,003,"Baker County, FL",Nov-21,12267,11918,349,2.80000000
CN1200500000000,12,005,"Bay County, FL",Nov-21,85370,82932,2438,2.90000000
CN1200700000000,12,007,"Bradford County, FL",Nov-21,10953,10590,363,3.30000000
CN1200900000000,12,009,"Brevard County, FL",Nov-21,291698,283071,8627,3.00000000
CN1201100000000,12,011,"Broward County, FL",Nov-21,1040443,1004285,36158,3.50000000
CN1201300000000,12,013,"Calhoun County, FL",Nov-21,4830,4666,164,3.40000000
CN1201500000000,12,015,"Charlotte County, FL",Nov-21,74099,71622,2477,3.30000000
CN1201700000000,12,017,"Citrus County, FL",Nov-21,47019,44995,2024,4.30000000
CN1201900000000,12,019,"Clay County, FL",Nov-21,109439,106619,2820,2.60000000
CN1202100000000,12,021,"Collier County, FL",Nov-21,183987,179136,4851,2.60000000
CN1202300000000,12,023,"Columbia County, FL",Nov-21,29366,28359,1007,3.40000000
CN1202700000000,12,027,"DeSoto County, FL",Nov-21,14453,14042,411,2.80000000
CN1202900000000,12,029,"Dixie County, FL",Nov-21,5891,5695,196,3.30000000
CN1203100000000,12,031,"Duval County, FL",Nov-21,498415,482071,16344,3.30000000
CN1203300000000,12,033,"Escambia County, FL",Nov-21,147187,142270,4917,3.30000000
CN1203500000000,12,035,"Flagler County, FL",Nov-21,48810,47100,1710,3.50000000
CN1203700000000,12,037,"Franklin County, FL",Nov-21,4604,4467,137,3.00000000
CN1203900000000,12,039,"Gadsden County, FL",Nov-21,19848,19027,821,4.10000000
CN1204100000000,12,041,"Gilchrist County, FL",Nov-21,7349,7146,203,2.80000000
CN1204300000000,12,043,"Glades County, FL",Nov-21,5249,5096,153,2.90000000
CN1204500000000,12,045,"Gulf County, FL",Nov-21,5240,5100,140,2.70000000
CN1204700000000,12,047,"Hamilton County, FL",Nov-21,4149,3959,190,4.60000000
CN1204900000000,12,049,"Hardee County, FL",Nov-21,8915,8611,304,3.40000000
CN1205100000000,12,051,"Hendry County, FL",Nov-21,15888,15129,759,4.80000000
CN1205300000000,12,053,"Hernando County, FL",Nov-21,73989,71177,2812,3.80000000
CN1205500000000,12,055,"Highlands County, FL",Nov-21,34736,33194,1542,4.40000000
CN1205700000000,12,057,"Hillsborough County, FL",Nov-21,777313,753407,23906,3.10000000
CN1205900000000,12,059,"Holmes County, FL",Nov-21,6933,6721,212,3.10000000
CN1206100000000,12,061,"Indian River County, FL",Nov-21,65563,63255,2308,3.50000000
CN1206300000000,12,063,"Jackson County, FL",Nov-21,17161,16601,560,3.30000000
CN1206500000000,12,065,"Jefferson County, FL",Nov-21,5674,5485,189,3.30000000
CN1206700000000,12,067,"Lafayette County, FL",Nov-21,2756,2670,86,3.10000000
CN1206900000000,12,069,"Lake County, FL",Nov-21,163814,158206,5608,3.40000000
CN1207100000000,12,071,"Lee County, FL",Nov-21,362561,351442,11119,3.10000000
CN1207300000000,12,073,"Leon County, FL",Nov-21,156505,151808,4697,3.00000000
CN1207500000000,12,075,"Levy County, FL",Nov-21,16858,16283,575,3.40000000
CN1207700000000,12,077,"Liberty County, FL",Nov-21,2569,2481,88,3.40000000
CN1207900000000,12,079,"Madison County, FL",Nov-21,7814,7526,288,3.70000000
CN1208100000000,12,081,"Manatee County, FL",Nov-21,186441,181109,5332,2.90000000
CN1208300000000,12,083,"Marion County, FL",Nov-21,142009,136749,5260,3.70000000
CN1208500000000,12,085,"Martin County, FL",Nov-21,74146,72168,1978,2.70000000
CN1208600000000,12,086,"Miami-Dade County, FL",Nov-21,1344253,1299496,44757,3.30000000
CN1208700000000,12,087,"Monroe County, FL",Nov-21,47282,46304,978,2.10000000
CN1208900000000,12,089,"Nassau County, FL",Nov-21,43333,42252,1081,2.50000000
CN1209100000000,12,091,"Okaloosa County, FL",Nov-21,98739,96307,2432,2.50000000
CN1209300000000,12,093,"Okeechobee County, FL",Nov-21,17696,17131,565,3.20000000
CN1209500000000,12,095,"Orange County, FL",Nov-21,759729,732090,27639,3.60000000
CN1209700000000,12,097,"Osceola County, FL",Nov-21,190022,181400,8622,4.50000000
CN1209900000000,12,099,"Palm Beach County, FL",Nov-21,743445,720208,23237,3.10000000
CN1210100000000,12,101,"Pasco County, FL",Nov-21,248622,240533,8089,3.30000000
CN1210300000000,12,103,"Pinellas County, FL",Nov-21,491215,476777,14438,2.90000000
CN1210500000000,12,105,"Polk County, FL",Nov-21,333449,320385,13064,3.90000000
CN1210700000000,12,107,"Putnam County, FL",Nov-21,27206,25924,1282,4.70000000
CN1210900000000,12,109,"St. Johns County, FL",Nov-21,143958,140744,3214,2.20000000
CN1211100000000,12,111,"St. Lucie County, FL",Nov-21,151392,145916,5476,3.60000000
CN1211300000000,12,113,"Santa Rosa County, FL",Nov-21,85960,83735,2225,2.60000000
CN1211500000000,12,115,"Sarasota County, FL",Nov-21,194602,189091,5511,2.80000000
CN1211700000000,12,117,"Seminole County, FL",Nov-21,251629,244159,7470,3.00000000
CN1211900000000,12,119,"Sumter County, FL",Nov-21,35234,33793,1441,4.10000000
CN1212100000000,12,121,"Suwannee County, FL",Nov-21,17295,16726,569,3.30000000
CN1212300000000,12,123,"Taylor County, FL",Nov-21,7958,7663,295,3.70000000
CN1212500000000,12,125,"Union County, FL",Nov-21,4559,4437,122,2.70000000
CN1212700000000,12,127,"Volusia County, FL",Nov-21,257497,248651,8846,3.40000000
CN1212900000000,12,129,"Wakulla County, FL",Nov-21,15746,15373,373,2.40000000
CN1213100000000,12,131,"Walton County, FL",Nov-21,33528,32642,886,2.60000000
CN1213300000000,12,133,"Washington County, FL",Nov-21,9476,9165,311,3.30000000
CN1300100000000,13,001,"Appling County, GA",Nov-21,8954,8702,252,2.80000000
CN1300300000000,13,003,"Atkinson County, GA",Nov-21,4402,4307,95,2.20000000
CN1300500000000,13,005,"Bacon County, GA",Nov-21,4707,4580,127,2.70000000
CN1300700000000,13,007,"Baker County, GA",Nov-21,1111,1064,47,4.20000000
CN1300900000000,13,009,"Baldwin County, GA",Nov-21,17675,17063,612,3.50000000
CN1301100000000,13,011,"Banks County, GA",Nov-21,10297,10089,208,2.00000000
CN1301300000000,13,013,"Barrow County, GA",Nov-21,42773,41805,968,2.30000000
CN1301500000000,13,015,"Bartow County, GA",Nov-21,51890,50547,1343,2.60000000
CN1301700000000,13,017,"Ben Hill County, GA",Nov-21,5464,5258,206,3.80000000
CN1301900000000,13,019,"Berrien County, GA",Nov-21,7651,7441,210,2.70000000
CN1302100000000,13,021,"Bibb County, GA",Nov-21,68429,65996,2433,3.60000000
CN1302300000000,13,023,"Bleckley County, GA",Nov-21,4629,4461,168,3.60000000
CN1302500000000,13,025,"Brantley County, GA",Nov-21,7267,7053,214,2.90000000
CN1302700000000,13,027,"Brooks County, GA",Nov-21,6765,6571,194,2.90000000
CN1302900000000,13,029,"Bryan County, GA",Nov-21,20162,19709,453,2.20000000
CN1303100000000,13,031,"Bulloch County, GA",Nov-21,38239,37103,1136,3.00000000
CN1303300000000,13,033,"Burke County, GA",Nov-21,9038,8627,411,4.50000000
CN1303500000000,13,035,"Butts County, GA",Nov-21,11259,10963,296,2.60000000
CN1303700000000,13,037,"Calhoun County, GA",Nov-21,2204,2139,65,2.90000000
CN1303900000000,13,039,"Camden County, GA",Nov-21,21655,21082,573,2.60000000
CN1304300000000,13,043,"Candler County, GA",Nov-21,5987,5844,143,2.40000000
CN1304500000000,13,045,"Carroll County, GA",Nov-21,56796,55252,1544,2.70000000
CN1304700000000,13,047,"Catoosa County, GA",Nov-21,33894,33138,756,2.20000000
CN1304900000000,13,049,"Charlton County, GA",Nov-21,4954,4820,134,2.70000000
CN1305100000000,13,051,"Chatham County, GA",Nov-21,145042,140496,4546,3.10000000
CN1305300000000,13,053,"Chattahoochee County, GA",Nov-21,1920,1841,79,4.10000000
CN1305500000000,13,055,"Chattooga County, GA",Nov-21,9436,9111,325,3.40000000
CN1305700000000,13,057,"Cherokee County, GA",Nov-21,141792,138851,2941,2.10000000
CN1305900000000,13,059,"Clarke County, GA",Nov-21,60059,58415,1644,2.70000000
CN1306100000000,13,061,"Clay County, GA",Nov-21,847,776,71,8.40000000
CN1306300000000,13,063,"Clayton County, GA",Nov-21,140713,134122,6591,4.70000000
CN1306500000000,13,065,"Clinch County, GA",Nov-21,3006,2935,71,2.40000000
CN1306700000000,13,067,"Cobb County, GA",Nov-21,429138,418696,10442,2.40000000
CN1306900000000,13,069,"Coffee County, GA",Nov-21,18539,17994,545,2.90000000
CN1307100000000,13,071,"Colquitt County, GA",Nov-21,21846,21321,525,2.40000000
CN1307300000000,13,073,"Columbia County, GA",Nov-21,76489,74741,1748,2.30000000
CN1307500000000,13,075,"Cook County, GA",Nov-21,8227,8016,211,2.60000000
CN1307700000000,13,077,"Coweta County, GA",Nov-21,77280,75327,1953,2.50000000
CN1307900000000,13,079,"Crawford County, GA",Nov-21,5591,5424,167,3.00000000
CN1308100000000,13,081,"Crisp County, GA",Nov-21,9551,9121,430,4.50000000
CN1308300000000,13,083,"Dade County, GA",Nov-21,8140,7965,175,2.10000000
CN1308500000000,13,085,"Dawson County, GA",Nov-21,13319,13031,288,2.20000000
CN1308700000000,13,087,"Decatur County, GA",Nov-21,11274,10951,323,2.90000000
CN1308900000000,13,089,"DeKalb County, GA",Nov-21,404402,390993,13409,3.30000000
CN1309100000000,13,091,"Dodge County, GA",Nov-21,7060,6816,244,3.50000000
CN1309300000000,13,093,"Dooly County, GA",Nov-21,4741,4545,196,4.10000000
CN1309500000000,13,095,"Dougherty County, GA",Nov-21,37033,35398,1635,4.40000000
CN1309700000000,13,097,"Douglas County, GA",Nov-21,74795,72403,2392,3.20000000
CN1309900000000,13,099,"Early County, GA",Nov-21,4266,4108,158,3.70000000
CN1310100000000,13,101,"Echols County, GA",Nov-21,1877,1834,43,2.30000000
CN1310300000000,13,103,"Effingham County, GA",Nov-21,33728,32956,772,2.30000000
CN1310500000000,13,105,"Elbert County, GA",Nov-21,7654,7377,277,3.60000000
CN1310700000000,13,107,"Emanuel County, GA",Nov-21,8639,8311,328,3.80000000
CN1310900000000,13,109,"Evans County, GA",Nov-21,5183,5047,136,2.60000000
CN1311100000000,13,111,"Fannin County, GA",Nov-21,11917,11639,278,2.30000000
CN1311300000000,13,113,"Fayette County, GA",Nov-21,59100,57775,1325,2.20000000
CN1311500000000,13,115,"Floyd County, GA",Nov-21,43889,42718,1171,2.70000000
CN1311700000000,13,117,"Forsyth County, GA",Nov-21,129258,126665,2593,2.00000000
CN1311900000000,13,119,"Franklin County, GA",Nov-21,10101,9806,295,2.90000000
CN1312100000000,13,121,"Fulton County, GA",Nov-21,574271,555059,19212,3.30000000
CN1312300000000,13,123,"Gilmer County, GA",Nov-21,12379,12060,319,2.60000000
CN1312500000000,13,125,"Glascock County, GA",Nov-21,1261,1232,29,2.30000000
CN1312700000000,13,127,"Glynn County, GA",Nov-21,39134,38042,1092,2.80000000
CN1312900000000,13,129,"Gordon County, GA",Nov-21,28766,28085,681,2.40000000
CN1313100000000,13,131,"Grady County, GA",Nov-21,10948,10679,269,2.50000000
CN1313300000000,13,133,"Greene County, GA",Nov-21,7167,6957,210,2.90000000
CN1313500000000,13,135,"Gwinnett County, GA",Nov-21,498650,485828,12822,2.60000000
CN1313700000000,13,137,"Habersham County, GA",Nov-21,18520,18011,509,2.70000000
CN1313900000000,13,139,"Hall County, GA",Nov-21,106204,104013,2191,2.10000000
CN1314100000000,13,141,"Hancock County, GA",Nov-21,2489,2368,121,4.90000000
CN1314300000000,13,143,"Haralson County, GA",Nov-21,12917,12578,339,2.60000000
CN1314500000000,13,145,"Harris County, GA",Nov-21,16957,16564,393,2.30000000
CN1314700000000,13,147,"Hart County, GA",Nov-21,11738,11378,360,3.10000000
CN1314900000000,13,149,"Heard County, GA",Nov-21,5292,5139,153,2.90000000
CN1315100000000,13,151,"Henry County, GA",Nov-21,120037,116338,3699,3.10000000
CN1315300000000,13,153,"Houston County, GA",Nov-21,72061,70130,1931,2.70000000
CN1315500000000,13,155,"Irwin County, GA",Nov-21,3545,3424,121,3.40000000
CN1315700000000,13,157,"Jackson County, GA",Nov-21,44873,44047,826,1.80000000
CN1315900000000,13,159,"Jasper County, GA",Nov-21,7145,6974,171,2.40000000
CN1316100000000,13,161,"Jeff Davis County, GA",Nov-21,6016,5837,179,3.00000000
CN1316300000000,13,163,"Jefferson County, GA",Nov-21,6966,6734,232,3.30000000
CN1316500000000,13,165,"Jenkins County, GA",Nov-21,3155,3039,116,3.70000000
CN1316700000000,13,167,"Johnson County, GA",Nov-21,4122,4008,114,2.80000000
CN1316900000000,13,169,"Jones County, GA",Nov-21,13842,13510,332,2.40000000
CN1317100000000,13,171,"Lamar County, GA",Nov-21,8331,8082,249,3.00000000
CN1317300000000,13,173,"Lanier County, GA",Nov-21,3859,3743,116,3.00000000
CN1317500000000,13,175,"Laurens County, GA",Nov-21,19680,19049,631,3.20000000
CN1317700000000,13,177,"Lee County, GA",Nov-21,15190,14822,368,2.40000000
CN1317900000000,13,179,"Liberty County, GA",Nov-21,26314,25525,789,3.00000000
CN1318100000000,13,181,"Lincoln County, GA",Nov-21,3536,3409,127,3.60000000
CN1318300000000,13,183,"Long County, GA",Nov-21,8471,8246,225,2.70000000
CN1318500000000,13,185,"Lowndes County, GA",Nov-21,51778,50276,1502,2.90000000
CN1318700000000,13,187,"Lumpkin County, GA",Nov-21,17670,17302,368,2.10000000
CN1318900000000,13,189,"McDuffie County, GA",Nov-21,8459,8139,320,3.80000000
CN1319100000000,13,191,"McIntosh County, GA",Nov-21,6102,5921,181,3.00000000
CN1319300000000,13,193,"Macon County, GA",Nov-21,4544,4361,183,4.00000000
CN1319500000000,13,195,"Madison County, GA",Nov-21,13855,13514,341,2.50000000
CN1319700000000,13,197,"Marion County, GA",Nov-21,3261,3168,93,2.90000000
CN1319900000000,13,199,"Meriwether County, GA",Nov-21,8934,8595,339,3.80000000
CN1320100000000,13,201,"Miller County, GA",Nov-21,2733,2667,66,2.40000000
CN1320500000000,13,205,"Mitchell County, GA",Nov-21,7996,7698,298,3.70000000
CN1320700000000,13,207,"Monroe County, GA",Nov-21,13298,12983,315,2.40000000
CN1320900000000,13,209,"Montgomery County, GA",Nov-21,3760,3643,117,3.10000000
CN1321100000000,13,211,"Morgan County, GA",Nov-21,9611,9372,239,2.50000000
CN1321300000000,13,213,"Murray County, GA",Nov-21,15433,14958,475,3.10000000
CN1321500000000,13,215,"Muscogee County, GA",Nov-21,76500,73426,3074,4.00000000
CN1321700000000,13,217,"Newton County, GA",Nov-21,53927,52203,1724,3.20000000
CN1321900000000,13,219,"Oconee County, GA",Nov-21,20706,20338,368,1.80000000
CN1322100000000,13,221,"Oglethorpe County, GA",Nov-21,7135,6970,165,2.30000000
CN1322300000000,13,223,"Paulding County, GA",Nov-21,90751,88635,2116,2.30000000
CN1322500000000,13,225,"Peach County, GA",Nov-21,12018,11613,405,3.40000000
CN1322700000000,13,227,"Pickens County, GA",Nov-21,15798,15446,352,2.20000000
CN1322900000000,13,229,"Pierce County, GA",Nov-21,8547,8339,208,2.40000000
CN1323100000000,13,231,"Pike County, GA",Nov-21,9115,8912,203,2.20000000
CN1323300000000,13,233,"Polk County, GA",Nov-21,18516,18020,496,2.70000000
CN1323500000000,13,235,"Pulaski County, GA",Nov-21,4049,3937,112,2.80000000
CN1323700000000,13,237,"Putnam County, GA",Nov-21,8769,8492,277,3.20000000
CN1323900000000,13,239,"Quitman County, GA",Nov-21,754,722,32,4.20000000
CN1324100000000,13,241,"Rabun County, GA",Nov-21,7515,7315,200,2.70000000
CN1324300000000,13,243,"Randolph County, GA",Nov-21,2349,2253,96,4.10000000
CN1324500000000,13,245,"Richmond County, GA",Nov-21,83664,80261,3403,4.10000000
CN1324700000000,13,247,"Rockdale County, GA",Nov-21,45042,43504,1538,3.40000000
CN1324900000000,13,249,"Schley County, GA",Nov-21,2146,2073,73,3.40000000
CN1325100000000,13,251,"Screven County, GA",Nov-21,5010,4798,212,4.20000000
CN1325300000000,13,253,"Seminole County, GA",Nov-21,2947,2860,87,3.00000000
CN1325500000000,13,255,"Spalding County, GA",Nov-21,29208,28242,966,3.30000000
CN1325700000000,13,257,"Stephens County, GA",Nov-21,10534,10170,364,3.50000000
CN1325900000000,13,259,"Stewart County, GA",Nov-21,2591,2511,80,3.10000000
CN1326100000000,13,261,"Sumter County, GA",Nov-21,12202,11714,488,4.00000000
CN1326300000000,13,263,"Talbot County, GA",Nov-21,2776,2685,91,3.30000000
CN1326500000000,13,265,"Taliaferro County, GA",Nov-21,526,506,20,3.80000000
CN1326700000000,13,267,"Tattnall County, GA",Nov-21,9606,9377,229,2.40000000
CN1326900000000,13,269,"Taylor County, GA",Nov-21,2856,2729,127,4.40000000
CN1327100000000,13,271,"Telfair County, GA",Nov-21,3646,3449,197,5.40000000
CN1327300000000,13,273,"Terrell County, GA",Nov-21,3544,3368,176,5.00000000
CN1327500000000,13,275,"Thomas County, GA",Nov-21,17372,16826,546,3.10000000
CN1327700000000,13,277,"Tift County, GA",Nov-21,21514,21007,507,2.40000000
CN1327900000000,13,279,"Toombs County, GA",Nov-21,11867,11460,407,3.40000000
CN1328100000000,13,281,"Towns County, GA",Nov-21,4107,3971,136,3.30000000
CN1328300000000,13,283,"Treutlen County, GA",Nov-21,2573,2493,80,3.10000000
CN1328500000000,13,285,"Troup County, GA",Nov-21,37509,36372,1137,3.00000000
CN1328700000000,13,287,"Turner County, GA",Nov-21,3237,3097,140,4.30000000
CN1328900000000,13,289,"Twiggs County, GA",Nov-21,2830,2722,108,3.80000000
CN1329100000000,13,291,"Union County, GA",Nov-21,11207,10953,254,2.30000000
CN1329300000000,13,293,"Upson County, GA",Nov-21,11732,11398,334,2.80000000
CN1329500000000,13,295,"Walker County, GA",Nov-21,31630,30846,784,2.50000000
CN1329700000000,13,297,"Walton County, GA",Nov-21,47634,46475,1159,2.40000000
CN1329900000000,13,299,"Ware County, GA",Nov-21,15236,14822,414,2.70000000
CN1330100000000,13,301,"Warren County, GA",Nov-21,2664,2575,89,3.30000000
CN1330300000000,13,303,"Washington County, GA",Nov-21,6771,6510,261,3.90000000
CN1330500000000,13,305,"Wayne County, GA",Nov-21,11890,11549,341,2.90000000
CN1330700000000,13,307,"Webster County, GA",Nov-21,992,958,34,3.40000000
CN1330900000000,13,309,"Wheeler County, GA",Nov-21,1614,1541,73,4.50000000
CN1331100000000,13,311,"White County, GA",Nov-21,16749,16417,332,2.00000000
CN1331300000000,13,313,"Whitfield County, GA",Nov-21,43362,42136,1226,2.80000000
CN1331500000000,13,315,"Wilcox County, GA",Nov-21,2727,2639,88,3.20000000
CN1331700000000,13,317,"Wilkes County, GA",Nov-21,3598,3467,131,3.60000000
CN1331900000000,13,319,"Wilkinson County, GA",Nov-21,3594,3481,113,3.10000000
CN1332100000000,13,321,"Worth County, GA",Nov-21,8837,8571,266,3.00000000
CN1500100000000,15,001,"Hawaii County, HI",Nov-21,94871,90643,4228,4.50000000
CN1500300000000,15,003,"Honolulu County/city, HI",Nov-21,457348,437209,20139,4.40000000
CN1500700000000,15,007,"Kauai County, HI",Nov-21,37142,34965,2177,5.90000000
CN1500900000000,15,009,"Maui County, HI",Nov-21,88259,83265,4994,5.70000000
CN1600100000000,16,001,"Ada County, ID",Nov-21,269552,262631,6921,2.60000000
CN1600300000000,16,003,"Adams County, ID",Nov-21,1770,1657,113,6.40000000
CN1600500000000,16,005,"Bannock County, ID",Nov-21,43849,42674,1175,2.70000000
CN1600700000000,16,007,"Bear Lake County, ID",Nov-21,3176,3098,78,2.50000000
CN1600900000000,16,009,"Benewah County, ID",Nov-21,3996,3823,173,4.30000000
CN1601100000000,16,011,"Bingham County, ID",Nov-21,24365,23754,611,2.50000000
CN1601300000000,16,013,"Blaine County, ID",Nov-21,12429,12062,367,3.00000000
CN1601500000000,16,015,"Boise County, ID",Nov-21,3761,3593,168,4.50000000
CN1601700000000,16,017,"Bonner County, ID",Nov-21,21512,20713,799,3.70000000
CN1601900000000,16,019,"Bonneville County, ID",Nov-21,61456,60135,1321,2.10000000
CN1602100000000,16,021,"Boundary County, ID",Nov-21,5480,5302,178,3.20000000
CN1602300000000,16,023,"Butte County, ID",Nov-21,1461,1413,48,3.30000000
CN1602500000000,16,025,"Camas County, ID",Nov-21,688,670,18,2.60000000
CN1602700000000,16,027,"Canyon County, ID",Nov-21,110465,107109,3356,3.00000000
CN1602900000000,16,029,"Caribou County, ID",Nov-21,4113,4012,101,2.50000000
CN1603100000000,16,031,"Cassia County, ID",Nov-21,12654,12364,290,2.30000000
CN1603300000000,16,033,"Clark County, ID",Nov-21,376,367,9,2.40000000
CN1603500000000,16,035,"Clearwater County, ID",Nov-21,2995,2846,149,5.00000000
CN1603700000000,16,037,"Custer County, ID",Nov-21,2116,2031,85,4.00000000
CN1603900000000,16,039,"Elmore County, ID",Nov-21,12028,11681,347,2.90000000
CN1604100000000,16,041,"Franklin County, ID",Nov-21,7507,7356,151,2.00000000
CN1604300000000,16,043,"Fremont County, ID",Nov-21,8461,8269,192,2.30000000
CN1604500000000,16,045,"Gem County, ID",Nov-21,8804,8533,271,3.10000000
CN1604700000000,16,047,"Gooding County, ID",Nov-21,8431,8228,203,2.40000000
CN1604900000000,16,049,"Idaho County, ID",Nov-21,6697,6444,253,3.80000000
CN1605100000000,16,051,"Jefferson County, ID",Nov-21,14861,14571,290,2.00000000
CN1605300000000,16,053,"Jerome County, ID",Nov-21,12448,12122,326,2.60000000
CN1605500000000,16,055,"Kootenai County, ID",Nov-21,83275,80434,2841,3.40000000
CN1605700000000,16,057,"Latah County, ID",Nov-21,20689,20196,493,2.40000000
CN1605900000000,16,059,"Lemhi County, ID",Nov-21,3629,3465,164,4.50000000
CN1606100000000,16,061,"Lewis County, ID",Nov-21,1623,1547,76,4.70000000
CN1606300000000,16,063,"Lincoln County, ID",Nov-21,2621,2524,97,3.70000000
CN1606500000000,16,065,"Madison County, ID",Nov-21,24219,23847,372,1.50000000
CN1606700000000,16,067,"Minidoka County, ID",Nov-21,11952,11664,288,2.40000000
CN1606900000000,16,069,"Nez Perce County, ID",Nov-21,21026,20485,541,2.60000000
CN1607100000000,16,071,"Oneida County, ID",Nov-21,2631,2572,59,2.20000000
CN1607300000000,16,073,"Owyhee County, ID",Nov-21,5505,5328,177,3.20000000
CN1607500000000,16,075,"Payette County, ID",Nov-21,12164,11792,372,3.10000000
CN1607700000000,16,077,"Power County, ID",Nov-21,4082,3968,114,2.80000000
CN1607900000000,16,079,"Shoshone County, ID",Nov-21,5420,5122,298,5.50000000
CN1608100000000,16,081,"Teton County, ID",Nov-21,6820,6601,219,3.20000000
CN1608300000000,16,083,"Twin Falls County, ID",Nov-21,42509,41321,1188,2.80000000
CN1608500000000,16,085,"Valley County, ID",Nov-21,5328,5085,243,4.60000000
CN1608700000000,16,087,"Washington County, ID",Nov-21,4888,4727,161,3.30000000
CN1700100000000,17,001,"Adams County, IL",Nov-21,30509,29641,868,2.80000000
CN1700300000000,17,003,"Alexander County, IL",Nov-21,1830,1711,119,6.50000000
CN1700500000000,17,005,"Bond County, IL",Nov-21,7439,7175,264,3.50000000
CN1700700000000,17,007,"Boone County, IL",Nov-21,24958,23460,1498,6.00000000
CN1700900000000,17,009,"Brown County, IL",Nov-21,3054,2996,58,1.90000000
CN1701100000000,17,011,"Bureau County, IL",Nov-21,16009,15425,584,3.60000000
CN1701300000000,17,013,"Calhoun County, IL",Nov-21,2158,2082,76,3.50000000
CN1701500000000,17,015,"Carroll County, IL",Nov-21,7450,7217,233,3.10000000
CN1701700000000,17,017,"Cass County, IL",Nov-21,5572,5368,204,3.70000000
CN1701900000000,17,019,"Champaign County, IL",Nov-21,112391,108554,3837,3.40000000
CN1702100000000,17,021,"Christian County, IL",Nov-21,13354,12822,532,4.00000000
CN1702300000000,17,023,"Clark County, IL",Nov-21,7115,6850,265,3.70000000
CN1702500000000,17,025,"Clay County, IL",Nov-21,5788,5548,240,4.10000000
CN1702700000000,17,027,"Clinton County, IL",Nov-21,19821,19322,499,2.50000000
CN1702900000000,17,029,"Coles County, IL",Nov-21,23018,22159,859,3.70000000
CN1703100000000,17,031,"Cook County, IL",Nov-21,2626147,2496022,130125,5.00000000
CN1703300000000,17,033,"Crawford County, IL",Nov-21,8741,8414,327,3.70000000
CN1703500000000,17,035,"Cumberland County, IL",Nov-21,5964,5779,185,3.10000000
CN1703700000000,17,037,"DeKalb County, IL",Nov-21,53754,51552,2202,4.10000000
CN1703900000000,17,039,"De Witt County, IL",Nov-21,7245,6990,255,3.50000000
CN1704100000000,17,041,"Douglas County, IL",Nov-21,10248,9962,286,2.80000000
CN1704300000000,17,043,"DuPage County, IL",Nov-21,509082,493930,15152,3.00000000
CN1704500000000,17,045,"Edgar County, IL",Nov-21,8950,8676,274,3.10000000
CN1704700000000,17,047,"Edwards County, IL",Nov-21,2521,2429,92,3.60000000
CN1704900000000,17,049,"Effingham County, IL",Nov-21,19518,18971,547,2.80000000
CN1705100000000,17,051,"Fayette County, IL",Nov-21,9681,9322,359,3.70000000
CN1705300000000,17,053,"Ford County, IL",Nov-21,6355,6162,193,3.00000000
CN1705500000000,17,055,"Franklin County, IL",Nov-21,15756,14933,823,5.20000000
CN1705700000000,17,057,"Fulton County, IL",Nov-21,14343,13744,599,4.20000000
CN1705900000000,17,059,"Gallatin County, IL",Nov-21,1984,1891,93,4.70000000
CN1706100000000,17,061,"Greene County, IL",Nov-21,5816,5614,202,3.50000000
CN1706300000000,17,063,"Grundy County, IL",Nov-21,25511,24624,887,3.50000000
CN1706500000000,17,065,"Hamilton County, IL",Nov-21,4169,4039,130,3.10000000
CN1706700000000,17,067,"Hancock County, IL",Nov-21,8084,7836,248,3.10000000
CN1706900000000,17,069,"Hardin County, IL",Nov-21,1313,1243,70,5.30000000
CN1707100000000,17,071,"Henderson County, IL",Nov-21,3526,3425,101,2.90000000
CN1707300000000,17,073,"Henry County, IL",Nov-21,23749,22904,845,3.60000000
CN1707500000000,17,075,"Iroquois County, IL",Nov-21,12906,12431,475,3.70000000
CN1707700000000,17,077,"Jackson County, IL",Nov-21,27906,26817,1089,3.90000000
CN1707900000000,17,079,"Jasper County, IL",Nov-21,4684,4544,140,3.00000000
CN1708100000000,17,081,"Jefferson County, IL",Nov-21,16424,15635,789,4.80000000
CN1708300000000,17,083,"Jersey County, IL",Nov-21,10549,10218,331,3.10000000
CN1708500000000,17,085,"Jo Daviess County, IL",Nov-21,10327,10014,313,3.00000000
CN1708700000000,17,087,"Johnson County, IL",Nov-21,4082,3886,196,4.80000000
CN1708900000000,17,089,"Kane County, IL",Nov-21,263786,252538,11248,4.30000000
CN1709100000000,17,091,"Kankakee County, IL",Nov-21,52314,49658,2656,5.10000000
CN1709300000000,17,093,"Kendall County, IL",Nov-21,70969,68781,2188,3.10000000
CN1709500000000,17,095,"Knox County, IL",Nov-21,20171,19140,1031,5.10000000
CN1709700000000,17,097,"Lake County, IL",Nov-21,367472,353417,14055,3.80000000
CN1709900000000,17,099,"LaSalle County, IL",Nov-21,52575,50264,2311,4.40000000
CN1710100000000,17,101,"Lawrence County, IL",Nov-21,5590,5308,282,5.00000000
CN1710300000000,17,103,"Lee County, IL",Nov-21,16732,16151,581,3.50000000
CN1710500000000,17,105,"Livingston County, IL",Nov-21,15417,14879,538,3.50000000
CN1710700000000,17,107,"Logan County, IL",Nov-21,11704,11289,415,3.50000000
CN1710900000000,17,109,"McDonough County, IL",Nov-21,13147,12707,440,3.30000000
CN1711100000000,17,111,"McHenry County, IL",Nov-21,165871,160766,5105,3.10000000
CN1711300000000,17,113,"McLean County, IL",Nov-21,88051,85214,2837,3.20000000
CN1711500000000,17,115,"Macon County, IL",Nov-21,46707,43895,2812,6.00000000
CN1711700000000,17,117,"Macoupin County, IL",Nov-21,22016,21259,757,3.40000000
CN1711900000000,17,119,"Madison County, IL",Nov-21,131132,126465,4667,3.60000000
CN1712100000000,17,121,"Marion County, IL",Nov-21,16764,15993,771,4.60000000
CN1712300000000,17,123,"Marshall County, IL",Nov-21,5064,4848,216,4.30000000
CN1712500000000,17,125,"Mason County, IL",Nov-21,5823,5586,237,4.10000000
CN1712700000000,17,127,"Massac County, IL",Nov-21,5334,5120,214,4.00000000
CN1712900000000,17,129,"Menard County, IL",Nov-21,6225,6040,185,3.00000000
CN1713100000000,17,131,"Mercer County, IL",Nov-21,7547,7297,250,3.30000000
CN1713300000000,17,133,"Monroe County, IL",Nov-21,18586,18176,410,2.20000000
CN1713500000000,17,135,"Montgomery County, IL",Nov-21,11115,10653,462,4.20000000
CN1713700000000,17,137,"Morgan County, IL",Nov-21,15656,15066,590,3.80000000
CN1713900000000,17,139,"Moultrie County, IL",Nov-21,7348,7156,192,2.60000000
CN1714100000000,17,141,"Ogle County, IL",Nov-21,23577,22577,1000,4.20000000
CN1714300000000,17,143,"Peoria County, IL",Nov-21,82632,78057,4575,5.50000000
CN1714500000000,17,145,"Perry County, IL",Nov-21,7968,7604,364,4.60000000
CN1714700000000,17,147,"Piatt County, IL",Nov-21,8778,8523,255,2.90000000
CN1714900000000,17,149,"Pike County, IL",Nov-21,6673,6457,216,3.20000000
CN1715100000000,17,151,"Pope County, IL",Nov-21,1664,1603,61,3.70000000
CN1715300000000,17,153,"Pulaski County, IL",Nov-21,1685,1563,122,7.20000000
CN1715500000000,17,155,"Putnam County, IL",Nov-21,2909,2801,108,3.70000000
CN1715700000000,17,157,"Randolph County, IL",Nov-21,13588,13162,426,3.10000000
CN1715900000000,17,159,"Richland County, IL",Nov-21,7092,6863,229,3.20000000
CN1716100000000,17,161,"Rock Island County, IL",Nov-21,68035,65278,2757,4.10000000
CN1716300000000,17,163,"St. Clair County, IL",Nov-21,123811,118115,5696,4.60000000
CN1716500000000,17,165,"Saline County, IL",Nov-21,9200,8727,473,5.10000000
CN1716700000000,17,167,"Sangamon County, IL",Nov-21,99043,94985,4058,4.10000000
CN1716900000000,17,169,"Schuyler County, IL",Nov-21,3132,3032,100,3.20000000
CN1717100000000,17,171,"Scott County, IL",Nov-21,2260,2172,88,3.90000000
CN1717300000000,17,173,"Shelby County, IL",Nov-21,10251,9927,324,3.20000000
CN1717500000000,17,175,"Stark County, IL",Nov-21,2353,2250,103,4.40000000
CN1717700000000,17,177,"Stephenson County, IL",Nov-21,20615,19782,833,4.00000000
CN1717900000000,17,179,"Tazewell County, IL",Nov-21,61474,59244,2230,3.60000000
CN1718100000000,17,181,"Union County, IL",Nov-21,7221,6898,323,4.50000000
CN1718300000000,17,183,"Vermilion County, IL",Nov-21,31635,30026,1609,5.10000000
CN1718500000000,17,185,"Wabash County, IL",Nov-21,5413,5226,187,3.50000000
CN1718700000000,17,187,"Warren County, IL",Nov-21,7586,7333,253,3.30000000
CN1718900000000,17,189,"Washington County, IL",Nov-21,9514,9295,219,2.30000000
CN1719100000000,17,191,"Wayne County, IL",Nov-21,6788,6554,234,3.40000000
CN1719300000000,17,193,"White County, IL",Nov-21,5924,5696,228,3.80000000
CN1719500000000,17,195,"Whiteside County, IL",Nov-21,27372,26417,955,3.50000000
CN1719700000000,17,197,"Will County, IL",Nov-21,361020,346954,14066,3.90000000
CN1719900000000,17,199,"Williamson County, IL",Nov-21,32035,30699,1336,4.20000000
CN1720100000000,17,201,"Winnebago County, IL",Nov-21,134370,125525,8845,6.60000000
CN1720300000000,17,203,"Woodford County, IL",Nov-21,18058,17539,519,2.90000000
CN1800100000000,18,001,"Adams County, IN",Nov-21,16547,16304,243,1.50000000
CN1800300000000,18,003,"Allen County, IN",Nov-21,183970,180001,3969,2.20000000
CN1800500000000,18,005,"Bartholomew County, IN",Nov-21,42681,41948,733,1.70000000
CN1800700000000,18,007,"Benton County, IN",Nov-21,4240,4170,70,1.70000000
CN1800900000000,18,009,"Blackford County, IN",Nov-21,4589,4484,105,2.30000000
CN1801100000000,18,011,"Boone County, IN",Nov-21,37218,36741,477,1.30000000
CN1801300000000,18,013,"Brown County, IN",Nov-21,7655,7514,141,1.80000000
CN1801500000000,18,015,"Carroll County, IN",Nov-21,9641,9455,186,1.90000000
CN1801700000000,18,017,"Cass County, IN",Nov-21,16835,16441,394,2.30000000
CN1801900000000,18,019,"Clark County, IN",Nov-21,61522,60295,1227,2.00000000
CN1802100000000,18,021,"Clay County, IN",Nov-21,11473,11231,242,2.10000000
CN1802300000000,18,023,"Clinton County, IN",Nov-21,16649,16362,287,1.70000000
CN1802500000000,18,025,"Crawford County, IN",Nov-21,4683,4580,103,2.20000000
CN1802700000000,18,027,"Daviess County, IN",Nov-21,16129,15890,239,1.50000000
CN1802900000000,18,029,"Dearborn County, IN",Nov-21,25048,24595,453,1.80000000
CN1803100000000,18,031,"Decatur County, IN",Nov-21,14583,14332,251,1.70000000
CN1803300000000,18,033,"DeKalb County, IN",Nov-21,21788,21447,341,1.60000000
CN1803500000000,18,035,"Delaware County, IN",Nov-21,51848,50583,1265,2.40000000
CN1803700000000,18,037,"Dubois County, IN",Nov-21,21495,21207,288,1.30000000
CN1803900000000,18,039,"Elkhart County, IN",Nov-21,116228,114512,1716,1.50000000
CN1804100000000,18,041,"Fayette County, IN",Nov-21,8250,8011,239,2.90000000
CN1804300000000,18,043,"Floyd County, IN",Nov-21,41389,40694,695,1.70000000
CN1804500000000,18,045,"Fountain County, IN",Nov-21,7528,7399,129,1.70000000
CN1804700000000,18,047,"Franklin County, IN",Nov-21,11106,10924,182,1.60000000
CN1804900000000,18,049,"Fulton County, IN",Nov-21,9282,9097,185,2.00000000
CN1805100000000,18,051,"Gibson County, IN",Nov-21,18797,18512,285,1.50000000
CN1805300000000,18,053,"Grant County, IN",Nov-21,31311,30549,762,2.40000000
CN1805500000000,18,055,"Greene County, IN",Nov-21,13468,13183,285,2.10000000
CN1805700000000,18,057,"Hamilton County, IN",Nov-21,190066,187534,2532,1.30000000
CN1805900000000,18,059,"Hancock County, IN",Nov-21,41551,40878,673,1.60000000
CN1806100000000,18,061,"Harrison County, IN",Nov-21,20038,19714,324,1.60000000
CN1806300000000,18,063,"Hendricks County, IN",Nov-21,92474,91079,1395,1.50000000
CN1806500000000,18,065,"Henry County, IN",Nov-21,21555,21096,459,2.10000000
CN1806700000000,18,067,"Howard County, IN",Nov-21,33821,32100,1721,5.10000000
CN1806900000000,18,069,"Huntington County, IN",Nov-21,17769,17474,295,1.70000000
CN1807100000000,18,071,"Jackson County, IN",Nov-21,22970,22554,416,1.80000000
CN1807300000000,18,073,"Jasper County, IN",Nov-21,15315,15005,310,2.00000000
CN1807500000000,18,075,"Jay County, IN",Nov-21,8619,8477,142,1.60000000
CN1807700000000,18,077,"Jefferson County, IN",Nov-21,14810,14541,269,1.80000000
CN1807900000000,18,079,"Jennings County, IN",Nov-21,13206,12925,281,2.10000000
CN1808100000000,18,081,"Johnson County, IN",Nov-21,84514,83197,1317,1.60000000
CN1808300000000,18,083,"Knox County, IN",Nov-21,18010,17700,310,1.70000000
CN1808500000000,18,085,"Kosciusko County, IN",Nov-21,39905,39244,661,1.70000000
CN1808700000000,18,087,"LaGrange County, IN",Nov-21,20500,20248,252,1.20000000
CN1808900000000,18,089,"Lake County, IN",Nov-21,221188,212891,8297,3.80000000
CN1809100000000,18,091,"LaPorte County, IN",Nov-21,46051,44677,1374,3.00000000
CN1809300000000,18,093,"Lawrence County, IN",Nov-21,20745,20305,440,2.10000000
CN1809500000000,18,095,"Madison County, IN",Nov-21,58553,57114,1439,2.50000000
CN1809700000000,18,097,"Marion County, IN",Nov-21,496143,482683,13460,2.70000000
CN1809900000000,18,099,"Marshall County, IN",Nov-21,22135,21772,363,1.60000000
CN1810100000000,18,101,"Martin County, IN",Nov-21,5291,5209,82,1.50000000
CN1810300000000,18,103,"Miami County, IN",Nov-21,14366,13914,452,3.10000000
CN1810500000000,18,105,"Monroe County, IN",Nov-21,71356,70159,1197,1.70000000
CN1810700000000,18,107,"Montgomery County, IN",Nov-21,18198,17899,299,1.60000000
CN1810900000000,18,109,"Morgan County, IN",Nov-21,36349,35707,642,1.80000000
CN1811100000000,18,111,"Newton County, IN",Nov-21,6513,6363,150,2.30000000
CN1811300000000,18,113,"Noble County, IN",Nov-21,21548,21108,440,2.00000000
CN1811500000000,18,115,"Ohio County, IN",Nov-21,3101,3056,45,1.50000000
CN1811700000000,18,117,"Orange County, IN",Nov-21,7968,7758,210,2.60000000
CN1811900000000,18,119,"Owen County, IN",Nov-21,9397,9201,196,2.10000000
CN1812100000000,18,121,"Parke County, IN",Nov-21,6811,6691,120,1.80000000
CN1812300000000,18,123,"Perry County, IN",Nov-21,8491,8330,161,1.90000000
CN1812500000000,18,125,"Pike County, IN",Nov-21,5584,5472,112,2.00000000
CN1812700000000,18,127,"Porter County, IN",Nov-21,83230,81343,1887,2.30000000
CN1812900000000,18,129,"Posey County, IN",Nov-21,12734,12536,198,1.60000000
CN1813100000000,18,131,"Pulaski County, IN",Nov-21,6204,6092,112,1.80000000
CN1813300000000,18,133,"Putnam County, IN",Nov-21,16371,16086,285,1.70000000
CN1813500000000,18,135,"Randolph County, IN",Nov-21,12122,11921,201,1.70000000
CN1813700000000,18,137,"Ripley County, IN",Nov-21,13237,13011,226,1.70000000
CN1813900000000,18,139,"Rush County, IN",Nov-21,8679,8524,155,1.80000000
CN1814100000000,18,141,"St. Joseph County, IN",Nov-21,129984,126748,3236,2.50000000
CN1814300000000,18,143,"Scott County, IN",Nov-21,10331,10076,255,2.50000000
CN1814500000000,18,145,"Shelby County, IN",Nov-21,23103,22675,428,1.90000000
CN1814700000000,18,147,"Spencer County, IN",Nov-21,9901,9734,167,1.70000000
CN1814900000000,18,149,"Starke County, IN",Nov-21,9329,9086,243,2.60000000
CN1815100000000,18,151,"Steuben County, IN",Nov-21,19814,19511,303,1.50000000
CN1815300000000,18,153,"Sullivan County, IN",Nov-21,7823,7631,192,2.50000000
CN1815500000000,18,155,"Switzerland County, IN",Nov-21,4604,4513,91,2.00000000
CN1815700000000,18,157,"Tippecanoe County, IN",Nov-21,94942,93046,1896,2.00000000
CN1815900000000,18,159,"Tipton County, IN",Nov-21,8772,8580,192,2.20000000
CN1816100000000,18,161,"Union County, IN",Nov-21,3439,3395,44,1.30000000
CN1816300000000,18,163,"Vanderburgh County, IN",Nov-21,90664,88597,2067,2.30000000
CN1816500000000,18,165,"Vermillion County, IN",Nov-21,6477,6309,168,2.60000000
CN1816700000000,18,167,"Vigo County, IN",Nov-21,45466,44248,1218,2.70000000
CN1816900000000,18,169,"Wabash County, IN",Nov-21,14382,14111,271,1.90000000
CN1817100000000,18,171,"Warren County, IN",Nov-21,3953,3892,61,1.50000000
CN1817300000000,18,173,"Warrick County, IN",Nov-21,31728,31219,509,1.60000000
CN1817500000000,18,175,"Washington County, IN",Nov-21,13441,13198,243,1.80000000
CN1817700000000,18,177,"Wayne County, IN",Nov-21,29073,28416,657,2.30000000
CN1817900000000,18,179,"Wells County, IN",Nov-21,13867,13662,205,1.50000000
CN1818100000000,18,181,"White County, IN",Nov-21,12889,12663,226,1.80000000
CN1818300000000,18,183,"Whitley County, IN",Nov-21,17289,17022,267,1.50000000
CN1900100000000,19,001,"Adair County, IA",Nov-21,4396,4288,108,2.50000000
CN1900300000000,19,003,"Adams County, IA",Nov-21,2030,1985,45,2.20000000
CN1900500000000,19,005,"Allamakee County, IA",Nov-21,7032,6815,217,3.10000000
CN1900700000000,19,007,"Appanoose County, IA",Nov-21,5945,5743,202,3.40000000
CN1900900000000,19,009,"Audubon County, IA",Nov-21,3062,2996,66,2.20000000
CN1901100000000,19,011,"Benton County, IA",Nov-21,12865,12415,450,3.50000000
CN1901300000000,19,013,"Black Hawk County, IA",Nov-21,67650,65234,2416,3.60000000
CN1901500000000,19,015,"Boone County, IA",Nov-21,14550,14162,388,2.70000000
CN1901700000000,19,017,"Bremer County, IA",Nov-21,13969,13632,337,2.40000000
CN1901900000000,19,019,"Buchanan County, IA",Nov-21,11109,10808,301,2.70000000
CN1902100000000,19,021,"Buena Vista County, IA",Nov-21,11984,11719,265,2.20000000
CN1902300000000,19,023,"Butler County, IA",Nov-21,7985,7771,214,2.70000000
CN1902500000000,19,025,"Calhoun County, IA",Nov-21,4058,3940,118,2.90000000
CN1902700000000,19,027,"Carroll County, IA",Nov-21,10615,10367,248,2.30000000
CN1902900000000,19,029,"Cass County, IA",Nov-21,6800,6605,195,2.90000000
CN1903100000000,19,031,"Cedar County, IA",Nov-21,10473,10202,271,2.60000000
CN1903300000000,19,033,"Cerro Gordo County, IA",Nov-21,22097,21352,745,3.40000000
CN1903500000000,19,035,"Cherokee County, IA",Nov-21,6090,5937,153,2.50000000
CN1903700000000,19,037,"Chickasaw County, IA",Nov-21,6413,6257,156,2.40000000
CN1903900000000,19,039,"Clarke County, IA",Nov-21,4835,4688,147,3.00000000
CN1904100000000,19,041,"Clay County, IA",Nov-21,8500,8261,239,2.80000000
CN1904300000000,19,043,"Clayton County, IA",Nov-21,9578,9238,340,3.50000000
CN1904500000000,19,045,"Clinton County, IA",Nov-21,21897,20989,908,4.10000000
CN1904700000000,19,047,"Crawford County, IA",Nov-21,7978,7673,305,3.80000000
CN1904900000000,19,049,"Dallas County, IA",Nov-21,52273,51112,1161,2.20000000
CN1905100000000,19,051,"Davis County, IA",Nov-21,4260,4146,114,2.70000000
CN1905300000000,19,053,"Decatur County, IA",Nov-21,4427,4316,111,2.50000000
CN1905500000000,19,055,"Delaware County, IA",Nov-21,10560,10315,245,2.30000000
CN1905700000000,19,057,"Des Moines County, IA",Nov-21,18178,17237,941,5.20000000
CN1905900000000,19,059,"Dickinson County, IA",Nov-21,9749,9439,310,3.20000000
CN1906100000000,19,061,"Dubuque County, IA",Nov-21,54639,52867,1772,3.20000000
CN1906300000000,19,063,"Emmet County, IA",Nov-21,4870,4725,145,3.00000000
CN1906500000000,19,065,"Fayette County, IA",Nov-21,10200,9848,352,3.50000000
CN1906700000000,19,067,"Floyd County, IA",Nov-21,8215,7937,278,3.40000000
CN1906900000000,19,069,"Franklin County, IA",Nov-21,5571,5421,150,2.70000000
CN1907100000000,19,071,"Fremont County, IA",Nov-21,3718,3618,100,2.70000000
CN1907300000000,19,073,"Greene County, IA",Nov-21,5416,5272,144,2.70000000
CN1907500000000,19,075,"Grundy County, IA",Nov-21,6434,6265,169,2.60000000
CN1907700000000,19,077,"Guthrie County, IA",Nov-21,5565,5379,186,3.30000000
CN1907900000000,19,079,"Hamilton County, IA",Nov-21,6929,6706,223,3.20000000
CN1908100000000,19,081,"Hancock County, IA",Nov-21,5743,5560,183,3.20000000
CN1908300000000,19,083,"Hardin County, IA",Nov-21,7879,7644,235,3.00000000
CN1908500000000,19,085,"Harrison County, IA",Nov-21,7059,6840,219,3.10000000
CN1908700000000,19,087,"Henry County, IA",Nov-21,9594,9295,299,3.10000000
CN1908900000000,19,089,"Howard County, IA",Nov-21,5133,4988,145,2.80000000
CN1909100000000,19,091,"Humboldt County, IA",Nov-21,4964,4846,118,2.40000000
CN1909300000000,19,093,"Ida County, IA",Nov-21,3935,3854,81,2.10000000
CN1909500000000,19,095,"Iowa County, IA",Nov-21,10059,9791,268,2.70000000
CN1909700000000,19,097,"Jackson County, IA",Nov-21,10547,10186,361,3.40000000
CN1909900000000,19,099,"Jasper County, IA",Nov-21,18977,18336,641,3.40000000
CN1910100000000,19,101,"Jefferson County, IA",Nov-21,9913,9603,310,3.10000000
CN1910300000000,19,103,"Johnson County, IA",Nov-21,85525,83165,2360,2.80000000
CN1910500000000,19,105,"Jones County, IA",Nov-21,10175,9853,322,3.20000000
CN1910700000000,19,107,"Keokuk County, IA",Nov-21,5185,5008,177,3.40000000
CN1910900000000,19,109,"Kossuth County, IA",Nov-21,8161,7956,205,2.50000000
CN1911100000000,19,111,"Lee County, IA",Nov-21,15159,14438,721,4.80000000
CN1911300000000,19,113,"Linn County, IA",Nov-21,117798,113307,4491,3.80000000
CN1911500000000,19,115,"Louisa County, IA",Nov-21,5802,5607,195,3.40000000
CN1911700000000,19,117,"Lucas County, IA",Nov-21,4655,4547,108,2.30000000
CN1911900000000,19,119,"Lyon County, IA",Nov-21,6990,6878,112,1.60000000
CN1912100000000,19,121,"Madison County, IA",Nov-21,8526,8243,283,3.30000000
CN1912300000000,19,123,"Mahaska County, IA",Nov-21,12016,11681,335,2.80000000
CN1912500000000,19,125,"Marion County, IA",Nov-21,18680,18241,439,2.40000000
CN1912700000000,19,127,"Marshall County, IA",Nov-21,16904,16097,807,4.80000000
CN1912900000000,19,129,"Mills County, IA",Nov-21,7000,6820,180,2.60000000
CN1913100000000,19,131,"Mitchell County, IA",Nov-21,5859,5724,135,2.30000000
CN1913300000000,19,133,"Monona County, IA",Nov-21,4416,4263,153,3.50000000
CN1913500000000,19,135,"Monroe County, IA",Nov-21,3924,3794,130,3.30000000
CN1913700000000,19,137,"Montgomery County, IA",Nov-21,4905,4760,145,3.00000000
CN1913900000000,19,139,"Muscatine County, IA",Nov-21,20436,19733,703,3.40000000
CN1914100000000,19,141,"O'Brien County, IA",Nov-21,8082,7898,184,2.30000000
CN1914300000000,19,143,"Osceola County, IA",Nov-21,3605,3541,64,1.80000000
CN1914500000000,19,145,"Page County, IA",Nov-21,6244,6046,198,3.20000000
CN1914700000000,19,147,"Palo Alto County, IA",Nov-21,4497,4385,112,2.50000000
CN1914900000000,19,149,"Plymouth County, IA",Nov-21,14526,14180,346,2.40000000
CN1915100000000,19,151,"Pocahontas County, IA",Nov-21,4375,4291,84,1.90000000
CN1915300000000,19,153,"Polk County, IA",Nov-21,268388,259335,9053,3.40000000
CN1915500000000,19,155,"Pottawattamie County, IA",Nov-21,46816,45276,1540,3.30000000
CN1915700000000,19,157,"Poweshiek County, IA",Nov-21,10446,10121,325,3.10000000
CN1915900000000,19,159,"Ringgold County, IA",Nov-21,2396,2335,61,2.50000000
CN1916100000000,19,161,"Sac County, IA",Nov-21,5202,5067,135,2.60000000
CN1916300000000,19,163,"Scott County, IA",Nov-21,87070,83438,3632,4.20000000
CN1916500000000,19,165,"Shelby County, IA",Nov-21,6242,6097,145,2.30000000
CN1916700000000,19,167,"Sioux County, IA",Nov-21,22334,21960,374,1.70000000
CN1916900000000,19,169,"Story County, IA",Nov-21,58873,57574,1299,2.20000000
CN1917100000000,19,171,"Tama County, IA",Nov-21,9106,8819,287,3.20000000
CN1917300000000,19,173,"Taylor County, IA",Nov-21,3111,3035,76,2.40000000
CN1917500000000,19,175,"Union County, IA",Nov-21,6154,5971,183,3.00000000
CN1917700000000,19,177,"Van Buren County, IA",Nov-21,3627,3525,102,2.80000000
CN1917900000000,19,179,"Wapello County, IA",Nov-21,17355,16711,644,3.70000000
CN1918100000000,19,181,"Warren County, IA",Nov-21,28346,27593,753,2.70000000
CN1918300000000,19,183,"Washington County, IA",Nov-21,11633,11332,301,2.60000000
CN1918500000000,19,185,"Wayne County, IA",Nov-21,2846,2767,79,2.80000000
CN1918700000000,19,187,"Webster County, IA",Nov-21,18379,17740,639,3.50000000
CN1918900000000,19,189,"Winnebago County, IA",Nov-21,4857,4686,171,3.50000000
CN1919100000000,19,191,"Winneshiek County, IA",Nov-21,11669,11346,323,2.80000000
CN1919300000000,19,193,"Woodbury County, IA",Nov-21,54565,52793,1772,3.20000000
CN1919500000000,19,195,"Worth County, IA",Nov-21,3990,3861,129,3.20000000
CN1919700000000,19,197,"Wright County, IA",Nov-21,6647,6424,223,3.40000000
CN2000100000000,20,001,"Allen County, KS",Nov-21,6613,6478,135,2.00000000
CN2000300000000,20,003,"Anderson County, KS",Nov-21,4745,4671,74,1.60000000
CN2000500000000,20,005,"Atchison County, KS",Nov-21,6793,6634,159,2.30000000
CN2000700000000,20,007,"Barber County, KS",Nov-21,2311,2281,30,1.30000000
CN2000900000000,20,009,"Barton County, KS",Nov-21,13476,13208,268,2.00000000
CN2001100000000,20,011,"Bourbon County, KS",Nov-21,6462,6295,167,2.60000000
CN2001300000000,20,013,"Brown County, KS",Nov-21,5126,5035,91,1.80000000
CN2001500000000,20,015,"Butler County, KS",Nov-21,32706,31926,780,2.40000000
CN2001700000000,20,017,"Chase County, KS",Nov-21,1379,1357,22,1.60000000
CN2001900000000,20,019,"Chautauqua County, KS",Nov-21,1439,1401,38,2.60000000
CN2002100000000,20,021,"Cherokee County, KS",Nov-21,9990,9793,197,2.00000000
CN2002300000000,20,023,"Cheyenne County, KS",Nov-21,1305,1286,19,1.50000000
CN2002500000000,20,025,"Clark County, KS",Nov-21,1170,1155,15,1.30000000
CN2002700000000,20,027,"Clay County, KS",Nov-21,3821,3759,62,1.60000000
CN2002900000000,20,029,"Cloud County, KS",Nov-21,3945,3877,68,1.70000000
CN2003100000000,20,031,"Coffey County, KS",Nov-21,3790,3702,88,2.30000000
CN2003300000000,20,033,"Comanche County, KS",Nov-21,917,900,17,1.90000000
CN2003500000000,20,035,"Cowley County, KS",Nov-21,16686,16289,397,2.40000000
CN2003700000000,20,037,"Crawford County, KS",Nov-21,19215,18803,412,2.10000000
CN2003900000000,20,039,"Decatur County, KS",Nov-21,1231,1207,24,1.90000000
CN2004100000000,20,041,"Dickinson County, KS",Nov-21,9197,9011,186,2.00000000
CN2004300000000,20,043,"Doniphan County, KS",Nov-21,4152,4081,71,1.70000000
CN2004500000000,20,045,"Douglas County, KS",Nov-21,66633,65326,1307,2.00000000
CN2004700000000,20,047,"Edwards County, KS",Nov-21,1464,1443,21,1.40000000
CN2004900000000,20,049,"Elk County, KS",Nov-21,1192,1173,19,1.60000000
CN2005100000000,20,051,"Ellis County, KS",Nov-21,17253,17041,212,1.20000000
CN2005300000000,20,053,"Ellsworth County, KS",Nov-21,2719,2679,40,1.50000000
CN2005500000000,20,055,"Finney County, KS",Nov-21,20280,19988,292,1.40000000
CN2005700000000,20,057,"Ford County, KS",Nov-21,17839,17582,257,1.40000000
CN2005900000000,20,059,"Franklin County, KS",Nov-21,14732,14447,285,1.90000000
CN2006100000000,20,061,"Geary County, KS",Nov-21,11487,11152,335,2.90000000
CN2006300000000,20,063,"Gove County, KS",Nov-21,1493,1474,19,1.30000000
CN2006500000000,20,065,"Graham County, KS",Nov-21,1131,1105,26,2.30000000
CN2006700000000,20,067,"Grant County, KS",Nov-21,2988,2921,67,2.20000000
CN2006900000000,20,069,"Gray County, KS",Nov-21,3330,3294,36,1.10000000
CN2007100000000,20,071,"Greeley County, KS",Nov-21,826,820,6,0.70000000
CN2007300000000,20,073,"Greenwood County, KS",Nov-21,3017,2960,57,1.90000000
CN2007500000000,20,075,"Hamilton County, KS",Nov-21,1636,1621,15,0.90000000
CN2007700000000,20,077,"Harper County, KS",Nov-21,2776,2727,49,1.80000000
CN2007900000000,20,079,"Harvey County, KS",Nov-21,17064,16743,321,1.90000000
CN2008100000000,20,081,"Haskell County, KS",Nov-21,2239,2210,29,1.30000000
CN2008300000000,20,083,"Hodgeman County, KS",Nov-21,1062,1049,13,1.20000000
CN2008500000000,20,085,"Jackson County, KS",Nov-21,7141,7014,127,1.80000000
CN2008700000000,20,087,"Jefferson County, KS",Nov-21,10193,9975,218,2.10000000
CN2008900000000,20,089,"Jewell County, KS",Nov-21,1236,1217,19,1.50000000
CN2009100000000,20,091,"Johnson County, KS",Nov-21,343962,337885,6077,1.80000000
CN2009300000000,20,093,"Kearny County, KS",Nov-21,2113,2089,24,1.10000000
CN2009500000000,20,095,"Kingman County, KS",Nov-21,3306,3245,61,1.80000000
CN2009700000000,20,097,"Kiowa County, KS",Nov-21,1252,1235,17,1.40000000
CN2009900000000,20,099,"Labette County, KS",Nov-21,9405,9176,229,2.40000000
CN2010100000000,20,101,"Lane County, KS",Nov-21,760,749,11,1.40000000
CN2010300000000,20,103,"Leavenworth County, KS",Nov-21,36817,35997,820,2.20000000
CN2010500000000,20,105,"Lincoln County, KS",Nov-21,1709,1680,29,1.70000000
CN2010700000000,20,107,"Linn County, KS",Nov-21,4312,4188,124,2.90000000
CN2010900000000,20,109,"Logan County, KS",Nov-21,1645,1627,18,1.10000000
CN2011100000000,20,111,"Lyon County, KS",Nov-21,17145,16834,311,1.80000000
CN2011300000000,20,113,"McPherson County, KS",Nov-21,17065,16828,237,1.40000000
CN2011500000000,20,115,"Marion County, KS",Nov-21,6091,5996,95,1.60000000
CN2011700000000,20,117,"Marshall County, KS",Nov-21,5415,5354,61,1.10000000
CN2011900000000,20,119,"Meade County, KS",Nov-21,2189,2157,32,1.50000000
CN2012100000000,20,121,"Miami County, KS",Nov-21,17739,17403,336,1.90000000
CN2012300000000,20,123,"Mitchell County, KS",Nov-21,3431,3391,40,1.20000000
CN2012500000000,20,125,"Montgomery County, KS",Nov-21,14954,14568,386,2.60000000
CN2012700000000,20,127,"Morris County, KS",Nov-21,3031,2981,50,1.60000000
CN2012900000000,20,129,"Morton County, KS",Nov-21,1145,1119,26,2.30000000
CN2013100000000,20,131,"Nemaha County, KS",Nov-21,5557,5491,66,1.20000000
CN2013300000000,20,133,"Neosho County, KS",Nov-21,6027,5842,185,3.10000000
CN2013500000000,20,135,"Ness County, KS",Nov-21,1356,1334,22,1.60000000
CN2013700000000,20,137,"Norton County, KS",Nov-21,2660,2630,30,1.10000000
CN2013900000000,20,139,"Osage County, KS",Nov-21,7882,7718,164,2.10000000
CN2014100000000,20,141,"Osborne County, KS",Nov-21,1970,1942,28,1.40000000
CN2014300000000,20,143,"Ottawa County, KS",Nov-21,2992,2934,58,1.90000000
CN2014500000000,20,145,"Pawnee County, KS",Nov-21,2810,2767,43,1.50000000
CN2014700000000,20,147,"Phillips County, KS",Nov-21,2670,2627,43,1.60000000
CN2014900000000,20,149,"Pottawatomie County, KS",Nov-21,12823,12613,210,1.60000000
CN2015100000000,20,151,"Pratt County, KS",Nov-21,4992,4920,72,1.40000000
CN2015300000000,20,153,"Rawlins County, KS",Nov-21,1663,1642,21,1.30000000
CN2015500000000,20,155,"Reno County, KS",Nov-21,29800,29097,703,2.40000000
CN2015700000000,20,157,"Republic County, KS",Nov-21,2414,2376,38,1.60000000
CN2015900000000,20,159,"Rice County, KS",Nov-21,5516,5425,91,1.60000000
CN2016100000000,20,161,"Riley County, KS",Nov-21,35329,34721,608,1.70000000
CN2016300000000,20,163,"Rooks County, KS",Nov-21,2442,2398,44,1.80000000
CN2016500000000,20,165,"Rush County, KS",Nov-21,1596,1570,26,1.60000000
CN2016700000000,20,167,"Russell County, KS",Nov-21,3404,3346,58,1.70000000
CN2016900000000,20,169,"Saline County, KS",Nov-21,29451,28835,616,2.10000000
CN2017100000000,20,171,"Scott County, KS",Nov-21,2870,2842,28,1.00000000
CN2017300000000,20,173,"Sedgwick County, KS",Nov-21,255884,247962,7922,3.10000000
CN2017500000000,20,175,"Seward County, KS",Nov-21,9778,9604,174,1.80000000
CN2017700000000,20,177,"Shawnee County, KS",Nov-21,89704,87796,1908,2.10000000
CN2017900000000,20,179,"Sheridan County, KS",Nov-21,1492,1474,18,1.20000000
CN2018100000000,20,181,"Sherman County, KS",Nov-21,2864,2817,47,1.60000000
CN2018300000000,20,183,"Smith County, KS",Nov-21,2026,2003,23,1.10000000
CN2018500000000,20,185,"Stafford County, KS",Nov-21,2020,1993,27,1.30000000
CN2018700000000,20,187,"Stanton County, KS",Nov-21,1174,1158,16,1.40000000
CN2018900000000,20,189,"Stevens County, KS",Nov-21,2961,2921,40,1.40000000
CN2019100000000,20,191,"Sumner County, KS",Nov-21,10811,10518,293,2.70000000
CN2019300000000,20,193,"Thomas County, KS",Nov-21,4361,4314,47,1.10000000
CN2019500000000,20,195,"Trego County, KS",Nov-21,1423,1401,22,1.50000000
CN2019700000000,20,197,"Wabaunsee County, KS",Nov-21,3686,3626,60,1.60000000
CN2019900000000,20,199,"Wallace County, KS",Nov-21,892,882,10,1.10000000
CN2020100000000,20,201,"Washington County, KS",Nov-21,3070,3035,35,1.10000000
CN2020300000000,20,203,"Wichita County, KS",Nov-21,1206,1190,16,1.30000000
CN2020500000000,20,205,"Wilson County, KS",Nov-21,3854,3737,117,3.00000000
CN2020700000000,20,207,"Woodson County, KS",Nov-21,1530,1496,34,2.20000000
CN2020900000000,20,209,"Wyandotte County, KS",Nov-21,77169,74681,2488,3.20000000
CN2100100000000,21,001,"Adair County, KY",Nov-21,7387,7113,274,3.70000000
CN2100300000000,21,003,"Allen County, KY",Nov-21,8995,8711,284,3.20000000
CN2100500000000,21,005,"Anderson County, KY",Nov-21,12219,11838,381,3.10000000
CN2100700000000,21,007,"Ballard County, KY",Nov-21,3504,3352,152,4.30000000
CN2100900000000,21,009,"Barren County, KY",Nov-21,18183,17439,744,4.10000000
CN2101100000000,21,011,"Bath County, KY",Nov-21,4682,4449,233,5.00000000
CN2101300000000,21,013,"Bell County, KY",Nov-21,8206,7838,368,4.50000000
CN2101500000000,21,015,"Boone County, KY",Nov-21,71835,69724,2111,2.90000000
CN2101700000000,21,017,"Bourbon County, KY",Nov-21,9754,9443,311,3.20000000
CN2101900000000,21,019,"Boyd County, KY",Nov-21,17419,16557,862,4.90000000
CN2102100000000,21,021,"Boyle County, KY",Nov-21,12754,12265,489,3.80000000
CN2102300000000,21,023,"Bracken County, KY",Nov-21,3774,3646,128,3.40000000
CN2102500000000,21,025,"Breathitt County, KY",Nov-21,3321,3047,274,8.30000000
CN2102700000000,21,027,"Breckinridge County, KY",Nov-21,8029,7667,362,4.50000000
CN2102900000000,21,029,"Bullitt County, KY",Nov-21,43862,41682,2180,5.00000000
CN2103100000000,21,031,"Butler County, KY",Nov-21,5016,4842,174,3.50000000
CN2103300000000,21,033,"Caldwell County, KY",Nov-21,5981,5784,197,3.30000000
CN2103500000000,21,035,"Calloway County, KY",Nov-21,17882,17248,634,3.50000000
CN2103700000000,21,037,"Campbell County, KY",Nov-21,50513,48928,1585,3.10000000
CN2103900000000,21,039,"Carlisle County, KY",Nov-21,2198,2128,70,3.20000000
CN2104100000000,21,041,"Carroll County, KY",Nov-21,5534,5360,174,3.10000000
CN2104300000000,21,043,"Carter County, KY",Nov-21,9786,9194,592,6.00000000
CN2104500000000,21,045,"Casey County, KY",Nov-21,6767,6541,226,3.30000000
CN2104700000000,21,047,"Christian County, KY",Nov-21,25179,23994,1185,4.70000000
CN2104900000000,21,049,"Clark County, KY",Nov-21,17338,16740,598,3.40000000
CN2105100000000,21,051,"Clay County, KY",Nov-21,5200,4921,279,5.40000000
CN2105300000000,21,053,"Clinton County, KY",Nov-21,3904,3757,147,3.80000000
CN2105500000000,21,055,"Crittenden County, KY",Nov-21,3854,3726,128,3.30000000
CN2105700000000,21,057,"Cumberland County, KY",Nov-21,3356,3262,94,2.80000000
CN2105900000000,21,059,"Daviess County, KY",Nov-21,46525,44993,1532,3.30000000
CN2106100000000,21,061,"Edmonson County, KY",Nov-21,4714,4528,186,3.90000000
CN2106300000000,21,063,"Elliott County, KY",Nov-21,1877,1739,138,7.40000000
CN2106500000000,21,065,"Estill County, KY",Nov-21,5234,5020,214,4.10000000
CN2106700000000,21,067,"Fayette County, KY",Nov-21,176074,170834,5240,3.00000000
CN2106900000000,21,069,"Fleming County, KY",Nov-21,6034,5786,248,4.10000000
CN2107100000000,21,071,"Floyd County, KY",Nov-21,10990,10316,674,6.10000000
CN2107300000000,21,073,"Franklin County, KY",Nov-21,25645,24777,868,3.40000000
CN2107500000000,21,075,"Fulton County, KY",Nov-21,2091,2009,82,3.90000000
CN2107700000000,21,077,"Gallatin County, KY",Nov-21,4010,3875,135,3.40000000
CN2107900000000,21,079,"Garrard County, KY",Nov-21,7759,7472,287,3.70000000
CN2108100000000,21,081,"Grant County, KY",Nov-21,11670,11263,407,3.50000000
CN2108300000000,21,083,"Graves County, KY",Nov-21,16015,15471,544,3.40000000
CN2108500000000,21,085,"Grayson County, KY",Nov-21,10557,10071,486,4.60000000
CN2108700000000,21,087,"Green County, KY",Nov-21,5347,5181,166,3.10000000
CN2108900000000,21,089,"Greenup County, KY",Nov-21,13098,12382,716,5.50000000
CN2109100000000,21,091,"Hancock County, KY",Nov-21,3870,3737,133,3.40000000
CN2109300000000,21,093,"Hardin County, KY",Nov-21,47252,45339,1913,4.00000000
CN2109500000000,21,095,"Harlan County, KY",Nov-21,6593,6147,446,6.80000000
CN2109700000000,21,097,"Harrison County, KY",Nov-21,8915,8653,262,2.90000000
CN2109900000000,21,099,"Hart County, KY",Nov-21,7596,7331,265,3.50000000
CN2110100000000,21,101,"Henderson County, KY",Nov-21,20847,20143,704,3.40000000
CN2110300000000,21,103,"Henry County, KY",Nov-21,8259,7975,284,3.40000000
CN2110500000000,21,105,"Hickman County, KY",Nov-21,1711,1651,60,3.50000000
CN2110700000000,21,107,"Hopkins County, KY",Nov-21,18183,17390,793,4.40000000
CN2110900000000,21,109,"Jackson County, KY",Nov-21,4193,3976,217,5.20000000
CN2111100000000,21,111,"Jefferson County, KY",Nov-21,400570,383501,17069,4.30000000
CN2111300000000,21,113,"Jessamine County, KY",Nov-21,26666,25856,810,3.00000000
CN2111500000000,21,115,"Johnson County, KY",Nov-21,6716,6311,405,6.00000000
CN2111700000000,21,117,"Kenton County, KY",Nov-21,87414,84636,2778,3.20000000
CN2111900000000,21,119,"Knott County, KY",Nov-21,4299,4037,262,6.10000000
CN2112100000000,21,121,"Knox County, KY",Nov-21,10418,9902,516,5.00000000
CN2112300000000,21,123,"Larue County, KY",Nov-21,5823,5585,238,4.10000000
CN2112500000000,21,125,"Laurel County, KY",Nov-21,26246,25331,915,3.50000000
CN2112700000000,21,127,"Lawrence County, KY",Nov-21,5444,5172,272,5.00000000
CN2112900000000,21,129,"Lee County, KY",Nov-21,1976,1885,91,4.60000000
CN2113100000000,21,131,"Leslie County, KY",Nov-21,2544,2371,173,6.80000000
CN2113300000000,21,133,"Letcher County, KY",Nov-21,6130,5737,393,6.40000000
CN2113500000000,21,135,"Lewis County, KY",Nov-21,4718,4421,297,6.30000000
CN2113700000000,21,137,"Lincoln County, KY",Nov-21,9334,8927,407,4.40000000
CN2113900000000,21,139,"Livingston County, KY",Nov-21,3672,3492,180,4.90000000
CN2114100000000,21,141,"Logan County, KY",Nov-21,12414,12038,376,3.00000000
CN2114300000000,21,143,"Lyon County, KY",Nov-21,3082,2976,106,3.40000000
CN2114500000000,21,145,"McCracken County, KY",Nov-21,30096,28884,1212,4.00000000
CN2114700000000,21,147,"McCreary County, KY",Nov-21,4819,4605,214,4.40000000
CN2114900000000,21,149,"McLean County, KY",Nov-21,4037,3899,138,3.40000000
CN2115100000000,21,151,"Madison County, KY",Nov-21,48005,46461,1544,3.20000000
CN2115300000000,21,153,"Magoffin County, KY",Nov-21,3252,2898,354,10.90000000
CN2115500000000,21,155,"Marion County, KY",Nov-21,9238,8898,340,3.70000000
CN2115700000000,21,157,"Marshall County, KY",Nov-21,14389,13852,537,3.70000000
CN2115900000000,21,159,"Martin County, KY",Nov-21,2299,2116,183,8.00000000
CN2116100000000,21,161,"Mason County, KY",Nov-21,6796,6490,306,4.50000000
CN2116300000000,21,163,"Meade County, KY",Nov-21,11723,11174,549,4.70000000
CN2116500000000,21,165,"Menifee County, KY",Nov-21,2311,2195,116,5.00000000
CN2116700000000,21,167,"Mercer County, KY",Nov-21,10100,9727,373,3.70000000
CN2116900000000,21,169,"Metcalfe County, KY",Nov-21,4014,3836,178,4.40000000
CN2117100000000,21,171,"Monroe County, KY",Nov-21,4650,4515,135,2.90000000
CN2117300000000,21,173,"Montgomery County, KY",Nov-21,11678,11169,509,4.40000000
CN2117500000000,21,175,"Morgan County, KY",Nov-21,4338,4150,188,4.30000000
CN2117700000000,21,177,"Muhlenberg County, KY",Nov-21,9994,9457,537,5.40000000
CN2117900000000,21,179,"Nelson County, KY",Nov-21,23675,22736,939,4.00000000
CN2118100000000,21,181,"Nicholas County, KY",Nov-21,3430,3309,121,3.50000000
CN2118300000000,21,183,"Ohio County, KY",Nov-21,8901,8508,393,4.40000000
CN2118500000000,21,185,"Oldham County, KY",Nov-21,33570,32601,969,2.90000000
CN2118700000000,21,187,"Owen County, KY",Nov-21,5070,4902,168,3.30000000
CN2118900000000,21,189,"Owsley County, KY",Nov-21,1037,974,63,6.10000000
CN2119100000000,21,191,"Pendleton County, KY",Nov-21,6928,6706,222,3.20000000
CN2119300000000,21,193,"Perry County, KY",Nov-21,8040,7635,405,5.00000000
CN2119500000000,21,195,"Pike County, KY",Nov-21,19211,18211,1000,5.20000000
CN2119700000000,21,197,"Powell County, KY",Nov-21,5221,5023,198,3.80000000
CN2119900000000,21,199,"Pulaski County, KY",Nov-21,26203,25160,1043,4.00000000
CN2120100000000,21,201,"Robertson County, KY",Nov-21,816,787,29,3.60000000
CN2120300000000,21,203,"Rockcastle County, KY",Nov-21,6636,6371,265,4.00000000
CN2120500000000,21,205,"Rowan County, KY",Nov-21,9990,9573,417,4.20000000
CN2120700000000,21,207,"Russell County, KY",Nov-21,6129,5861,268,4.40000000
CN2120900000000,21,209,"Scott County, KY",Nov-21,30409,29544,865,2.80000000
CN2121100000000,21,211,"Shelby County, KY",Nov-21,26268,25352,916,3.50000000
CN2121300000000,21,213,"Simpson County, KY",Nov-21,8911,8620,291,3.30000000
CN2121500000000,21,215,"Spencer County, KY",Nov-21,10765,10303,462,4.30000000
CN2121700000000,21,217,"Taylor County, KY",Nov-21,12993,12590,403,3.10000000
CN2121900000000,21,219,"Todd County, KY",Nov-21,5576,5417,159,2.90000000
CN2122100000000,21,221,"Trigg County, KY",Nov-21,6126,5895,231,3.80000000
CN2122300000000,21,223,"Trimble County, KY",Nov-21,3865,3721,144,3.70000000
CN2122500000000,21,225,"Union County, KY",Nov-21,6008,5799,209,3.50000000
CN2122700000000,21,227,"Warren County, KY",Nov-21,65432,63333,2099,3.20000000
CN2122900000000,21,229,"Washington County, KY",Nov-21,6195,5992,203,3.30000000
CN2123100000000,21,231,"Wayne County, KY",Nov-21,7302,6998,304,4.20000000
CN2123300000000,21,233,"Webster County, KY",Nov-21,5348,5162,186,3.50000000
CN2123500000000,21,235,"Whitley County, KY",Nov-21,14533,13986,547,3.80000000
CN2123700000000,21,237,"Wolfe County, KY",Nov-21,2244,2135,109,4.90000000
CN2123900000000,21,239,"Woodford County, KY",Nov-21,15205,14815,390,2.60000000
CN2200100000000,22,001,"Acadia Parish, LA",Nov-21,23559,22725,834,3.50000000
CN2200300000000,22,003,"Allen Parish, LA",Nov-21,8214,7891,323,3.90000000
CN2200500000000,22,005,"Ascension Parish, LA",Nov-21,65777,63851,1926,2.90000000
CN2200700000000,22,007,"Assumption Parish, LA",Nov-21,8608,8146,462,5.40000000
CN2200900000000,22,009,"Avoyelles Parish, LA",Nov-21,14567,14027,540,3.70000000
CN2201100000000,22,011,"Beauregard Parish, LA",Nov-21,14997,14577,420,2.80000000
CN2201300000000,22,013,"Bienville Parish, LA",Nov-21,5198,4984,214,4.10000000
CN2201500000000,22,015,"Bossier Parish, LA",Nov-21,58005,56395,1610,2.80000000
CN2201700000000,22,017,"Caddo Parish, LA",Nov-21,102498,97829,4669,4.60000000
CN2201900000000,22,019,"Calcasieu Parish, LA",Nov-21,98299,94476,3823,3.90000000
CN2202100000000,22,021,"Caldwell Parish, LA",Nov-21,3639,3520,119,3.30000000
CN2202300000000,22,023,"Cameron Parish, LA",Nov-21,3612,3525,87,2.40000000
CN2202500000000,22,025,"Catahoula Parish, LA",Nov-21,3416,3292,124,3.60000000
CN2202700000000,22,027,"Claiborne Parish, LA",Nov-21,5416,5233,183,3.40000000
CN2202900000000,22,029,"Concordia Parish, LA",Nov-21,6835,6538,297,4.30000000
CN2203100000000,22,031,"De Soto Parish, LA",Nov-21,10875,10494,381,3.50000000
CN2203300000000,22,033,"East Baton Rouge Parish, LA",Nov-21,230397,221727,8670,3.80000000
CN2203500000000,22,035,"East Carroll Parish, LA",Nov-21,1676,1545,131,7.80000000
CN2203700000000,22,037,"East Feliciana Parish, LA",Nov-21,7744,7493,251,3.20000000
CN2203900000000,22,039,"Evangeline Parish, LA",Nov-21,11777,11304,473,4.00000000
CN2204100000000,22,041,"Franklin Parish, LA",Nov-21,7362,7039,323,4.40000000
CN2204300000000,22,043,"Grant Parish, LA",Nov-21,8245,7997,248,3.00000000
CN2204500000000,22,045,"Iberia Parish, LA",Nov-21,27537,26151,1386,5.00000000
CN2204700000000,22,047,"Iberville Parish, LA",Nov-21,13763,13028,735,5.30000000
CN2204900000000,22,049,"Jackson Parish, LA",Nov-21,6820,6627,193,2.80000000
CN2205100000000,22,051,"Jefferson Parish, LA",Nov-21,209198,199864,9334,4.50000000
CN2205300000000,22,053,"Jefferson Davis Parish, LA",Nov-21,12737,12309,428,3.40000000
CN2205500000000,22,055,"Lafayette Parish, LA",Nov-21,115786,112146,3640,3.10000000
CN2205700000000,22,057,"Lafourche Parish, LA",Nov-21,39447,38033,1414,3.60000000
CN2205900000000,22,059,"LaSalle Parish, LA",Nov-21,6609,6453,156,2.40000000
CN2206100000000,22,061,"Lincoln Parish, LA",Nov-21,21637,20976,661,3.10000000
CN2206300000000,22,063,"Livingston Parish, LA",Nov-21,70307,68427,1880,2.70000000
CN2206500000000,22,065,"Madison Parish, LA",Nov-21,3415,3247,168,4.90000000
CN2206700000000,22,067,"Morehouse Parish, LA",Nov-21,9958,9393,565,5.70000000
CN2206900000000,22,069,"Natchitoches Parish, LA",Nov-21,16235,15676,559,3.40000000
CN2207100000000,22,071,"Orleans Parish, LA",Nov-21,176971,166058,10913,6.20000000
CN2207300000000,22,073,"Ouachita Parish, LA",Nov-21,69549,67051,2498,3.60000000
CN2207500000000,22,075,"Plaquemines Parish, LA",Nov-21,9560,9256,304,3.20000000
CN2207700000000,22,077,"Pointe Coupee Parish, LA",Nov-21,9591,9187,404,4.20000000
CN2207900000000,22,079,"Rapides Parish, LA",Nov-21,55785,54129,1656,3.00000000
CN2208100000000,22,081,"Red River Parish, LA",Nov-21,3653,3540,113,3.10000000
CN2208300000000,22,083,"Richland Parish, LA",Nov-21,8122,7814,308,3.80000000
CN2208500000000,22,085,"Sabine Parish, LA",Nov-21,9139,8892,247,2.70000000
CN2208700000000,22,087,"St. Bernard Parish, LA",Nov-21,19851,18844,1007,5.10000000
CN2208900000000,22,089,"St. Charles Parish, LA",Nov-21,24541,23610,931,3.80000000
CN2209100000000,22,091,"St. Helena Parish, LA",Nov-21,4252,3967,285,6.70000000
CN2209300000000,22,093,"St. James Parish, LA",Nov-21,8875,8362,513,5.80000000
CN2209500000000,22,095,"St. John the Baptist Parish, LA",Nov-21,19227,17893,1334,6.90000000
CN2209700000000,22,097,"St. Landry Parish, LA",Nov-21,31826,30311,1515,4.80000000
CN2209900000000,22,099,"St. Martin Parish, LA",Nov-21,21992,21103,889,4.00000000
CN2210100000000,22,101,"St. Mary Parish, LA",Nov-21,19151,18193,958,5.00000000
CN2210300000000,22,103,"St. Tammany Parish, LA",Nov-21,117587,114341,3246,2.80000000
CN2210500000000,22,105,"Tangipahoa Parish, LA",Nov-21,55836,53115,2721,4.90000000
CN2210700000000,22,107,"Tensas Parish, LA",Nov-21,1269,1209,60,4.70000000
CN2210900000000,22,109,"Terrebonne Parish, LA",Nov-21,43641,41560,2081,4.80000000
CN2211100000000,22,111,"Union Parish, LA",Nov-21,8975,8657,318,3.50000000
CN2211300000000,22,113,"Vermilion Parish, LA",Nov-21,23817,22979,838,3.50000000
CN2211500000000,22,115,"Vernon Parish, LA",Nov-21,16113,15574,539,3.30000000
CN2211700000000,22,117,"Washington Parish, LA",Nov-21,17107,16387,720,4.20000000
CN2211900000000,22,119,"Webster Parish, LA",Nov-21,14156,13604,552,3.90000000
CN2212100000000,22,121,"West Baton Rouge Parish, LA",Nov-21,13808,13334,474,3.40000000
CN2212300000000,22,123,"West Carroll Parish, LA",Nov-21,3454,3281,173,5.00000000
CN2212500000000,22,125,"West Feliciana Parish, LA",Nov-21,5330,5188,142,2.70000000
CN2212700000000,22,127,"Winn Parish, LA",Nov-21,4513,4357,156,3.50000000
CN2300100000000,23,001,"Androscoggin County, ME",Nov-21,54098,51926,2172,4.00000000
CN2300300000000,23,003,"Aroostook County, ME",Nov-21,28294,26920,1374,4.90000000
CN2300500000000,23,005,"Cumberland County, ME",Nov-21,162120,156677,5443,3.40000000
CN2300700000000,23,007,"Franklin County, ME",Nov-21,13669,13017,652,4.80000000
CN2300900000000,23,009,"Hancock County, ME",Nov-21,26601,25394,1207,4.50000000
CN2301100000000,23,011,"Kennebec County, ME",Nov-21,61242,58968,2274,3.70000000
CN2301300000000,23,013,"Knox County, ME",Nov-21,19111,18402,709,3.70000000
CN2301500000000,23,015,"Lincoln County, ME",Nov-21,15854,15245,609,3.80000000
CN2301700000000,23,017,"Oxford County, ME",Nov-21,25443,24316,1127,4.40000000
CN2301900000000,23,019,"Penobscot County, ME",Nov-21,75732,72789,2943,3.90000000
CN2302100000000,23,021,"Piscataquis County, ME",Nov-21,7169,6829,340,4.70000000
CN2302300000000,23,023,"Sagadahoc County, ME",Nov-21,19093,18506,587,3.10000000
CN2302500000000,23,025,"Somerset County, ME",Nov-21,21770,20586,1184,5.40000000
CN2302700000000,23,027,"Waldo County, ME",Nov-21,19913,19113,800,4.00000000
CN2302900000000,23,029,"Washington County, ME",Nov-21,13125,12453,672,5.10000000
CN2303100000000,23,031,"York County, ME",Nov-21,111820,107937,3883,3.50000000
CN2400100000000,24,001,"Allegany County, MD",Nov-21,30615,28940,1675,5.50000000
CN2400300000000,24,003,"Anne Arundel County, MD",Nov-21,316831,303630,13201,4.20000000
CN2400500000000,24,005,"Baltimore County, MD",Nov-21,449644,428088,21556,4.80000000
CN2400900000000,24,009,"Calvert County, MD",Nov-21,49498,47486,2012,4.10000000
CN2401100000000,24,011,"Caroline County, MD",Nov-21,17186,16464,722,4.20000000
CN2401300000000,24,013,"Carroll County, MD",Nov-21,94748,91359,3389,3.60000000
CN2401500000000,24,015,"Cecil County, MD",Nov-21,52575,50147,2428,4.60000000
CN2401700000000,24,017,"Charles County, MD",Nov-21,87409,83068,4341,5.00000000
CN2401900000000,24,019,"Dorchester County, MD",Nov-21,16263,15439,824,5.10000000
CN2402100000000,24,021,"Frederick County, MD",Nov-21,135966,130347,5619,4.10000000
CN2402300000000,24,023,"Garrett County, MD",Nov-21,15090,14399,691,4.60000000
CN2402500000000,24,025,"Harford County, MD",Nov-21,141096,135310,5786,4.10000000
CN2402700000000,24,027,"Howard County, MD",Nov-21,189016,181992,7024,3.70000000
CN2402900000000,24,029,"Kent County, MD",Nov-21,9427,8973,454,4.80000000
CN2403100000000,24,031,"Montgomery County, MD",Nov-21,550649,524944,25705,4.70000000
CN2403300000000,24,033,"Prince George's County, MD",Nov-21,508288,475259,33029,6.50000000
CN2403500000000,24,035,"Queen Anne's County, MD",Nov-21,27884,26815,1069,3.80000000
CN2403700000000,24,037,"St. Mary's County, MD",Nov-21,57361,55045,2316,4.00000000
CN2403900000000,24,039,"Somerset County, MD",Nov-21,8587,8008,579,6.70000000
CN2404100000000,24,041,"Talbot County, MD",Nov-21,17685,16843,842,4.80000000
CN2404300000000,24,043,"Washington County, MD",Nov-21,73460,70163,3297,4.50000000
CN2404500000000,24,045,"Wicomico County, MD",Nov-21,49218,46570,2648,5.40000000
CN2404700000000,24,047,"Worcester County, MD",Nov-21,24561,22616,1945,7.90000000
CN2451000000000,24,510,"Baltimore city, MD",Nov-21,280448,261724,18724,6.70000000
CN2500100000000,25,001,"Barnstable County, MA",Nov-21,108589,102763,5826,5.40000000
CN2500300000000,25,003,"Berkshire County, MA",Nov-21,61796,58701,3095,5.00000000
CN2500500000000,25,005,"Bristol County, MA",Nov-21,301469,286574,14895,4.90000000
CN2500700000000,25,007,"Dukes County, MA",Nov-21,8807,8305,502,5.70000000
CN2500900000000,25,009,"Essex County, MA",Nov-21,425439,405635,19804,4.70000000
CN2501100000000,25,011,"Franklin County, MA",Nov-21,41085,39605,1480,3.60000000
CN2501300000000,25,013,"Hampden County, MA",Nov-21,229503,216493,13010,5.70000000
CN2501500000000,25,015,"Hampshire County, MA",Nov-21,90961,87863,3098,3.40000000
CN2501700000000,25,017,"Middlesex County, MA",Nov-21,914714,883919,30795,3.40000000
CN2501900000000,25,019,"Nantucket County/town, MA",Nov-21,6884,6492,392,5.70000000
CN2502100000000,25,021,"Norfolk County, MA",Nov-21,394483,379318,15165,3.80000000
CN2502300000000,25,023,"Plymouth County, MA",Nov-21,284908,272027,12881,4.50000000
CN2502500000000,25,025,"Suffolk County, MA",Nov-21,455834,436333,19501,4.30000000
CN2502700000000,25,027,"Worcester County, MA",Nov-21,446405,426947,19458,4.40000000
CN2600100000000,26,001,"Alcona County, MI",Nov-21,3702,3505,197,5.30000000
CN2600300000000,26,003,"Alger County, MI",Nov-21,3017,2818,199,6.60000000
CN2600500000000,26,005,"Allegan County, MI",Nov-21,60535,58681,1854,3.10000000
CN2600700000000,26,007,"Alpena County, MI",Nov-21,13358,12872,486,3.60000000
CN2600900000000,26,009,"Antrim County, MI",Nov-21,9383,8922,461,4.90000000
CN2601100000000,26,011,"Arenac County, MI",Nov-21,5605,5264,341,6.10000000
CN2601300000000,26,013,"Baraga County, MI",Nov-21,2998,2816,182,6.10000000
CN2601500000000,26,015,"Barry County, MI",Nov-21,30979,30054,925,3.00000000
CN2601700000000,26,017,"Bay County, MI",Nov-21,47861,45861,2000,4.20000000
CN2601900000000,26,019,"Benzie County, MI",Nov-21,8363,8017,346,4.10000000
CN2602100000000,26,021,"Berrien County, MI",Nov-21,69466,66695,2771,4.00000000
CN2602300000000,26,023,"Branch County, MI",Nov-21,18941,18301,640,3.40000000
CN2602500000000,26,025,"Calhoun County, MI",Nov-21,59256,56551,2705,4.60000000
CN2602700000000,26,027,"Cass County, MI",Nov-21,23032,22267,765,3.30000000
CN2602900000000,26,029,"Charlevoix County, MI",Nov-21,11604,11146,458,3.90000000
CN2603100000000,26,031,"Cheboygan County, MI",Nov-21,9380,8801,579,6.20000000
CN2603300000000,26,033,"Chippewa County, MI",Nov-21,16002,15212,790,4.90000000
CN2603500000000,26,035,"Clare County, MI",Nov-21,10987,10363,624,5.70000000
CN2603700000000,26,037,"Clinton County, MI",Nov-21,39276,38162,1114,2.80000000
CN2603900000000,26,039,"Crawford County, MI",Nov-21,5294,5012,282,5.30000000
CN2604100000000,26,041,"Delta County, MI",Nov-21,16036,15307,729,4.50000000
CN2604300000000,26,043,"Dickinson County, MI",Nov-21,12169,11782,387,3.20000000
CN2604500000000,26,045,"Eaton County, MI",Nov-21,54380,52643,1737,3.20000000
CN2604700000000,26,047,"Emmet County, MI",Nov-21,15604,14882,722,4.60000000
CN2604900000000,26,049,"Genesee County, MI",Nov-21,173853,164521,9332,5.40000000
CN2605100000000,26,051,"Gladwin County, MI",Nov-21,9410,8942,468,5.00000000
CN2605300000000,26,053,"Gogebic County, MI",Nov-21,5530,5317,213,3.90000000
CN2605500000000,26,055,"Grand Traverse County, MI",Nov-21,47473,45927,1546,3.30000000
CN2605700000000,26,057,"Gratiot County, MI",Nov-21,17074,16425,649,3.80000000
CN2605900000000,26,059,"Hillsdale County, MI",Nov-21,19598,18872,726,3.70000000
CN2606100000000,26,061,"Houghton County, MI",Nov-21,16068,15538,530,3.30000000
CN2606300000000,26,063,"Huron County, MI",Nov-21,14572,14068,504,3.50000000
CN2606500000000,26,065,"Ingham County, MI",Nov-21,142556,137505,5051,3.50000000
CN2606700000000,26,067,"Ionia County, MI",Nov-21,29417,28525,892,3.00000000
CN2606900000000,26,069,"Iosco County, MI",Nov-21,9874,9362,512,5.20000000
CN2607100000000,26,071,"Iron County, MI",Nov-21,4725,4525,200,4.20000000
CN2607300000000,26,073,"Isabella County, MI",Nov-21,32058,30950,1108,3.50000000
CN2607500000000,26,075,"Jackson County, MI",Nov-21,72374,69562,2812,3.90000000
CN2607700000000,26,077,"Kalamazoo County, MI",Nov-21,129609,125288,4321,3.30000000
CN2607900000000,26,079,"Kalkaska County, MI",Nov-21,7537,7140,397,5.30000000
CN2608100000000,26,081,"Kent County, MI",Nov-21,350814,339963,10851,3.10000000
CN2608300000000,26,083,"Keweenaw County, MI",Nov-21,906,858,48,5.30000000
CN2608500000000,26,085,"Lake County, MI",Nov-21,3819,3596,223,5.80000000
CN2608700000000,26,087,"Lapeer County, MI",Nov-21,40382,38752,1630,4.00000000
CN2608900000000,26,089,"Leelanau County, MI",Nov-21,9936,9599,337,3.40000000
CN2609100000000,26,091,"Lenawee County, MI",Nov-21,44782,43155,1627,3.60000000
CN2609300000000,26,093,"Livingston County, MI",Nov-21,103257,100405,2852,2.80000000
CN2609500000000,26,095,"Luce County, MI",Nov-21,2013,1901,112,5.60000000
CN2609700000000,26,097,"Mackinac County, MI",Nov-21,4368,4039,329,7.50000000
CN2609900000000,26,099,"Macomb County, MI",Nov-21,443585,425694,17891,4.00000000
CN2610100000000,26,101,"Manistee County, MI",Nov-21,9577,9096,481,5.00000000
CN2610300000000,26,103,"Marquette County, MI",Nov-21,30755,29660,1095,3.60000000
CN2610500000000,26,105,"Mason County, MI",Nov-21,12739,12103,636,5.00000000
CN2610700000000,26,107,"Mecosta County, MI",Nov-21,18125,17387,738,4.10000000
CN2610900000000,26,109,"Menominee County, MI",Nov-21,10338,10001,337,3.30000000
CN2611100000000,26,111,"Midland County, MI",Nov-21,38122,36861,1261,3.30000000
CN2611300000000,26,113,"Missaukee County, MI",Nov-21,6682,6445,237,3.50000000
CN2611500000000,26,115,"Monroe County, MI",Nov-21,72358,69540,2818,3.90000000
CN2611700000000,26,117,"Montcalm County, MI",Nov-21,27060,26071,989,3.70000000
CN2611900000000,26,119,"Montmorency County, MI",Nov-21,2900,2683,217,7.50000000
CN2612100000000,26,121,"Muskegon County, MI",Nov-21,75308,71310,3998,5.30000000
CN2612300000000,26,123,"Newaygo County, MI",Nov-21,22781,21918,863,3.80000000
CN2612500000000,26,125,"Oakland County, MI",Nov-21,668939,647657,21282,3.20000000
CN2612700000000,26,127,"Oceana County, MI",Nov-21,11204,10592,612,5.50000000
CN2612900000000,26,129,"Ogemaw County, MI",Nov-21,7773,7342,431,5.50000000
CN2613100000000,26,131,"Ontonagon County, MI",Nov-21,2007,1895,112,5.60000000
CN2613300000000,26,133,"Osceola County, MI",Nov-21,11293,10873,420,3.70000000
CN2613500000000,26,135,"Oscoda County, MI",Nov-21,2553,2383,170,6.70000000
CN2613700000000,26,137,"Otsego County, MI",Nov-21,11039,10501,538,4.90000000
CN2613900000000,26,139,"Ottawa County, MI",Nov-21,157770,153500,4270,2.70000000
CN2614100000000,26,141,"Presque Isle County, MI",Nov-21,4702,4452,250,5.30000000
CN2614300000000,26,143,"Roscommon County, MI",Nov-21,7180,6655,525,7.30000000
CN2614500000000,26,145,"Saginaw County, MI",Nov-21,81012,76958,4054,5.00000000
CN2614700000000,26,147,"St. Clair County, MI",Nov-21,74804,71850,2954,3.90000000
CN2614900000000,26,149,"St. Joseph County, MI",Nov-21,27471,26533,938,3.40000000
CN2615100000000,26,151,"Sanilac County, MI",Nov-21,18772,18037,735,3.90000000
CN2615300000000,26,153,"Schoolcraft County, MI",Nov-21,3102,2914,188,6.10000000
CN2615500000000,26,155,"Shiawassee County, MI",Nov-21,31769,30582,1187,3.70000000
CN2615700000000,26,157,"Tuscola County, MI",Nov-21,22473,21522,951,4.20000000
CN2615900000000,26,159,"Van Buren County, MI",Nov-21,33847,32489,1358,4.00000000
CN2616100000000,26,161,"Washtenaw County, MI",Nov-21,193039,187633,5406,2.80000000
CN2616300000000,26,163,"Wayne County, MI",Nov-21,804285,760516,43769,5.40000000
CN2616500000000,26,165,"Wexford County, MI",Nov-21,14386,13799,587,4.10000000
CN2700100000000,27,001,"Aitkin County, MN",Nov-21,7282,7047,235,3.20000000
CN2700300000000,27,003,"Anoka County, MN",Nov-21,196046,191862,4184,2.10000000
CN2700500000000,27,005,"Becker County, MN",Nov-21,18686,18269,417,2.20000000
CN2700700000000,27,007,"Beltrami County, MN",Nov-21,23925,23317,608,2.50000000
CN2700900000000,27,009,"Benton County, MN",Nov-21,21429,20884,545,2.50000000
CN2701100000000,27,011,"Big Stone County, MN",Nov-21,2341,2299,42,1.80000000
CN2701300000000,27,013,"Blue Earth County, MN",Nov-21,39628,38893,735,1.90000000
CN2701500000000,27,015,"Brown County, MN",Nov-21,13332,13102,230,1.70000000
CN2701700000000,27,017,"Carlton County, MN",Nov-21,17290,16784,506,2.90000000
CN2701900000000,27,019,"Carver County, MN",Nov-21,58639,57618,1021,1.70000000
CN2702100000000,27,021,"Cass County, MN",Nov-21,15306,14800,506,3.30000000
CN2702300000000,27,023,"Chippewa County, MN",Nov-21,6408,6308,100,1.60000000
CN2702500000000,27,025,"Chisago County, MN",Nov-21,29560,28850,710,2.40000000
CN2702700000000,27,027,"Clay County, MN",Nov-21,36527,35935,592,1.60000000
CN2702900000000,27,029,"Clearwater County, MN",Nov-21,4434,4227,207,4.70000000
CN2703100000000,27,031,"Cook County, MN",Nov-21,2727,2648,79,2.90000000
CN2703300000000,27,033,"Cottonwood County, MN",Nov-21,6508,6391,117,1.80000000
CN2703500000000,27,035,"Crow Wing County, MN",Nov-21,31355,30457,898,2.90000000
CN2703700000000,27,037,"Dakota County, MN",Nov-21,239225,234471,4754,2.00000000
CN2703900000000,27,039,"Dodge County, MN",Nov-21,11734,11525,209,1.80000000
CN2704100000000,27,041,"Douglas County, MN",Nov-21,20754,20358,396,1.90000000
CN2704300000000,27,043,"Faribault County, MN",Nov-21,6708,6544,164,2.40000000
CN2704500000000,27,045,"Fillmore County, MN",Nov-21,11273,11084,189,1.70000000
CN2704700000000,27,047,"Freeborn County, MN",Nov-21,15123,14794,329,2.20000000
CN2704900000000,27,049,"Goodhue County, MN",Nov-21,25921,25407,514,2.00000000
CN2705100000000,27,051,"Grant County, MN",Nov-21,3195,3125,70,2.20000000
CN2705300000000,27,053,"Hennepin County, MN",Nov-21,697520,682076,15444,2.20000000
CN2705500000000,27,055,"Houston County, MN",Nov-21,10234,10066,168,1.60000000
CN2705700000000,27,057,"Hubbard County, MN",Nov-21,9742,9418,324,3.30000000
CN2705900000000,27,059,"Isanti County, MN",Nov-21,21371,20844,527,2.50000000
CN2706100000000,27,061,"Itasca County, MN",Nov-21,20911,20136,775,3.70000000
CN2706300000000,27,063,"Jackson County, MN",Nov-21,5337,5248,89,1.70000000
CN2706500000000,27,065,"Kanabec County, MN",Nov-21,8934,8639,295,3.30000000
CN2706700000000,27,067,"Kandiyohi County, MN",Nov-21,22744,22261,483,2.10000000
CN2706900000000,27,069,"Kittson County, MN",Nov-21,2204,2156,48,2.20000000
CN2707100000000,27,071,"Koochiching County, MN",Nov-21,5454,5250,204,3.70000000
CN2707300000000,27,073,"Lac qui Parle County, MN",Nov-21,3320,3268,52,1.60000000
CN2707500000000,27,075,"Lake County, MN",Nov-21,5123,4991,132,2.60000000
CN2707700000000,27,077,"Lake of the Woods County, MN",Nov-21,2237,2166,71,3.20000000
CN2707900000000,27,079,"Le Sueur County, MN",Nov-21,15632,15254,378,2.40000000
CN2708100000000,27,081,"Lincoln County, MN",Nov-21,2901,2852,49,1.70000000
CN2708300000000,27,083,"Lyon County, MN",Nov-21,13951,13711,240,1.70000000
CN2708500000000,27,085,"McLeod County, MN",Nov-21,18642,18249,393,2.10000000
CN2708700000000,27,087,"Mahnomen County, MN",Nov-21,2178,2077,101,4.60000000
CN2708900000000,27,089,"Marshall County, MN",Nov-21,5224,5052,172,3.30000000
CN2709100000000,27,091,"Martin County, MN",Nov-21,9387,9207,180,1.90000000
CN2709300000000,27,093,"Meeker County, MN",Nov-21,12922,12665,257,2.00000000
CN2709500000000,27,095,"Mille Lacs County, MN",Nov-21,12440,12031,409,3.30000000
CN2709700000000,27,097,"Morrison County, MN",Nov-21,17081,16545,536,3.10000000
CN2709900000000,27,099,"Mower County, MN",Nov-21,20214,19834,380,1.90000000
CN2710100000000,27,101,"Murray County, MN",Nov-21,4504,4407,97,2.20000000
CN2710300000000,27,103,"Nicollet County, MN",Nov-21,20352,20032,320,1.60000000
CN2710500000000,27,105,"Nobles County, MN",Nov-21,11126,10935,191,1.70000000
CN2710700000000,27,107,"Norman County, MN",Nov-21,3182,3099,83,2.60000000
CN2710900000000,27,109,"Olmsted County, MN",Nov-21,90120,88485,1635,1.80000000
CN2711100000000,27,111,"Otter Tail County, MN",Nov-21,30305,29672,633,2.10000000
CN2711300000000,27,113,"Pennington County, MN",Nov-21,8605,8416,189,2.20000000
CN2711500000000,27,115,"Pine County, MN",Nov-21,13969,13547,422,3.00000000
CN2711700000000,27,117,"Pipestone County, MN",Nov-21,4458,4400,58,1.30000000
CN2711900000000,27,119,"Polk County, MN",Nov-21,15789,15416,373,2.40000000
CN2712100000000,27,121,"Pope County, MN",Nov-21,6200,6096,104,1.70000000
CN2712300000000,27,123,"Ramsey County, MN",Nov-21,282514,275661,6853,2.40000000
CN2712500000000,27,125,"Red Lake County, MN",Nov-21,2169,2109,60,2.80000000
CN2712700000000,27,127,"Redwood County, MN",Nov-21,7257,7110,147,2.00000000
CN2712900000000,27,129,"Renville County, MN",Nov-21,8199,7997,202,2.50000000
CN2713100000000,27,131,"Rice County, MN",Nov-21,36341,35588,753,2.10000000
CN2713300000000,27,133,"Rock County, MN",Nov-21,5889,5815,74,1.30000000
CN2713500000000,27,135,"Roseau County, MN",Nov-21,7794,7635,159,2.00000000
CN2713700000000,27,137,"St. Louis County, MN",Nov-21,98581,95962,2619,2.70000000
CN2713900000000,27,139,"Scott County, MN",Nov-21,83340,81773,1567,1.90000000
CN2714100000000,27,141,"Sherburne County, MN",Nov-21,52287,51197,1090,2.10000000
CN2714300000000,27,143,"Sibley County, MN",Nov-21,7962,7785,177,2.20000000
CN2714500000000,27,145,"Stearns County, MN",Nov-21,89012,87022,1990,2.20000000
CN2714700000000,27,147,"Steele County, MN",Nov-21,20077,19678,399,2.00000000
CN2714900000000,27,149,"Stevens County, MN",Nov-21,5211,5132,79,1.50000000
CN2715100000000,27,151,"Swift County, MN",Nov-21,4657,4553,104,2.20000000
CN2715300000000,27,153,"Todd County, MN",Nov-21,13217,12885,332,2.50000000
CN2715500000000,27,155,"Traverse County, MN",Nov-21,1634,1603,31,1.90000000
CN2715700000000,27,157,"Wabasha County, MN",Nov-21,12048,11806,242,2.00000000
CN2715900000000,27,159,"Wadena County, MN",Nov-21,5863,5694,169,2.90000000
CN2716100000000,27,161,"Waseca County, MN",Nov-21,8586,8389,197,2.30000000
CN2716300000000,27,163,"Washington County, MN",Nov-21,142998,140336,2662,1.90000000
CN2716500000000,27,165,"Watonwan County, MN",Nov-21,6368,6269,99,1.60000000
CN2716700000000,27,167,"Wilkin County, MN",Nov-21,3310,3254,56,1.70000000
CN2716900000000,27,169,"Winona County, MN",Nov-21,27517,27034,483,1.80000000
CN2717100000000,27,171,"Wright County, MN",Nov-21,75528,74113,1415,1.90000000
CN2717300000000,27,173,"Yellow Medicine County, MN",Nov-21,4954,4872,82,1.70000000
CN2800100000000,28,001,"Adams County, MS",Nov-21,10574,10010,564,5.30000000
CN2800300000000,28,003,"Alcorn County, MS",Nov-21,15111,14647,464,3.10000000
CN2800500000000,28,005,"Amite County, MS",Nov-21,4295,4065,230,5.40000000
CN2800700000000,28,007,"Attala County, MS",Nov-21,6902,6639,263,3.80000000
CN2800900000000,28,009,"Benton County, MS",Nov-21,3038,2916,122,4.00000000
CN2801100000000,28,011,"Bolivar County, MS",Nov-21,11167,10687,480,4.30000000
CN2801300000000,28,013,"Calhoun County, MS",Nov-21,5153,4983,170,3.30000000
CN2801500000000,28,015,"Carroll County, MS",Nov-21,3503,3369,134,3.80000000
CN2801700000000,28,017,"Chickasaw County, MS",Nov-21,6777,6501,276,4.10000000
CN2801900000000,28,019,"Choctaw County, MS",Nov-21,3507,3390,117,3.30000000
CN2802100000000,28,021,"Claiborne County, MS",Nov-21,2903,2676,227,7.80000000
CN2802300000000,28,023,"Clarke County, MS",Nov-21,5552,5318,234,4.20000000
CN2802500000000,28,025,"Clay County, MS",Nov-21,8101,7718,383,4.70000000
CN2802700000000,28,027,"Coahoma County, MS",Nov-21,7719,7286,433,5.60000000
CN2802900000000,28,029,"Copiah County, MS",Nov-21,10612,10171,441,4.20000000
CN2803100000000,28,031,"Covington County, MS",Nov-21,8165,7906,259,3.20000000
CN2803300000000,28,033,"DeSoto County, MS",Nov-21,93740,91097,2643,2.80000000
CN2803500000000,28,035,"Forrest County, MS",Nov-21,33439,32279,1160,3.50000000
CN2803700000000,28,037,"Franklin County, MS",Nov-21,2570,2445,125,4.90000000
CN2803900000000,28,039,"George County, MS",Nov-21,8446,8037,409,4.80000000
CN2804100000000,28,041,"Greene County, MS",Nov-21,4087,3859,228,5.60000000
CN2804300000000,28,043,"Grenada County, MS",Nov-21,9006,8726,280,3.10000000
CN2804500000000,28,045,"Hancock County, MS",Nov-21,18861,18159,702,3.70000000
CN2804700000000,28,047,"Harrison County, MS",Nov-21,87016,83918,3098,3.60000000
CN2804900000000,28,049,"Hinds County, MS",Nov-21,101216,97194,4022,4.00000000
CN2805100000000,28,051,"Holmes County, MS",Nov-21,5061,4686,375,7.40000000
CN2805300000000,28,053,"Humphreys County, MS",Nov-21,1878,1715,163,8.70000000
CN2805500000000,28,055,"Issaquena County, MS",Nov-21,293,274,19,6.50000000
CN2805700000000,28,057,"Itawamba County, MS",Nov-21,10271,9996,275,2.70000000
CN2805900000000,28,059,"Jackson County, MS",Nov-21,58408,56000,2408,4.10000000
CN2806100000000,28,061,"Jasper County, MS",Nov-21,5650,5388,262,4.60000000
CN2806300000000,28,063,"Jefferson County, MS",Nov-21,1813,1595,218,12.00000000
CN2806500000000,28,065,"Jefferson Davis County, MS",Nov-21,3860,3659,201,5.20000000
CN2806700000000,28,067,"Jones County, MS",Nov-21,24149,23277,872,3.60000000
CN2806900000000,28,069,"Kemper County, MS",Nov-21,3176,3012,164,5.20000000
CN2807100000000,28,071,"Lafayette County, MS",Nov-21,28538,27839,699,2.40000000
CN2807300000000,28,073,"Lamar County, MS",Nov-21,31813,30966,847,2.70000000
CN2807500000000,28,075,"Lauderdale County, MS",Nov-21,28715,27706,1009,3.50000000
CN2807700000000,28,077,"Lawrence County, MS",Nov-21,4534,4325,209,4.60000000
CN2807900000000,28,079,"Leake County, MS",Nov-21,7793,7500,293,3.80000000
CN2808100000000,28,081,"Lee County, MS",Nov-21,41147,39969,1178,2.90000000
CN2808300000000,28,083,"Leflore County, MS",Nov-21,9961,9465,496,5.00000000
CN2808500000000,28,085,"Lincoln County, MS",Nov-21,14953,14462,491,3.30000000
CN2808700000000,28,087,"Lowndes County, MS",Nov-21,25151,24198,953,3.80000000
CN2808900000000,28,089,"Madison County, MS",Nov-21,52794,51359,1435,2.70000000
CN2809100000000,28,091,"Marion County, MS",Nov-21,10416,10070,346,3.30000000
CN2809300000000,28,093,"Marshall County, MS",Nov-21,14209,13693,516,3.60000000
CN2809500000000,28,095,"Monroe County, MS",Nov-21,15814,15274,540,3.40000000
CN2809700000000,28,097,"Montgomery County, MS",Nov-21,3837,3683,154,4.00000000
CN2809900000000,28,099,"Neshoba County, MS",Nov-21,9793,9407,386,3.90000000
CN2810100000000,28,101,"Newton County, MS",Nov-21,8112,7821,291,3.60000000
CN2810300000000,28,103,"Noxubee County, MS",Nov-21,3417,3194,223,6.50000000
CN2810500000000,28,105,"Oktibbeha County, MS",Nov-21,22772,21991,781,3.40000000
CN2810700000000,28,107,"Panola County, MS",Nov-21,12494,11914,580,4.60000000
CN2810900000000,28,109,"Pearl River County, MS",Nov-21,23348,22498,850,3.60000000
CN2811100000000,28,111,"Perry County, MS",Nov-21,4237,4057,180,4.20000000
CN2811300000000,28,113,"Pike County, MS",Nov-21,14163,13476,687,4.90000000
CN2811500000000,28,115,"Pontotoc County, MS",Nov-21,14934,14528,406,2.70000000
CN2811700000000,28,117,"Prentiss County, MS",Nov-21,11263,10951,312,2.80000000
CN2811900000000,28,119,"Quitman County, MS",Nov-21,2224,2100,124,5.60000000
CN2812100000000,28,121,"Rankin County, MS",Nov-21,75686,73881,1805,2.40000000
CN2812300000000,28,123,"Scott County, MS",Nov-21,12103,11738,365,3.00000000
CN2812500000000,28,125,"Sharkey County, MS",Nov-21,1297,1214,83,6.40000000
CN2812700000000,28,127,"Simpson County, MS",Nov-21,10417,10073,344,3.30000000
CN2812900000000,28,129,"Smith County, MS",Nov-21,6395,6209,186,2.90000000
CN2813100000000,28,131,"Stone County, MS",Nov-21,6898,6652,246,3.60000000
CN2813300000000,28,133,"Sunflower County, MS",Nov-21,7232,6786,446,6.20000000
CN2813500000000,28,135,"Tallahatchie County, MS",Nov-21,4590,4402,188,4.10000000
CN2813700000000,28,137,"Tate County, MS",Nov-21,12069,11640,429,3.60000000
CN2813900000000,28,139,"Tippah County, MS",Nov-21,9569,9304,265,2.80000000
CN2814100000000,28,141,"Tishomingo County, MS",Nov-21,8323,8071,252,3.00000000
CN2814300000000,28,143,"Tunica County, MS",Nov-21,4178,3943,235,5.60000000
CN2814500000000,28,145,"Union County, MS",Nov-21,14279,13927,352,2.50000000
CN2814700000000,28,147,"Walthall County, MS",Nov-21,4836,4612,224,4.60000000
CN2814900000000,28,149,"Warren County, MS",Nov-21,19398,18617,781,4.00000000
CN2815100000000,28,151,"Washington County, MS",Nov-21,15535,14668,867,5.60000000
CN2815300000000,28,153,"Wayne County, MS",Nov-21,7227,6900,327,4.50000000
CN2815500000000,28,155,"Webster County, MS",Nov-21,3923,3788,135,3.40000000
CN2815700000000,28,157,"Wilkinson County, MS",Nov-21,2610,2409,201,7.70000000
CN2815900000000,28,159,"Winston County, MS",Nov-21,6980,6680,300,4.30000000
CN2816100000000,28,161,"Yalobusha County, MS",Nov-21,4928,4764,164,3.30000000
CN2816300000000,28,163,"Yazoo County, MS",Nov-21,8732,8304,428,4.90000000
CN2900100000000,29,001,"Adair County, MO",Nov-21,9981,9640,341,3.40000000
CN2900300000000,29,003,"Andrew County, MO",Nov-21,9670,9455,215,2.20000000
CN2900500000000,29,005,"Atchison County, MO",Nov-21,2573,2506,67,2.60000000
CN2900700000000,29,007,"Audrain County, MO",Nov-21,10236,9916,320,3.10000000
CN2900900000000,29,009,"Barry County, MO",Nov-21,14835,14319,516,3.50000000
CN2901100000000,29,011,"Barton County, MO",Nov-21,5136,4997,139,2.70000000
CN2901300000000,29,013,"Bates County, MO",Nov-21,7524,7277,247,3.30000000
CN2901500000000,29,015,"Benton County, MO",Nov-21,7243,6935,308,4.30000000
CN2901700000000,29,017,"Bollinger County, MO",Nov-21,5325,5161,164,3.10000000
CN2901900000000,29,019,"Boone County, MO",Nov-21,100553,98153,2400,2.40000000
CN2902100000000,29,021,"Buchanan County, MO",Nov-21,43570,42317,1253,2.90000000
CN2902300000000,29,023,"Butler County, MO",Nov-21,18211,17589,622,3.40000000
CN2902500000000,29,025,"Caldwell County, MO",Nov-21,4205,4041,164,3.90000000
CN2902700000000,29,027,"Callaway County, MO",Nov-21,21234,20658,576,2.70000000
CN2902900000000,29,029,"Camden County, MO",Nov-21,18802,18042,760,4.00000000
CN2903100000000,29,031,"Cape Girardeau County, MO",Nov-21,40872,39753,1119,2.70000000
CN2903300000000,29,033,"Carroll County, MO",Nov-21,4382,4234,148,3.40000000
CN2903500000000,29,035,"Carter County, MO",Nov-21,2514,2411,103,4.10000000
CN2903700000000,29,037,"Cass County, MO",Nov-21,54316,52720,1596,2.90000000
CN2903900000000,29,039,"Cedar County, MO",Nov-21,5676,5512,164,2.90000000
CN2904100000000,29,041,"Chariton County, MO",Nov-21,3707,3620,87,2.30000000
CN2904300000000,29,043,"Christian County, MO",Nov-21,47149,46006,1143,2.40000000
CN2904500000000,29,045,"Clark County, MO",Nov-21,3039,2949,90,3.00000000
CN2904700000000,29,047,"Clay County, MO",Nov-21,138161,132916,5245,3.80000000
CN2904900000000,29,049,"Clinton County, MO",Nov-21,10493,10104,389,3.70000000
CN2905100000000,29,051,"Cole County, MO",Nov-21,38624,37699,925,2.40000000
CN2905300000000,29,053,"Cooper County, MO",Nov-21,7038,6849,189,2.70000000
CN2905500000000,29,055,"Crawford County, MO",Nov-21,10789,10440,349,3.20000000
CN2905700000000,29,057,"Dade County, MO",Nov-21,3470,3380,90,2.60000000
CN2905900000000,29,059,"Dallas County, MO",Nov-21,7160,6908,252,3.50000000
CN2906100000000,29,061,"Daviess County, MO",Nov-21,3959,3846,113,2.90000000
CN2906300000000,29,063,"DeKalb County, MO",Nov-21,4118,3998,120,2.90000000
CN2906500000000,29,065,"Dent County, MO",Nov-21,6212,5991,221,3.60000000
CN2906700000000,29,067,"Douglas County, MO",Nov-21,5138,4976,162,3.20000000
CN2906900000000,29,069,"Dunklin County, MO",Nov-21,10865,10387,478,4.40000000
CN2907100000000,29,071,"Franklin County, MO",Nov-21,52967,51455,1512,2.90000000
CN2907300000000,29,073,"Gasconade County, MO",Nov-21,7633,7439,194,2.50000000
CN2907500000000,29,075,"Gentry County, MO",Nov-21,3228,3160,68,2.10000000
CN2907700000000,29,077,"Greene County, MO",Nov-21,153994,150006,3988,2.60000000
CN2907900000000,29,079,"Grundy County, MO",Nov-21,4065,3945,120,3.00000000
CN2908100000000,29,081,"Harrison County, MO",Nov-21,3696,3601,95,2.60000000
CN2908300000000,29,083,"Henry County, MO",Nov-21,10041,9745,296,2.90000000
CN2908500000000,29,085,"Hickory County, MO",Nov-21,3897,3776,121,3.10000000
CN2908700000000,29,087,"Holt County, MO",Nov-21,2380,2332,48,2.00000000
CN2908900000000,29,089,"Howard County, MO",Nov-21,4850,4715,135,2.80000000
CN2909100000000,29,091,"Howell County, MO",Nov-21,16250,15655,595,3.70000000
CN2909300000000,29,093,"Iron County, MO",Nov-21,3451,3282,169,4.90000000
CN2909500000000,29,095,"Jackson County, MO",Nov-21,358481,344120,14361,4.00000000
CN2909700000000,29,097,"Jasper County, MO",Nov-21,57683,56052,1631,2.80000000
CN2909900000000,29,099,"Jefferson County, MO",Nov-21,118541,115027,3514,3.00000000
CN2910100000000,29,101,"Johnson County, MO",Nov-21,23058,22324,734,3.20000000
CN2910300000000,29,103,"Knox County, MO",Nov-21,1676,1637,39,2.30000000
CN2910500000000,29,105,"Laclede County, MO",Nov-21,16371,15808,563,3.40000000
CN2910700000000,29,107,"Lafayette County, MO",Nov-21,16470,15942,528,3.20000000
CN2910900000000,29,109,"Lawrence County, MO",Nov-21,17360,16862,498,2.90000000
CN2911100000000,29,111,"Lewis County, MO",Nov-21,4740,4610,130,2.70000000
CN2911300000000,29,113,"Lincoln County, MO",Nov-21,29219,28341,878,3.00000000
CN2911500000000,29,115,"Linn County, MO",Nov-21,5016,4840,176,3.50000000
CN2911700000000,29,117,"Livingston County, MO",Nov-21,7159,6990,169,2.40000000
CN2911900000000,29,119,"McDonald County, MO",Nov-21,10769,10455,314,2.90000000
CN2912100000000,29,121,"Macon County, MO",Nov-21,7319,7126,193,2.60000000
CN2912300000000,29,123,"Madison County, MO",Nov-21,5464,5286,178,3.30000000
CN2912500000000,29,125,"Maries County, MO",Nov-21,3903,3787,116,3.00000000
CN2912700000000,29,127,"Marion County, MO",Nov-21,14209,13841,368,2.60000000
CN2912900000000,29,129,"Mercer County, MO",Nov-21,1706,1665,41,2.40000000
CN2913100000000,29,131,"Miller County, MO",Nov-21,12557,12172,385,3.10000000
CN2913300000000,29,133,"Mississippi County, MO",Nov-21,5244,5060,184,3.50000000
CN2913500000000,29,135,"Moniteau County, MO",Nov-21,6907,6722,185,2.70000000
CN2913700000000,29,137,"Monroe County, MO",Nov-21,3714,3592,122,3.30000000
CN2913900000000,29,139,"Montgomery County, MO",Nov-21,5739,5583,156,2.70000000
CN2914100000000,29,141,"Morgan County, MO",Nov-21,8489,8184,305,3.60000000
CN2914300000000,29,143,"New Madrid County, MO",Nov-21,8107,7819,288,3.60000000
CN2914500000000,29,145,"Newton County, MO",Nov-21,27234,26458,776,2.80000000
CN2914700000000,29,147,"Nodaway County, MO",Nov-21,11008,10756,252,2.30000000
CN2914900000000,29,149,"Oregon County, MO",Nov-21,3793,3638,155,4.10000000
CN2915100000000,29,151,"Osage County, MO",Nov-21,6913,6762,151,2.20000000
CN2915300000000,29,153,"Ozark County, MO",Nov-21,3360,3214,146,4.30000000
CN2915500000000,29,155,"Pemiscot County, MO",Nov-21,5887,5574,313,5.30000000
CN2915700000000,29,157,"Perry County, MO",Nov-21,9676,9449,227,2.30000000
CN2915900000000,29,159,"Pettis County, MO",Nov-21,20080,19469,611,3.00000000
CN2916100000000,29,161,"Phelps County, MO",Nov-21,20236,19652,584,2.90000000
CN2916300000000,29,163,"Pike County, MO",Nov-21,7353,7143,210,2.90000000
CN2916500000000,29,165,"Platte County, MO",Nov-21,59357,57606,1751,2.90000000
CN2916700000000,29,167,"Polk County, MO",Nov-21,14632,14238,394,2.70000000
CN2916900000000,29,169,"Pulaski County, MO",Nov-21,14672,14155,517,3.50000000
CN2917100000000,29,171,"Putnam County, MO",Nov-21,2119,2072,47,2.20000000
CN2917300000000,29,173,"Ralls County, MO",Nov-21,5568,5430,138,2.50000000
CN2917500000000,29,175,"Randolph County, MO",Nov-21,10370,10041,329,3.20000000
CN2917700000000,29,177,"Ray County, MO",Nov-21,10915,10337,578,5.30000000
CN2917900000000,29,179,"Reynolds County, MO",Nov-21,2869,2766,103,3.60000000
CN2918100000000,29,181,"Ripley County, MO",Nov-21,5071,4856,215,4.20000000
CN2918300000000,29,183,"St. Charles County, MO",Nov-21,229012,223185,5827,2.50000000
CN2918500000000,29,185,"St. Clair County, MO",Nov-21,3791,3665,126,3.30000000
CN2918600000000,29,186,"Ste. Genevieve County, MO",Nov-21,9171,8936,235,2.60000000
CN2918700000000,29,187,"St. Francois County, MO",Nov-21,26049,25096,953,3.70000000
CN2918900000000,29,189,"St. Louis County, MO",Nov-21,529477,511905,17572,3.30000000
CN2919500000000,29,195,"Saline County, MO",Nov-21,10587,10296,291,2.70000000
CN2919700000000,29,197,"Schuyler County, MO",Nov-21,1808,1744,64,3.50000000
CN2919900000000,29,199,"Scotland County, MO",Nov-21,2222,2173,49,2.20000000
CN2920100000000,29,201,"Scott County, MO",Nov-21,20021,19440,581,2.90000000
CN2920300000000,29,203,"Shannon County, MO",Nov-21,3256,3108,148,4.50000000
CN2920500000000,29,205,"Shelby County, MO",Nov-21,2904,2840,64,2.20000000
CN2920700000000,29,207,"Stoddard County, MO",Nov-21,13149,12713,436,3.30000000
CN2920900000000,29,209,"Stone County, MO",Nov-21,13803,13223,580,4.20000000
CN2921100000000,29,211,"Sullivan County, MO",Nov-21,2537,2447,90,3.50000000
CN2921300000000,29,213,"Taney County, MO",Nov-21,26546,25301,1245,4.70000000
CN2921500000000,29,215,"Texas County, MO",Nov-21,8939,8600,339,3.80000000
CN2921700000000,29,217,"Vernon County, MO",Nov-21,9336,9076,260,2.80000000
CN2921900000000,29,219,"Warren County, MO",Nov-21,18738,18205,533,2.80000000
CN2922100000000,29,221,"Washington County, MO",Nov-21,10107,9743,364,3.60000000
CN2922300000000,29,223,"Wayne County, MO",Nov-21,4758,4564,194,4.10000000
CN2922500000000,29,225,"Webster County, MO",Nov-21,17453,16988,465,2.70000000
CN2922700000000,29,227,"Worth County, MO",Nov-21,1164,1140,24,2.10000000
CN2922900000000,29,229,"Wright County, MO",Nov-21,7494,7260,234,3.10000000
CN2951000000000,29,510,"St. Louis city, MO",Nov-21,150531,143603,6928,4.60000000
CN3000100000000,30,001,"Beaverhead County, MT",Nov-21,5239,5116,123,2.30000000
CN3000300000000,30,003,"Big Horn County, MT",Nov-21,4707,4443,264,5.60000000
CN3000500000000,30,005,"Blaine County, MT",Nov-21,2289,2223,66,2.90000000
CN3000700000000,30,007,"Broadwater County, MT",Nov-21,2704,2619,85,3.10000000
CN3000900000000,30,009,"Carbon County, MT",Nov-21,5776,5623,153,2.60000000
CN3001100000000,30,011,"Carter County, MT",Nov-21,701,684,17,2.40000000
CN3001300000000,30,013,"Cascade County, MT",Nov-21,38391,37468,923,2.40000000
CN3001500000000,30,015,"Chouteau County, MT",Nov-21,2535,2485,50,2.00000000
CN3001700000000,30,017,"Custer County, MT",Nov-21,6269,6139,130,2.10000000
CN3001900000000,30,019,"Daniels County, MT",Nov-21,899,882,17,1.90000000
CN3002100000000,30,021,"Dawson County, MT",Nov-21,4595,4495,100,2.20000000
CN3002300000000,30,023,"Deer Lodge County, MT",Nov-21,5065,4936,129,2.50000000
CN3002500000000,30,025,"Fallon County, MT",Nov-21,1645,1611,34,2.10000000
CN3002700000000,30,027,"Fergus County, MT",Nov-21,5949,5811,138,2.30000000
CN3002900000000,30,029,"Flathead County, MT",Nov-21,51093,49475,1618,3.20000000
CN3003100000000,30,031,"Gallatin County, MT",Nov-21,74744,73265,1479,2.00000000
CN3003300000000,30,033,"Garfield County, MT",Nov-21,765,744,21,2.70000000
CN3003500000000,30,035,"Glacier County, MT",Nov-21,5456,5156,300,5.50000000
CN3003700000000,30,037,"Golden Valley County, MT",Nov-21,379,368,11,2.90000000
CN3003900000000,30,039,"Granite County, MT",Nov-21,1617,1547,70,4.30000000
CN3004100000000,30,041,"Hill County, MT",Nov-21,7659,7477,182,2.40000000
CN3004300000000,30,043,"Jefferson County, MT",Nov-21,5969,5825,144,2.40000000
CN3004500000000,30,045,"Judith Basin County, MT",Nov-21,1031,1008,23,2.20000000
CN3004700000000,30,047,"Lake County, MT",Nov-21,14187,13792,395,2.80000000
CN3004900000000,30,049,"Lewis and Clark County, MT",Nov-21,37595,36766,829,2.20000000
CN3005100000000,30,051,"Liberty County, MT",Nov-21,1012,991,21,2.10000000
CN3005300000000,30,053,"Lincoln County, MT",Nov-21,8163,7786,377,4.60000000
CN3005500000000,30,055,"McCone County, MT",Nov-21,996,982,14,1.40000000
CN3005700000000,30,057,"Madison County, MT",Nov-21,4462,4340,122,2.70000000
CN3005900000000,30,059,"Meagher County, MT",Nov-21,1002,980,22,2.20000000
CN3006100000000,30,061,"Mineral County, MT",Nov-21,1860,1771,89,4.80000000
CN3006300000000,30,063,"Missoula County, MT",Nov-21,65858,64175,1683,2.60000000
CN3006500000000,30,065,"Musselshell County, MT",Nov-21,2394,2317,77,3.20000000
CN3006700000000,30,067,"Park County, MT",Nov-21,9185,8903,282,3.10000000
CN3006900000000,30,069,"Petroleum County, MT",Nov-21,283,276,7,2.50000000
CN3007100000000,30,071,"Phillips County, MT",Nov-21,1872,1822,50,2.70000000
CN3007300000000,30,073,"Pondera County, MT",Nov-21,2671,2613,58,2.20000000
CN3007500000000,30,075,"Powder River County, MT",Nov-21,1039,1016,23,2.20000000
CN3007700000000,30,077,"Powell County, MT",Nov-21,3075,3014,61,2.00000000
CN3007900000000,30,079,"Prairie County, MT",Nov-21,512,495,17,3.30000000
CN3008100000000,30,081,"Ravalli County, MT",Nov-21,21484,20909,575,2.70000000
CN3008300000000,30,083,"Richland County, MT",Nov-21,6043,5891,152,2.50000000
CN3008500000000,30,085,"Roosevelt County, MT",Nov-21,4355,4231,124,2.80000000
CN3008700000000,30,087,"Rosebud County, MT",Nov-21,3582,3470,112,3.10000000
CN3008900000000,30,089,"Sanders County, MT",Nov-21,5314,5091,223,4.20000000
CN3009100000000,30,091,"Sheridan County, MT",Nov-21,1788,1750,38,2.10000000
CN3009300000000,30,093,"Silver Bow County, MT",Nov-21,17628,17171,457,2.60000000
CN3009500000000,30,095,"Stillwater County, MT",Nov-21,5597,5487,110,2.00000000
CN3009700000000,30,097,"Sweet Grass County, MT",Nov-21,1950,1917,33,1.70000000
CN3009900000000,30,099,"Teton County, MT",Nov-21,2886,2817,69,2.40000000
CN3010100000000,30,101,"Toole County, MT",Nov-21,2084,2039,45,2.20000000
CN3010300000000,30,103,"Treasure County, MT",Nov-21,357,347,10,2.80000000
CN3010500000000,30,105,"Valley County, MT",Nov-21,4132,4044,88,2.10000000
CN3010700000000,30,107,"Wheatland County, MT",Nov-21,786,759,27,3.40000000
CN3010900000000,30,109,"Wibaux County, MT",Nov-21,414,401,13,3.10000000
CN3011100000000,30,111,"Yellowstone County, MT",Nov-21,85786,83864,1922,2.20000000
CN3100100000000,31,001,"Adams County, NE",Nov-21,16909,16623,286,1.70000000
CN3100300000000,31,003,"Antelope County, NE",Nov-21,3634,3591,43,1.20000000
CN3100500000000,31,005,"Arthur County, NE",Nov-21,230,226,4,1.70000000
CN3100700000000,31,007,"Banner County, NE",Nov-21,394,387,7,1.80000000
CN3100900000000,31,009,"Blaine County, NE",Nov-21,243,238,5,2.10000000
CN3101100000000,31,011,"Boone County, NE",Nov-21,2935,2903,32,1.10000000
CN3101300000000,31,013,"Box Butte County, NE",Nov-21,5454,5359,95,1.70000000
CN3101500000000,31,015,"Boyd County, NE",Nov-21,1032,1016,16,1.60000000
CN3101700000000,31,017,"Brown County, NE",Nov-21,1413,1387,26,1.80000000
CN3101900000000,31,019,"Buffalo County, NE",Nov-21,28629,28242,387,1.40000000
CN3102100000000,31,021,"Burt County, NE",Nov-21,3747,3683,64,1.70000000
CN3102300000000,31,023,"Butler County, NE",Nov-21,4691,4624,67,1.40000000
CN3102500000000,31,025,"Cass County, NE",Nov-21,13687,13458,229,1.70000000
CN3102700000000,31,027,"Cedar County, NE",Nov-21,4657,4601,56,1.20000000
CN3102900000000,31,029,"Chase County, NE",Nov-21,2252,2226,26,1.20000000
CN3103100000000,31,031,"Cherry County, NE",Nov-21,3394,3352,42,1.20000000
CN3103300000000,31,033,"Cheyenne County, NE",Nov-21,4236,4155,81,1.90000000
CN3103500000000,31,035,"Clay County, NE",Nov-21,3229,3173,56,1.70000000
CN3103700000000,31,037,"Colfax County, NE",Nov-21,5764,5690,74,1.30000000
CN3103900000000,31,039,"Cuming County, NE",Nov-21,4921,4867,54,1.10000000
CN3104100000000,31,041,"Custer County, NE",Nov-21,6373,6301,72,1.10000000
CN3104300000000,31,043,"Dakota County, NE",Nov-21,10938,10733,205,1.90000000
CN3104500000000,31,045,"Dawes County, NE",Nov-21,5146,5075,71,1.40000000
CN3104700000000,31,047,"Dawson County, NE",Nov-21,13572,13363,209,1.50000000
CN3104900000000,31,049,"Deuel County, NE",Nov-21,977,962,15,1.50000000
CN3105100000000,31,051,"Dixon County, NE",Nov-21,3002,2956,46,1.50000000
CN3105300000000,31,053,"Dodge County, NE",Nov-21,20378,20056,322,1.60000000
CN3105500000000,31,055,"Douglas County, NE",Nov-21,307325,301021,6304,2.10000000
CN3105700000000,31,057,"Dundy County, NE",Nov-21,1151,1137,14,1.20000000
CN3105900000000,31,059,"Fillmore County, NE",Nov-21,3252,3209,43,1.30000000
CN3106100000000,31,061,"Franklin County, NE",Nov-21,1499,1475,24,1.60000000
CN3106300000000,31,063,"Frontier County, NE",Nov-21,1602,1580,22,1.40000000
CN3106500000000,31,065,"Furnas County, NE",Nov-21,2559,2521,38,1.50000000
CN3106700000000,31,067,"Gage County, NE",Nov-21,10995,10820,175,1.60000000
CN3106900000000,31,069,"Garden County, NE",Nov-21,1122,1107,15,1.30000000
CN3107100000000,31,071,"Garfield County, NE",Nov-21,1129,1113,16,1.40000000
CN3107300000000,31,073,"Gosper County, NE",Nov-21,1188,1174,14,1.20000000
CN3107500000000,31,075,"Grant County, NE",Nov-21,426,421,5,1.20000000
CN3107700000000,31,077,"Greeley County, NE",Nov-21,1218,1199,19,1.60000000
CN3107900000000,31,079,"Hall County, NE",Nov-21,32576,31970,606,1.90000000
CN3108100000000,31,081,"Hamilton County, NE",Nov-21,4854,4785,69,1.40000000
CN3108300000000,31,083,"Harlan County, NE",Nov-21,1746,1721,25,1.40000000
CN3108500000000,31,085,"Hayes County, NE",Nov-21,620,615,5,0.80000000
CN3108700000000,31,087,"Hitchcock County, NE",Nov-21,1317,1294,23,1.70000000
CN3108900000000,31,089,"Holt County, NE",Nov-21,5672,5599,73,1.30000000
CN3109100000000,31,091,"Hooker County, NE",Nov-21,410,405,5,1.20000000
CN3109300000000,31,093,"Howard County, NE",Nov-21,3448,3392,56,1.60000000
CN3109500000000,31,095,"Jefferson County, NE",Nov-21,4244,4197,47,1.10000000
CN3109700000000,31,097,"Johnson County, NE",Nov-21,1994,1958,36,1.80000000
CN3109900000000,31,099,"Kearney County, NE",Nov-21,3849,3805,44,1.10000000
CN3110100000000,31,101,"Keith County, NE",Nov-21,4699,4635,64,1.40000000
CN3110300000000,31,103,"Keya Paha County, NE",Nov-21,592,584,8,1.40000000
CN3110500000000,31,105,"Kimball County, NE",Nov-21,1960,1932,28,1.40000000
CN3110700000000,31,107,"Knox County, NE",Nov-21,4683,4617,66,1.40000000
CN3110900000000,31,109,"Lancaster County, NE",Nov-21,181025,178095,2930,1.60000000
CN3111100000000,31,111,"Lincoln County, NE",Nov-21,18613,18322,291,1.60000000
CN3111300000000,31,113,"Logan County, NE",Nov-21,469,461,8,1.70000000
CN3111500000000,31,115,"Loup County, NE",Nov-21,390,383,7,1.80000000
CN3111700000000,31,117,"McPherson County, NE",Nov-21,434,429,5,1.20000000
CN3111900000000,31,119,"Madison County, NE",Nov-21,20363,20074,289,1.40000000
CN3112100000000,31,121,"Merrick County, NE",Nov-21,4147,4081,66,1.60000000
CN3112300000000,31,123,"Morrill County, NE",Nov-21,2600,2551,49,1.90000000
CN3112500000000,31,125,"Nance County, NE",Nov-21,1960,1934,26,1.30000000
CN3112700000000,31,127,"Nemaha County, NE",Nov-21,3714,3655,59,1.60000000
CN3112900000000,31,129,"Nuckolls County, NE",Nov-21,2507,2474,33,1.30000000
CN3113100000000,31,131,"Otoe County, NE",Nov-21,8632,8501,131,1.50000000
CN3113300000000,31,133,"Pawnee County, NE",Nov-21,1523,1502,21,1.40000000
CN3113500000000,31,135,"Perkins County, NE",Nov-21,1866,1845,21,1.10000000
CN3113700000000,31,137,"Phelps County, NE",Nov-21,4947,4883,64,1.30000000
CN3113900000000,31,139,"Pierce County, NE",Nov-21,4202,4152,50,1.20000000
CN3114100000000,31,141,"Platte County, NE",Nov-21,18551,18294,257,1.40000000
CN3114300000000,31,143,"Polk County, NE",Nov-21,2940,2903,37,1.30000000
CN3114500000000,31,145,"Red Willow County, NE",Nov-21,5849,5767,82,1.40000000
CN3114700000000,31,147,"Richardson County, NE",Nov-21,4270,4202,68,1.60000000
CN3114900000000,31,149,"Rock County, NE",Nov-21,891,882,9,1.00000000
CN3115100000000,31,151,"Saline County, NE",Nov-21,7263,7153,110,1.50000000
CN3115300000000,31,153,"Sarpy County, NE",Nov-21,100159,98477,1682,1.70000000
CN3115500000000,31,155,"Saunders County, NE",Nov-21,11594,11410,184,1.60000000
CN3115700000000,31,157,"Scotts Bluff County, NE",Nov-21,18194,17854,340,1.90000000
CN3115900000000,31,159,"Seward County, NE",Nov-21,8893,8755,138,1.60000000
CN3116100000000,31,161,"Sheridan County, NE",Nov-21,2740,2704,36,1.30000000
CN3116300000000,31,163,"Sherman County, NE",Nov-21,1689,1663,26,1.50000000
CN3116500000000,31,165,"Sioux County, NE",Nov-21,749,738,11,1.50000000
CN3116700000000,31,167,"Stanton County, NE",Nov-21,3647,3603,44,1.20000000
CN3116900000000,31,169,"Thayer County, NE",Nov-21,2698,2662,36,1.30000000
CN3117100000000,31,171,"Thomas County, NE",Nov-21,423,416,7,1.70000000
CN3117300000000,31,173,"Thurston County, NE",Nov-21,3115,3031,84,2.70000000
CN3117500000000,31,175,"Valley County, NE",Nov-21,2088,2060,28,1.30000000
CN3117700000000,31,177,"Washington County, NE",Nov-21,11513,11332,181,1.60000000
CN3117900000000,31,179,"Wayne County, NE",Nov-21,5829,5742,87,1.50000000
CN3118100000000,31,181,"Webster County, NE",Nov-21,1653,1629,24,1.50000000
CN3118300000000,31,183,"Wheeler County, NE",Nov-21,571,566,5,0.90000000
CN3118500000000,31,185,"York County, NE",Nov-21,7281,7187,94,1.30000000
CN3200100000000,32,001,"Churchill County, NV",Nov-21,10527,10274,253,2.40000000
CN3200300000000,32,003,"Clark County, NV",Nov-21,1099665,1040987,58678,5.30000000
CN3200500000000,32,005,"Douglas County, NV",Nov-21,20954,20346,608,2.90000000
CN3200700000000,32,007,"Elko County, NV",Nov-21,24366,23851,515,2.10000000
CN3200900000000,32,009,"Esmeralda County, NV",Nov-21,380,369,11,2.90000000
CN3201100000000,32,011,"Eureka County, NV",Nov-21,884,867,17,1.90000000
CN3201300000000,32,013,"Humboldt County, NV",Nov-21,7498,7334,164,2.20000000
CN3201500000000,32,015,"Lander County, NV",Nov-21,2978,2904,74,2.50000000
CN3201700000000,32,017,"Lincoln County, NV",Nov-21,2019,1973,46,2.30000000
CN3201900000000,32,019,"Lyon County, NV",Nov-21,22724,21944,780,3.40000000
CN3202100000000,32,021,"Mineral County, NV",Nov-21,1989,1942,47,2.40000000
CN3202300000000,32,023,"Nye County, NV",Nov-21,16623,15932,691,4.20000000
CN3202700000000,32,027,"Pershing County, NV",Nov-21,2341,2278,63,2.70000000
CN3202900000000,32,029,"Storey County, NV",Nov-21,2029,1975,54,2.70000000
CN3203100000000,32,031,"Washoe County, NV",Nov-21,249357,242983,6374,2.60000000
CN3203300000000,32,033,"White Pine County, NV",Nov-21,4369,4274,95,2.20000000
CN3251000000000,32,510,"Carson City, NV",Nov-21,24985,24254,731,2.90000000
CN3300100000000,33,001,"Belknap County, NH",Nov-21,30472,29673,799,2.60000000
CN3300300000000,33,003,"Carroll County, NH",Nov-21,21994,21379,615,2.80000000
CN3300500000000,33,005,"Cheshire County, NH",Nov-21,39539,38414,1125,2.80000000
CN3300700000000,33,007,"Coos County, NH",Nov-21,14032,13589,443,3.20000000
CN3300900000000,33,009,"Grafton County, NH",Nov-21,48407,47234,1173,2.40000000
CN3301100000000,33,011,"Hillsborough County, NH",Nov-21,238153,231933,6220,2.60000000
CN3301300000000,33,013,"Merrimack County, NH",Nov-21,81000,79197,1803,2.20000000
CN3301500000000,33,015,"Rockingham County, NH",Nov-21,185906,181028,4878,2.60000000
CN3301700000000,33,017,"Strafford County, NH",Nov-21,73198,71517,1681,2.30000000
CN3301900000000,33,019,"Sullivan County, NH",Nov-21,22819,22254,565,2.50000000
CN3400100000000,34,001,"Atlantic County, NJ",Nov-21,123443,115277,8166,6.60000000
CN3400300000000,34,003,"Bergen County, NJ",Nov-21,494588,473308,21280,4.30000000
CN3400500000000,34,005,"Burlington County, NJ",Nov-21,242857,233650,9207,3.80000000
CN3400700000000,34,007,"Camden County, NJ",Nov-21,266667,253576,13091,4.90000000
CN3400900000000,34,009,"Cape May County, NJ",Nov-21,42918,39660,3258,7.60000000
CN3401100000000,34,011,"Cumberland County, NJ",Nov-21,67438,63580,3858,5.70000000
CN3401300000000,34,013,"Essex County, NJ",Nov-21,382574,360630,21944,5.70000000
CN3401500000000,34,015,"Gloucester County, NJ",Nov-21,158410,151574,6836,4.30000000
CN3401700000000,34,017,"Hudson County, NJ",Nov-21,370663,352883,17780,4.80000000
CN3401900000000,34,019,"Hunterdon County, NJ",Nov-21,66383,64201,2182,3.30000000
CN3402100000000,34,021,"Mercer County, NJ",Nov-21,212253,204389,7864,3.70000000
CN3402300000000,34,023,"Middlesex County, NJ",Nov-21,449426,431020,18406,4.10000000
CN3402500000000,34,025,"Monmouth County, NJ",Nov-21,338316,324998,13318,3.90000000
CN3402700000000,34,027,"Morris County, NJ",Nov-21,262871,253506,9365,3.60000000
CN3402900000000,34,029,"Ocean County, NJ",Nov-21,290291,277661,12630,4.40000000
CN3403100000000,34,031,"Passaic County, NJ",Nov-21,248952,234087,14865,6.00000000
CN3403300000000,34,033,"Salem County, NJ",Nov-21,29679,28037,1642,5.50000000
CN3403500000000,34,035,"Somerset County, NJ",Nov-21,175255,168832,6423,3.70000000
CN3403700000000,34,037,"Sussex County, NJ",Nov-21,75904,72678,3226,4.30000000
CN3403900000000,34,039,"Union County, NJ",Nov-21,284219,270467,13752,4.80000000
CN3404100000000,34,041,"Warren County, NJ",Nov-21,58481,56263,2218,3.80000000
CN3500100000000,35,001,"Bernalillo County, NM",Nov-21,340749,323389,17360,5.10000000
CN3500300000000,35,003,"Catron County, NM",Nov-21,1119,1060,59,5.30000000
CN3500500000000,35,005,"Chaves County, NM",Nov-21,27700,25993,1707,6.20000000
CN3500600000000,35,006,"Cibola County, NM",Nov-21,9075,8405,670,7.40000000
CN3500700000000,35,007,"Colfax County, NM",Nov-21,5641,5366,275,4.90000000
CN3500900000000,35,009,"Curry County, NM",Nov-21,21280,20378,902,4.20000000
CN3501100000000,35,011,"De Baca County, NM",Nov-21,678,648,30,4.40000000
CN3501300000000,35,013,"Dona Ana County, NM",Nov-21,99060,93489,5571,5.60000000
CN3501500000000,35,015,"Eddy County, NM",Nov-21,31655,29989,1666,5.30000000
CN3501700000000,35,017,"Grant County, NM",Nov-21,11403,10702,701,6.10000000
CN3501900000000,35,019,"Guadalupe County, NM",Nov-21,1721,1611,110,6.40000000
CN3502100000000,35,021,"Harding County, NM",Nov-21,283,270,13,4.60000000
CN3502300000000,35,023,"Hidalgo County, NM",Nov-21,1875,1792,83,4.40000000
CN3502500000000,35,025,"Lea County, NM",Nov-21,28105,25935,2170,7.70000000
CN3502700000000,35,027,"Lincoln County, NM",Nov-21,9002,8460,542,6.00000000
CN3502800000000,35,028,"Los Alamos County, NM",Nov-21,10014,9753,261,2.60000000
CN3502900000000,35,029,"Luna County, NM",Nov-21,9514,8139,1375,14.50000000
CN3503100000000,35,031,"McKinley County, NM",Nov-21,23729,21809,1920,8.10000000
CN3503300000000,35,033,"Mora County, NM",Nov-21,1924,1819,105,5.50000000
CN3503500000000,35,035,"Otero County, NM",Nov-21,24672,23306,1366,5.50000000
CN3503700000000,35,037,"Quay County, NM",Nov-21,2966,2779,187,6.30000000
CN3503900000000,35,039,"Rio Arriba County, NM",Nov-21,16664,15671,993,6.00000000
CN3504100000000,35,041,"Roosevelt County, NM",Nov-21,7829,7454,375,4.80000000
CN3504300000000,35,043,"Sandoval County, NM",Nov-21,68963,65245,3718,5.40000000
CN3504500000000,35,045,"San Juan County, NM",Nov-21,50134,46820,3314,6.60000000
CN3504700000000,35,047,"San Miguel County, NM",Nov-21,10365,9718,647,6.20000000
CN3504900000000,35,049,"Santa Fe County, NM",Nov-21,73772,70114,3658,5.00000000
CN3505100000000,35,051,"Sierra County, NM",Nov-21,4077,3797,280,6.90000000
CN3505300000000,35,053,"Socorro County, NM",Nov-21,6185,5850,335,5.40000000
CN3505500000000,35,055,"Taos County, NM",Nov-21,14663,13575,1088,7.40000000
CN3505700000000,35,057,"Torrance County, NM",Nov-21,5508,5127,381,6.90000000
CN3505900000000,35,059,"Union County, NM",Nov-21,1569,1511,58,3.70000000
CN3506100000000,35,061,"Valencia County, NM",Nov-21,31415,29629,1786,5.70000000
CN3600100000000,36,001,"Albany County, NY",Nov-21,155687,151034,4653,3.00000000
CN3600300000000,36,003,"Allegany County, NY",Nov-21,19156,18456,700,3.70000000
CN3600500000000,36,005,"Bronx County, NY",Nov-21,591805,533295,58510,9.90000000
CN3600700000000,36,007,"Broome County, NY",Nov-21,80364,77445,2919,3.60000000
CN3600900000000,36,009,"Cattaraugus County, NY",Nov-21,32231,31017,1214,3.80000000
CN3601100000000,36,011,"Cayuga County, NY",Nov-21,34542,33419,1123,3.30000000
CN3601300000000,36,013,"Chautauqua County, NY",Nov-21,51119,49119,2000,3.90000000
CN3601500000000,36,015,"Chemung County, NY",Nov-21,34127,32876,1251,3.70000000
CN3601700000000,36,017,"Chenango County, NY",Nov-21,21198,20567,631,3.00000000
CN3601900000000,36,019,"Clinton County, NY",Nov-21,35119,34053,1066,3.00000000
CN3602100000000,36,021,"Columbia County, NY",Nov-21,29742,28979,763,2.60000000
CN3602300000000,36,023,"Cortland County, NY",Nov-21,22077,21302,775,3.50000000
CN3602500000000,36,025,"Delaware County, NY",Nov-21,19037,18461,576,3.00000000
CN3602700000000,36,027,"Dutchess County, NY",Nov-21,140958,136625,4333,3.10000000
CN3602900000000,36,029,"Erie County, NY",Nov-21,431521,414896,16625,3.90000000
CN3603100000000,36,031,"Essex County, NY",Nov-21,16036,15478,558,3.50000000
CN3603300000000,36,033,"Franklin County, NY",Nov-21,18805,18173,632,3.40000000
CN3603500000000,36,035,"Fulton County, NY",Nov-21,22144,21295,849,3.80000000
CN3603700000000,36,037,"Genesee County, NY",Nov-21,28963,28115,848,2.90000000
CN3603900000000,36,039,"Greene County, NY",Nov-21,19844,19153,691,3.50000000
CN3604100000000,36,041,"Hamilton County, NY",Nov-21,2124,2042,82,3.90000000
CN3604300000000,36,043,"Herkimer County, NY",Nov-21,27022,25928,1094,4.00000000
CN3604500000000,36,045,"Jefferson County, NY",Nov-21,43668,42095,1573,3.60000000
CN3604700000000,36,047,"Kings County, NY",Nov-21,1174596,1089892,84704,7.20000000
CN3604900000000,36,049,"Lewis County, NY",Nov-21,11412,10996,416,3.60000000
CN3605100000000,36,051,"Livingston County, NY",Nov-21,29716,28859,857,2.90000000
CN3605300000000,36,053,"Madison County, NY",Nov-21,31975,31006,969,3.00000000
CN3605500000000,36,055,"Monroe County, NY",Nov-21,359581,346759,12822,3.60000000
CN3605700000000,36,057,"Montgomery County, NY",Nov-21,21848,20964,884,4.00000000
CN3605900000000,36,059,"Nassau County, NY",Nov-21,708379,687032,21347,3.00000000
CN3606100000000,36,061,"New York County, NY",Nov-21,887277,839952,47325,5.30000000
CN3606300000000,36,063,"Niagara County, NY",Nov-21,95099,91393,3706,3.90000000
CN3606500000000,36,065,"Oneida County, NY",Nov-21,98716,95263,3453,3.50000000
CN3606700000000,36,067,"Onondaga County, NY",Nov-21,218622,211350,7272,3.30000000
CN3606900000000,36,069,"Ontario County, NY",Nov-21,54860,53291,1569,2.90000000
CN3607100000000,36,071,"Orange County, NY",Nov-21,182310,176333,5977,3.30000000
CN3607300000000,36,073,"Orleans County, NY",Nov-21,16861,16284,577,3.40000000
CN3607500000000,36,075,"Oswego County, NY",Nov-21,51471,49484,1987,3.90000000
CN3607700000000,36,077,"Otsego County, NY",Nov-21,26764,25967,797,3.00000000
CN3607900000000,36,079,"Putnam County, NY",Nov-21,49983,48538,1445,2.90000000
CN3608100000000,36,081,"Queens County, NY",Nov-21,1111164,1035955,75209,6.80000000
CN3608300000000,36,083,"Rensselaer County, NY",Nov-21,80264,77878,2386,3.00000000
CN3608500000000,36,085,"Richmond County, NY",Nov-21,219332,205610,13722,6.30000000
CN3608700000000,36,087,"Rockland County, NY",Nov-21,152524,147932,4592,3.00000000
CN3608900000000,36,089,"St. Lawrence County, NY",Nov-21,43000,41474,1526,3.50000000
CN3609100000000,36,091,"Saratoga County, NY",Nov-21,118640,115683,2957,2.50000000
CN3609300000000,36,093,"Schenectady County, NY",Nov-21,76176,73620,2556,3.40000000
CN3609500000000,36,095,"Schoharie County, NY",Nov-21,14357,13928,429,3.00000000
CN3609700000000,36,097,"Schuyler County, NY",Nov-21,7868,7586,282,3.60000000
CN3609900000000,36,099,"Seneca County, NY",Nov-21,14821,14365,456,3.10000000
CN3610100000000,36,101,"Steuben County, NY",Nov-21,40764,39340,1424,3.50000000
CN3610300000000,36,103,"Suffolk County, NY",Nov-21,776662,752567,24095,3.10000000
CN3610500000000,36,105,"Sullivan County, NY",Nov-21,35452,34227,1225,3.50000000
CN3610700000000,36,107,"Tioga County, NY",Nov-21,21744,21082,662,3.00000000
CN3610900000000,36,109,"Tompkins County, NY",Nov-21,48602,47366,1236,2.50000000
CN3611100000000,36,111,"Ulster County, NY",Nov-21,85787,83074,2713,3.20000000
CN3611300000000,36,113,"Warren County, NY",Nov-21,30341,29256,1085,3.60000000
CN3611500000000,36,115,"Washington County, NY",Nov-21,26709,25854,855,3.20000000
CN3611700000000,36,117,"Wayne County, NY",Nov-21,42700,41445,1255,2.90000000
CN3611900000000,36,119,"Westchester County, NY",Nov-21,475275,459432,15843,3.30000000
CN3612100000000,36,121,"Wyoming County, NY",Nov-21,17620,17077,543,3.10000000
CN3612300000000,36,123,"Yates County, NY",Nov-21,11443,11147,296,2.60000000
CN3700100000000,37,001,"Alamance County, NC",Nov-21,81685,78675,3010,3.70000000
CN3700300000000,37,003,"Alexander County, NC",Nov-21,17523,16960,563,3.20000000
CN3700500000000,37,005,"Alleghany County, NC",Nov-21,4193,4047,146,3.50000000
CN3700700000000,37,007,"Anson County, NC",Nov-21,10124,9587,537,5.30000000
CN3700900000000,37,009,"Ashe County, NC",Nov-21,12672,12302,370,2.90000000
CN3701100000000,37,011,"Avery County, NC",Nov-21,7292,7080,212,2.90000000
CN3701300000000,37,013,"Beaufort County, NC",Nov-21,19543,18797,746,3.80000000
CN3701500000000,37,015,"Bertie County, NC",Nov-21,7104,6766,338,4.80000000
CN3701700000000,37,017,"Bladen County, NC",Nov-21,13850,13179,671,4.80000000
CN3701900000000,37,019,"Brunswick County, NC",Nov-21,54083,51482,2601,4.80000000
CN3702100000000,37,021,"Buncombe County, NC",Nov-21,137855,133674,4181,3.00000000
CN3702300000000,37,023,"Burke County, NC",Nov-21,39822,38454,1368,3.40000000
CN3702500000000,37,025,"Cabarrus County, NC",Nov-21,110831,107072,3759,3.40000000
CN3702700000000,37,027,"Caldwell County, NC",Nov-21,35515,34215,1300,3.70000000
CN3702900000000,37,029,"Camden County, NC",Nov-21,4515,4373,142,3.10000000
CN3703100000000,37,031,"Carteret County, NC",Nov-21,31139,30146,993,3.20000000
CN3703300000000,37,033,"Caswell County, NC",Nov-21,9590,9209,381,4.00000000
CN3703500000000,37,035,"Catawba County, NC",Nov-21,77458,74748,2710,3.50000000
CN3703700000000,37,037,"Chatham County, NC",Nov-21,37077,36066,1011,2.70000000
CN3703900000000,37,039,"Cherokee County, NC",Nov-21,10569,10171,398,3.80000000
CN3704100000000,37,041,"Chowan County, NC",Nov-21,5659,5443,216,3.80000000
CN3704300000000,37,043,"Clay County, NC",Nov-21,3995,3848,147,3.70000000
CN3704500000000,37,045,"Cleveland County, NC",Nov-21,48160,46161,1999,4.20000000
CN3704700000000,37,047,"Columbus County, NC",Nov-21,22679,21529,1150,5.10000000
CN3704900000000,37,049,"Craven County, NC",Nov-21,41001,39531,1470,3.60000000
CN3705100000000,37,051,"Cumberland County, NC",Nov-21,126064,118972,7092,5.60000000
CN3705300000000,37,053,"Currituck County, NC",Nov-21,14221,13795,426,3.00000000
CN3705500000000,37,055,"Dare County, NC",Nov-21,18544,17764,780,4.20000000
CN3705700000000,37,057,"Davidson County, NC",Nov-21,79962,77202,2760,3.50000000
CN3705900000000,37,059,"Davie County, NC",Nov-21,20357,19687,670,3.30000000
CN3706100000000,37,061,"Duplin County, NC",Nov-21,24135,23290,845,3.50000000
CN3706300000000,37,063,"Durham County, NC",Nov-21,177648,172092,5556,3.10000000
CN3706500000000,37,065,"Edgecombe County, NC",Nov-21,20542,19035,1507,7.30000000
CN3706700000000,37,067,"Forsyth County, NC",Nov-21,185461,178423,7038,3.80000000
CN3706900000000,37,069,"Franklin County, NC",Nov-21,32519,31306,1213,3.70000000
CN3707100000000,37,071,"Gaston County, NC",Nov-21,109965,105487,4478,4.10000000
CN3707300000000,37,073,"Gates County, NC",Nov-21,4953,4794,159,3.20000000
CN3707500000000,37,075,"Graham County, NC",Nov-21,2926,2761,165,5.60000000
CN3707700000000,37,077,"Granville County, NC",Nov-21,30070,29135,935,3.10000000
CN3707900000000,37,079,"Greene County, NC",Nov-21,9389,9089,300,3.20000000
CN3708100000000,37,081,"Guilford County, NC",Nov-21,257573,246241,11332,4.40000000
CN3708300000000,37,083,"Halifax County, NC",Nov-21,18954,17775,1179,6.20000000
CN3708500000000,37,085,"Harnett County, NC",Nov-21,53718,51468,2250,4.20000000
CN3708700000000,37,087,"Haywood County, NC",Nov-21,29266,28338,928,3.20000000
CN3708900000000,37,089,"Henderson County, NC",Nov-21,53746,52108,1638,3.00000000
CN3709100000000,37,091,"Hertford County, NC",Nov-21,8477,8020,457,5.40000000
CN3709300000000,37,093,"Hoke County, NC",Nov-21,19967,18929,1038,5.20000000
CN3709500000000,37,095,"Hyde County, NC",Nov-21,1743,1650,93,5.30000000
CN3709700000000,37,097,"Iredell County, NC",Nov-21,90471,87304,3167,3.50000000
CN3709900000000,37,099,"Jackson County, NC",Nov-21,19513,18851,662,3.40000000
CN3710100000000,37,101,"Johnston County, NC",Nov-21,103154,99820,3334,3.20000000
CN3710300000000,37,103,"Jones County, NC",Nov-21,4181,4038,143,3.40000000
CN3710500000000,37,105,"Lee County, NC",Nov-21,25519,24412,1107,4.30000000
CN3710700000000,37,107,"Lenoir County, NC",Nov-21,26962,25885,1077,4.00000000
CN3710900000000,37,109,"Lincoln County, NC",Nov-21,44345,42966,1379,3.10000000
CN3711100000000,37,111,"McDowell County, NC",Nov-21,19641,18978,663,3.40000000
CN3711300000000,37,113,"Macon County, NC",Nov-21,15346,14879,467,3.00000000
CN3711500000000,37,115,"Madison County, NC",Nov-21,9740,9434,306,3.10000000
CN3711700000000,37,117,"Martin County, NC",Nov-21,8680,8312,368,4.20000000
CN3711900000000,37,119,"Mecklenburg County, NC",Nov-21,625338,601424,23914,3.80000000
CN3712100000000,37,121,"Mitchell County, NC",Nov-21,5959,5722,237,4.00000000
CN3712300000000,37,123,"Montgomery County, NC",Nov-21,10922,10532,390,3.60000000
CN3712500000000,37,125,"Moore County, NC",Nov-21,40552,39124,1428,3.50000000
CN3712700000000,37,127,"Nash County, NC",Nov-21,42643,40497,2146,5.00000000
CN3712900000000,37,129,"New Hanover County, NC",Nov-21,124822,120808,4014,3.20000000
CN3713100000000,37,131,"Northampton County, NC",Nov-21,7096,6740,356,5.00000000
CN3713300000000,37,133,"Onslow County, NC",Nov-21,65721,63135,2586,3.90000000
CN3713500000000,37,135,"Orange County, NC",Nov-21,80691,78587,2104,2.60000000
CN3713700000000,37,137,"Pamlico County, NC",Nov-21,5337,5155,182,3.40000000
CN3713900000000,37,139,"Pasquotank County, NC",Nov-21,16216,15549,667,4.10000000
CN3714100000000,37,141,"Pender County, NC",Nov-21,29532,28580,952,3.20000000
CN3714300000000,37,143,"Perquimans County, NC",Nov-21,4821,4613,208,4.30000000
CN3714500000000,37,145,"Person County, NC",Nov-21,18664,17955,709,3.80000000
CN3714700000000,37,147,"Pitt County, NC",Nov-21,88541,85070,3471,3.90000000
CN3714900000000,37,149,"Polk County, NC",Nov-21,9076,8712,364,4.00000000
CN3715100000000,37,151,"Randolph County, NC",Nov-21,64337,62066,2271,3.50000000
CN3715300000000,37,153,"Richmond County, NC",Nov-21,16314,15332,982,6.00000000
CN3715500000000,37,155,"Robeson County, NC",Nov-21,48157,45127,3030,6.30000000
CN3715700000000,37,157,"Rockingham County, NC",Nov-21,38979,37322,1657,4.30000000
CN3715900000000,37,159,"Rowan County, NC",Nov-21,64792,62395,2397,3.70000000
CN3716100000000,37,161,"Rutherford County, NC",Nov-21,24031,22785,1246,5.20000000
CN3716300000000,37,163,"Sampson County, NC",Nov-21,27525,26552,973,3.50000000
CN3716500000000,37,165,"Scotland County, NC",Nov-21,11127,10273,854,7.70000000
CN3716700000000,37,167,"Stanly County, NC",Nov-21,29722,28709,1013,3.40000000
CN3716900000000,37,169,"Stokes County, NC",Nov-21,21258,20576,682,3.20000000
CN3717100000000,37,171,"Surry County, NC",Nov-21,32110,31052,1058,3.30000000
CN3717300000000,37,173,"Swain County, NC",Nov-21,6861,6634,227,3.30000000
CN3717500000000,37,175,"Transylvania County, NC",Nov-21,14047,13594,453,3.20000000
CN3717700000000,37,177,"Tyrrell County, NC",Nov-21,1212,1143,69,5.70000000
CN3717900000000,37,179,"Union County, NC",Nov-21,124386,120655,3731,3.00000000
CN3718100000000,37,181,"Vance County, NC",Nov-21,16720,15630,1090,6.50000000
CN3718300000000,37,183,"Wake County, NC",Nov-21,603263,584922,18341,3.00000000
CN3718500000000,37,185,"Warren County, NC",Nov-21,6409,5995,414,6.50000000
CN3718700000000,37,187,"Washington County, NC",Nov-21,4237,4001,236,5.60000000
CN3718900000000,37,189,"Watauga County, NC",Nov-21,29234,28442,792,2.70000000
CN3719100000000,37,191,"Wayne County, NC",Nov-21,50746,48734,2012,4.00000000
CN3719300000000,37,193,"Wilkes County, NC",Nov-21,27397,26388,1009,3.70000000
CN3719500000000,37,195,"Wilson County, NC",Nov-21,33025,31196,1829,5.50000000
CN3719700000000,37,197,"Yadkin County, NC",Nov-21,17248,16702,546,3.20000000
CN3719900000000,37,199,"Yancey County, NC",Nov-21,8033,7777,256,3.20000000
CN3800100000000,38,001,"Adams County, ND",Nov-21,943,918,25,2.70000000
CN3800300000000,38,003,"Barnes County, ND",Nov-21,5234,5126,108,2.10000000
CN3800500000000,38,005,"Benson County, ND",Nov-21,2312,2237,75,3.20000000
CN3800700000000,38,007,"Billings County, ND",Nov-21,389,378,11,2.80000000
CN3800900000000,38,009,"Bottineau County, ND",Nov-21,2942,2849,93,3.20000000
CN3801100000000,38,011,"Bowman County, ND",Nov-21,1568,1538,30,1.90000000
CN3801300000000,38,013,"Burke County, ND",Nov-21,1040,1008,32,3.10000000
CN3801500000000,38,015,"Burleigh County, ND",Nov-21,51524,50420,1104,2.10000000
CN3801700000000,38,017,"Cass County, ND",Nov-21,107956,105845,2111,2.00000000
CN3801900000000,38,019,"Cavalier County, ND",Nov-21,1836,1796,40,2.20000000
CN3802100000000,38,021,"Dickey County, ND",Nov-21,2234,2190,44,2.00000000
CN3802300000000,38,023,"Divide County, ND",Nov-21,1400,1373,27,1.90000000
CN3802500000000,38,025,"Dunn County, ND",Nov-21,3181,3104,77,2.40000000
CN3802700000000,38,027,"Eddy County, ND",Nov-21,1180,1147,33,2.80000000
CN3802900000000,38,029,"Emmons County, ND",Nov-21,1473,1413,60,4.10000000
CN3803100000000,38,031,"Foster County, ND",Nov-21,1475,1443,32,2.20000000
CN3803300000000,38,033,"Golden Valley County, ND",Nov-21,833,815,18,2.20000000
CN3803500000000,38,035,"Grand Forks County, ND",Nov-21,37322,36495,827,2.20000000
CN3803700000000,38,037,"Grant County, ND",Nov-21,1236,1203,33,2.70000000
CN3803900000000,38,039,"Griggs County, ND",Nov-21,1015,993,22,2.20000000
CN3804100000000,38,041,"Hettinger County, ND",Nov-21,1413,1386,27,1.90000000
CN3804300000000,38,043,"Kidder County, ND",Nov-21,1314,1259,55,4.20000000
CN3804500000000,38,045,"LaMoure County, ND",Nov-21,2051,2008,43,2.10000000
CN3804700000000,38,047,"Logan County, ND",Nov-21,860,842,18,2.10000000
CN3804900000000,38,049,"McHenry County, ND",Nov-21,3145,3049,96,3.10000000
CN3805100000000,38,051,"McIntosh County, ND",Nov-21,1065,1040,25,2.30000000
CN3805300000000,38,053,"McKenzie County, ND",Nov-21,8713,8369,344,3.90000000
CN3805500000000,38,055,"McLean County, ND",Nov-21,4604,4472,132,2.90000000
CN3805700000000,38,057,"Mercer County, ND",Nov-21,3493,3356,137,3.90000000
CN3805900000000,38,059,"Morton County, ND",Nov-21,17013,16522,491,2.90000000
CN3806100000000,38,061,"Mountrail County, ND",Nov-21,6478,6316,162,2.50000000
CN3806300000000,38,063,"Nelson County, ND",Nov-21,1380,1347,33,2.40000000
CN3806500000000,38,065,"Oliver County, ND",Nov-21,878,845,33,3.80000000
CN3806700000000,38,067,"Pembina County, ND",Nov-21,3229,3118,111,3.40000000
CN3806900000000,38,069,"Pierce County, ND",Nov-21,1648,1612,36,2.20000000
CN3807100000000,38,071,"Ramsey County, ND",Nov-21,5661,5521,140,2.50000000
CN3807300000000,38,073,"Ransom County, ND",Nov-21,2667,2622,45,1.70000000
CN3807500000000,38,075,"Renville County, ND",Nov-21,1182,1157,25,2.10000000
CN3807700000000,38,077,"Richland County, ND",Nov-21,8589,8429,160,1.90000000
CN3807900000000,38,079,"Rolette County, ND",Nov-21,4741,4386,355,7.50000000
CN3808100000000,38,081,"Sargent County, ND",Nov-21,2359,2311,48,2.00000000
CN3808300000000,38,083,"Sheridan County, ND",Nov-21,644,621,23,3.60000000
CN3808500000000,38,085,"Sioux County, ND",Nov-21,1213,1176,37,3.10000000
CN3808700000000,38,087,"Slope County, ND",Nov-21,352,345,7,2.00000000
CN3808900000000,38,089,"Stark County, ND",Nov-21,17586,17022,564,3.20000000
CN3809100000000,38,091,"Steele County, ND",Nov-21,918,899,19,2.10000000
CN3809300000000,38,093,"Stutsman County, ND",Nov-21,10256,10037,219,2.10000000
CN3809500000000,38,095,"Towner County, ND",Nov-21,1112,1087,25,2.20000000
CN3809700000000,38,097,"Traill County, ND",Nov-21,4442,4347,95,2.10000000
CN3809900000000,38,099,"Walsh County, ND",Nov-21,5208,5023,185,3.60000000
CN3810100000000,38,101,"Ward County, ND",Nov-21,31707,30773,934,2.90000000
CN3810300000000,38,103,"Wells County, ND",Nov-21,1856,1786,70,3.80000000
CN3810500000000,38,105,"Williams County, ND",Nov-21,20792,19739,1053,5.10000000
CN3900100000000,39,001,"Adams County, OH",Nov-21,11002,10500,502,4.60000000
CN3900300000000,39,003,"Allen County, OH",Nov-21,46771,44988,1783,3.80000000
CN3900500000000,39,005,"Ashland County, OH",Nov-21,26367,25538,829,3.10000000
CN3900700000000,39,007,"Ashtabula County, OH",Nov-21,42977,41260,1717,4.00000000
CN3900900000000,39,009,"Athens County, OH",Nov-21,26136,25072,1064,4.10000000
CN3901100000000,39,011,"Auglaize County, OH",Nov-21,24417,23775,642,2.60000000
CN3901300000000,39,013,"Belmont County, OH",Nov-21,27936,26731,1205,4.30000000
CN3901500000000,39,015,"Brown County, OH",Nov-21,19388,18600,788,4.10000000
CN3901700000000,39,017,"Butler County, OH",Nov-21,195299,188908,6391,3.30000000
CN3901900000000,39,019,"Carroll County, OH",Nov-21,12655,12142,513,4.10000000
CN3902100000000,39,021,"Champaign County, OH",Nov-21,19522,18926,596,3.10000000
CN3902300000000,39,023,"Clark County, OH",Nov-21,62297,60035,2262,3.60000000
CN3902500000000,39,025,"Clermont County, OH",Nov-21,107160,103737,3423,3.20000000
CN3902700000000,39,027,"Clinton County, OH",Nov-21,18127,17432,695,3.80000000
CN3902900000000,39,029,"Columbiana County, OH",Nov-21,45397,43493,1904,4.20000000
CN3903100000000,39,031,"Coshocton County, OH",Nov-21,13611,13016,595,4.40000000
CN3903300000000,39,033,"Crawford County, OH",Nov-21,17767,17011,756,4.30000000
CN3903500000000,39,035,"Cuyahoga County, OH",Nov-21,599439,570990,28449,4.70000000
CN3903700000000,39,037,"Darke County, OH",Nov-21,25877,25151,726,2.80000000
CN3903900000000,39,039,"Defiance County, OH",Nov-21,17533,16926,607,3.50000000
CN3904100000000,39,041,"Delaware County, OH",Nov-21,116006,113092,2914,2.50000000
CN3904300000000,39,043,"Erie County, OH",Nov-21,36318,34258,2060,5.70000000
CN3904500000000,39,045,"Fairfield County, OH",Nov-21,80624,78188,2436,3.00000000
CN3904700000000,39,047,"Fayette County, OH",Nov-21,13913,13454,459,3.30000000
CN3904900000000,39,049,"Franklin County, OH",Nov-21,713376,689684,23692,3.30000000
CN3905100000000,39,051,"Fulton County, OH",Nov-21,21899,21037,862,3.90000000
CN3905300000000,39,053,"Gallia County, OH",Nov-21,12132,11627,505,4.20000000
CN3905500000000,39,055,"Geauga County, OH",Nov-21,48101,46654,1447,3.00000000
CN3905700000000,39,057,"Greene County, OH",Nov-21,83087,80531,2556,3.10000000
CN3905900000000,39,059,"Guernsey County, OH",Nov-21,17734,16986,748,4.20000000
CN3906100000000,39,061,"Hamilton County, OH",Nov-21,414759,400232,14527,3.50000000
CN3906300000000,39,063,"Hancock County, OH",Nov-21,40840,39703,1137,2.80000000
CN3906500000000,39,065,"Hardin County, OH",Nov-21,13754,13256,498,3.60000000
CN3906700000000,39,067,"Harrison County, OH",Nov-21,6442,6150,292,4.50000000
CN3906900000000,39,069,"Henry County, OH",Nov-21,12731,12242,489,3.80000000
CN3907100000000,39,071,"Highland County, OH",Nov-21,17589,16841,748,4.30000000
CN3907300000000,39,073,"Hocking County, OH",Nov-21,12987,12540,447,3.40000000
CN3907500000000,39,075,"Holmes County, OH",Nov-21,21592,21145,447,2.10000000
CN3907700000000,39,077,"Huron County, OH",Nov-21,27479,26283,1196,4.40000000
CN3907900000000,39,079,"Jackson County, OH",Nov-21,12588,11983,605,4.80000000
CN3908100000000,39,081,"Jefferson County, OH",Nov-21,27234,25936,1298,4.80000000
CN3908300000000,39,083,"Knox County, OH",Nov-21,31368,30460,908,2.90000000
CN3908500000000,39,085,"Lake County, OH",Nov-21,123834,119443,4391,3.50000000
CN3908700000000,39,087,"Lawrence County, OH",Nov-21,23400,22486,914,3.90000000
CN3908900000000,39,089,"Licking County, OH",Nov-21,92430,89733,2697,2.90000000
CN3909100000000,39,091,"Logan County, OH",Nov-21,22496,21823,673,3.00000000
CN3909300000000,39,093,"Lorain County, OH",Nov-21,154105,146358,7747,5.00000000
CN3909500000000,39,095,"Lucas County, OH",Nov-21,204726,195713,9013,4.40000000
CN3909700000000,39,097,"Madison County, OH",Nov-21,21094,20531,563,2.70000000
CN3909900000000,39,099,"Mahoning County, OH",Nov-21,98418,94000,4418,4.50000000
CN3910100000000,39,101,"Marion County, OH",Nov-21,27937,26983,954,3.40000000
CN3910300000000,39,103,"Medina County, OH",Nov-21,97027,93910,3117,3.20000000
CN3910500000000,39,105,"Meigs County, OH",Nov-21,8752,8309,443,5.10000000
CN3910700000000,39,107,"Mercer County, OH",Nov-21,22783,22272,511,2.20000000
CN3910900000000,39,109,"Miami County, OH",Nov-21,53957,52326,1631,3.00000000
CN3911100000000,39,111,"Monroe County, OH",Nov-21,5226,4910,316,6.00000000
CN3911300000000,39,113,"Montgomery County, OH",Nov-21,249163,239405,9758,3.90000000
CN3911500000000,39,115,"Morgan County, OH",Nov-21,6743,6422,321,4.80000000
CN3911700000000,39,117,"Morrow County, OH",Nov-21,17097,16537,560,3.30000000
CN3911900000000,39,119,"Muskingum County, OH",Nov-21,40724,39272,1452,3.60000000
CN3912100000000,39,121,"Noble County, OH",Nov-21,4547,4297,250,5.50000000
CN3912300000000,39,123,"Ottawa County, OH",Nov-21,19892,18767,1125,5.70000000
CN3912500000000,39,125,"Paulding County, OH",Nov-21,8581,8310,271,3.20000000
CN3912700000000,39,127,"Perry County, OH",Nov-21,16036,15402,634,4.00000000
CN3912900000000,39,129,"Pickaway County, OH",Nov-21,26945,26087,858,3.20000000
CN3913100000000,39,131,"Pike County, OH",Nov-21,10867,10316,551,5.10000000
CN3913300000000,39,133,"Portage County, OH",Nov-21,84834,81945,2889,3.40000000
CN3913500000000,39,135,"Preble County, OH",Nov-21,21839,21202,637,2.90000000
CN3913700000000,39,137,"Putnam County, OH",Nov-21,18893,18474,419,2.20000000
CN3913900000000,39,139,"Richland County, OH",Nov-21,51289,49173,2116,4.10000000
CN3914100000000,39,141,"Ross County, OH",Nov-21,35186,33879,1307,3.70000000
CN3914300000000,39,143,"Sandusky County, OH",Nov-21,30019,28929,1090,3.60000000
CN3914500000000,39,145,"Scioto County, OH",Nov-21,29387,27984,1403,4.80000000
CN3914700000000,39,147,"Seneca County, OH",Nov-21,26576,25683,893,3.40000000
CN3914900000000,39,149,"Shelby County, OH",Nov-21,23709,22993,716,3.00000000
CN3915100000000,39,151,"Stark County, OH",Nov-21,181053,174362,6691,3.70000000
CN3915300000000,39,153,"Summit County, OH",Nov-21,264377,254259,10118,3.80000000
CN3915500000000,39,155,"Trumbull County, OH",Nov-21,83074,79321,3753,4.50000000
CN3915700000000,39,157,"Tuscarawas County, OH",Nov-21,44065,42565,1500,3.40000000
CN3915900000000,39,159,"Union County, OH",Nov-21,30429,29665,764,2.50000000
CN3916100000000,39,161,"Van Wert County, OH",Nov-21,14561,14149,412,2.80000000
CN3916300000000,39,163,"Vinton County, OH",Nov-21,5491,5215,276,5.00000000
CN3916500000000,39,165,"Warren County, OH",Nov-21,121483,117914,3569,2.90000000
CN3916700000000,39,167,"Washington County, OH",Nov-21,26756,25655,1101,4.10000000
CN3916900000000,39,169,"Wayne County, OH",Nov-21,60317,58714,1603,2.70000000
CN3917100000000,39,171,"Williams County, OH",Nov-21,18375,17771,604,3.30000000
CN3917300000000,39,173,"Wood County, OH",Nov-21,69575,67474,2101,3.00000000
CN3917500000000,39,175,"Wyandot County, OH",Nov-21,12880,12540,340,2.60000000
CN4000100000000,40,001,"Adair County, OK",Nov-21,8653,8433,220,2.50000000
CN4000300000000,40,003,"Alfalfa County, OK",Nov-21,2701,2660,41,1.50000000
CN4000500000000,40,005,"Atoka County, OK",Nov-21,5048,4892,156,3.10000000
CN4000700000000,40,007,"Beaver County, OK",Nov-21,2672,2641,31,1.20000000
CN4000900000000,40,009,"Beckham County, OK",Nov-21,9479,9232,247,2.60000000
CN4001100000000,40,011,"Blaine County, OK",Nov-21,4432,4353,79,1.80000000
CN4001300000000,40,013,"Bryan County, OK",Nov-21,22107,21656,451,2.00000000
CN4001500000000,40,015,"Caddo County, OK",Nov-21,12292,12004,288,2.30000000
CN4001700000000,40,017,"Canadian County, OK",Nov-21,79220,77650,1570,2.00000000
CN4001900000000,40,019,"Carter County, OK",Nov-21,21413,20793,620,2.90000000
CN4002100000000,40,021,"Cherokee County, OK",Nov-21,19892,19356,536,2.70000000
CN4002300000000,40,023,"Choctaw County, OK",Nov-21,5869,5661,208,3.50000000
CN4002500000000,40,025,"Cimarron County, OK",Nov-21,1550,1531,19,1.20000000
CN4002700000000,40,027,"Cleveland County, OK",Nov-21,145770,142921,2849,2.00000000
CN4002900000000,40,029,"Coal County, OK",Nov-21,2291,2232,59,2.60000000
CN4003100000000,40,031,"Comanche County, OK",Nov-21,47434,46145,1289,2.70000000
CN4003300000000,40,033,"Cotton County, OK",Nov-21,2688,2623,65,2.40000000
CN4003500000000,40,035,"Craig County, OK",Nov-21,5687,5548,139,2.40000000
CN4003700000000,40,037,"Creek County, OK",Nov-21,31148,30278,870,2.80000000
CN4003900000000,40,039,"Custer County, OK",Nov-21,15177,14866,311,2.00000000
CN4004100000000,40,041,"Delaware County, OK",Nov-21,18705,18277,428,2.30000000
CN4004300000000,40,043,"Dewey County, OK",Nov-21,2983,2938,45,1.50000000
CN4004500000000,40,045,"Ellis County, OK",Nov-21,2082,2045,37,1.80000000
CN4004700000000,40,047,"Garfield County, OK",Nov-21,26674,26088,586,2.20000000
CN4004900000000,40,049,"Garvin County, OK",Nov-21,12819,12520,299,2.30000000
CN4005100000000,40,051,"Grady County, OK",Nov-21,26919,26342,577,2.10000000
CN4005300000000,40,053,"Grant County, OK",Nov-21,2703,2657,46,1.70000000
CN4005500000000,40,055,"Greer County, OK",Nov-21,1842,1792,50,2.70000000
CN4005700000000,40,057,"Harmon County, OK",Nov-21,1193,1172,21,1.80000000
CN4005900000000,40,059,"Harper County, OK",Nov-21,1796,1770,26,1.40000000
CN4006100000000,40,061,"Haskell County, OK",Nov-21,4168,4026,142,3.40000000
CN4006300000000,40,063,"Hughes County, OK",Nov-21,5208,5028,180,3.50000000
CN4006500000000,40,065,"Jackson County, OK",Nov-21,10949,10740,209,1.90000000
CN4006700000000,40,067,"Jefferson County, OK",Nov-21,2465,2407,58,2.40000000
CN4006900000000,40,069,"Johnston County, OK",Nov-21,3647,3539,108,3.00000000
CN4007100000000,40,071,"Kay County, OK",Nov-21,18302,17778,524,2.90000000
CN4007300000000,40,073,"Kingfisher County, OK",Nov-21,8768,8632,136,1.60000000
CN4007500000000,40,075,"Kiowa County, OK",Nov-21,3616,3533,83,2.30000000
CN4007700000000,40,077,"Latimer County, OK",Nov-21,3042,2894,148,4.90000000
CN4007900000000,40,079,"Le Flore County, OK",Nov-21,19356,18742,614,3.20000000
CN4008100000000,40,081,"Lincoln County, OK",Nov-21,15916,15546,370,2.30000000
CN4008300000000,40,083,"Logan County, OK",Nov-21,22978,22508,470,2.00000000
CN4008500000000,40,085,"Love County, OK",Nov-21,5966,5870,96,1.60000000
CN4008700000000,40,087,"McClain County, OK",Nov-21,20589,20179,410,2.00000000
CN4008900000000,40,089,"McCurtain County, OK",Nov-21,15636,15159,477,3.10000000
CN4009100000000,40,091,"McIntosh County, OK",Nov-21,7024,6733,291,4.10000000
CN4009300000000,40,093,"Major County, OK",Nov-21,3678,3612,66,1.80000000
CN4009500000000,40,095,"Marshall County, OK",Nov-21,7016,6843,173,2.50000000
CN4009700000000,40,097,"Mayes County, OK",Nov-21,19358,18884,474,2.40000000
CN4009900000000,40,099,"Murray County, OK",Nov-21,6033,5884,149,2.50000000
CN4010100000000,40,101,"Muskogee County, OK",Nov-21,28536,27743,793,2.80000000
CN4010300000000,40,103,"Noble County, OK",Nov-21,5669,5572,97,1.70000000
CN4010500000000,40,105,"Nowata County, OK",Nov-21,4659,4557,102,2.20000000
CN4010700000000,40,107,"Okfuskee County, OK",Nov-21,4399,4266,133,3.00000000
CN4010900000000,40,109,"Oklahoma County, OK",Nov-21,391512,382058,9454,2.40000000
CN4011100000000,40,111,"Okmulgee County, OK",Nov-21,15452,14927,525,3.40000000
CN4011300000000,40,113,"Osage County, OK",Nov-21,20356,19790,566,2.80000000
CN4011500000000,40,115,"Ottawa County, OK",Nov-21,14615,14322,293,2.00000000
CN4011700000000,40,117,"Pawnee County, OK",Nov-21,7299,7090,209,2.90000000
CN4011900000000,40,119,"Payne County, OK",Nov-21,39149,38364,785,2.00000000
CN4012100000000,40,121,"Pittsburg County, OK",Nov-21,16238,15633,605,3.70000000
CN4012300000000,40,123,"Pontotoc County, OK",Nov-21,19200,18775,425,2.20000000
CN4012500000000,40,125,"Pottawatomie County, OK",Nov-21,32956,32106,850,2.60000000
CN4012700000000,40,127,"Pushmataha County, OK",Nov-21,4734,4604,130,2.70000000
CN4012900000000,40,129,"Roger Mills County, OK",Nov-21,1823,1789,34,1.90000000
CN4013100000000,40,131,"Rogers County, OK",Nov-21,45160,44138,1022,2.30000000
CN4013300000000,40,133,"Seminole County, OK",Nov-21,9073,8781,292,3.20000000
CN4013500000000,40,135,"Sequoyah County, OK",Nov-21,16619,16142,477,2.90000000
CN4013700000000,40,137,"Stephens County, OK",Nov-21,18880,18346,534,2.80000000
CN4013900000000,40,139,"Texas County, OK",Nov-21,11435,11284,151,1.30000000
CN4014100000000,40,141,"Tillman County, OK",Nov-21,2849,2779,70,2.50000000
CN4014300000000,40,143,"Tulsa County, OK",Nov-21,323853,315725,8128,2.50000000
CN4014500000000,40,145,"Wagoner County, OK",Nov-21,38834,37917,917,2.40000000
CN4014700000000,40,147,"Washington County, OK",Nov-21,22371,21817,554,2.50000000
CN4014900000000,40,149,"Washita County, OK",Nov-21,4909,4763,146,3.00000000
CN4015100000000,40,151,"Woods County, OK",Nov-21,4765,4707,58,1.20000000
CN4015300000000,40,153,"Woodward County, OK",Nov-21,8497,8275,222,2.60000000
CN4100100000000,41,001,"Baker County, OR",Nov-21,7491,7212,279,3.70000000
CN4100300000000,41,003,"Benton County, OR",Nov-21,48671,47421,1250,2.60000000
CN4100500000000,41,005,"Clackamas County, OR",Nov-21,226993,219460,7533,3.30000000
CN4100700000000,41,007,"Clatsop County, OR",Nov-21,19297,18494,803,4.20000000
CN4100900000000,41,009,"Columbia County, OR",Nov-21,25064,24012,1052,4.20000000
CN4101100000000,41,011,"Coos County, OR",Nov-21,27009,25761,1248,4.60000000
CN4101300000000,41,013,"Crook County, OR",Nov-21,10980,10421,559,5.10000000
CN4101500000000,41,015,"Curry County, OR",Nov-21,8987,8511,476,5.30000000
CN4101700000000,41,017,"Deschutes County, OR",Nov-21,103680,99900,3780,3.60000000
CN4101900000000,41,019,"Douglas County, OR",Nov-21,47478,45406,2072,4.40000000
CN4102100000000,41,021,"Gilliam County, OR",Nov-21,963,934,29,3.00000000
CN4102300000000,41,023,"Grant County, OR",Nov-21,3157,3004,153,4.80000000
CN4102500000000,41,025,"Harney County, OR",Nov-21,3668,3521,147,4.00000000
CN4102700000000,41,027,"Hood River County, OR",Nov-21,13729,13322,407,3.00000000
CN4102900000000,41,029,"Jackson County, OR",Nov-21,108548,104466,4082,3.80000000
CN4103100000000,41,031,"Jefferson County, OR",Nov-21,10227,9745,482,4.70000000
CN4103300000000,41,033,"Josephine County, OR",Nov-21,37042,35339,1703,4.60000000
CN4103500000000,41,035,"Klamath County, OR",Nov-21,29522,28046,1476,5.00000000
CN4103700000000,41,037,"Lake County, OR",Nov-21,3612,3452,160,4.40000000
CN4103900000000,41,039,"Lane County, OR",Nov-21,184001,176897,7104,3.90000000
CN4104100000000,41,041,"Lincoln County, OR",Nov-21,20540,19498,1042,5.10000000
CN4104300000000,41,043,"Linn County, OR",Nov-21,61088,58621,2467,4.00000000
CN4104500000000,41,045,"Malheur County, OR",Nov-21,12578,12205,373,3.00000000
CN4104700000000,41,047,"Marion County, OR",Nov-21,168334,162350,5984,3.60000000
CN4104900000000,41,049,"Morrow County, OR",Nov-21,5937,5738,199,3.40000000
CN4105100000000,41,051,"Multnomah County, OR",Nov-21,469714,451721,17993,3.80000000
CN4105300000000,41,053,"Polk County, OR",Nov-21,42568,41124,1444,3.40000000
CN4105500000000,41,055,"Sherman County, OR",Nov-21,909,877,32,3.50000000
CN4105700000000,41,057,"Tillamook County, OR",Nov-21,11837,11365,472,4.00000000
CN4105900000000,41,059,"Umatilla County, OR",Nov-21,37515,36089,1426,3.80000000
CN4106100000000,41,061,"Union County, OR",Nov-21,12232,11773,459,3.80000000
CN4106300000000,41,063,"Wallowa County, OR",Nov-21,3547,3392,155,4.40000000
CN4106500000000,41,065,"Wasco County, OR",Nov-21,13059,12552,507,3.90000000
CN4106700000000,41,067,"Washington County, OR",Nov-21,333759,323928,9831,2.90000000
CN4106900000000,41,069,"Wheeler County, OR",Nov-21,749,727,22,2.90000000
CN4107100000000,41,071,"Yamhill County, OR",Nov-21,55922,54112,1810,3.20000000
CN4200100000000,42,001,"Adams County, PA",Nov-21,54516,52834,1682,3.10000000
CN4200300000000,42,003,"Allegheny County, PA",Nov-21,625003,596677,28326,4.50000000
CN4200500000000,42,005,"Armstrong County, PA",Nov-21,30891,29150,1741,5.60000000
CN4200700000000,42,007,"Beaver County, PA",Nov-21,80881,76465,4416,5.50000000
CN4200900000000,42,009,"Bedford County, PA",Nov-21,23509,22512,997,4.20000000
CN4201100000000,42,011,"Berks County, PA",Nov-21,209828,199377,10451,5.00000000
CN4201300000000,42,013,"Blair County, PA",Nov-21,58586,56005,2581,4.40000000
CN4201500000000,42,015,"Bradford County, PA",Nov-21,27493,26362,1131,4.10000000
CN4201700000000,42,017,"Bucks County, PA",Nov-21,339961,326525,13436,4.00000000
CN4201900000000,42,019,"Butler County, PA",Nov-21,97351,93355,3996,4.10000000
CN4202100000000,42,021,"Cambria County, PA",Nov-21,54972,52058,2914,5.30000000
CN4202300000000,42,023,"Cameron County, PA",Nov-21,1974,1848,126,6.40000000
CN4202500000000,42,025,"Carbon County, PA",Nov-21,32308,30616,1692,5.20000000
CN4202700000000,42,027,"Centre County, PA",Nov-21,77355,74877,2478,3.20000000
CN4202900000000,42,029,"Chester County, PA",Nov-21,286167,277369,8798,3.10000000
CN4203100000000,42,031,"Clarion County, PA",Nov-21,16488,15682,806,4.90000000
CN4203300000000,42,033,"Clearfield County, PA",Nov-21,34843,33022,1821,5.20000000
CN4203500000000,42,035,"Clinton County, PA",Nov-21,17096,16212,884,5.20000000
CN4203700000000,42,037,"Columbia County, PA",Nov-21,33235,31780,1455,4.40000000
CN4203900000000,42,039,"Crawford County, PA",Nov-21,37100,35265,1835,4.90000000
CN4204100000000,42,041,"Cumberland County, PA",Nov-21,132979,128543,4436,3.30000000
CN4204300000000,42,043,"Dauphin County, PA",Nov-21,144868,138167,6701,4.60000000
CN4204500000000,42,045,"Delaware County, PA",Nov-21,294782,280548,14234,4.80000000
CN4204700000000,42,047,"Elk County, PA",Nov-21,14432,13647,785,5.40000000
CN4204900000000,42,049,"Erie County, PA",Nov-21,125021,118155,6866,5.50000000
CN4205100000000,42,051,"Fayette County, PA",Nov-21,54811,51069,3742,6.80000000
CN4205300000000,42,053,"Forest County, PA",Nov-21,1688,1589,99,5.90000000
CN4205500000000,42,055,"Franklin County, PA",Nov-21,76469,73704,2765,3.60000000
CN4205700000000,42,057,"Fulton County, PA",Nov-21,7059,6737,322,4.60000000
CN4205900000000,42,059,"Greene County, PA",Nov-21,15366,14518,848,5.50000000
CN4206100000000,42,061,"Huntingdon County, PA",Nov-21,18970,17924,1046,5.50000000
CN4206300000000,42,063,"Indiana County, PA",Nov-21,36664,34722,1942,5.30000000
CN4206500000000,42,065,"Jefferson County, PA",Nov-21,19305,18335,970,5.00000000
CN4206700000000,42,067,"Juniata County, PA",Nov-21,12317,11863,454,3.70000000
CN4206900000000,42,069,"Lackawanna County, PA",Nov-21,103883,98668,5215,5.00000000
CN4207100000000,42,071,"Lancaster County, PA",Nov-21,282685,272487,10198,3.60000000
CN4207300000000,42,073,"Lawrence County, PA",Nov-21,39048,36876,2172,5.60000000
CN4207500000000,42,075,"Lebanon County, PA",Nov-21,72264,69426,2838,3.90000000
CN4207700000000,42,077,"Lehigh County, PA",Nov-21,197028,186818,10210,5.20000000
CN4207900000000,42,079,"Luzerne County, PA",Nov-21,157676,147614,10062,6.40000000
CN4208100000000,42,081,"Lycoming County, PA",Nov-21,54391,51598,2793,5.10000000
CN4208300000000,42,083,"McKean County, PA",Nov-21,16363,15474,889,5.40000000
CN4208500000000,42,085,"Mercer County, PA",Nov-21,47054,44538,2516,5.30000000
CN4208700000000,42,087,"Mifflin County, PA",Nov-21,20480,19523,957,4.70000000
CN4208900000000,42,089,"Monroe County, PA",Nov-21,81395,76403,4992,6.10000000
CN4209100000000,42,091,"Montgomery County, PA",Nov-21,452425,435786,16639,3.70000000
CN4209300000000,42,093,"Montour County, PA",Nov-21,9017,8739,278,3.10000000
CN4209500000000,42,095,"Northampton County, PA",Nov-21,163225,155871,7354,4.50000000
CN4209700000000,42,097,"Northumberland County, PA",Nov-21,41066,38842,2224,5.40000000
CN4209900000000,42,099,"Perry County, PA",Nov-21,24306,23506,800,3.30000000
CN4210100000000,42,101,"Philadelphia County/city, PA",Nov-21,718688,668079,50609,7.00000000
CN4210300000000,42,103,"Pike County, PA",Nov-21,25096,23646,1450,5.80000000
CN4210500000000,42,105,"Potter County, PA",Nov-21,6944,6588,356,5.10000000
CN4210700000000,42,107,"Schuylkill County, PA",Nov-21,64324,60937,3387,5.30000000
CN4210900000000,42,109,"Snyder County, PA",Nov-21,19472,18726,746,3.80000000
CN4211100000000,42,111,"Somerset County, PA",Nov-21,31974,30351,1623,5.10000000
CN4211300000000,42,113,"Sullivan County, PA",Nov-21,2495,2360,135,5.40000000
CN4211500000000,42,115,"Susquehanna County, PA",Nov-21,19793,18996,797,4.00000000
CN4211700000000,42,117,"Tioga County, PA",Nov-21,18735,17785,950,5.10000000
CN4211900000000,42,119,"Union County, PA",Nov-21,19265,18606,659,3.40000000
CN4212100000000,42,121,"Venango County, PA",Nov-21,21092,19986,1106,5.20000000
CN4212300000000,42,123,"Warren County, PA",Nov-21,17382,16507,875,5.00000000
CN4212500000000,42,125,"Washington County, PA",Nov-21,103685,98573,5112,4.90000000
CN4212700000000,42,127,"Wayne County, PA",Nov-21,21771,20675,1096,5.00000000
CN4212900000000,42,129,"Westmoreland County, PA",Nov-21,173491,165429,8062,4.60000000
CN4213100000000,42,131,"Wyoming County, PA",Nov-21,13330,12701,629,4.70000000
CN4213300000000,42,133,"York County, PA",Nov-21,233948,224734,9214,3.90000000
CN4400100000000,44,001,"Bristol County, RI",Nov-21,26690,25846,844,3.20000000
CN4400300000000,44,003,"Kent County, RI",Nov-21,94339,90965,3374,3.60000000
CN4400500000000,44,005,"Newport County, RI",Nov-21,45282,43857,1425,3.10000000
CN4400700000000,44,007,"Providence County, RI",Nov-21,337998,322919,15079,4.50000000
CN4400900000000,44,009,"Washington County, RI",Nov-21,70437,68111,2326,3.30000000
CN4500100000000,45,001,"Abbeville County, SC",Nov-21,9639,9281,358,3.70000000
CN4500300000000,45,003,"Aiken County, SC",Nov-21,73660,71649,2011,2.70000000
CN4500500000000,45,005,"Allendale County, SC",Nov-21,2347,2201,146,6.20000000
CN4500700000000,45,007,"Anderson County, SC",Nov-21,90655,88103,2552,2.80000000
CN4500900000000,45,009,"Bamberg County, SC",Nov-21,4628,4352,276,6.00000000
CN4501100000000,45,011,"Barnwell County, SC",Nov-21,7446,7035,411,5.50000000
CN4501300000000,45,013,"Beaufort County, SC",Nov-21,75765,73616,2149,2.80000000
CN4501500000000,45,015,"Berkeley County, SC",Nov-21,107992,104932,3060,2.80000000
CN4501700000000,45,017,"Calhoun County, SC",Nov-21,6357,6126,231,3.60000000
CN4501900000000,45,019,"Charleston County, SC",Nov-21,212550,206672,5878,2.80000000
CN4502100000000,45,021,"Cherokee County, SC",Nov-21,24789,23813,976,3.90000000
CN4502300000000,45,023,"Chester County, SC",Nov-21,13280,12628,652,4.90000000
CN4502500000000,45,025,"Chesterfield County, SC",Nov-21,21396,20589,807,3.80000000
CN4502700000000,45,027,"Clarendon County, SC",Nov-21,11981,11504,477,4.00000000
CN4502900000000,45,029,"Colleton County, SC",Nov-21,16052,15520,532,3.30000000
CN4503100000000,45,031,"Darlington County, SC",Nov-21,29609,28564,1045,3.50000000
CN4503300000000,45,033,"Dillon County, SC",Nov-21,12895,12257,638,4.90000000
CN4503500000000,45,035,"Dorchester County, SC",Nov-21,78412,76197,2215,2.80000000
CN4503700000000,45,037,"Edgefield County, SC",Nov-21,10279,9996,283,2.80000000
CN4503900000000,45,039,"Fairfield County, SC",Nov-21,9152,8713,439,4.80000000
CN4504100000000,45,041,"Florence County, SC",Nov-21,65848,63722,2126,3.20000000
CN4504300000000,45,043,"Georgetown County, SC",Nov-21,25522,24562,960,3.80000000
CN4504500000000,45,045,"Greenville County, SC",Nov-21,258002,250996,7006,2.70000000
CN4504700000000,45,047,"Greenwood County, SC",Nov-21,30229,29169,1060,3.50000000
CN4504900000000,45,049,"Hampton County, SC",Nov-21,7868,7647,221,2.80000000
CN4505100000000,45,051,"Horry County, SC",Nov-21,147427,141426,6001,4.10000000
CN4505300000000,45,053,"Jasper County, SC",Nov-21,13070,12713,357,2.70000000
CN4505500000000,45,055,"Kershaw County, SC",Nov-21,29043,28164,879,3.00000000
CN4505700000000,45,057,"Lancaster County, SC",Nov-21,43146,41570,1576,3.70000000
CN4505900000000,45,059,"Laurens County, SC",Nov-21,29848,28850,998,3.30000000
CN4506100000000,45,061,"Lee County, SC",Nov-21,6472,6179,293,4.50000000
CN4506300000000,45,063,"Lexington County, SC",Nov-21,149799,146073,3726,2.50000000
CN4506500000000,45,065,"McCormick County, SC",Nov-21,3272,3152,120,3.70000000
CN4506700000000,45,067,"Marion County, SC",Nov-21,12674,11981,693,5.50000000
CN4506900000000,45,069,"Marlboro County, SC",Nov-21,8735,8116,619,7.10000000
CN4507100000000,45,071,"Newberry County, SC",Nov-21,18945,18433,512,2.70000000
CN4507300000000,45,073,"Oconee County, SC",Nov-21,33955,33003,952,2.80000000
CN4507500000000,45,075,"Orangeburg County, SC",Nov-21,33750,31771,1979,5.90000000
CN4507700000000,45,077,"Pickens County, SC",Nov-21,57443,55815,1628,2.80000000
CN4507900000000,45,079,"Richland County, SC",Nov-21,195846,189561,6285,3.20000000
CN4508100000000,45,081,"Saluda County, SC",Nov-21,8216,8007,209,2.50000000
CN4508300000000,45,083,"Spartanburg County, SC",Nov-21,156037,151200,4837,3.10000000
CN4508500000000,45,085,"Sumter County, SC",Nov-21,42204,40661,1543,3.70000000
CN4508700000000,45,087,"Union County, SC",Nov-21,11386,10803,583,5.10000000
CN4508900000000,45,089,"Williamsburg County, SC",Nov-21,10801,10267,534,4.90000000
CN4509100000000,45,091,"York County, SC",Nov-21,146722,142114,4608,3.10000000
CN4600300000000,46,003,"Aurora County, SD",Nov-21,1463,1432,31,2.10000000
CN4600500000000,46,005,"Beadle County, SD",Nov-21,9174,8950,224,2.40000000
CN4600700000000,46,007,"Bennett County, SD",Nov-21,1061,1023,38,3.60000000
CN4600900000000,46,009,"Bon Homme County, SD",Nov-21,2799,2736,63,2.30000000
CN4601100000000,46,011,"Brookings County, SD",Nov-21,19076,18593,483,2.50000000
CN4601300000000,46,013,"Brown County, SD",Nov-21,20573,20030,543,2.60000000
CN4601500000000,46,015,"Brule County, SD",Nov-21,2634,2574,60,2.30000000
CN4601700000000,46,017,"Buffalo County, SD",Nov-21,684,653,31,4.50000000
CN4601900000000,46,019,"Butte County, SD",Nov-21,5026,4887,139,2.80000000
CN4602100000000,46,021,"Campbell County, SD",Nov-21,770,744,26,3.40000000
CN4602300000000,46,023,"Charles Mix County, SD",Nov-21,3780,3672,108,2.90000000
CN4602500000000,46,025,"Clark County, SD",Nov-21,1896,1841,55,2.90000000
CN4602700000000,46,027,"Clay County, SD",Nov-21,7813,7618,195,2.50000000
CN4602900000000,46,029,"Codington County, SD",Nov-21,15864,15470,394,2.50000000
CN4603100000000,46,031,"Corson County, SD",Nov-21,1327,1274,53,4.00000000
CN4603300000000,46,033,"Custer County, SD",Nov-21,4130,3976,154,3.70000000
CN4603500000000,46,035,"Davison County, SD",Nov-21,10934,10689,245,2.20000000
CN4603700000000,46,037,"Day County, SD",Nov-21,2647,2556,91,3.40000000
CN4603900000000,46,039,"Deuel County, SD",Nov-21,2292,2221,71,3.10000000
CN4604100000000,46,041,"Dewey County, SD",Nov-21,2297,2184,113,4.90000000
CN4604300000000,46,043,"Douglas County, SD",Nov-21,1521,1490,31,2.00000000
CN4604500000000,46,045,"Edmunds County, SD",Nov-21,2017,1976,41,2.00000000
CN4604700000000,46,047,"Fall River County, SD",Nov-21,3041,2942,99,3.30000000
CN4604900000000,46,049,"Faulk County, SD",Nov-21,1087,1057,30,2.80000000
CN4605100000000,46,051,"Grant County, SD",Nov-21,4327,4218,109,2.50000000
CN4605300000000,46,053,"Gregory County, SD",Nov-21,2148,2100,48,2.20000000
CN4605500000000,46,055,"Haakon County, SD",Nov-21,1065,1035,30,2.80000000
CN4605700000000,46,057,"Hamlin County, SD",Nov-21,3489,3418,71,2.00000000
CN4605900000000,46,059,"Hand County, SD",Nov-21,1802,1761,41,2.30000000
CN4606100000000,46,061,"Hanson County, SD",Nov-21,1765,1704,61,3.50000000
CN4606300000000,46,063,"Harding County, SD",Nov-21,738,720,18,2.40000000
CN4606500000000,46,065,"Hughes County, SD",Nov-21,9875,9671,204,2.10000000
CN4606700000000,46,067,"Hutchinson County, SD",Nov-21,3590,3509,81,2.30000000
CN4606900000000,46,069,"Hyde County, SD",Nov-21,652,632,20,3.10000000
CN4607100000000,46,071,"Jackson County, SD",Nov-21,1154,1109,45,3.90000000
CN4607300000000,46,073,"Jerauld County, SD",Nov-21,1357,1329,28,2.10000000
CN4607500000000,46,075,"Jones County, SD",Nov-21,513,496,17,3.30000000
CN4607700000000,46,077,"Kingsbury County, SD",Nov-21,2678,2613,65,2.40000000
CN4607900000000,46,079,"Lake County, SD",Nov-21,6634,6472,162,2.40000000
CN4608100000000,46,081,"Lawrence County, SD",Nov-21,13760,13396,364,2.60000000
CN4608300000000,46,083,"Lincoln County, SD",Nov-21,37248,36500,748,2.00000000
CN4608500000000,46,085,"Lyman County, SD",Nov-21,1730,1669,61,3.50000000
CN4608700000000,46,087,"McCook County, SD",Nov-21,3080,3020,60,1.90000000
CN4608900000000,46,089,"McPherson County, SD",Nov-21,959,923,36,3.80000000
CN4609100000000,46,091,"Marshall County, SD",Nov-21,2417,2349,68,2.80000000
CN4609300000000,46,093,"Meade County, SD",Nov-21,14085,13724,361,2.60000000
CN4609500000000,46,095,"Mellette County, SD",Nov-21,739,713,26,3.50000000
CN4609700000000,46,097,"Miner County, SD",Nov-21,1188,1157,31,2.60000000
CN4609900000000,46,099,"Minnehaha County, SD",Nov-21,115732,113134,2598,2.20000000
CN4610100000000,46,101,"Moody County, SD",Nov-21,4003,3919,84,2.10000000
CN4610200000000,46,102,"Oglala Lakota County, SD",Nov-21,4226,3923,303,7.20000000
CN4610300000000,46,103,"Pennington County, SD",Nov-21,58054,56486,1568,2.70000000
CN4610500000000,46,105,"Perkins County, SD",Nov-21,1404,1366,38,2.70000000
CN4610700000000,46,107,"Potter County, SD",Nov-21,1049,1014,35,3.30000000
CN4610900000000,46,109,"Roberts County, SD",Nov-21,4845,4674,171,3.50000000
CN4611100000000,46,111,"Sanborn County, SD",Nov-21,1189,1158,31,2.60000000
CN4611500000000,46,115,"Spink County, SD",Nov-21,3057,2981,76,2.50000000
CN4611700000000,46,117,"Stanley County, SD",Nov-21,1920,1872,48,2.50000000
CN4611900000000,46,119,"Sully County, SD",Nov-21,812,787,25,3.10000000
CN4612100000000,46,121,"Todd County, SD",Nov-21,3209,3083,126,3.90000000
CN4612300000000,46,123,"Tripp County, SD",Nov-21,3019,2956,63,2.10000000
CN4612500000000,46,125,"Turner County, SD",Nov-21,4730,4619,111,2.30000000
CN4612700000000,46,127,"Union County, SD",Nov-21,8679,8421,258,3.00000000
CN4612900000000,46,129,"Walworth County, SD",Nov-21,2126,2035,91,4.30000000
CN4613500000000,46,135,"Yankton County, SD",Nov-21,11641,11386,255,2.20000000
CN4613700000000,46,137,"Ziebach County, SD",Nov-21,967,921,46,4.80000000
CN4700100000000,47,001,"Anderson County, TN",Nov-21,35209,34251,958,2.70000000
CN4700300000000,47,003,"Bedford County, TN",Nov-21,21263,20615,648,3.00000000
CN4700500000000,47,005,"Benton County, TN",Nov-21,6724,6490,234,3.50000000
CN4700700000000,47,007,"Bledsoe County, TN",Nov-21,4320,4146,174,4.00000000
CN4700900000000,47,009,"Blount County, TN",Nov-21,65401,63791,1610,2.50000000
CN4701100000000,47,011,"Bradley County, TN",Nov-21,50882,49359,1523,3.00000000
CN4701300000000,47,013,"Campbell County, TN",Nov-21,14918,14406,512,3.40000000
CN4701500000000,47,015,"Cannon County, TN",Nov-21,6787,6619,168,2.50000000
CN4701700000000,47,017,"Carroll County, TN",Nov-21,11489,11119,370,3.20000000
CN4701900000000,47,019,"Carter County, TN",Nov-21,24300,23535,765,3.10000000
CN4702100000000,47,021,"Cheatham County, TN",Nov-21,22329,21840,489,2.20000000
CN4702300000000,47,023,"Chester County, TN",Nov-21,8527,8327,200,2.30000000
CN4702500000000,47,025,"Claiborne County, TN",Nov-21,12869,12489,380,3.00000000
CN4702700000000,47,027,"Clay County, TN",Nov-21,2782,2667,115,4.10000000
CN4702900000000,47,029,"Cocke County, TN",Nov-21,14489,13825,664,4.60000000
CN4703100000000,47,031,"Coffee County, TN",Nov-21,25139,24387,752,3.00000000
CN4703300000000,47,033,"Crockett County, TN",Nov-21,6855,6676,179,2.60000000
CN4703500000000,47,035,"Cumberland County, TN",Nov-21,22501,21716,785,3.50000000
CN4703700000000,47,037,"Davidson County, TN",Nov-21,409988,398479,11509,2.80000000
CN4703900000000,47,039,"Decatur County, TN",Nov-21,4226,4056,170,4.00000000
CN4704100000000,47,041,"DeKalb County, TN",Nov-21,7732,7477,255,3.30000000
CN4704300000000,47,043,"Dickson County, TN",Nov-21,27611,26923,688,2.50000000
CN4704500000000,47,045,"Dyer County, TN",Nov-21,16176,15631,545,3.40000000
CN4704700000000,47,047,"Fayette County, TN",Nov-21,19479,18889,590,3.00000000
CN4704900000000,47,049,"Fentress County, TN",Nov-21,7602,7370,232,3.10000000
CN4705100000000,47,051,"Franklin County, TN",Nov-21,19679,19130,549,2.80000000
CN4705300000000,47,053,"Gibson County, TN",Nov-21,21472,20808,664,3.10000000
CN4705500000000,47,055,"Giles County, TN",Nov-21,14863,14378,485,3.30000000
CN4705700000000,47,057,"Grainger County, TN",Nov-21,9685,9396,289,3.00000000
CN4705900000000,47,059,"Greene County, TN",Nov-21,28816,27907,909,3.20000000
CN4706100000000,47,061,"Grundy County, TN",Nov-21,5085,4883,202,4.00000000
CN4706300000000,47,063,"Hamblen County, TN",Nov-21,28101,27231,870,3.10000000
CN4706500000000,47,065,"Hamilton County, TN",Nov-21,186168,180687,5481,2.90000000
CN4706700000000,47,067,"Hancock County, TN",Nov-21,2279,2202,77,3.40000000
CN4706900000000,47,069,"Hardeman County, TN",Nov-21,8877,8495,382,4.30000000
CN4707100000000,47,071,"Hardin County, TN",Nov-21,9996,9667,329,3.30000000
CN4707300000000,47,073,"Hawkins County, TN",Nov-21,23353,22616,737,3.20000000
CN4707500000000,47,075,"Haywood County, TN",Nov-21,7614,7297,317,4.20000000
CN4707700000000,47,077,"Henderson County, TN",Nov-21,11873,11505,368,3.10000000
CN4707900000000,47,079,"Henry County, TN",Nov-21,14097,13674,423,3.00000000
CN4708100000000,47,081,"Hickman County, TN",Nov-21,11643,11326,317,2.70000000
CN4708300000000,47,083,"Houston County, TN",Nov-21,3219,3108,111,3.40000000
CN4708500000000,47,085,"Humphreys County, TN",Nov-21,8670,8409,261,3.00000000
CN4708700000000,47,087,"Jackson County, TN",Nov-21,4798,4644,154,3.20000000
CN4708900000000,47,089,"Jefferson County, TN",Nov-21,24937,24198,739,3.00000000
CN4709100000000,47,091,"Johnson County, TN",Nov-21,7753,7560,193,2.50000000
CN4709300000000,47,093,"Knox County, TN",Nov-21,250789,244893,5896,2.40000000
CN4709500000000,47,095,"Lake County, TN",Nov-21,1646,1575,71,4.30000000
CN4709700000000,47,097,"Lauderdale County, TN",Nov-21,9589,9178,411,4.30000000
CN4709900000000,47,099,"Lawrence County, TN",Nov-21,19589,18926,663,3.40000000
CN4710100000000,47,101,"Lewis County, TN",Nov-21,5673,5435,238,4.20000000
CN4710300000000,47,103,"Lincoln County, TN",Nov-21,16102,15616,486,3.00000000
CN4710500000000,47,105,"Loudon County, TN",Nov-21,24346,23729,617,2.50000000
CN4710700000000,47,107,"McMinn County, TN",Nov-21,22089,21351,738,3.30000000
CN4710900000000,47,109,"McNairy County, TN",Nov-21,8289,7973,316,3.80000000
CN4711100000000,47,111,"Macon County, TN",Nov-21,11560,11267,293,2.50000000
CN4711300000000,47,113,"Madison County, TN",Nov-21,49140,47588,1552,3.20000000
CN4711500000000,47,115,"Marion County, TN",Nov-21,12421,12048,373,3.00000000
CN4711700000000,47,117,"Marshall County, TN",Nov-21,15640,15000,640,4.10000000
CN4711900000000,47,119,"Maury County, TN",Nov-21,53363,51026,2337,4.40000000
CN4712100000000,47,121,"Meigs County, TN",Nov-21,5134,4953,181,3.50000000
CN4712300000000,47,123,"Monroe County, TN",Nov-21,20811,20240,571,2.70000000
CN4712500000000,47,125,"Montgomery County, TN",Nov-21,88774,85934,2840,3.20000000
CN4712700000000,47,127,"Moore County, TN",Nov-21,3682,3607,75,2.00000000
CN4712900000000,47,129,"Morgan County, TN",Nov-21,7835,7596,239,3.10000000
CN4713100000000,47,131,"Obion County, TN",Nov-21,12308,11895,413,3.40000000
CN4713300000000,47,133,"Overton County, TN",Nov-21,9934,9692,242,2.40000000
CN4713500000000,47,135,"Perry County, TN",Nov-21,2819,2677,142,5.00000000
CN4713700000000,47,137,"Pickett County, TN",Nov-21,2144,2081,63,2.90000000
CN4713900000000,47,139,"Polk County, TN",Nov-21,7119,6913,206,2.90000000
CN4714100000000,47,141,"Putnam County, TN",Nov-21,35812,34829,983,2.70000000
CN4714300000000,47,143,"Rhea County, TN",Nov-21,13988,13520,468,3.30000000
CN4714500000000,47,145,"Roane County, TN",Nov-21,23696,23007,689,2.90000000
CN4714700000000,47,147,"Robertson County, TN",Nov-21,38838,37910,928,2.40000000
CN4714900000000,47,149,"Rutherford County, TN",Nov-21,193752,189062,4690,2.40000000
CN4715100000000,47,151,"Scott County, TN",Nov-21,8001,7644,357,4.50000000
CN4715300000000,47,153,"Sequatchie County, TN",Nov-21,6223,6027,196,3.10000000
CN4715500000000,47,155,"Sevier County, TN",Nov-21,54936,53563,1373,2.50000000
CN4715700000000,47,157,"Shelby County, TN",Nov-21,447034,425664,21370,4.80000000
CN4715900000000,47,159,"Smith County, TN",Nov-21,9648,9410,238,2.50000000
CN4716100000000,47,161,"Stewart County, TN",Nov-21,5383,5209,174,3.20000000
CN4716300000000,47,163,"Sullivan County, TN",Nov-21,69454,67383,2071,3.00000000
CN4716500000000,47,165,"Sumner County, TN",Nov-21,107550,105046,2504,2.30000000
CN4716700000000,47,167,"Tipton County, TN",Nov-21,27967,27099,868,3.10000000
CN4716900000000,47,169,"Trousdale County, TN",Nov-21,5668,5521,147,2.60000000
CN4717100000000,47,171,"Unicoi County, TN",Nov-21,7138,6881,257,3.60000000
CN4717300000000,47,173,"Union County, TN",Nov-21,7813,7582,231,3.00000000
CN4717500000000,47,175,"Van Buren County, TN",Nov-21,2019,1944,75,3.70000000
CN4717700000000,47,177,"Warren County, TN",Nov-21,16738,16186,552,3.30000000
CN4717900000000,47,179,"Washington County, TN",Nov-21,61978,60360,1618,2.60000000
CN4718100000000,47,181,"Wayne County, TN",Nov-21,6291,6102,189,3.00000000
CN4718300000000,47,183,"Weakley County, TN",Nov-21,15775,15338,437,2.80000000
CN4718500000000,47,185,"White County, TN",Nov-21,11759,11418,341,2.90000000
CN4718700000000,47,187,"Williamson County, TN",Nov-21,136487,133828,2659,1.90000000
CN4718900000000,47,189,"Wilson County, TN",Nov-21,81109,79286,1823,2.20000000
CN4800100000000,48,001,"Anderson County, TX",Nov-21,23313,22435,878,3.80000000
CN4800300000000,48,003,"Andrews County, TX",Nov-21,8902,8492,410,4.60000000
CN4800500000000,48,005,"Angelina County, TX",Nov-21,35792,33864,1928,5.40000000
CN4800700000000,48,007,"Aransas County, TX",Nov-21,9234,8669,565,6.10000000
CN4800900000000,48,009,"Archer County, TX",Nov-21,3925,3786,139,3.50000000
CN4801100000000,48,011,"Armstrong County, TX",Nov-21,907,882,25,2.80000000
CN4801300000000,48,013,"Atascosa County, TX",Nov-21,21984,20874,1110,5.00000000
CN4801500000000,48,015,"Austin County, TX",Nov-21,13788,13158,630,4.60000000
CN4801700000000,48,017,"Bailey County, TX",Nov-21,2266,2165,101,4.50000000
CN4801900000000,48,019,"Bandera County, TX",Nov-21,10316,9902,414,4.00000000
CN4802100000000,48,021,"Bastrop County, TX",Nov-21,46181,44533,1648,3.60000000
CN4802300000000,48,023,"Baylor County, TX",Nov-21,1773,1722,51,2.90000000
CN4802500000000,48,025,"Bee County, TX",Nov-21,9033,8373,660,7.30000000
CN4802700000000,48,027,"Bell County, TX",Nov-21,148646,141478,7168,4.80000000
CN4802900000000,48,029,"Bexar County, TX",Nov-21,955367,914783,40584,4.20000000
CN4803100000000,48,031,"Blanco County, TX",Nov-21,6973,6779,194,2.80000000
CN4803300000000,48,033,"Borden County, TX",Nov-21,605,591,14,2.30000000
CN4803500000000,48,035,"Bosque County, TX",Nov-21,8462,8131,331,3.90000000
CN4803700000000,48,037,"Bowie County, TX",Nov-21,39252,37284,1968,5.00000000
CN4803900000000,48,039,"Brazoria County, TX",Nov-21,181893,171714,10179,5.60000000
CN4804100000000,48,041,"Brazos County, TX",Nov-21,124193,120165,4028,3.20000000
CN4804300000000,48,043,"Brewster County, TX",Nov-21,4136,3979,157,3.80000000
CN4804500000000,48,045,"Briscoe County, TX",Nov-21,554,529,25,4.50000000
CN4804700000000,48,047,"Brooks County, TX",Nov-21,2484,2298,186,7.50000000
CN4804900000000,48,049,"Brown County, TX",Nov-21,15158,14507,651,4.30000000
CN4805100000000,48,051,"Burleson County, TX",Nov-21,8549,8211,338,4.00000000
CN4805300000000,48,053,"Burnet County, TX",Nov-21,24574,23823,751,3.10000000
CN4805500000000,48,055,"Caldwell County, TX",Nov-21,20440,19658,782,3.80000000
CN4805700000000,48,057,"Calhoun County, TX",Nov-21,12243,11730,513,4.20000000
CN4805900000000,48,059,"Callahan County, TX",Nov-21,6186,5947,239,3.90000000
CN4806100000000,48,061,"Cameron County, TX",Nov-21,174021,162376,11645,6.70000000
CN4806300000000,48,063,"Camp County, TX",Nov-21,5117,4863,254,5.00000000
CN4806500000000,48,065,"Carson County, TX",Nov-21,2931,2836,95,3.20000000
CN4806700000000,48,067,"Cass County, TX",Nov-21,12256,11577,679,5.50000000
CN4806900000000,48,069,"Castro County, TX",Nov-21,3196,3100,96,3.00000000
CN4807100000000,48,071,"Chambers County, TX",Nov-21,20823,19422,1401,6.70000000
CN4807300000000,48,073,"Cherokee County, TX",Nov-21,20628,19516,1112,5.40000000
CN4807500000000,48,075,"Childress County, TX",Nov-21,2956,2865,91,3.10000000
CN4807700000000,48,077,"Clay County, TX",Nov-21,4741,4552,189,4.00000000
CN4807900000000,48,079,"Cochran County, TX",Nov-21,992,932,60,6.00000000
CN4808100000000,48,081,"Coke County, TX",Nov-21,1345,1295,50,3.70000000
CN4808300000000,48,083,"Coleman County, TX",Nov-21,2886,2743,143,5.00000000
CN4808500000000,48,085,"Collin County, TX",Nov-21,613292,592573,20719,3.40000000
CN4808700000000,48,087,"Collingsworth County, TX",Nov-21,1044,1007,37,3.50000000
CN4808900000000,48,089,"Colorado County, TX",Nov-21,9818,9428,390,4.00000000
CN4809100000000,48,091,"Comal County, TX",Nov-21,80036,77139,2897,3.60000000
CN4809300000000,48,093,"Comanche County, TX",Nov-21,6037,5797,240,4.00000000
CN4809500000000,48,095,"Concho County, TX",Nov-21,1304,1257,47,3.60000000
CN4809700000000,48,097,"Cooke County, TX",Nov-21,19285,18528,757,3.90000000
CN4809900000000,48,099,"Coryell County, TX",Nov-21,24527,23353,1174,4.80000000
CN4810100000000,48,101,"Cottle County, TX",Nov-21,586,564,22,3.80000000
CN4810300000000,48,103,"Crane County, TX",Nov-21,1609,1493,116,7.20000000
CN4810500000000,48,105,"Crockett County, TX",Nov-21,1408,1331,77,5.50000000
CN4810700000000,48,107,"Crosby County, TX",Nov-21,2304,2198,106,4.60000000
CN4810900000000,48,109,"Culberson County, TX",Nov-21,1037,995,42,4.10000000
CN4811100000000,48,111,"Dallam County, TX",Nov-21,3671,3588,83,2.30000000
CN4811300000000,48,113,"Dallas County, TX",Nov-21,1400372,1339408,60964,4.40000000
CN4811500000000,48,115,"Dawson County, TX",Nov-21,4499,4236,263,5.80000000
CN4811700000000,48,117,"Deaf Smith County, TX",Nov-21,8534,8260,274,3.20000000
CN4811900000000,48,119,"Delta County, TX",Nov-21,2446,2343,103,4.20000000
CN4812100000000,48,121,"Denton County, TX",Nov-21,540760,522302,18458,3.40000000
CN4812300000000,48,123,"DeWitt County, TX",Nov-21,9421,9065,356,3.80000000
CN4812500000000,48,125,"Dickens County, TX",Nov-21,662,635,27,4.10000000
CN4812700000000,48,127,"Dimmit County, TX",Nov-21,5816,5557,259,4.50000000
CN4812900000000,48,129,"Donley County, TX",Nov-21,1453,1406,47,3.20000000
CN4813100000000,48,131,"Duval County, TX",Nov-21,5511,5157,354,6.40000000
CN4813300000000,48,133,"Eastland County, TX",Nov-21,7334,6993,341,4.60000000
CN4813500000000,48,135,"Ector County, TX",Nov-21,80983,75960,5023,6.20000000
CN4813700000000,48,137,"Edwards County, TX",Nov-21,1202,1150,52,4.30000000
CN4813900000000,48,139,"Ellis County, TX",Nov-21,101193,97541,3652,3.60000000
CN4814100000000,48,141,"El Paso County, TX",Nov-21,366621,348329,18292,5.00000000
CN4814300000000,48,143,"Erath County, TX",Nov-21,20503,19763,740,3.60000000
CN4814500000000,48,145,"Falls County, TX",Nov-21,6606,6310,296,4.50000000
CN4814700000000,48,147,"Fannin County, TX",Nov-21,17254,16669,585,3.40000000
CN4814900000000,48,149,"Fayette County, TX",Nov-21,11716,11285,431,3.70000000
CN4815100000000,48,151,"Fisher County, TX",Nov-21,1575,1524,51,3.20000000
CN4815300000000,48,153,"Floyd County, TX",Nov-21,2418,2303,115,4.80000000
CN4815500000000,48,155,"Foard County, TX",Nov-21,588,568,20,3.40000000
CN4815700000000,48,157,"Fort Bend County, TX",Nov-21,411908,392502,19406,4.70000000
CN4815900000000,48,159,"Franklin County, TX",Nov-21,5149,4966,183,3.60000000
CN4816100000000,48,161,"Freestone County, TX",Nov-21,6137,5771,366,6.00000000
CN4816300000000,48,163,"Frio County, TX",Nov-21,9062,8706,356,3.90000000
CN4816500000000,48,165,"Gaines County, TX",Nov-21,9537,9209,328,3.40000000
CN4816700000000,48,167,"Galveston County, TX",Nov-21,166529,157616,8913,5.40000000
CN4816900000000,48,169,"Garza County, TX",Nov-21,1939,1864,75,3.90000000
CN4817100000000,48,171,"Gillespie County, TX",Nov-21,14245,13848,397,2.80000000
CN4817300000000,48,173,"Glasscock County, TX",Nov-21,772,751,21,2.70000000
CN4817500000000,48,175,"Goliad County, TX",Nov-21,3167,2994,173,5.50000000
CN4817700000000,48,177,"Gonzales County, TX",Nov-21,9365,9037,328,3.50000000
CN4817900000000,48,179,"Gray County, TX",Nov-21,7607,7205,402,5.30000000
CN4818100000000,48,181,"Grayson County, TX",Nov-21,66202,63684,2518,3.80000000
CN4818300000000,48,183,"Gregg County, TX",Nov-21,56431,53508,2923,5.20000000
CN4818500000000,48,185,"Grimes County, TX",Nov-21,11151,10534,617,5.50000000
CN4818700000000,48,187,"Guadalupe County, TX",Nov-21,83197,80198,2999,3.60000000
CN4818900000000,48,189,"Hale County, TX",Nov-21,11706,11134,572,4.90000000
CN4819100000000,48,191,"Hall County, TX",Nov-21,1054,1008,46,4.40000000
CN4819300000000,48,193,"Hamilton County, TX",Nov-21,3710,3582,128,3.50000000
CN4819500000000,48,195,"Hansford County, TX",Nov-21,2454,2388,66,2.70000000
CN4819700000000,48,197,"Hardeman County, TX",Nov-21,1665,1604,61,3.70000000
CN4819900000000,48,199,"Hardin County, TX",Nov-21,24803,23129,1674,6.70000000
CN4820100000000,48,201,"Harris County, TX",Nov-21,2306238,2187454,118784,5.20000000
CN4820300000000,48,203,"Harrison County, TX",Nov-21,28374,26831,1543,5.40000000
CN4820500000000,48,205,"Hartley County, TX",Nov-21,2681,2629,52,1.90000000
CN4820700000000,48,207,"Haskell County, TX",Nov-21,2688,2592,96,3.60000000
CN4820900000000,48,209,"Hays County, TX",Nov-21,133134,128789,4345,3.30000000
CN4821100000000,48,211,"Hemphill County, TX",Nov-21,1601,1545,56,3.50000000
CN4821300000000,48,213,"Henderson County, TX",Nov-21,38604,36982,1622,4.20000000
CN4821500000000,48,215,"Hidalgo County, TX",Nov-21,367158,338908,28250,7.70000000
CN4821700000000,48,217,"Hill County, TX",Nov-21,16949,16253,696,4.10000000
CN4821900000000,48,219,"Hockley County, TX",Nov-21,10624,10137,487,4.60000000
CN4822100000000,48,221,"Hood County, TX",Nov-21,29277,28065,1212,4.10000000
CN4822300000000,48,223,"Hopkins County, TX",Nov-21,17980,17337,643,3.60000000
CN4822500000000,48,225,"Houston County, TX",Nov-21,10676,10249,427,4.00000000
CN4822700000000,48,227,"Howard County, TX",Nov-21,13223,12517,706,5.30000000
CN4822900000000,48,229,"Hudspeth County, TX",Nov-21,1813,1725,88,4.90000000
CN4823100000000,48,231,"Hunt County, TX",Nov-21,45860,43967,1893,4.10000000
CN4823300000000,48,233,"Hutchinson County, TX",Nov-21,8348,7911,437,5.20000000
CN4823500000000,48,235,"Irion County, TX",Nov-21,760,729,31,4.10000000
CN4823700000000,48,237,"Jack County, TX",Nov-21,3380,3239,141,4.20000000
CN4823900000000,48,239,"Jackson County, TX",Nov-21,7004,6709,295,4.20000000
CN4824100000000,48,241,"Jasper County, TX",Nov-21,12813,11747,1066,8.30000000
CN4824300000000,48,243,"Jeff Davis County, TX",Nov-21,982,942,40,4.10000000
CN4824500000000,48,245,"Jefferson County, TX",Nov-21,101045,92865,8180,8.10000000
CN4824700000000,48,247,"Jim Hogg County, TX",Nov-21,1847,1708,139,7.50000000
CN4824900000000,48,249,"Jim Wells County, TX",Nov-21,15301,14077,1224,8.00000000
CN4825100000000,48,251,"Johnson County, TX",Nov-21,87178,83839,3339,3.80000000
CN4825300000000,48,253,"Jones County, TX",Nov-21,5702,5413,289,5.10000000
CN4825500000000,48,255,"Karnes County, TX",Nov-21,6766,6491,275,4.10000000
CN4825700000000,48,257,"Kaufman County, TX",Nov-21,73561,70701,2860,3.90000000
CN4825900000000,48,259,"Kendall County, TX",Nov-21,22969,22234,735,3.20000000
CN4826100000000,48,261,"Kenedy County, TX",Nov-21,180,170,10,5.60000000
CN4826300000000,48,263,"Kent County, TX",Nov-21,422,411,11,2.60000000
CN4826500000000,48,265,"Kerr County, TX",Nov-21,22094,21251,843,3.80000000
CN4826700000000,48,267,"Kimble County, TX",Nov-21,1876,1812,64,3.40000000
CN4826900000000,48,269,"King County, TX",Nov-21,524,520,4,0.80000000
CN4827100000000,48,271,"Kinney County, TX",Nov-21,1215,1155,60,4.90000000
CN4827300000000,48,273,"Kleberg County, TX",Nov-21,13188,12430,758,5.70000000
CN4827500000000,48,275,"Knox County, TX",Nov-21,1376,1322,54,3.90000000
CN4827700000000,48,277,"Lamar County, TX",Nov-21,24344,23193,1151,4.70000000
CN4827900000000,48,279,"Lamb County, TX",Nov-21,5003,4796,207,4.10000000
CN4828100000000,48,281,"Lampasas County, TX",Nov-21,9341,8961,380,4.10000000
CN4828300000000,48,283,"La Salle County, TX",Nov-21,3956,3830,126,3.20000000
CN4828500000000,48,285,"Lavaca County, TX",Nov-21,8604,8276,328,3.80000000
CN4828700000000,48,287,"Lee County, TX",Nov-21,9046,8716,330,3.60000000
CN4828900000000,48,289,"Leon County, TX",Nov-21,6015,5659,356,5.90000000
CN4829100000000,48,291,"Liberty County, TX",Nov-21,34905,32343,2562,7.30000000
CN4829300000000,48,293,"Limestone County, TX",Nov-21,8456,8019,437,5.20000000
CN4829500000000,48,295,"Lipscomb County, TX",Nov-21,1458,1412,46,3.20000000
CN4829700000000,48,297,"Live Oak County, TX",Nov-21,4855,4583,272,5.60000000
CN4829900000000,48,299,"Llano County, TX",Nov-21,8918,8551,367,4.10000000
CN4830100000000,48,301,"Loving County, TX",Nov-21,472,468,4,0.80000000
CN4830300000000,48,303,"Lubbock County, TX",Nov-21,161823,156099,5724,3.50000000
CN4830500000000,48,305,"Lynn County, TX",Nov-21,2738,2641,97,3.50000000
CN4830700000000,48,307,"McCulloch County, TX",Nov-21,3093,2924,169,5.50000000
CN4830900000000,48,309,"McLennan County, TX",Nov-21,124002,119207,4795,3.90000000
CN4831100000000,48,311,"McMullen County, TX",Nov-21,763,748,15,2.00000000
CN4831300000000,48,313,"Madison County, TX",Nov-21,4731,4496,235,5.00000000
CN4831500000000,48,315,"Marion County, TX",Nov-21,4260,4022,238,5.60000000
CN4831700000000,48,317,"Martin County, TX",Nov-21,2610,2505,105,4.00000000
CN4831900000000,48,319,"Mason County, TX",Nov-21,1781,1709,72,4.00000000
CN4832100000000,48,321,"Matagorda County, TX",Nov-21,16278,15141,1137,7.00000000
CN4832300000000,48,323,"Maverick County, TX",Nov-21,23392,21074,2318,9.90000000
CN4832500000000,48,325,"Medina County, TX",Nov-21,21959,21054,905,4.10000000
CN4832700000000,48,327,"Menard County, TX",Nov-21,791,759,32,4.00000000
CN4832900000000,48,329,"Midland County, TX",Nov-21,101050,96711,4339,4.30000000
CN4833100000000,48,331,"Milam County, TX",Nov-21,10236,9756,480,4.70000000
CN4833300000000,48,333,"Mills County, TX",Nov-21,1850,1772,78,4.20000000
CN4833500000000,48,335,"Mitchell County, TX",Nov-21,2298,2168,130,5.70000000
CN4833700000000,48,337,"Montague County, TX",Nov-21,9252,8875,377,4.10000000
CN4833900000000,48,339,"Montgomery County, TX",Nov-21,296898,283064,13834,4.70000000
CN4834100000000,48,341,"Moore County, TX",Nov-21,10806,10511,295,2.70000000
CN4834300000000,48,343,"Morris County, TX",Nov-21,4598,4208,390,8.50000000
CN4834500000000,48,345,"Motley County, TX",Nov-21,437,417,20,4.60000000
CN4834700000000,48,347,"Nacogdoches County, TX",Nov-21,28017,26753,1264,4.50000000
CN4834900000000,48,349,"Navarro County, TX",Nov-21,24081,23091,990,4.10000000
CN4835100000000,48,351,"Newton County, TX",Nov-21,4874,4436,438,9.00000000
CN4835300000000,48,353,"Nolan County, TX",Nov-21,6956,6691,265,3.80000000
CN4835500000000,48,355,"Nueces County, TX",Nov-21,163858,154524,9334,5.70000000
CN4835700000000,48,357,"Ochiltree County, TX",Nov-21,3835,3694,141,3.70000000
CN4835900000000,48,359,"Oldham County, TX",Nov-21,906,877,29,3.20000000
CN4836100000000,48,361,"Orange County, TX",Nov-21,34807,32216,2591,7.40000000
CN4836300000000,48,363,"Palo Pinto County, TX",Nov-21,12798,12206,592,4.60000000
CN4836500000000,48,365,"Panola County, TX",Nov-21,9718,9175,543,5.60000000
CN4836700000000,48,367,"Parker County, TX",Nov-21,72952,70358,2594,3.60000000
CN4836900000000,48,369,"Parmer County, TX",Nov-21,4764,4639,125,2.60000000
CN4837100000000,48,371,"Pecos County, TX",Nov-21,5848,5499,349,6.00000000
CN4837300000000,48,373,"Polk County, TX",Nov-21,18562,17312,1250,6.70000000
CN4837500000000,48,375,"Potter County, TX",Nov-21,54607,52708,1899,3.50000000
CN4837700000000,48,377,"Presidio County, TX",Nov-21,3089,2844,245,7.90000000
CN4837900000000,48,379,"Rains County, TX",Nov-21,6396,6189,207,3.20000000
CN4838100000000,48,381,"Randall County, TX",Nov-21,75098,72915,2183,2.90000000
CN4838300000000,48,383,"Reagan County, TX",Nov-21,1591,1499,92,5.80000000
CN4838500000000,48,385,"Real County, TX",Nov-21,1075,1019,56,5.20000000
CN4838700000000,48,387,"Red River County, TX",Nov-21,5261,4986,275,5.20000000
CN4838900000000,48,389,"Reeves County, TX",Nov-21,8769,8372,397,4.50000000
CN4839100000000,48,391,"Refugio County, TX",Nov-21,3007,2836,171,5.70000000
CN4839300000000,48,393,"Roberts County, TX",Nov-21,390,371,19,4.90000000
CN4839500000000,48,395,"Robertson County, TX",Nov-21,7659,7339,320,4.20000000
CN4839700000000,48,397,"Rockwall County, TX",Nov-21,58059,56050,2009,3.50000000
CN4839900000000,48,399,"Runnels County, TX",Nov-21,4525,4367,158,3.50000000
CN4840100000000,48,401,"Rusk County, TX",Nov-21,22112,21031,1081,4.90000000
CN4840300000000,48,403,"Sabine County, TX",Nov-21,3885,3559,326,8.40000000
CN4840500000000,48,405,"San Augustine County, TX",Nov-21,2935,2737,198,6.70000000
CN4840700000000,48,407,"San Jacinto County, TX",Nov-21,11841,11132,709,6.00000000
CN4840900000000,48,409,"San Patricio County, TX",Nov-21,29325,27106,2219,7.60000000
CN4841100000000,48,411,"San Saba County, TX",Nov-21,2181,2101,80,3.70000000
CN4841300000000,48,413,"Schleicher County, TX",Nov-21,1181,1126,55,4.70000000
CN4841500000000,48,415,"Scurry County, TX",Nov-21,5983,5659,324,5.40000000
CN4841700000000,48,417,"Shackelford County, TX",Nov-21,1793,1732,61,3.40000000
CN4841900000000,48,419,"Shelby County, TX",Nov-21,11403,10897,506,4.40000000
CN4842100000000,48,421,"Sherman County, TX",Nov-21,1352,1316,36,2.70000000
CN4842300000000,48,423,"Smith County, TX",Nov-21,110877,106335,4542,4.10000000
CN4842500000000,48,425,"Somervell County, TX",Nov-21,4474,4296,178,4.00000000
CN4842700000000,48,427,"Starr County, TX",Nov-21,24623,21246,3377,13.70000000
CN4842900000000,48,429,"Stephens County, TX",Nov-21,4176,4013,163,3.90000000
CN4843100000000,48,431,"Sterling County, TX",Nov-21,517,492,25,4.80000000
CN4843300000000,48,433,"Stonewall County, TX",Nov-21,562,540,22,3.90000000
CN4843500000000,48,435,"Sutton County, TX",Nov-21,1073,998,75,7.00000000
CN4843700000000,48,437,"Swisher County, TX",Nov-21,2538,2431,107,4.20000000
CN4843900000000,48,439,"Tarrant County, TX",Nov-21,1119995,1074207,45788,4.10000000
CN4844100000000,48,441,"Taylor County, TX",Nov-21,67900,65470,2430,3.60000000
CN4844300000000,48,443,"Terrell County, TX",Nov-21,410,396,14,3.40000000
CN4844500000000,48,445,"Terry County, TX",Nov-21,4563,4328,235,5.20000000
CN4844700000000,48,447,"Throckmorton County, TX",Nov-21,1142,1117,25,2.20000000
CN4844900000000,48,449,"Titus County, TX",Nov-21,13577,12979,598,4.40000000
CN4845100000000,48,451,"Tom Green County, TX",Nov-21,54018,51887,2131,3.90000000
CN4845300000000,48,453,"Travis County, TX",Nov-21,791721,766945,24776,3.10000000
CN4845500000000,48,455,"Trinity County, TX",Nov-21,5231,4892,339,6.50000000
CN4845700000000,48,457,"Tyler County, TX",Nov-21,7350,6811,539,7.30000000
CN4845900000000,48,459,"Upshur County, TX",Nov-21,17631,16701,930,5.30000000
CN4846100000000,48,461,"Upton County, TX",Nov-21,1662,1590,72,4.30000000
CN4846300000000,48,463,"Uvalde County, TX",Nov-21,11010,10513,497,4.50000000
CN4846500000000,48,465,"Val Verde County, TX",Nov-21,22272,21160,1112,5.00000000
CN4846700000000,48,467,"Van Zandt County, TX",Nov-21,26820,25795,1025,3.80000000
CN4846900000000,48,469,"Victoria County, TX",Nov-21,41157,39006,2151,5.20000000
CN4847100000000,48,471,"Walker County, TX",Nov-21,23689,22439,1250,5.30000000
CN4847300000000,48,473,"Waller County, TX",Nov-21,24899,23646,1253,5.00000000
CN4847500000000,48,475,"Ward County, TX",Nov-21,5952,5634,318,5.30000000
CN4847700000000,48,477,"Washington County, TX",Nov-21,14826,14181,645,4.40000000
CN4847900000000,48,479,"Webb County, TX",Nov-21,117630,111799,5831,5.00000000
CN4848100000000,48,481,"Wharton County, TX",Nov-21,20864,19910,954,4.60000000
CN4848300000000,48,483,"Wheeler County, TX",Nov-21,1945,1849,96,4.90000000
CN4848500000000,48,485,"Wichita County, TX",Nov-21,54943,52598,2345,4.30000000
CN4848700000000,48,487,"Wilbarger County, TX",Nov-21,4741,4484,257,5.40000000
CN4848900000000,48,489,"Willacy County, TX",Nov-21,6786,6196,590,8.70000000
CN4849100000000,48,491,"Williamson County, TX",Nov-21,350212,339118,11094,3.20000000
CN4849300000000,48,493,"Wilson County, TX",Nov-21,25246,24348,898,3.60000000
CN4849500000000,48,495,"Winkler County, TX",Nov-21,3708,3475,233,6.30000000
CN4849700000000,48,497,"Wise County, TX",Nov-21,33503,32216,1287,3.80000000
CN4849900000000,48,499,"Wood County, TX",Nov-21,17780,16917,863,4.90000000
CN4850100000000,48,501,"Yoakum County, TX",Nov-21,3161,2974,187,5.90000000
CN4850300000000,48,503,"Young County, TX",Nov-21,7986,7693,293,3.70000000
CN4850500000000,48,505,"Zapata County, TX",Nov-21,4549,4107,442,9.70000000
CN4850700000000,48,507,"Zavala County, TX",Nov-21,3250,2914,336,10.30000000
CN4900100000000,49,001,"Beaver County, UT",Nov-21,2796,2736,60,2.10000000
CN4900300000000,49,003,"Box Elder County, UT",Nov-21,27104,26609,495,1.80000000
CN4900500000000,49,005,"Cache County, UT",Nov-21,70919,69874,1045,1.50000000
CN4900700000000,49,007,"Carbon County, UT",Nov-21,8460,8221,239,2.80000000
CN4900900000000,49,009,"Daggett County, UT",Nov-21,387,373,14,3.60000000
CN4901100000000,49,011,"Davis County, UT",Nov-21,180591,177366,3225,1.80000000
CN4901300000000,49,013,"Duchesne County, UT",Nov-21,7827,7576,251,3.20000000
CN4901500000000,49,015,"Emery County, UT",Nov-21,4443,4332,111,2.50000000
CN4901700000000,49,017,"Garfield County, UT",Nov-21,2530,2390,140,5.50000000
CN4901900000000,49,019,"Grand County, UT",Nov-21,6401,6223,178,2.80000000
CN4902100000000,49,021,"Iron County, UT",Nov-21,26997,26407,590,2.20000000
CN4902300000000,49,023,"Juab County, UT",Nov-21,6356,6267,89,1.40000000
CN4902500000000,49,025,"Kane County, UT",Nov-21,3880,3796,84,2.20000000
CN4902700000000,49,027,"Millard County, UT",Nov-21,5995,5882,113,1.90000000
CN4902900000000,49,029,"Morgan County, UT",Nov-21,5826,5737,89,1.50000000
CN4903100000000,49,031,"Piute County, UT",Nov-21,485,466,19,3.90000000
CN4903300000000,49,033,"Rich County, UT",Nov-21,1078,1057,21,1.90000000
CN4903500000000,49,035,"Salt Lake County, UT",Nov-21,663326,650225,13101,2.00000000
CN4903700000000,49,037,"San Juan County, UT",Nov-21,5384,5142,242,4.50000000
CN4903900000000,49,039,"Sanpete County, UT",Nov-21,13270,12999,271,2.00000000
CN4904100000000,49,041,"Sevier County, UT",Nov-21,10065,9835,230,2.30000000
CN4904300000000,49,043,"Summit County, UT",Nov-21,24224,23698,526,2.20000000
CN4904500000000,49,045,"Tooele County, UT",Nov-21,37364,36601,763,2.00000000
CN4904700000000,49,047,"Uintah County, UT",Nov-21,13697,13191,506,3.70000000
CN4904900000000,49,049,"Utah County, UT",Nov-21,342182,336459,5723,1.70000000
CN4905100000000,49,051,"Wasatch County, UT",Nov-21,16806,16452,354,2.10000000
CN4905300000000,49,053,"Washington County, UT",Nov-21,85297,83501,1796,2.10000000
CN4905500000000,49,055,"Wayne County, UT",Nov-21,1485,1434,51,3.40000000
CN4905700000000,49,057,"Weber County, UT",Nov-21,132541,129835,2706,2.00000000
CN5000100000000,50,001,"Addison County, VT",Nov-21,20017,19588,429,2.10000000
CN5000300000000,50,003,"Bennington County, VT",Nov-21,16967,16369,598,3.50000000
CN5000500000000,50,005,"Caledonia County, VT",Nov-21,13852,13487,365,2.60000000
CN5000700000000,50,007,"Chittenden County, VT",Nov-21,94102,92240,1862,2.00000000
CN5000900000000,50,009,"Essex County, VT",Nov-21,2580,2485,95,3.70000000
CN5001100000000,50,011,"Franklin County, VT",Nov-21,26947,26234,713,2.60000000
CN5001300000000,50,013,"Grand Isle County, VT",Nov-21,4065,3870,195,4.80000000
CN5001500000000,50,015,"Lamoille County, VT",Nov-21,13255,12820,435,3.30000000
CN5001700000000,50,017,"Orange County, VT",Nov-21,15192,14861,331,2.20000000
CN5001900000000,50,019,"Orleans County, VT",Nov-21,12759,12300,459,3.60000000
CN5002100000000,50,021,"Rutland County, VT",Nov-21,29007,28124,883,3.00000000
CN5002300000000,50,023,"Washington County, VT",Nov-21,32498,31743,755,2.30000000
CN5002500000000,50,025,"Windham County, VT",Nov-21,20414,19768,646,3.20000000
CN5002700000000,50,027,"Windsor County, VT",Nov-21,27886,27289,597,2.10000000
CN5100100000000,51,001,"Accomack County, VA",Nov-21,15260,14780,480,3.10000000
CN5100300000000,51,003,"Albemarle County, VA",Nov-21,55908,54625,1283,2.30000000
CN5100500000000,51,005,"Alleghany County, VA",Nov-21,6612,6418,194,2.90000000
CN5100700000000,51,007,"Amelia County, VA",Nov-21,5972,5821,151,2.50000000
CN5100900000000,51,009,"Amherst County, VA",Nov-21,14368,13972,396,2.80000000
CN5101100000000,51,011,"Appomattox County, VA",Nov-21,6915,6733,182,2.60000000
CN5101300000000,51,013,"Arlington County, VA",Nov-21,150987,147880,3107,2.10000000
CN5101500000000,51,015,"Augusta County, VA",Nov-21,36607,35812,795,2.20000000
CN5101700000000,51,017,"Bath County, VA",Nov-21,2243,2176,67,3.00000000
CN5101900000000,51,019,"Bedford County, VA",Nov-21,37361,36427,934,2.50000000
CN5102100000000,51,021,"Bland County, VA",Nov-21,2723,2663,60,2.20000000
CN5102300000000,51,023,"Botetourt County, VA",Nov-21,16949,16585,364,2.10000000
CN5102500000000,51,025,"Brunswick County, VA",Nov-21,5739,5455,284,4.90000000
CN5102700000000,51,027,"Buchanan County, VA",Nov-21,6318,5996,322,5.10000000
CN5102900000000,51,029,"Buckingham County, VA",Nov-21,6251,5995,256,4.10000000
CN5103100000000,51,031,"Campbell County, VA",Nov-21,25028,24309,719,2.90000000
CN5103300000000,51,033,"Caroline County, VA",Nov-21,14524,14066,458,3.20000000
CN5103500000000,51,035,"Carroll County, VA",Nov-21,12971,12576,395,3.00000000
CN5103600000000,51,036,"Charles City County, VA",Nov-21,3420,3311,109,3.20000000
CN5103700000000,51,037,"Charlotte County, VA",Nov-21,5497,5358,139,2.50000000
CN5104100000000,51,041,"Chesterfield County, VA",Nov-21,182526,177689,4837,2.70000000
CN5104300000000,51,043,"Clarke County, VA",Nov-21,7443,7281,162,2.20000000
CN5104500000000,51,045,"Craig County, VA",Nov-21,2222,2170,52,2.30000000
CN5104700000000,51,047,"Culpeper County, VA",Nov-21,24719,24138,581,2.40000000
CN5104900000000,51,049,"Cumberland County, VA",Nov-21,4584,4446,138,3.00000000
CN5105100000000,51,051,"Dickenson County, VA",Nov-21,4774,4592,182,3.80000000
CN5105300000000,51,053,"Dinwiddie County, VA",Nov-21,13128,12707,421,3.20000000
CN5105700000000,51,057,"Essex County, VA",Nov-21,5230,5040,190,3.60000000
CN5105900000000,51,059,"Fairfax County, VA",Nov-21,615782,600925,14857,2.40000000
CN5106100000000,51,061,"Fauquier County, VA",Nov-21,36467,35700,767,2.10000000
CN5106300000000,51,063,"Floyd County, VA",Nov-21,8495,8321,174,2.00000000
CN5106500000000,51,065,"Fluvanna County, VA",Nov-21,13666,13353,313,2.30000000
CN5106700000000,51,067,"Franklin County, VA",Nov-21,25537,24872,665,2.60000000
CN5106900000000,51,069,"Frederick County, VA",Nov-21,49199,48178,1021,2.10000000
CN5107100000000,51,071,"Giles County, VA",Nov-21,8044,7847,197,2.40000000
CN5107300000000,51,073,"Gloucester County, VA",Nov-21,18680,18222,458,2.50000000
CN5107500000000,51,075,"Goochland County, VA",Nov-21,11228,10964,264,2.40000000
CN5107700000000,51,077,"Grayson County, VA",Nov-21,8345,8155,190,2.30000000
CN5107900000000,51,079,"Greene County, VA",Nov-21,10265,10044,221,2.20000000
CN5108100000000,51,081,"Greensville County, VA",Nov-21,4306,4161,145,3.40000000
CN5108300000000,51,083,"Halifax County, VA",Nov-21,15054,14483,571,3.80000000
CN5108500000000,51,085,"Hanover County, VA",Nov-21,56605,55389,1216,2.10000000
CN5108700000000,51,087,"Henrico County, VA",Nov-21,175090,169868,5222,3.00000000
CN5108900000000,51,089,"Henry County, VA",Nov-21,24179,23350,829,3.40000000
CN5109100000000,51,091,"Highland County, VA",Nov-21,1271,1246,25,2.00000000
CN5109300000000,51,093,"Isle of Wight County, VA",Nov-21,18895,18401,494,2.60000000
CN5109500000000,51,095,"James City County, VA",Nov-21,35450,34415,1035,2.90000000
CN5109700000000,51,097,"King and Queen County, VA",Nov-21,3845,3762,83,2.20000000
CN5109900000000,51,099,"King George County, VA",Nov-21,14168,13869,299,2.10000000
CN5110100000000,51,101,"King William County, VA",Nov-21,9088,8872,216,2.40000000
CN5110300000000,51,103,"Lancaster County, VA",Nov-21,5405,5217,188,3.50000000
CN5110500000000,51,105,"Lee County, VA",Nov-21,8327,8093,234,2.80000000
CN5110700000000,51,107,"Loudoun County, VA",Nov-21,223103,218270,4833,2.20000000
CN5110900000000,51,109,"Louisa County, VA",Nov-21,20485,20004,481,2.30000000
CN5111100000000,51,111,"Lunenburg County, VA",Nov-21,5117,4974,143,2.80000000
CN5111300000000,51,113,"Madison County, VA",Nov-21,7643,7505,138,1.80000000
CN5111500000000,51,115,"Mathews County, VA",Nov-21,3911,3814,97,2.50000000
CN5111700000000,51,117,"Mecklenburg County, VA",Nov-21,12751,12287,464,3.60000000
CN5111900000000,51,119,"Middlesex County, VA",Nov-21,5174,5044,130,2.50000000
CN5112100000000,51,121,"Montgomery County, VA",Nov-21,51233,50174,1059,2.10000000
CN5112500000000,51,125,"Nelson County, VA",Nov-21,7204,7029,175,2.40000000
CN5112700000000,51,127,"New Kent County, VA",Nov-21,12507,12238,269,2.20000000
CN5113100000000,51,131,"Northampton County, VA",Nov-21,5426,5218,208,3.80000000
CN5113300000000,51,133,"Northumberland County, VA",Nov-21,5671,5496,175,3.10000000
CN5113500000000,51,135,"Nottoway County, VA",Nov-21,7081,6896,185,2.60000000
CN5113700000000,51,137,"Orange County, VA",Nov-21,17275,16825,450,2.60000000
CN5113900000000,51,139,"Page County, VA",Nov-21,12174,11782,392,3.20000000
CN5114100000000,51,141,"Patrick County, VA",Nov-21,7083,6836,247,3.50000000
CN5114300000000,51,143,"Pittsylvania County, VA",Nov-21,30065,29172,893,3.00000000
CN5114500000000,51,145,"Powhatan County, VA",Nov-21,13843,13554,289,2.10000000
CN5114700000000,51,147,"Prince Edward County, VA",Nov-21,10254,9906,348,3.40000000
CN5114900000000,51,149,"Prince George County, VA",Nov-21,14484,14030,454,3.10000000
CN5115300000000,51,153,"Prince William County, VA",Nov-21,241517,234854,6663,2.80000000
CN5115500000000,51,155,"Pulaski County, VA",Nov-21,16492,16041,451,2.70000000
CN5115700000000,51,157,"Rappahannock County, VA",Nov-21,3639,3561,78,2.10000000
CN5115900000000,51,159,"Richmond County, VA",Nov-21,3951,3856,95,2.40000000
CN5116100000000,51,161,"Roanoke County, VA",Nov-21,47752,46685,1067,2.20000000
CN5116300000000,51,163,"Rockbridge County, VA",Nov-21,10565,10291,274,2.60000000
CN5116500000000,51,165,"Rockingham County, VA",Nov-21,42056,41200,856,2.00000000
CN5116700000000,51,167,"Russell County, VA",Nov-21,10833,10496,337,3.10000000
CN5116900000000,51,169,"Scott County, VA",Nov-21,8856,8616,240,2.70000000
CN5117100000000,51,171,"Shenandoah County, VA",Nov-21,21778,21219,559,2.60000000
CN5117300000000,51,173,"Smyth County, VA",Nov-21,14214,13825,389,2.70000000
CN5117500000000,51,175,"Southampton County, VA",Nov-21,8856,8640,216,2.40000000
CN5117700000000,51,177,"Spotsylvania County, VA",Nov-21,66741,64929,1812,2.70000000
CN5117900000000,51,179,"Stafford County, VA",Nov-21,72486,70596,1890,2.60000000
CN5118100000000,51,181,"Surry County, VA",Nov-21,3536,3435,101,2.90000000
CN5118300000000,51,183,"Sussex County, VA",Nov-21,3584,3408,176,4.90000000
CN5118500000000,51,185,"Tazewell County, VA",Nov-21,15308,14754,554,3.60000000
CN5118700000000,51,187,"Warren County, VA",Nov-21,20000,19501,499,2.50000000
CN5119100000000,51,191,"Washington County, VA",Nov-21,25387,24721,666,2.60000000
CN5119300000000,51,193,"Westmoreland County, VA",Nov-21,9770,9458,312,3.20000000
CN5119500000000,51,195,"Wise County, VA",Nov-21,13337,12853,484,3.60000000
CN5119700000000,51,197,"Wythe County, VA",Nov-21,13917,13545,372,2.70000000
CN5119900000000,51,199,"York County, VA",Nov-21,31592,30820,772,2.40000000
CN5151000000000,51,510,"Alexandria city, VA",Nov-21,97281,94780,2501,2.60000000
CN5152000000000,51,520,"Bristol city, VA",Nov-21,7340,7082,258,3.50000000
CN5153000000000,51,530,"Buena Vista city, VA",Nov-21,2985,2907,78,2.60000000
CN5154000000000,51,540,"Charlottesville city, VA",Nov-21,24699,24067,632,2.60000000
CN5155000000000,51,550,"Chesapeake city, VA",Nov-21,118207,114832,3375,2.90000000
CN5157000000000,51,570,"Colonial Heights city, VA",Nov-21,8070,7796,274,3.40000000
CN5158000000000,51,580,"Covington city, VA",Nov-21,2298,2206,92,4.00000000
CN5159000000000,51,590,"Danville city, VA",Nov-21,18826,17863,963,5.10000000
CN5159500000000,51,595,"Emporia city, VA",Nov-21,2368,2229,139,5.90000000
CN5160000000000,51,600,"Fairfax city, VA",Nov-21,12462,12155,307,2.50000000
CN5161000000000,51,610,"Falls Church city, VA",Nov-21,8234,8079,155,1.90000000
CN5162000000000,51,620,"Franklin city, VA",Nov-21,3462,3288,174,5.00000000
CN5163000000000,51,630,"Fredericksburg city, VA",Nov-21,13807,13344,463,3.40000000
CN5164000000000,51,640,"Galax city, VA",Nov-21,2866,2788,78,2.70000000
CN5165000000000,51,650,"Hampton city, VA",Nov-21,61868,59115,2753,4.40000000
CN5166000000000,51,660,"Harrisonburg city, VA",Nov-21,24207,23536,671,2.80000000
CN5167000000000,51,670,"Hopewell city, VA",Nov-21,9181,8670,511,5.60000000
CN5167800000000,51,678,"Lexington city, VA",Nov-21,2075,2004,71,3.40000000
CN5168000000000,51,680,"Lynchburg city, VA",Nov-21,34505,33252,1253,3.60000000
CN5168300000000,51,683,"Manassas city, VA",Nov-21,20964,20398,566,2.70000000
CN5168500000000,51,685,"Manassas Park city, VA",Nov-21,9476,9223,253,2.70000000
CN5169000000000,51,690,"Martinsville city, VA",Nov-21,5668,5344,324,5.70000000
CN5170000000000,51,700,"Newport News city, VA",Nov-21,84961,81268,3693,4.30000000
CN5171000000000,51,710,"Norfolk city, VA",Nov-21,105981,101370,4611,4.40000000
CN5172000000000,51,720,"Norton city, VA",Nov-21,1677,1619,58,3.50000000
CN5173000000000,51,730,"Petersburg city, VA",Nov-21,12220,11230,990,8.10000000
CN5173500000000,51,735,"Poquoson city, VA",Nov-21,6096,5968,128,2.10000000
CN5174000000000,51,740,"Portsmouth city, VA",Nov-21,42665,40460,2205,5.20000000
CN5175000000000,51,750,"Radford city, VA",Nov-21,8815,8586,229,2.60000000
CN5176000000000,51,760,"Richmond city, VA",Nov-21,114982,110189,4793,4.20000000
CN5177000000000,51,770,"Roanoke city, VA",Nov-21,47294,45633,1661,3.50000000
CN5177500000000,51,775,"Salem city, VA",Nov-21,12326,12009,317,2.60000000
CN5179000000000,51,790,"Staunton city, VA",Nov-21,11877,11560,317,2.70000000
CN5180000000000,51,800,"Suffolk city, VA",Nov-21,43582,42167,1415,3.20000000
CN5181000000000,51,810,"Virginia Beach city, VA",Nov-21,221420,215489,5931,2.70000000
CN5182000000000,51,820,"Waynesboro city, VA",Nov-21,10287,10005,282,2.70000000
CN5183000000000,51,830,"Williamsburg city, VA",Nov-21,6476,6246,230,3.60000000
CN5184000000000,51,840,"Winchester city, VA",Nov-21,14478,14122,356,2.50000000
CN5300100000000,53,001,"Adams County, WA",Nov-21,9391,8958,433,4.60000000
CN5300300000000,53,003,"Asotin County, WA",Nov-21,10843,10558,285,2.60000000
CN5300500000000,53,005,"Benton County, WA",Nov-21,106224,101538,4686,4.40000000
CN5300700000000,53,007,"Chelan County, WA",Nov-21,43707,41794,1913,4.40000000
CN5300900000000,53,009,"Clallam County, WA",Nov-21,30303,28763,1540,5.10000000
CN5301100000000,53,011,"Clark County, WA",Nov-21,254553,244137,10416,4.10000000
CN5301300000000,53,013,"Columbia County, WA",Nov-21,1839,1769,70,3.80000000
CN5301500000000,53,015,"Cowlitz County, WA",Nov-21,49282,46806,2476,5.00000000
CN5301700000000,53,017,"Douglas County, WA",Nov-21,21790,20817,973,4.50000000
CN5301900000000,53,019,"Ferry County, WA",Nov-21,2299,2129,170,7.40000000
CN5302100000000,53,021,"Franklin County, WA",Nov-21,43437,41081,2356,5.40000000
CN5302300000000,53,023,"Garfield County, WA",Nov-21,829,790,39,4.70000000
CN5302500000000,53,025,"Grant County, WA",Nov-21,47195,44544,2651,5.60000000
CN5302700000000,53,027,"Grays Harbor County, WA",Nov-21,29613,27714,1899,6.40000000
CN5302900000000,53,029,"Island County, WA",Nov-21,37264,35724,1540,4.10000000
CN5303100000000,53,031,"Jefferson County, WA",Nov-21,13093,12464,629,4.80000000
CN5303300000000,53,033,"King County, WA",Nov-21,1285786,1247949,37837,2.90000000
CN5303500000000,53,035,"Kitsap County, WA",Nov-21,131549,126669,4880,3.70000000
CN5303700000000,53,037,"Kittitas County, WA",Nov-21,22897,21861,1036,4.50000000
CN5303900000000,53,039,"Klickitat County, WA",Nov-21,10095,9613,482,4.80000000
CN5304100000000,53,041,"Lewis County, WA",Nov-21,35342,33554,1788,5.10000000
CN5304300000000,53,043,"Lincoln County, WA",Nov-21,4768,4584,184,3.90000000
CN5304500000000,53,045,"Mason County, WA",Nov-21,25723,24269,1454,5.70000000
CN5304700000000,53,047,"Okanogan County, WA",Nov-21,19479,18430,1049,5.40000000
CN5304900000000,53,049,"Pacific County, WA",Nov-21,8773,8203,570,6.50000000
CN5305100000000,53,051,"Pend Oreille County, WA",Nov-21,5284,4972,312,5.90000000
CN5305300000000,53,053,"Pierce County, WA",Nov-21,457328,435906,21422,4.70000000
CN5305500000000,53,055,"San Juan County, WA",Nov-21,8432,8120,312,3.70000000
CN5305700000000,53,057,"Skagit County, WA",Nov-21,63402,60237,3165,5.00000000
CN5305900000000,53,059,"Skamania County, WA",Nov-21,5697,5412,285,5.00000000
CN5306100000000,53,061,"Snohomish County, WA",Nov-21,439249,423521,15728,3.60000000
CN5306300000000,53,063,"Spokane County, WA",Nov-21,268330,257953,10377,3.90000000
CN5306500000000,53,065,"Stevens County, WA",Nov-21,19582,18563,1019,5.20000000
CN5306700000000,53,067,"Thurston County, WA",Nov-21,149423,143559,5864,3.90000000
CN5306900000000,53,069,"Wahkiakum County, WA",Nov-21,1379,1310,69,5.00000000
CN5307100000000,53,071,"Walla Walla County, WA",Nov-21,32750,31647,1103,3.40000000
CN5307300000000,53,073,"Whatcom County, WA",Nov-21,116925,111714,5211,4.50000000
CN5307500000000,53,075,"Whitman County, WA",Nov-21,23907,23235,672,2.80000000
CN5307700000000,53,077,"Yakima County, WA",Nov-21,128870,121050,7820,6.10000000
CN5400100000000,54,001,"Barbour County, WV",Nov-21,7267,7013,254,3.50000000
CN5400300000000,54,003,"Berkeley County, WV",Nov-21,60971,59542,1429,2.30000000
CN5400500000000,54,005,"Boone County, WV",Nov-21,7122,6828,294,4.10000000
CN5400700000000,54,007,"Braxton County, WV",Nov-21,5049,4814,235,4.70000000
CN5400900000000,54,009,"Brooke County, WV",Nov-21,9894,9484,410,4.10000000
CN5401100000000,54,011,"Cabell County, WV",Nov-21,41340,40066,1274,3.10000000
CN5401300000000,54,013,"Calhoun County, WV",Nov-21,2529,2353,176,7.00000000
CN5401500000000,54,015,"Clay County, WV",Nov-21,2985,2838,147,4.90000000
CN5401700000000,54,017,"Doddridge County, WV",Nov-21,3847,3735,112,2.90000000
CN5401900000000,54,019,"Fayette County, WV",Nov-21,15860,15168,692,4.40000000
CN5402100000000,54,021,"Gilmer County, WV",Nov-21,2405,2297,108,4.50000000
CN5402300000000,54,023,"Grant County, WV",Nov-21,6004,5821,183,3.00000000
CN5402500000000,54,025,"Greenbrier County, WV",Nov-21,15715,15260,455,2.90000000
CN5402700000000,54,027,"Hampshire County, WV",Nov-21,11346,11094,252,2.20000000
CN5402900000000,54,029,"Hancock County, WV",Nov-21,12955,12422,533,4.10000000
CN5403100000000,54,031,"Hardy County, WV",Nov-21,5802,5613,189,3.30000000
CN5403300000000,54,033,"Harrison County, WV",Nov-21,33875,32781,1094,3.20000000
CN5403500000000,54,035,"Jackson County, WV",Nov-21,12023,11570,453,3.80000000
CN5403700000000,54,037,"Jefferson County, WV",Nov-21,30785,30156,629,2.00000000
CN5403900000000,54,039,"Kanawha County, WV",Nov-21,80414,77649,2765,3.40000000
CN5404100000000,54,041,"Lewis County, WV",Nov-21,6085,5805,280,4.60000000
CN5404300000000,54,043,"Lincoln County, WV",Nov-21,7022,6708,314,4.50000000
CN5404500000000,54,045,"Logan County, WV",Nov-21,11056,10555,501,4.50000000
CN5404700000000,54,047,"McDowell County, WV",Nov-21,4177,3929,248,5.90000000
CN5404900000000,54,049,"Marion County, WV",Nov-21,25374,24435,939,3.70000000
CN5405100000000,54,051,"Marshall County, WV",Nov-21,13255,12714,541,4.10000000
CN5405300000000,54,053,"Mason County, WV",Nov-21,10211,9840,371,3.60000000
CN5405500000000,54,055,"Mercer County, WV",Nov-21,20623,19787,836,4.10000000
CN5405700000000,54,057,"Mineral County, WV",Nov-21,12352,11966,386,3.10000000
CN5405900000000,54,059,"Mingo County, WV",Nov-21,6087,5704,383,6.30000000
CN5406100000000,54,061,"Monongalia County, WV",Nov-21,56886,55259,1627,2.90000000
CN5406300000000,54,063,"Monroe County, WV",Nov-21,6331,6187,144,2.30000000
CN5406500000000,54,065,"Morgan County, WV",Nov-21,8731,8525,206,2.40000000
CN5406700000000,54,067,"Nicholas County, WV",Nov-21,9125,8757,368,4.00000000
CN5406900000000,54,069,"Ohio County, WV",Nov-21,20241,19563,678,3.30000000
CN5407100000000,54,071,"Pendleton County, WV",Nov-21,3924,3842,82,2.10000000
CN5407300000000,54,073,"Pleasants County, WV",Nov-21,2682,2549,133,5.00000000
CN5407500000000,54,075,"Pocahontas County, WV",Nov-21,3937,3788,149,3.80000000
CN5407700000000,54,077,"Preston County, WV",Nov-21,16083,15566,517,3.20000000
CN5407900000000,54,079,"Putnam County, WV",Nov-21,26924,26175,749,2.80000000
CN5408100000000,54,081,"Raleigh County, WV",Nov-21,29852,28814,1038,3.50000000
CN5408300000000,54,083,"Randolph County, WV",Nov-21,12106,11637,469,3.90000000
CN5408500000000,54,085,"Ritchie County, WV",Nov-21,4279,4109,170,4.00000000
CN5408700000000,54,087,"Roane County, WV",Nov-21,5054,4772,282,5.60000000
CN5408900000000,54,089,"Summers County, WV",Nov-21,4489,4348,141,3.10000000
CN5409100000000,54,091,"Taylor County, WV",Nov-21,7901,7641,260,3.30000000
CN5409300000000,54,093,"Tucker County, WV",Nov-21,3351,3225,126,3.80000000
CN5409500000000,54,095,"Tyler County, WV",Nov-21,2991,2830,161,5.40000000
CN5409700000000,54,097,"Upshur County, WV",Nov-21,9844,9417,427,4.30000000
CN5409900000000,54,099,"Wayne County, WV",Nov-21,15520,14985,535,3.40000000
CN5410100000000,54,101,"Webster County, WV",Nov-21,3352,3213,139,4.10000000
CN5410300000000,54,103,"Wetzel County, WV",Nov-21,6924,6624,300,4.30000000
CN5410500000000,54,105,"Wirt County, WV",Nov-21,2276,2158,118,5.20000000
CN5410700000000,54,107,"Wood County, WV",Nov-21,36434,35137,1297,3.60000000
CN5410900000000,54,109,"Wyoming County, WV",Nov-21,7189,6905,284,4.00000000
CN5500100000000,55,001,"Adams County, WI",Nov-21,7838,7518,320,4.10000000
CN5500300000000,55,003,"Ashland County, WI",Nov-21,7492,7246,246,3.30000000
CN5500500000000,55,005,"Barron County, WI",Nov-21,24187,23624,563,2.30000000
CN5500700000000,55,007,"Bayfield County, WI",Nov-21,7362,7083,279,3.80000000
CN5500900000000,55,009,"Brown County, WI",Nov-21,143800,140631,3169,2.20000000
CN5501100000000,55,011,"Buffalo County, WI",Nov-21,6244,6080,164,2.60000000
CN5501300000000,55,013,"Burnett County, WI",Nov-21,7295,7049,246,3.40000000
CN5501500000000,55,015,"Calumet County, WI",Nov-21,27848,27346,502,1.80000000
CN5501700000000,55,017,"Chippewa County, WI",Nov-21,33800,33020,780,2.30000000
CN5501900000000,55,019,"Clark County, WI",Nov-21,17672,17330,342,1.90000000
CN5502100000000,55,021,"Columbia County, WI",Nov-21,32097,31426,671,2.10000000
CN5502300000000,55,023,"Crawford County, WI",Nov-21,7429,7229,200,2.70000000
CN5502500000000,55,025,"Dane County, WI",Nov-21,335156,328912,6244,1.90000000
CN5502700000000,55,027,"Dodge County, WI",Nov-21,48375,47427,948,2.00000000
CN5502900000000,55,029,"Door County, WI",Nov-21,14707,14298,409,2.80000000
CN5503100000000,55,031,"Douglas County, WI",Nov-21,23395,22711,684,2.90000000
CN5503300000000,55,033,"Dunn County, WI",Nov-21,24914,24372,542,2.20000000
CN5503500000000,55,035,"Eau Claire County, WI",Nov-21,60535,59307,1228,2.00000000
CN5503700000000,55,037,"Florence County, WI",Nov-21,2228,2162,66,3.00000000
CN5503900000000,55,039,"Fond du Lac County, WI",Nov-21,57758,56604,1154,2.00000000
CN5504100000000,55,041,"Forest County, WI",Nov-21,3914,3761,153,3.90000000
CN5504300000000,55,043,"Grant County, WI",Nov-21,27949,27406,543,1.90000000
CN5504500000000,55,045,"Green County, WI",Nov-21,20941,20550,391,1.90000000
CN5504700000000,55,047,"Green Lake County, WI",Nov-21,9221,8961,260,2.80000000
CN5504900000000,55,049,"Iowa County, WI",Nov-21,13637,13364,273,2.00000000
CN5505100000000,55,051,"Iron County, WI",Nov-21,2543,2440,103,4.10000000
CN5505300000000,55,053,"Jackson County, WI",Nov-21,9370,9071,299,3.20000000
CN5505500000000,55,055,"Jefferson County, WI",Nov-21,46673,45688,985,2.10000000
CN5505700000000,55,057,"Juneau County, WI",Nov-21,13323,12954,369,2.80000000
CN5505900000000,55,059,"Kenosha County, WI",Nov-21,92431,89838,2593,2.80000000
CN5506100000000,55,061,"Kewaunee County, WI",Nov-21,10873,10669,204,1.90000000
CN5506300000000,55,063,"La Crosse County, WI",Nov-21,68362,67025,1337,2.00000000
CN5506500000000,55,065,"Lafayette County, WI",Nov-21,10209,10048,161,1.60000000
CN5506700000000,55,067,"Langlade County, WI",Nov-21,9357,9099,258,2.80000000
CN5506900000000,55,069,"Lincoln County, WI",Nov-21,14832,14508,324,2.20000000
CN5507100000000,55,071,"Manitowoc County, WI",Nov-21,41328,40424,904,2.20000000
CN5507300000000,55,073,"Marathon County, WI",Nov-21,74665,73226,1439,1.90000000
CN5507500000000,55,075,"Marinette County, WI",Nov-21,19392,18829,563,2.90000000
CN5507700000000,55,077,"Marquette County, WI",Nov-21,7756,7530,226,2.90000000
CN5507800000000,55,078,"Menominee County, WI",Nov-21,1534,1453,81,5.30000000
CN5507900000000,55,079,"Milwaukee County, WI",Nov-21,469693,452863,16830,3.60000000
CN5508100000000,55,081,"Monroe County, WI",Nov-21,23536,23062,474,2.00000000
CN5508300000000,55,083,"Oconto County, WI",Nov-21,20825,20342,483,2.30000000
CN5508500000000,55,085,"Oneida County, WI",Nov-21,17585,17107,478,2.70000000
CN5508700000000,55,087,"Outagamie County, WI",Nov-21,105659,103545,2114,2.00000000
CN5508900000000,55,089,"Ozaukee County, WI",Nov-21,49737,48747,990,2.00000000
CN5509100000000,55,091,"Pepin County, WI",Nov-21,4074,3995,79,1.90000000
CN5509300000000,55,093,"Pierce County, WI",Nov-21,25213,24633,580,2.30000000
CN5509500000000,55,095,"Polk County, WI",Nov-21,24783,24118,665,2.70000000
CN5509700000000,55,097,"Portage County, WI",Nov-21,38926,38060,866,2.20000000
CN5509900000000,55,099,"Price County, WI",Nov-21,6288,6118,170,2.70000000
CN5510100000000,55,101,"Racine County, WI",Nov-21,98856,95829,3027,3.10000000
CN5510300000000,55,103,"Richland County, WI",Nov-21,8969,8770,199,2.20000000
CN5510500000000,55,105,"Rock County, WI",Nov-21,86940,84412,2528,2.90000000
CN5510700000000,55,107,"Rusk County, WI",Nov-21,6569,6378,191,2.90000000
CN5510900000000,55,109,"St. Croix County, WI",Nov-21,51361,50257,1104,2.10000000
CN5511100000000,55,111,"Sauk County, WI",Nov-21,34428,33544,884,2.60000000
CN5511300000000,55,113,"Sawyer County, WI",Nov-21,7847,7578,269,3.40000000
CN5511500000000,55,115,"Shawano County, WI",Nov-21,20853,20361,492,2.40000000
CN5511700000000,55,117,"Sheboygan County, WI",Nov-21,62648,61381,1267,2.00000000
CN5511900000000,55,119,"Taylor County, WI",Nov-21,10893,10669,224,2.10000000
CN5512100000000,55,121,"Trempealeau County, WI",Nov-21,15382,15041,341,2.20000000
CN5512300000000,55,123,"Vernon County, WI",Nov-21,15497,15190,307,2.00000000
CN5512500000000,55,125,"Vilas County, WI",Nov-21,9996,9689,307,3.10000000
CN5512700000000,55,127,"Walworth County, WI",Nov-21,58600,57266,1334,2.30000000
CN5512900000000,55,129,"Washburn County, WI",Nov-21,7765,7550,215,2.80000000
CN5513100000000,55,131,"Washington County, WI",Nov-21,77740,76193,1547,2.00000000
CN5513300000000,55,133,"Waukesha County, WI",Nov-21,227588,222978,4610,2.00000000
CN5513500000000,55,135,"Waupaca County, WI",Nov-21,25870,25281,589,2.30000000
CN5513700000000,55,137,"Waushara County, WI",Nov-21,11328,11025,303,2.70000000
CN5513900000000,55,139,"Winnebago County, WI",Nov-21,93763,91809,1954,2.10000000
CN5514100000000,55,141,"Wood County, WI",Nov-21,34464,33522,942,2.70000000
CN5600100000000,56,001,"Albany County, WY",Nov-21,21750,21206,544,2.50000000
CN5600300000000,56,003,"Big Horn County, WY",Nov-21,5163,4975,188,3.60000000
CN5600500000000,56,005,"Campbell County, WY",Nov-21,22339,21476,863,3.90000000
CN5600700000000,56,007,"Carbon County, WY",Nov-21,7762,7520,242,3.10000000
CN5600900000000,56,009,"Converse County, WY",Nov-21,7607,7347,260,3.40000000
CN5601100000000,56,011,"Crook County, WY",Nov-21,3692,3591,101,2.70000000
CN5601300000000,56,013,"Fremont County, WY",Nov-21,19056,18400,656,3.40000000
CN5601500000000,56,015,"Goshen County, WY",Nov-21,6377,6200,177,2.80000000
CN5601700000000,56,017,"Hot Springs County, WY",Nov-21,2219,2152,67,3.00000000
CN5601900000000,56,019,"Johnson County, WY",Nov-21,4144,4007,137,3.30000000
CN5602100000000,56,021,"Laramie County, WY",Nov-21,50620,49097,1523,3.00000000
CN5602300000000,56,023,"Lincoln County, WY",Nov-21,9410,9129,281,3.00000000
CN5602500000000,56,025,"Natrona County, WY",Nov-21,39853,38097,1756,4.40000000
CN5602700000000,56,027,"Niobrara County, WY",Nov-21,1210,1179,31,2.60000000
CN5602900000000,56,029,"Park County, WY",Nov-21,14771,14253,518,3.50000000
CN5603100000000,56,031,"Platte County, WY",Nov-21,4363,4226,137,3.10000000
CN5603300000000,56,033,"Sheridan County, WY",Nov-21,16050,15553,497,3.10000000
CN5603500000000,56,035,"Sublette County, WY",Nov-21,3897,3735,162,4.20000000
CN5603700000000,56,037,"Sweetwater County, WY",Nov-21,19693,18895,798,4.10000000
CN5603900000000,56,039,"Teton County, WY",Nov-21,14263,13648,615,4.30000000
CN5604100000000,56,041,"Uinta County, WY",Nov-21,8782,8448,334,3.80000000
CN5604300000000,56,043,"Washakie County, WY",Nov-21,3983,3859,124,3.10000000
CN5604500000000,56,045,"Weston County, WY",Nov-21,3791,3697,94,2.50000000
CN7200100000000,72,001,"Adjuntas Municipio, PR",Nov-21,4705,4267,438,9.30000000
CN7200300000000,72,003,"Aguada Municipio, PR",Nov-21,13455,12348,1107,8.20000000
CN7200500000000,72,005,"Aguadilla Municipio, PR",Nov-21,16270,14865,1405,8.60000000
CN7200700000000,72,007,"Aguas Buenas Municipio, PR",Nov-21,7249,6631,618,8.50000000
CN7200900000000,72,009,"Aibonito Municipio, PR",Nov-21,7075,6550,525,7.40000000
CN7201100000000,72,011,"Anasco Municipio, PR",Nov-21,10087,9346,741,7.30000000
CN7201300000000,72,013,"Arecibo Municipio, PR",Nov-21,26812,24692,2120,7.90000000
CN7201500000000,72,015,"Arroyo Municipio, PR",Nov-21,5077,4681,396,7.80000000
CN7201700000000,72,017,"Barceloneta Municipio, PR",Nov-21,6627,5987,640,9.70000000
CN7201900000000,72,019,"Barranquitas Municipio, PR",Nov-21,8023,7412,611,7.60000000
CN7202100000000,72,021,"Bayamon Municipio, PR",Nov-21,72192,67372,4820,6.70000000
CN7202300000000,72,023,"Cabo Rojo Municipio, PR",Nov-21,15634,14404,1230,7.90000000
CN7202500000000,72,025,"Caguas Municipio, PR",Nov-21,52840,49679,3161,6.00000000
CN7202700000000,72,027,"Camuy Municipio, PR",Nov-21,10669,9954,715,6.70000000
CN7202900000000,72,029,"Canovanas Municipio, PR",Nov-21,18142,16991,1151,6.30000000
CN7203100000000,72,031,"Carolina Municipio, PR",Nov-21,68279,63879,4400,6.40000000
CN7203300000000,72,033,"Catano Municipio, PR",Nov-21,8677,8028,649,7.50000000
CN7203500000000,72,035,"Cayey Municipio, PR",Nov-21,17768,16812,956,5.40000000
CN7203700000000,72,037,"Ceiba Municipio, PR",Nov-21,3972,3645,327,8.20000000
CN7203900000000,72,039,"Ciales Municipio, PR",Nov-21,4084,3657,427,10.50000000
CN7204100000000,72,041,"Cidra Municipio, PR",Nov-21,16967,16113,854,5.00000000
CN7204300000000,72,043,"Coamo Municipio, PR",Nov-21,11315,10385,930,8.20000000
CN7204500000000,72,045,"Comerio Municipio, PR",Nov-21,5430,4992,438,8.10000000
CN7204700000000,72,047,"Corozal Municipio, PR",Nov-21,9925,9017,908,9.10000000
CN7204900000000,72,049,"Culebra Municipio, PR",Nov-21,1021,966,55,5.40000000
CN7205100000000,72,051,"Dorado Municipio, PR",Nov-21,14966,14160,806,5.40000000
CN7205300000000,72,053,"Fajardo Municipio, PR",Nov-21,11763,10747,1016,8.60000000
CN7205400000000,72,054,"Florida Municipio, PR",Nov-21,3653,3299,354,9.70000000
CN7205500000000,72,055,"Guanica Municipio, PR",Nov-21,4476,3910,566,12.60000000
CN7205700000000,72,057,"Guayama Municipio, PR",Nov-21,12051,11186,865,7.20000000
CN7205900000000,72,059,"Guayanilla Municipio, PR",Nov-21,5462,4845,617,11.30000000
CN7206100000000,72,061,"Guaynabo Municipio, PR",Nov-21,41942,40262,1680,4.00000000
CN7206300000000,72,063,"Gurabo Municipio, PR",Nov-21,20670,19736,934,4.50000000
CN7206500000000,72,065,"Hatillo Municipio, PR",Nov-21,15077,13930,1147,7.60000000
CN7206700000000,72,067,"Hormigueros Municipio, PR",Nov-21,6175,5657,518,8.40000000
CN7206900000000,72,069,"Humacao Municipio, PR",Nov-21,19315,17890,1425,7.40000000
CN7207100000000,72,071,"Isabela Municipio, PR",Nov-21,13288,12303,985,7.40000000
CN7207300000000,72,073,"Jayuya Municipio, PR",Nov-21,4769,4209,560,11.70000000
CN7207500000000,72,075,"Juana Diaz Municipio, PR",Nov-21,17515,16284,1231,7.00000000
CN7207700000000,72,077,"Juncos Municipio, PR",Nov-21,13855,12790,1065,7.70000000
CN7207900000000,72,079,"Lajas Municipio, PR",Nov-21,5964,5262,702,11.80000000
CN7208100000000,72,081,"Lares Municipio, PR",Nov-21,7999,7056,943,11.80000000
CN7208300000000,72,083,"Las Marias Municipio, PR",Nov-21,2904,2596,308,10.60000000
CN7208500000000,72,085,"Las Piedras Municipio, PR",Nov-21,12642,11766,876,6.90000000
CN7208700000000,72,087,"Loiza Municipio, PR",Nov-21,9313,8552,761,8.20000000
CN7208900000000,72,089,"Luquillo Municipio, PR",Nov-21,6834,6281,553,8.10000000
CN7209100000000,72,091,"Manati Municipio, PR",Nov-21,12483,11618,865,6.90000000
CN7209300000000,72,093,"Maricao Municipio, PR",Nov-21,2148,1907,241,11.20000000
CN7209500000000,72,095,"Maunabo Municipio, PR",Nov-21,3097,2763,334,10.80000000
CN7209700000000,72,097,"Mayaguez Municipio, PR",Nov-21,24525,22480,2045,8.30000000
CN7209900000000,72,099,"Moca Municipio, PR",Nov-21,11801,10759,1042,8.80000000
CN7210100000000,72,101,"Morovis Municipio, PR",Nov-21,9004,8236,768,8.50000000
CN7210300000000,72,103,"Naguabo Municipio, PR",Nov-21,9185,8519,666,7.30000000
CN7210500000000,72,105,"Naranjito Municipio, PR",Nov-21,7974,7208,766,9.60000000
CN7210700000000,72,107,"Orocovis Municipio, PR",Nov-21,5329,4871,458,8.60000000
CN7210900000000,72,109,"Patillas Municipio, PR",Nov-21,4654,4183,471,10.10000000
CN7211100000000,72,111,"Penuelas Municipio, PR",Nov-21,6340,5681,659,10.40000000
CN7211300000000,72,113,"Ponce Municipio, PR",Nov-21,50529,46242,4287,8.50000000
CN7211500000000,72,115,"Quebradillas Municipio, PR",Nov-21,6731,6165,566,8.40000000
CN7211700000000,72,117,"Rincon Municipio, PR",Nov-21,5254,4754,500,9.50000000
CN7211900000000,72,119,"Rio Grande Municipio, PR",Nov-21,19032,17598,1434,7.50000000
CN7212100000000,72,121,"Sabana Grande Municipio, PR",Nov-21,6739,6102,637,9.50000000
CN7212300000000,72,123,"Salinas Municipio, PR",Nov-21,7789,7016,773,9.90000000
CN7212500000000,72,125,"San German Municipio, PR",Nov-21,10809,9822,987,9.10000000
CN7212700000000,72,127,"San Juan Municipio, PR",Nov-21,148073,139417,8656,5.80000000
CN7212900000000,72,129,"San Lorenzo Municipio, PR",Nov-21,12790,11900,890,7.00000000
CN7213100000000,72,131,"San Sebastian Municipio, PR",Nov-21,11454,10201,1253,10.90000000
CN7213300000000,72,133,"Santa Isabel Municipio, PR",Nov-21,9975,9025,950,9.50000000
CN7213500000000,72,135,"Toa Alta Municipio, PR",Nov-21,31012,29177,1835,5.90000000
CN7213700000000,72,137,"Toa Baja Municipio, PR",Nov-21,32279,30292,1987,6.20000000
CN7213900000000,72,139,"Trujillo Alto Municipio, PR",Nov-21,30084,28614,1470,4.90000000
CN7214100000000,72,141,"Utuado Municipio, PR",Nov-21,7402,6736,666,9.00000000
CN7214300000000,72,143,"Vega Alta Municipio, PR",Nov-21,10967,10037,930,8.50000000
CN7214500000000,72,145,"Vega Baja Municipio, PR",Nov-21,14831,13446,1385,9.30000000
CN7214700000000,72,147,"Vieques Municipio, PR",Nov-21,2869,2511,358,12.50000000
CN7214900000000,72,149,"Villalba Municipio, PR",Nov-21,7928,7105,823,10.40000000
CN7215100000000,72,151,"Yabucoa Municipio, PR",Nov-21,9479,8592,887,9.40000000
CN7215300000000,72,153,"Yauco Municipio, PR",Nov-21,10749,9567,1182,11.00000000
CN0100100000000,01,001,"Autauga County, AL",Dec-21,26444,25870,574,2.20000000
CN0100300000000,01,003,"Baldwin County, AL",Dec-21,99220,97044,2176,2.20000000
CN0100500000000,01,005,"Barbour County, AL",Dec-21,8086,7725,361,4.50000000
CN0100700000000,01,007,"Bibb County, AL",Dec-21,8589,8377,212,2.50000000
CN0100900000000,01,009,"Blount County, AL",Dec-21,25336,24882,454,1.80000000
CN0101100000000,01,011,"Bullock County, AL",Dec-21,4587,4446,141,3.10000000
CN0101300000000,01,013,"Butler County, AL",Dec-21,8567,8201,366,4.30000000
CN0101500000000,01,015,"Calhoun County, AL",Dec-21,45712,44252,1460,3.20000000
CN0101700000000,01,017,"Chambers County, AL",Dec-21,15792,15389,403,2.60000000
CN0101900000000,01,019,"Cherokee County, AL",Dec-21,11720,11490,230,2.00000000
CN0102100000000,01,021,"Chilton County, AL",Dec-21,19999,19558,441,2.20000000
CN0102300000000,01,023,"Choctaw County, AL",Dec-21,4533,4381,152,3.40000000
CN0102500000000,01,025,"Clarke County, AL",Dec-21,7761,7386,375,4.80000000
CN0102700000000,01,027,"Clay County, AL",Dec-21,6098,5982,116,1.90000000
CN0102900000000,01,029,"Cleburne County, AL",Dec-21,6023,5909,114,1.90000000
CN0103100000000,01,031,"Coffee County, AL",Dec-21,21800,21316,484,2.20000000
CN0103300000000,01,033,"Colbert County, AL",Dec-21,23408,22673,735,3.10000000
CN0103500000000,01,035,"Conecuh County, AL",Dec-21,4307,4153,154,3.60000000
CN0103700000000,01,037,"Coosa County, AL",Dec-21,4315,4222,93,2.20000000
CN0103900000000,01,039,"Covington County, AL",Dec-21,15182,14846,336,2.20000000
CN0104100000000,01,041,"Crenshaw County, AL",Dec-21,6089,5935,154,2.50000000
CN0104300000000,01,043,"Cullman County, AL",Dec-21,39118,38436,682,1.70000000
CN0104500000000,01,045,"Dale County, AL",Dec-21,20967,20456,511,2.40000000
CN0104700000000,01,047,"Dallas County, AL",Dec-21,13801,12919,882,6.40000000
CN0104900000000,01,049,"DeKalb County, AL",Dec-21,31086,30492,594,1.90000000
CN0105100000000,01,051,"Elmore County, AL",Dec-21,37663,36913,750,2.00000000
CN0105300000000,01,053,"Escambia County, AL",Dec-21,13675,13262,413,3.00000000
CN0105500000000,01,055,"Etowah County, AL",Dec-21,39088,37870,1218,3.10000000
CN0105700000000,01,057,"Fayette County, AL",Dec-21,6643,6483,160,2.40000000
CN0105900000000,01,059,"Franklin County, AL",Dec-21,14347,14066,281,2.00000000
CN0106100000000,01,061,"Geneva County, AL",Dec-21,11156,10916,240,2.20000000
CN0106300000000,01,063,"Greene County, AL",Dec-21,2804,2647,157,5.60000000
CN0106500000000,01,065,"Hale County, AL",Dec-21,5956,5689,267,4.50000000
CN0106700000000,01,067,"Henry County, AL",Dec-21,6937,6773,164,2.40000000
CN0106900000000,01,069,"Houston County, AL",Dec-21,47162,45986,1176,2.50000000
CN0107100000000,01,071,"Jackson County, AL",Dec-21,23023,22506,517,2.20000000
CN0107300000000,01,073,"Jefferson County, AL",Dec-21,318504,309584,8920,2.80000000
CN0107500000000,01,075,"Lamar County, AL",Dec-21,5654,5533,121,2.10000000
CN0107700000000,01,077,"Lauderdale County, AL",Dec-21,42029,40969,1060,2.50000000
CN0107900000000,01,079,"Lawrence County, AL",Dec-21,14392,14077,315,2.20000000
CN0108100000000,01,081,"Lee County, AL",Dec-21,77399,75728,1671,2.20000000
CN0108300000000,01,083,"Limestone County, AL",Dec-21,46738,45871,867,1.90000000
CN0108500000000,01,085,"Lowndes County, AL",Dec-21,3576,3298,278,7.80000000
CN0108700000000,01,087,"Macon County, AL",Dec-21,7922,7533,389,4.90000000
CN0108900000000,01,089,"Madison County, AL",Dec-21,192547,188672,3875,2.00000000
CN0109100000000,01,091,"Marengo County, AL",Dec-21,7585,7334,251,3.30000000
CN0109300000000,01,093,"Marion County, AL",Dec-21,13401,13119,282,2.10000000
CN0109500000000,01,095,"Marshall County, AL",Dec-21,44541,43744,797,1.80000000
CN0109700000000,01,097,"Mobile County, AL",Dec-21,191694,184785,6909,3.60000000
CN0109900000000,01,099,"Monroe County, AL",Dec-21,7387,7073,314,4.30000000
CN0110100000000,01,101,"Montgomery County, AL",Dec-21,106594,102540,4054,3.80000000
CN0110300000000,01,103,"Morgan County, AL",Dec-21,59304,58132,1172,2.00000000
CN0110500000000,01,105,"Perry County, AL",Dec-21,3171,2949,222,7.00000000
CN0110700000000,01,107,"Pickens County, AL",Dec-21,7547,7320,227,3.00000000
CN0110900000000,01,109,"Pike County, AL",Dec-21,16136,15708,428,2.70000000
CN0111100000000,01,111,"Randolph County, AL",Dec-21,9389,9193,196,2.10000000
CN0111300000000,01,113,"Russell County, AL",Dec-21,23613,23110,503,2.10000000
CN0111500000000,01,115,"St. Clair County, AL",Dec-21,41428,40613,815,2.00000000
CN0111700000000,01,117,"Shelby County, AL",Dec-21,119078,117106,1972,1.70000000
CN0111900000000,01,119,"Sumter County, AL",Dec-21,4477,4318,159,3.60000000
CN0112100000000,01,121,"Talladega County, AL",Dec-21,35674,34458,1216,3.40000000
CN0112300000000,01,123,"Tallapoosa County, AL",Dec-21,17524,17002,522,3.00000000
CN0112500000000,01,125,"Tuscaloosa County, AL",Dec-21,101373,98647,2726,2.70000000
CN0112700000000,01,127,"Walker County, AL",Dec-21,25185,24465,720,2.90000000
CN0112900000000,01,129,"Washington County, AL",Dec-21,6489,6252,237,3.70000000
CN0113100000000,01,131,"Wilcox County, AL",Dec-21,2614,2358,256,9.80000000
CN0113300000000,01,133,"Winston County, AL",Dec-21,10009,9802,207,2.10000000
CN0201300000000,02,013,"Aleutians East Borough, AK",Dec-21,1463,1413,50,3.40000000
CN0201600000000,02,016,"Aleutians West Census Area, AK",Dec-21,2776,2649,127,4.60000000
CN0202000000000,02,020,"Anchorage Borough/municipality, AK",Dec-21,154601,148017,6584,4.30000000
CN0205000000000,02,050,"Bethel Census Area, AK",Dec-21,7347,6592,755,10.30000000
CN0206000000000,02,060,"Bristol Bay Borough, AK",Dec-21,254,228,26,10.20000000
CN0206300000000,02,063,"Chugach Census Area, AK",Dec-21,3186,2960,226,7.10000000
CN0206600000000,02,066,"Copper River Census Area, AK",Dec-21,1266,1156,110,8.70000000
CN0206800000000,02,068,"Denali Borough, AK",Dec-21,779,695,84,10.80000000
CN0207000000000,02,070,"Dillingham Census Area, AK",Dec-21,1717,1608,109,6.30000000
CN0209000000000,02,090,"Fairbanks North Star Borough, AK",Dec-21,46592,44604,1988,4.30000000
CN0210000000000,02,100,"Haines Borough, AK",Dec-21,931,832,99,10.60000000
CN0210500000000,02,105,"Hoonah-Angoon Census Area, AK",Dec-21,1062,969,93,8.80000000
CN0211000000000,02,110,"Juneau Borough/city, AK",Dec-21,16610,16037,573,3.40000000
CN0212200000000,02,122,"Kenai Peninsula Borough, AK",Dec-21,27716,25995,1721,6.20000000
CN0213000000000,02,130,"Ketchikan Gateway Borough, AK",Dec-21,6508,6143,365,5.60000000
CN0215000000000,02,150,"Kodiak Island Borough, AK",Dec-21,5471,4959,512,9.40000000
CN0215800000000,02,158,"Kusilvak Census Area, AK",Dec-21,2319,1948,371,16.00000000
CN0216400000000,02,164,"Lake and Peninsula Borough, AK",Dec-21,607,563,44,7.20000000
CN0217000000000,02,170,"Matanuska-Susitna Borough, AK",Dec-21,51226,48288,2938,5.70000000
CN0218000000000,02,180,"Nome Census Area, AK",Dec-21,4364,4033,331,7.60000000
CN0218500000000,02,185,"North Slope Borough, AK",Dec-21,3011,2871,140,4.60000000
CN0218800000000,02,188,"Northwest Arctic Borough, AK",Dec-21,3029,2749,280,9.20000000
CN0219500000000,02,195,"Petersburg Borough, AK",Dec-21,1462,1358,104,7.10000000
CN0219800000000,02,198,"Prince of Wales-Hyder Census Area, AK",Dec-21,2766,2577,189,6.80000000
CN0222000000000,02,220,"Sitka Borough/city, AK",Dec-21,4470,4315,155,3.50000000
CN0223000000000,02,230,"Skagway Municipality, AK",Dec-21,536,452,84,15.70000000
CN0224000000000,02,240,"Southeast Fairbanks Census Area, AK",Dec-21,3269,3074,195,6.00000000
CN0227500000000,02,275,"Wrangell Borough/city, AK",Dec-21,941,876,65,6.90000000
CN0228200000000,02,282,"Yakutat Borough/city, AK",Dec-21,256,238,18,7.00000000
CN0229000000000,02,290,"Yukon-Koyukuk Census Area, AK",Dec-21,2388,2138,250,10.50000000
CN0400100000000,04,001,"Apache County, AZ",Dec-21,18224,17063,1161,6.40000000
CN0400300000000,04,003,"Cochise County, AZ",Dec-21,48973,47459,1514,3.10000000
CN0400500000000,04,005,"Coconino County, AZ",Dec-21,73348,70505,2843,3.90000000
CN0400700000000,04,007,"Gila County, AZ",Dec-21,20152,19539,613,3.00000000
CN0400900000000,04,009,"Graham County, AZ",Dec-21,15732,15351,381,2.40000000
CN0401100000000,04,011,"Greenlee County, AZ",Dec-21,4333,4233,100,2.30000000
CN0401200000000,04,012,"La Paz County, AZ",Dec-21,8926,8650,276,3.10000000
CN0401300000000,04,013,"Maricopa County, AZ",Dec-21,2323383,2264033,59350,2.60000000
CN0401500000000,04,015,"Mohave County, AZ",Dec-21,87343,84177,3166,3.60000000
CN0401700000000,04,017,"Navajo County, AZ",Dec-21,38696,37033,1663,4.30000000
CN0401900000000,04,019,"Pima County, AZ",Dec-21,482383,468330,14053,2.90000000
CN0402100000000,04,021,"Pinal County, AZ",Dec-21,194624,189193,5431,2.80000000
CN0402300000000,04,023,"Santa Cruz County, AZ",Dec-21,19217,18080,1137,5.90000000
CN0402500000000,04,025,"Yavapai County, AZ",Dec-21,105633,103109,2524,2.40000000
CN0402700000000,04,027,"Yuma County, AZ",Dec-21,96004,86093,9911,10.30000000
CN0500100000000,05,001,"Arkansas County, AR",Dec-21,9416,9159,257,2.70000000
CN0500300000000,05,003,"Ashley County, AR",Dec-21,6494,6140,354,5.50000000
CN0500500000000,05,005,"Baxter County, AR",Dec-21,16137,15730,407,2.50000000
CN0500700000000,05,007,"Benton County, AR",Dec-21,144345,141766,2579,1.80000000
CN0500900000000,05,009,"Boone County, AR",Dec-21,15687,15393,294,1.90000000
CN0501100000000,05,011,"Bradley County, AR",Dec-21,3904,3781,123,3.20000000
CN0501300000000,05,013,"Calhoun County, AR",Dec-21,2360,2310,50,2.10000000
CN0501500000000,05,015,"Carroll County, AR",Dec-21,12322,12055,267,2.20000000
CN0501700000000,05,017,"Chicot County, AR",Dec-21,2918,2727,191,6.50000000
CN0501900000000,05,019,"Clark County, AR",Dec-21,8752,8475,277,3.20000000
CN0502100000000,05,021,"Clay County, AR",Dec-21,5196,5048,148,2.80000000
CN0502300000000,05,023,"Cleburne County, AR",Dec-21,8774,8487,287,3.30000000
CN0502500000000,05,025,"Cleveland County, AR",Dec-21,3045,2966,79,2.60000000
CN0502700000000,05,027,"Columbia County, AR",Dec-21,8752,8441,311,3.60000000
CN0502900000000,05,029,"Conway County, AR",Dec-21,8206,7975,231,2.80000000
CN0503100000000,05,031,"Craighead County, AR",Dec-21,56100,54944,1156,2.10000000
CN0503300000000,05,033,"Crawford County, AR",Dec-21,25769,25148,621,2.40000000
CN0503500000000,05,035,"Crittenden County, AR",Dec-21,20502,19816,686,3.30000000
CN0503700000000,05,037,"Cross County, AR",Dec-21,6780,6566,214,3.20000000
CN0503900000000,05,039,"Dallas County, AR",Dec-21,2721,2642,79,2.90000000
CN0504100000000,05,041,"Desha County, AR",Dec-21,4864,4647,217,4.50000000
CN0504300000000,05,043,"Drew County, AR",Dec-21,7425,7163,262,3.50000000
CN0504500000000,05,045,"Faulkner County, AR",Dec-21,61379,59995,1384,2.30000000
CN0504700000000,05,047,"Franklin County, AR",Dec-21,7144,6963,181,2.50000000
CN0504900000000,05,049,"Fulton County, AR",Dec-21,4808,4696,112,2.30000000
CN0505100000000,05,051,"Garland County, AR",Dec-21,39935,38612,1323,3.30000000
CN0505300000000,05,053,"Grant County, AR",Dec-21,8192,8016,176,2.10000000
CN0505500000000,05,055,"Greene County, AR",Dec-21,19099,18680,419,2.20000000
CN0505700000000,05,057,"Hempstead County, AR",Dec-21,8951,8720,231,2.60000000
CN0505900000000,05,059,"Hot Spring County, AR",Dec-21,13688,13333,355,2.60000000
CN0506100000000,05,061,"Howard County, AR",Dec-21,5306,5182,124,2.30000000
CN0506300000000,05,063,"Independence County, AR",Dec-21,16277,15853,424,2.60000000
CN0506500000000,05,065,"Izard County, AR",Dec-21,4298,4120,178,4.10000000
CN0506700000000,05,067,"Jackson County, AR",Dec-21,5496,5284,212,3.90000000
CN0506900000000,05,069,"Jefferson County, AR",Dec-21,25867,24596,1271,4.90000000
CN0507100000000,05,071,"Johnson County, AR",Dec-21,9799,9467,332,3.40000000
CN0507300000000,05,073,"Lafayette County, AR",Dec-21,2233,2149,84,3.80000000
CN0507500000000,05,075,"Lawrence County, AR",Dec-21,6587,6404,183,2.80000000
CN0507700000000,05,077,"Lee County, AR",Dec-21,2406,2307,99,4.10000000
CN0507900000000,05,079,"Lincoln County, AR",Dec-21,3644,3522,122,3.30000000
CN0508100000000,05,081,"Little River County, AR",Dec-21,5291,5125,166,3.10000000
CN0508300000000,05,083,"Logan County, AR",Dec-21,8207,7976,231,2.80000000
CN0508500000000,05,085,"Lonoke County, AR",Dec-21,33241,32502,739,2.20000000
CN0508700000000,05,087,"Madison County, AR",Dec-21,7348,7197,151,2.10000000
CN0508900000000,05,089,"Marion County, AR",Dec-21,5972,5806,166,2.80000000
CN0509100000000,05,091,"Miller County, AR",Dec-21,19054,18408,646,3.40000000
CN0509300000000,05,093,"Mississippi County, AR",Dec-21,15936,15115,821,5.20000000
CN0509500000000,05,095,"Monroe County, AR",Dec-21,2531,2432,99,3.90000000
CN0509700000000,05,097,"Montgomery County, AR",Dec-21,2643,2529,114,4.30000000
CN0509900000000,05,099,"Nevada County, AR",Dec-21,3305,3201,104,3.10000000
CN0510100000000,05,101,"Newton County, AR",Dec-21,3130,3067,63,2.00000000
CN0510300000000,05,103,"Ouachita County, AR",Dec-21,9722,9442,280,2.90000000
CN0510500000000,05,105,"Perry County, AR",Dec-21,4092,3965,127,3.10000000
CN0510700000000,05,107,"Phillips County, AR",Dec-21,5619,5280,339,6.00000000
CN0510900000000,05,109,"Pike County, AR",Dec-21,4019,3889,130,3.20000000
CN0511100000000,05,111,"Poinsett County, AR",Dec-21,9636,9385,251,2.60000000
CN0511300000000,05,113,"Polk County, AR",Dec-21,7595,7355,240,3.20000000
CN0511500000000,05,115,"Pope County, AR",Dec-21,27275,26507,768,2.80000000
CN0511700000000,05,117,"Prairie County, AR",Dec-21,3431,3354,77,2.20000000
CN0511900000000,05,119,"Pulaski County, AR",Dec-21,185350,179428,5922,3.20000000
CN0512100000000,05,121,"Randolph County, AR",Dec-21,7155,6975,180,2.50000000
CN0512300000000,05,123,"St. Francis County, AR",Dec-21,7494,7166,328,4.40000000
CN0512500000000,05,125,"Saline County, AR",Dec-21,58420,57216,1204,2.10000000
CN0512700000000,05,127,"Scott County, AR",Dec-21,4127,4039,88,2.10000000
CN0512900000000,05,129,"Searcy County, AR",Dec-21,2822,2733,89,3.20000000
CN0513100000000,05,131,"Sebastian County, AR",Dec-21,54348,53016,1332,2.50000000
CN0513300000000,05,133,"Sevier County, AR",Dec-21,5278,5115,163,3.10000000
CN0513500000000,05,135,"Sharp County, AR",Dec-21,5553,5367,186,3.30000000
CN0513700000000,05,137,"Stone County, AR",Dec-21,4323,4171,152,3.50000000
CN0513900000000,05,139,"Union County, AR",Dec-21,14795,14147,648,4.40000000
CN0514100000000,05,141,"Van Buren County, AR",Dec-21,5665,5476,189,3.30000000
CN0514300000000,05,143,"Washington County, AR",Dec-21,127686,125315,2371,1.90000000
CN0514500000000,05,145,"White County, AR",Dec-21,33821,32897,924,2.70000000
CN0514700000000,05,147,"Woodruff County, AR",Dec-21,2744,2655,89,3.20000000
CN0514900000000,05,149,"Yell County, AR",Dec-21,7736,7515,221,2.90000000
CN0600100000000,06,001,"Alameda County, CA",Dec-21,821509,790265,31244,3.80000000
CN0600300000000,06,003,"Alpine County, CA",Dec-21,535,506,29,5.40000000
CN0600500000000,06,005,"Amador County, CA",Dec-21,14224,13519,705,5.00000000
CN0600700000000,06,007,"Butte County, CA",Dec-21,91982,87589,4393,4.80000000
CN0600900000000,06,009,"Calaveras County, CA",Dec-21,21399,20571,828,3.90000000
CN0601100000000,06,011,"Colusa County, CA",Dec-21,10411,9205,1206,11.60000000
CN0601300000000,06,013,"Contra Costa County, CA",Dec-21,549515,527060,22455,4.10000000
CN0601500000000,06,015,"Del Norte County, CA",Dec-21,9085,8601,484,5.30000000
CN0601700000000,06,017,"El Dorado County, CA",Dec-21,91537,88042,3495,3.80000000
CN0601900000000,06,019,"Fresno County, CA",Dec-21,443813,413088,30725,6.90000000
CN0602100000000,06,021,"Glenn County, CA",Dec-21,12431,11793,638,5.10000000
CN0602300000000,06,023,"Humboldt County, CA",Dec-21,59342,56923,2419,4.10000000
CN0602500000000,06,025,"Imperial County, CA",Dec-21,69505,59787,9718,14.00000000
CN0602700000000,06,027,"Inyo County, CA",Dec-21,8103,7772,331,4.10000000
CN0602900000000,06,029,"Kern County, CA",Dec-21,378851,350378,28473,7.50000000
CN0603100000000,06,031,"Kings County, CA",Dec-21,56037,51862,4175,7.50000000
CN0603300000000,06,033,"Lake County, CA",Dec-21,27581,25982,1599,5.80000000
CN0603500000000,06,035,"Lassen County, CA",Dec-21,8866,8490,376,4.20000000
CN0603700000000,06,037,"Los Angeles County, CA",Dec-21,5001852,4701620,300232,6.00000000
CN0603900000000,06,039,"Madera County, CA",Dec-21,62076,57971,4105,6.60000000
CN0604100000000,06,041,"Marin County, CA",Dec-21,129496,125980,3516,2.70000000
CN0604300000000,06,043,"Mariposa County, CA",Dec-21,6525,6147,378,5.80000000
CN0604500000000,06,045,"Mendocino County, CA",Dec-21,36871,35256,1615,4.40000000
CN0604700000000,06,047,"Merced County, CA",Dec-21,114452,105210,9242,8.10000000
CN0604900000000,06,049,"Modoc County, CA",Dec-21,3056,2891,165,5.40000000
CN0605100000000,06,051,"Mono County, CA",Dec-21,9066,8681,385,4.20000000
CN0605300000000,06,053,"Monterey County, CA",Dec-21,201169,186393,14776,7.30000000
CN0605500000000,06,055,"Napa County, CA",Dec-21,67092,64370,2722,4.10000000
CN0605700000000,06,057,"Nevada County, CA",Dec-21,47168,45426,1742,3.70000000
CN0605900000000,06,059,"Orange County, CA",Dec-21,1574275,1516186,58089,3.70000000
CN0606100000000,06,061,"Placer County, CA",Dec-21,189277,183259,6018,3.20000000
CN0606300000000,06,063,"Plumas County, CA",Dec-21,6634,6094,540,8.10000000
CN0606500000000,06,065,"Riverside County, CA",Dec-21,1149019,1092632,56387,4.90000000
CN0606700000000,06,067,"Sacramento County, CA",Dec-21,715102,681641,33461,4.70000000
CN0606900000000,06,069,"San Benito County, CA",Dec-21,32196,30433,1763,5.50000000
CN0607100000000,06,071,"San Bernardino County, CA",Dec-21,1005965,955669,50296,5.00000000
CN0607300000000,06,073,"San Diego County, CA",Dec-21,1570184,1505925,64259,4.10000000
CN0607500000000,06,075,"San Francisco County/city, CA",Dec-21,560450,543659,16791,3.00000000
CN0607700000000,06,077,"San Joaquin County, CA",Dec-21,334808,313904,20904,6.20000000
CN0607900000000,06,079,"San Luis Obispo County, CA",Dec-21,134986,130584,4402,3.30000000
CN0608100000000,06,081,"San Mateo County, CA",Dec-21,443322,431213,12109,2.70000000
CN0608300000000,06,083,"Santa Barbara County, CA",Dec-21,216755,208345,8410,3.90000000
CN0608500000000,06,085,"Santa Clara County, CA",Dec-21,1035193,1005930,29263,2.80000000
CN0608700000000,06,087,"Santa Cruz County, CA",Dec-21,131992,125094,6898,5.20000000
CN0608900000000,06,089,"Shasta County, CA",Dec-21,72624,69125,3499,4.80000000
CN0609100000000,06,091,"Sierra County, CA",Dec-21,1289,1234,55,4.30000000
CN0609300000000,06,093,"Siskiyou County, CA",Dec-21,15878,14841,1037,6.50000000
CN0609500000000,06,095,"Solano County, CA",Dec-21,200121,189826,10295,5.10000000
CN0609700000000,06,097,"Sonoma County, CA",Dec-21,243938,235525,8413,3.40000000
CN0609900000000,06,099,"Stanislaus County, CA",Dec-21,237626,223233,14393,6.10000000
CN0610100000000,06,101,"Sutter County, CA",Dec-21,44838,41672,3166,7.10000000
CN0610300000000,06,103,"Tehama County, CA",Dec-21,24954,23681,1273,5.10000000
CN0610500000000,06,105,"Trinity County, CA",Dec-21,4312,4109,203,4.70000000
CN0610700000000,06,107,"Tulare County, CA",Dec-21,200861,184503,16358,8.10000000
CN0610900000000,06,109,"Tuolumne County, CA",Dec-21,19763,18771,992,5.00000000
CN0611100000000,06,111,"Ventura County, CA",Dec-21,405313,388349,16964,4.20000000
CN0611300000000,06,113,"Yolo County, CA",Dec-21,106464,102060,4404,4.10000000
CN0611500000000,06,115,"Yuba County, CA",Dec-21,30957,29086,1871,6.00000000
CN0800100000000,08,001,"Adams County, CO",Dec-21,277490,265498,11992,4.30000000
CN0800300000000,08,003,"Alamosa County, CO",Dec-21,8574,8247,327,3.80000000
CN0800500000000,08,005,"Arapahoe County, CO",Dec-21,368392,353945,14447,3.90000000
CN0800700000000,08,007,"Archuleta County, CO",Dec-21,7258,7008,250,3.40000000
CN0800900000000,08,009,"Baca County, CO",Dec-21,2262,2230,32,1.40000000
CN0801100000000,08,011,"Bent County, CO",Dec-21,1985,1901,84,4.20000000
CN0801300000000,08,013,"Boulder County, CO",Dec-21,198590,193073,5517,2.80000000
CN0801400000000,08,014,"Broomfield County/city, CO",Dec-21,41418,40224,1194,2.90000000
CN0801500000000,08,015,"Chaffee County, CO",Dec-21,10294,10012,282,2.70000000
CN0801700000000,08,017,"Cheyenne County, CO",Dec-21,1213,1195,18,1.50000000
CN0801900000000,08,019,"Clear Creek County, CO",Dec-21,6049,5827,222,3.70000000
CN0802100000000,08,021,"Conejos County, CO",Dec-21,4199,4068,131,3.10000000
CN0802300000000,08,023,"Costilla County, CO",Dec-21,1950,1872,78,4.00000000
CN0802500000000,08,025,"Crowley County, CO",Dec-21,1458,1404,54,3.70000000
CN0802700000000,08,027,"Custer County, CO",Dec-21,2370,2307,63,2.70000000
CN0802900000000,08,029,"Delta County, CO",Dec-21,14485,13971,514,3.50000000
CN0803100000000,08,031,"Denver County/city, CO",Dec-21,428646,411447,17199,4.00000000
CN0803300000000,08,033,"Dolores County, CO",Dec-21,1235,1198,37,3.00000000
CN0803500000000,08,035,"Douglas County, CO",Dec-21,202430,197052,5378,2.70000000
CN0803700000000,08,037,"Eagle County, CO",Dec-21,39589,38500,1089,2.80000000
CN0803900000000,08,039,"Elbert County, CO",Dec-21,15821,15426,395,2.50000000
CN0804100000000,08,041,"El Paso County, CO",Dec-21,351500,338128,13372,3.80000000
CN0804300000000,08,043,"Fremont County, CO",Dec-21,15587,14798,789,5.10000000
CN0804500000000,08,045,"Garfield County, CO",Dec-21,33363,32330,1033,3.10000000
CN0804700000000,08,047,"Gilpin County, CO",Dec-21,3879,3728,151,3.90000000
CN0804900000000,08,049,"Grand County, CO",Dec-21,10162,9887,275,2.70000000
CN0805100000000,08,051,"Gunnison County, CO",Dec-21,12214,11927,287,2.30000000
CN0805300000000,08,053,"Hinsdale County, CO",Dec-21,422,412,10,2.40000000
CN0805500000000,08,055,"Huerfano County, CO",Dec-21,2678,2514,164,6.10000000
CN0805700000000,08,057,"Jackson County, CO",Dec-21,1016,994,22,2.20000000
CN0805900000000,08,059,"Jefferson County, CO",Dec-21,335900,324758,11142,3.30000000
CN0806100000000,08,061,"Kiowa County, CO",Dec-21,1026,1007,19,1.90000000
CN0806300000000,08,063,"Kit Carson County, CO",Dec-21,4522,4431,91,2.00000000
CN0806500000000,08,065,"Lake County, CO",Dec-21,5315,5167,148,2.80000000
CN0806700000000,08,067,"La Plata County, CO",Dec-21,30913,29817,1096,3.50000000
CN0806900000000,08,069,"Larimer County, CO",Dec-21,208863,202604,6259,3.00000000
CN0807100000000,08,071,"Las Animas County, CO",Dec-21,6582,6263,319,4.80000000
CN0807300000000,08,073,"Lincoln County, CO",Dec-21,2421,2358,63,2.60000000
CN0807500000000,08,075,"Logan County, CO",Dec-21,11232,10919,313,2.80000000
CN0807700000000,08,077,"Mesa County, CO",Dec-21,77746,74698,3048,3.90000000
CN0807900000000,08,079,"Mineral County, CO",Dec-21,490,477,13,2.70000000
CN0808100000000,08,081,"Moffat County, CO",Dec-21,7198,6964,234,3.30000000
CN0808300000000,08,083,"Montezuma County, CO",Dec-21,13274,12754,520,3.90000000
CN0808500000000,08,085,"Montrose County, CO",Dec-21,22900,22126,774,3.40000000
CN0808700000000,08,087,"Morgan County, CO",Dec-21,16534,15968,566,3.40000000
CN0808900000000,08,089,"Otero County, CO",Dec-21,8421,8053,368,4.40000000
CN0809100000000,08,091,"Ouray County, CO",Dec-21,2697,2615,82,3.00000000
CN0809300000000,08,093,"Park County, CO",Dec-21,11421,11110,311,2.70000000
CN0809500000000,08,095,"Phillips County, CO",Dec-21,2701,2651,50,1.90000000
CN0809700000000,08,097,"Pitkin County, CO",Dec-21,11410,11022,388,3.40000000
CN0809900000000,08,099,"Prowers County, CO",Dec-21,6600,6403,197,3.00000000
CN0810100000000,08,101,"Pueblo County, CO",Dec-21,77843,73381,4462,5.70000000
CN0810300000000,08,103,"Rio Blanco County, CO",Dec-21,2938,2816,122,4.20000000
CN0810500000000,08,105,"Rio Grande County, CO",Dec-21,5628,5352,276,4.90000000
CN0810700000000,08,107,"Routt County, CO",Dec-21,16544,16100,444,2.70000000
CN0810900000000,08,109,"Saguache County, CO",Dec-21,3644,3505,139,3.80000000
CN0811100000000,08,111,"San Juan County, CO",Dec-21,578,562,16,2.80000000
CN0811300000000,08,113,"San Miguel County, CO",Dec-21,6478,6284,194,3.00000000
CN0811500000000,08,115,"Sedgwick County, CO",Dec-21,1250,1220,30,2.40000000
CN0811700000000,08,117,"Summit County, CO",Dec-21,24933,24361,572,2.30000000
CN0811900000000,08,119,"Teller County, CO",Dec-21,13130,12691,439,3.30000000
CN0812100000000,08,121,"Washington County, CO",Dec-21,3000,2934,66,2.20000000
CN0812300000000,08,123,"Weld County, CO",Dec-21,167574,161228,6346,3.80000000
CN0812500000000,08,125,"Yuma County, CO",Dec-21,6158,6050,108,1.80000000
CN0900100000000,09,001,"Fairfield County, CT",Dec-21,464642,446630,18012,3.90000000
CN0900300000000,09,003,"Hartford County, CT",Dec-21,468631,448992,19639,4.20000000
CN0900500000000,09,005,"Litchfield County, CT",Dec-21,101214,97550,3664,3.60000000
CN0900700000000,09,007,"Middlesex County, CT",Dec-21,91451,88439,3012,3.30000000
CN0900900000000,09,009,"New Haven County, CT",Dec-21,455249,435707,19542,4.30000000
CN0901100000000,09,011,"New London County, CT",Dec-21,128046,122284,5762,4.50000000
CN0901300000000,09,013,"Tolland County, CT",Dec-21,84615,81530,3085,3.60000000
CN0901500000000,09,015,"Windham County, CT",Dec-21,61930,59360,2570,4.10000000
CN1000100000000,10,001,"Kent County, DE",Dec-21,81691,77953,3738,4.60000000
CN1000300000000,10,003,"New Castle County, DE",Dec-21,306584,294409,12175,4.00000000
CN1000500000000,10,005,"Sussex County, DE",Dec-21,111016,106544,4472,4.00000000
CN1100100000000,11,001,District of Columbia,Dec-21,378144,358132,20012,5.30000000
CN1200100000000,12,001,"Alachua County, FL",Dec-21,139576,136166,3410,2.40000000
CN1200300000000,12,003,"Baker County, FL",Dec-21,12258,11949,309,2.50000000
CN1200500000000,12,005,"Bay County, FL",Dec-21,85331,83049,2282,2.70000000
CN1200700000000,12,007,"Bradford County, FL",Dec-21,10853,10542,311,2.90000000
CN1200900000000,12,009,"Brevard County, FL",Dec-21,292153,284494,7659,2.60000000
CN1201100000000,12,011,"Broward County, FL",Dec-21,1037371,1005584,31787,3.10000000
CN1201300000000,12,013,"Calhoun County, FL",Dec-21,4832,4687,145,3.00000000
CN1201500000000,12,015,"Charlotte County, FL",Dec-21,74545,72339,2206,3.00000000
CN1201700000000,12,017,"Citrus County, FL",Dec-21,46971,45133,1838,3.90000000
CN1201900000000,12,019,"Clay County, FL",Dec-21,109421,106875,2546,2.30000000
CN1202100000000,12,021,"Collier County, FL",Dec-21,185431,181174,4257,2.30000000
CN1202300000000,12,023,"Columbia County, FL",Dec-21,29261,28358,903,3.10000000
CN1202700000000,12,027,"DeSoto County, FL",Dec-21,14780,14423,357,2.40000000
CN1202900000000,12,029,"Dixie County, FL",Dec-21,5852,5691,161,2.80000000
CN1203100000000,12,031,"Duval County, FL",Dec-21,497731,483242,14489,2.90000000
CN1203300000000,12,033,"Escambia County, FL",Dec-21,146627,142234,4393,3.00000000
CN1203500000000,12,035,"Flagler County, FL",Dec-21,48833,47329,1504,3.10000000
CN1203700000000,12,037,"Franklin County, FL",Dec-21,4557,4432,125,2.70000000
CN1203900000000,12,039,"Gadsden County, FL",Dec-21,19674,18945,729,3.70000000
CN1204100000000,12,041,"Gilchrist County, FL",Dec-21,7283,7096,187,2.60000000
CN1204300000000,12,043,"Glades County, FL",Dec-21,5280,5137,143,2.70000000
CN1204500000000,12,045,"Gulf County, FL",Dec-21,5254,5109,145,2.80000000
CN1204700000000,12,047,"Hamilton County, FL",Dec-21,4093,3920,173,4.20000000
CN1204900000000,12,049,"Hardee County, FL",Dec-21,8996,8731,265,2.90000000
CN1205100000000,12,051,"Hendry County, FL",Dec-21,16295,15655,640,3.90000000
CN1205300000000,12,053,"Hernando County, FL",Dec-21,74154,71607,2547,3.40000000
CN1205500000000,12,055,"Highlands County, FL",Dec-21,34594,33236,1358,3.90000000
CN1205700000000,12,057,"Hillsborough County, FL",Dec-21,780632,759579,21053,2.70000000
CN1205900000000,12,059,"Holmes County, FL",Dec-21,6931,6745,186,2.70000000
CN1206100000000,12,061,"Indian River County, FL",Dec-21,65815,63776,2039,3.10000000
CN1206300000000,12,063,"Jackson County, FL",Dec-21,17243,16737,506,2.90000000
CN1206500000000,12,065,"Jefferson County, FL",Dec-21,5592,5433,159,2.80000000
CN1206700000000,12,067,"Lafayette County, FL",Dec-21,2737,2664,73,2.70000000
CN1206900000000,12,069,"Lake County, FL",Dec-21,164169,159201,4968,3.00000000
CN1207100000000,12,071,"Lee County, FL",Dec-21,362039,352239,9800,2.70000000
CN1207300000000,12,073,"Leon County, FL",Dec-21,154877,150645,4232,2.70000000
CN1207500000000,12,075,"Levy County, FL",Dec-21,16807,16292,515,3.10000000
CN1207700000000,12,077,"Liberty County, FL",Dec-21,2556,2478,78,3.10000000
CN1207900000000,12,079,"Madison County, FL",Dec-21,7772,7514,258,3.30000000
CN1208100000000,12,081,"Manatee County, FL",Dec-21,186566,181814,4752,2.50000000
CN1208300000000,12,083,"Marion County, FL",Dec-21,142308,137642,4666,3.30000000
CN1208500000000,12,085,"Martin County, FL",Dec-21,74236,72485,1751,2.40000000
CN1208600000000,12,086,"Miami-Dade County, FL",Dec-21,1345385,1304718,40667,3.00000000
CN1208700000000,12,087,"Monroe County, FL",Dec-21,48258,47386,872,1.80000000
CN1208900000000,12,089,"Nassau County, FL",Dec-21,43328,42352,976,2.30000000
CN1209100000000,12,091,"Okaloosa County, FL",Dec-21,98426,96232,2194,2.20000000
CN1209300000000,12,093,"Okeechobee County, FL",Dec-21,17801,17289,512,2.90000000
CN1209500000000,12,095,"Orange County, FL",Dec-21,760479,736096,24383,3.20000000
CN1209700000000,12,097,"Osceola County, FL",Dec-21,189951,182420,7531,4.00000000
CN1209900000000,12,099,"Palm Beach County, FL",Dec-21,748877,728453,20424,2.70000000
CN1210100000000,12,101,"Pasco County, FL",Dec-21,249155,241999,7156,2.90000000
CN1210300000000,12,103,"Pinellas County, FL",Dec-21,492527,479798,12729,2.60000000
CN1210500000000,12,105,"Polk County, FL",Dec-21,334394,322905,11489,3.40000000
CN1210700000000,12,107,"Putnam County, FL",Dec-21,27167,26031,1136,4.20000000
CN1210900000000,12,109,"St. Johns County, FL",Dec-21,144124,141245,2879,2.00000000
CN1211100000000,12,111,"St. Lucie County, FL",Dec-21,151506,146648,4858,3.20000000
CN1211300000000,12,113,"Santa Rosa County, FL",Dec-21,85721,83694,2027,2.40000000
CN1211500000000,12,115,"Sarasota County, FL",Dec-21,194704,189845,4859,2.50000000
CN1211700000000,12,117,"Seminole County, FL",Dec-21,252047,245446,6601,2.60000000
CN1211900000000,12,119,"Sumter County, FL",Dec-21,35150,33878,1272,3.60000000
CN1212100000000,12,121,"Suwannee County, FL",Dec-21,17314,16811,503,2.90000000
CN1212300000000,12,123,"Taylor County, FL",Dec-21,7943,7668,275,3.50000000
CN1212500000000,12,125,"Union County, FL",Dec-21,4537,4432,105,2.30000000
CN1212700000000,12,127,"Volusia County, FL",Dec-21,257774,249878,7896,3.10000000
CN1212900000000,12,129,"Wakulla County, FL",Dec-21,15588,15252,336,2.20000000
CN1213100000000,12,131,"Walton County, FL",Dec-21,33408,32609,799,2.40000000
CN1213300000000,12,133,"Washington County, FL",Dec-21,9511,9218,293,3.10000000
CN1300100000000,13,001,"Appling County, GA",Dec-21,8942,8672,270,3.00000000
CN1300300000000,13,003,"Atkinson County, GA",Dec-21,4432,4335,97,2.20000000
CN1300500000000,13,005,"Bacon County, GA",Dec-21,4737,4604,133,2.80000000
CN1300700000000,13,007,"Baker County, GA",Dec-21,1126,1079,47,4.20000000
CN1300900000000,13,009,"Baldwin County, GA",Dec-21,17554,16927,627,3.60000000
CN1301100000000,13,011,"Banks County, GA",Dec-21,10295,10076,219,2.10000000
CN1301300000000,13,013,"Barrow County, GA",Dec-21,42920,41938,982,2.30000000
CN1301500000000,13,015,"Bartow County, GA",Dec-21,52068,50709,1359,2.60000000
CN1301700000000,13,017,"Ben Hill County, GA",Dec-21,5425,5216,209,3.90000000
CN1301900000000,13,019,"Berrien County, GA",Dec-21,7649,7433,216,2.80000000
CN1302100000000,13,021,"Bibb County, GA",Dec-21,68518,66175,2343,3.40000000
CN1302300000000,13,023,"Bleckley County, GA",Dec-21,4615,4441,174,3.80000000
CN1302500000000,13,025,"Brantley County, GA",Dec-21,7278,7054,224,3.10000000
CN1302700000000,13,027,"Brooks County, GA",Dec-21,6742,6550,192,2.80000000
CN1302900000000,13,029,"Bryan County, GA",Dec-21,20256,19791,465,2.30000000
CN1303100000000,13,031,"Bulloch County, GA",Dec-21,38163,36981,1182,3.10000000
CN1303300000000,13,033,"Burke County, GA",Dec-21,9030,8627,403,4.50000000
CN1303500000000,13,035,"Butts County, GA",Dec-21,11292,11001,291,2.60000000
CN1303700000000,13,037,"Calhoun County, GA",Dec-21,2259,2193,66,2.90000000
CN1303900000000,13,039,"Camden County, GA",Dec-21,21785,21193,592,2.70000000
CN1304300000000,13,043,"Candler County, GA",Dec-21,6001,5856,145,2.40000000
CN1304500000000,13,045,"Carroll County, GA",Dec-21,56941,55376,1565,2.70000000
CN1304700000000,13,047,"Catoosa County, GA",Dec-21,33626,32851,775,2.30000000
CN1304900000000,13,049,"Charlton County, GA",Dec-21,4959,4819,140,2.80000000
CN1305100000000,13,051,"Chatham County, GA",Dec-21,145573,141143,4430,3.00000000
CN1305300000000,13,053,"Chattahoochee County, GA",Dec-21,1935,1857,78,4.00000000
CN1305500000000,13,055,"Chattooga County, GA",Dec-21,9420,9097,323,3.40000000
CN1305700000000,13,057,"Cherokee County, GA",Dec-21,142200,139131,3069,2.20000000
CN1305900000000,13,059,"Clarke County, GA",Dec-21,60379,58643,1736,2.90000000
CN1306100000000,13,061,"Clay County, GA",Dec-21,846,778,68,8.00000000
CN1306300000000,13,063,"Clayton County, GA",Dec-21,140750,134572,6178,4.40000000
CN1306500000000,13,065,"Clinch County, GA",Dec-21,3007,2933,74,2.50000000
CN1306700000000,13,067,"Cobb County, GA",Dec-21,430044,419646,10398,2.40000000
CN1306900000000,13,069,"Coffee County, GA",Dec-21,18520,17971,549,3.00000000
CN1307100000000,13,071,"Colquitt County, GA",Dec-21,21985,21438,547,2.50000000
CN1307300000000,13,073,"Columbia County, GA",Dec-21,76341,74529,1812,2.40000000
CN1307500000000,13,075,"Cook County, GA",Dec-21,8222,8005,217,2.60000000
CN1307700000000,13,077,"Coweta County, GA",Dec-21,77501,75552,1949,2.50000000
CN1307900000000,13,079,"Crawford County, GA",Dec-21,5605,5443,162,2.90000000
CN1308100000000,13,081,"Crisp County, GA",Dec-21,9527,9112,415,4.40000000
CN1308300000000,13,083,"Dade County, GA",Dec-21,8054,7866,188,2.30000000
CN1308500000000,13,085,"Dawson County, GA",Dec-21,13345,13041,304,2.30000000
CN1308700000000,13,087,"Decatur County, GA",Dec-21,11331,11000,331,2.90000000
CN1308900000000,13,089,"DeKalb County, GA",Dec-21,404903,392030,12873,3.20000000
CN1309100000000,13,091,"Dodge County, GA",Dec-21,7005,6776,229,3.30000000
CN1309300000000,13,093,"Dooly County, GA",Dec-21,4777,4584,193,4.00000000
CN1309500000000,13,095,"Dougherty County, GA",Dec-21,37273,35700,1573,4.20000000
CN1309700000000,13,097,"Douglas County, GA",Dec-21,74912,72587,2325,3.10000000
CN1309900000000,13,099,"Early County, GA",Dec-21,4264,4102,162,3.80000000
CN1310100000000,13,101,"Echols County, GA",Dec-21,1883,1838,45,2.40000000
CN1310300000000,13,103,"Effingham County, GA",Dec-21,33923,33131,792,2.30000000
CN1310500000000,13,105,"Elbert County, GA",Dec-21,7668,7398,270,3.50000000
CN1310700000000,13,107,"Emanuel County, GA",Dec-21,8661,8311,350,4.00000000
CN1310900000000,13,109,"Evans County, GA",Dec-21,5196,5062,134,2.60000000
CN1311100000000,13,111,"Fannin County, GA",Dec-21,11936,11644,292,2.40000000
CN1311300000000,13,113,"Fayette County, GA",Dec-21,59329,57950,1379,2.30000000
CN1311500000000,13,115,"Floyd County, GA",Dec-21,44001,42802,1199,2.70000000
CN1311700000000,13,117,"Forsyth County, GA",Dec-21,129712,126993,2719,2.10000000
CN1311900000000,13,119,"Franklin County, GA",Dec-21,10075,9793,282,2.80000000
CN1312100000000,13,121,"Fulton County, GA",Dec-21,574981,556536,18445,3.20000000
CN1312300000000,13,123,"Gilmer County, GA",Dec-21,12339,12006,333,2.70000000
CN1312500000000,13,125,"Glascock County, GA",Dec-21,1265,1234,31,2.50000000
CN1312700000000,13,127,"Glynn County, GA",Dec-21,39256,38165,1091,2.80000000
CN1312900000000,13,129,"Gordon County, GA",Dec-21,28880,28183,697,2.40000000
CN1313100000000,13,131,"Grady County, GA",Dec-21,10983,10708,275,2.50000000
CN1313300000000,13,133,"Greene County, GA",Dec-21,7160,6949,211,2.90000000
CN1313500000000,13,135,"Gwinnett County, GA",Dec-21,499609,486782,12827,2.60000000
CN1313700000000,13,137,"Habersham County, GA",Dec-21,18692,18179,513,2.70000000
CN1313900000000,13,139,"Hall County, GA",Dec-21,106540,104251,2289,2.10000000
CN1314100000000,13,141,"Hancock County, GA",Dec-21,2480,2362,118,4.80000000
CN1314300000000,13,143,"Haralson County, GA",Dec-21,12952,12598,354,2.70000000
CN1314500000000,13,145,"Harris County, GA",Dec-21,17079,16663,416,2.40000000
CN1314700000000,13,147,"Hart County, GA",Dec-21,11751,11400,351,3.00000000
CN1314900000000,13,149,"Heard County, GA",Dec-21,5310,5154,156,2.90000000
CN1315100000000,13,151,"Henry County, GA",Dec-21,120433,116799,3634,3.00000000
CN1315300000000,13,153,"Houston County, GA",Dec-21,71866,69947,1919,2.70000000
CN1315500000000,13,155,"Irwin County, GA",Dec-21,3524,3401,123,3.50000000
CN1315700000000,13,157,"Jackson County, GA",Dec-21,44760,43898,862,1.90000000
CN1315900000000,13,159,"Jasper County, GA",Dec-21,7164,6992,172,2.40000000
CN1316100000000,13,161,"Jeff Davis County, GA",Dec-21,6027,5841,186,3.10000000
CN1316300000000,13,163,"Jefferson County, GA",Dec-21,6972,6742,230,3.30000000
CN1316500000000,13,165,"Jenkins County, GA",Dec-21,3158,3041,117,3.70000000
CN1316700000000,13,167,"Johnson County, GA",Dec-21,4126,4015,111,2.70000000
CN1316900000000,13,169,"Jones County, GA",Dec-21,13888,13545,343,2.50000000
CN1317100000000,13,171,"Lamar County, GA",Dec-21,8348,8092,256,3.10000000
CN1317300000000,13,173,"Lanier County, GA",Dec-21,3837,3722,115,3.00000000
CN1317500000000,13,175,"Laurens County, GA",Dec-21,19684,19058,626,3.20000000
CN1317700000000,13,177,"Lee County, GA",Dec-21,15320,14946,374,2.40000000
CN1317900000000,13,179,"Liberty County, GA",Dec-21,26421,25625,796,3.00000000
CN1318100000000,13,181,"Lincoln County, GA",Dec-21,3528,3408,120,3.40000000
CN1318300000000,13,183,"Long County, GA",Dec-21,8503,8276,227,2.70000000
CN1318500000000,13,185,"Lowndes County, GA",Dec-21,51549,50033,1516,2.90000000
CN1318700000000,13,187,"Lumpkin County, GA",Dec-21,17594,17194,400,2.30000000
CN1318900000000,13,189,"McDuffie County, GA",Dec-21,8434,8124,310,3.70000000
CN1319100000000,13,191,"McIntosh County, GA",Dec-21,6129,5950,179,2.90000000
CN1319300000000,13,193,"Macon County, GA",Dec-21,4549,4383,166,3.60000000
CN1319500000000,13,195,"Madison County, GA",Dec-21,13888,13545,343,2.50000000
CN1319700000000,13,197,"Marion County, GA",Dec-21,3280,3184,96,2.90000000
CN1319900000000,13,199,"Meriwether County, GA",Dec-21,8942,8612,330,3.70000000
CN1320100000000,13,201,"Miller County, GA",Dec-21,2740,2673,67,2.40000000
CN1320500000000,13,205,"Mitchell County, GA",Dec-21,8028,7740,288,3.60000000
CN1320700000000,13,207,"Monroe County, GA",Dec-21,13329,13005,324,2.40000000
CN1320900000000,13,209,"Montgomery County, GA",Dec-21,3779,3657,122,3.20000000
CN1321100000000,13,211,"Morgan County, GA",Dec-21,9619,9382,237,2.50000000
CN1321300000000,13,213,"Murray County, GA",Dec-21,15534,15042,492,3.20000000
CN1321500000000,13,215,"Muscogee County, GA",Dec-21,76839,73870,2969,3.90000000
CN1321700000000,13,217,"Newton County, GA",Dec-21,54056,52363,1693,3.10000000
CN1321900000000,13,219,"Oconee County, GA",Dec-21,20786,20387,399,1.90000000
CN1322100000000,13,221,"Oglethorpe County, GA",Dec-21,7173,7003,170,2.40000000
CN1322300000000,13,223,"Paulding County, GA",Dec-21,91083,88925,2158,2.40000000
CN1322500000000,13,225,"Peach County, GA",Dec-21,11968,11581,387,3.20000000
CN1322700000000,13,227,"Pickens County, GA",Dec-21,15858,15487,371,2.30000000
CN1322900000000,13,229,"Pierce County, GA",Dec-21,8576,8358,218,2.50000000
CN1323100000000,13,231,"Pike County, GA",Dec-21,9144,8927,217,2.40000000
CN1323300000000,13,233,"Polk County, GA",Dec-21,18460,17957,503,2.70000000
CN1323500000000,13,235,"Pulaski County, GA",Dec-21,4040,3926,114,2.80000000
CN1323700000000,13,237,"Putnam County, GA",Dec-21,8772,8492,280,3.20000000
CN1323900000000,13,239,"Quitman County, GA",Dec-21,751,720,31,4.10000000
CN1324100000000,13,241,"Rabun County, GA",Dec-21,7475,7260,215,2.90000000
CN1324300000000,13,243,"Randolph County, GA",Dec-21,2364,2269,95,4.00000000
CN1324500000000,13,245,"Richmond County, GA",Dec-21,83411,80139,3272,3.90000000
CN1324700000000,13,247,"Rockdale County, GA",Dec-21,45100,43616,1484,3.30000000
CN1324900000000,13,249,"Schley County, GA",Dec-21,2131,2059,72,3.40000000
CN1325100000000,13,251,"Screven County, GA",Dec-21,5008,4800,208,4.20000000
CN1325300000000,13,253,"Seminole County, GA",Dec-21,2933,2843,90,3.10000000
CN1325500000000,13,255,"Spalding County, GA",Dec-21,29257,28323,934,3.20000000
CN1325700000000,13,257,"Stephens County, GA",Dec-21,10446,10107,339,3.20000000
CN1325900000000,13,259,"Stewart County, GA",Dec-21,2587,2509,78,3.00000000
CN1326100000000,13,261,"Sumter County, GA",Dec-21,12124,11655,469,3.90000000
CN1326300000000,13,263,"Talbot County, GA",Dec-21,2786,2697,89,3.20000000
CN1326500000000,13,265,"Taliaferro County, GA",Dec-21,526,507,19,3.60000000
CN1326700000000,13,267,"Tattnall County, GA",Dec-21,9652,9407,245,2.50000000
CN1326900000000,13,269,"Taylor County, GA",Dec-21,2823,2706,117,4.10000000
CN1327100000000,13,271,"Telfair County, GA",Dec-21,3645,3446,199,5.50000000
CN1327300000000,13,273,"Terrell County, GA",Dec-21,3561,3397,164,4.60000000
CN1327500000000,13,275,"Thomas County, GA",Dec-21,17370,16816,554,3.20000000
CN1327700000000,13,277,"Tift County, GA",Dec-21,21379,20859,520,2.40000000
CN1327900000000,13,279,"Toombs County, GA",Dec-21,11888,11485,403,3.40000000
CN1328100000000,13,281,"Towns County, GA",Dec-21,4041,3892,149,3.70000000
CN1328300000000,13,283,"Treutlen County, GA",Dec-21,2575,2494,81,3.10000000
CN1328500000000,13,285,"Troup County, GA",Dec-21,37567,36476,1091,2.90000000
CN1328700000000,13,287,"Turner County, GA",Dec-21,3241,3106,135,4.20000000
CN1328900000000,13,289,"Twiggs County, GA",Dec-21,2847,2736,111,3.90000000
CN1329100000000,13,291,"Union County, GA",Dec-21,11161,10886,275,2.50000000
CN1329300000000,13,293,"Upson County, GA",Dec-21,11715,11387,328,2.80000000
CN1329500000000,13,295,"Walker County, GA",Dec-21,31398,30591,807,2.60000000
CN1329700000000,13,297,"Walton County, GA",Dec-21,47808,46620,1188,2.50000000
CN1329900000000,13,299,"Ware County, GA",Dec-21,15284,14866,418,2.70000000
CN1330100000000,13,301,"Warren County, GA",Dec-21,2669,2584,85,3.20000000
CN1330300000000,13,303,"Washington County, GA",Dec-21,6704,6448,256,3.80000000
CN1330500000000,13,305,"Wayne County, GA",Dec-21,11908,11552,356,3.00000000
CN1330700000000,13,307,"Webster County, GA",Dec-21,990,959,31,3.10000000
CN1330900000000,13,309,"Wheeler County, GA",Dec-21,1616,1539,77,4.80000000
CN1331100000000,13,311,"White County, GA",Dec-21,16625,16279,346,2.10000000
CN1331300000000,13,313,"Whitfield County, GA",Dec-21,43618,42360,1258,2.90000000
CN1331500000000,13,315,"Wilcox County, GA",Dec-21,2726,2638,88,3.20000000
CN1331700000000,13,317,"Wilkes County, GA",Dec-21,3599,3470,129,3.60000000
CN1331900000000,13,319,"Wilkinson County, GA",Dec-21,3614,3501,113,3.10000000
CN1332100000000,13,321,"Worth County, GA",Dec-21,8917,8652,265,3.00000000
CN1500100000000,15,001,"Hawaii County, HI",Dec-21,94270,90323,3947,4.20000000
CN1500300000000,15,003,"Honolulu County/city, HI",Dec-21,459370,440467,18903,4.10000000
CN1500700000000,15,007,"Kauai County, HI",Dec-21,36477,34439,2038,5.60000000
CN1500900000000,15,009,"Maui County, HI",Dec-21,88094,83466,4628,5.30000000
CN1600100000000,16,001,"Ada County, ID",Dec-21,271807,265567,6240,2.30000000
CN1600300000000,16,003,"Adams County, ID",Dec-21,1731,1631,100,5.80000000
CN1600500000000,16,005,"Bannock County, ID",Dec-21,43744,42651,1093,2.50000000
CN1600700000000,16,007,"Bear Lake County, ID",Dec-21,3154,3070,84,2.70000000
CN1600900000000,16,009,"Benewah County, ID",Dec-21,3956,3790,166,4.20000000
CN1601100000000,16,011,"Bingham County, ID",Dec-21,23838,23243,595,2.50000000
CN1601300000000,16,013,"Blaine County, ID",Dec-21,12822,12485,337,2.60000000
CN1601500000000,16,015,"Boise County, ID",Dec-21,3765,3610,155,4.10000000
CN1601700000000,16,017,"Bonner County, ID",Dec-21,21334,20565,769,3.60000000
CN1601900000000,16,019,"Bonneville County, ID",Dec-21,61166,59871,1295,2.10000000
CN1602100000000,16,021,"Boundary County, ID",Dec-21,5366,5183,183,3.40000000
CN1602300000000,16,023,"Butte County, ID",Dec-21,1444,1401,43,3.00000000
CN1602500000000,16,025,"Camas County, ID",Dec-21,689,667,22,3.20000000
CN1602700000000,16,027,"Canyon County, ID",Dec-21,111023,107884,3139,2.80000000
CN1602900000000,16,029,"Caribou County, ID",Dec-21,4062,3947,115,2.80000000
CN1603100000000,16,031,"Cassia County, ID",Dec-21,12425,12136,289,2.30000000
CN1603300000000,16,033,"Clark County, ID",Dec-21,368,355,13,3.50000000
CN1603500000000,16,035,"Clearwater County, ID",Dec-21,2922,2773,149,5.10000000
CN1603700000000,16,037,"Custer County, ID",Dec-21,2031,1942,89,4.40000000
CN1603900000000,16,039,"Elmore County, ID",Dec-21,11817,11491,326,2.80000000
CN1604100000000,16,041,"Franklin County, ID",Dec-21,7507,7359,148,2.00000000
CN1604300000000,16,043,"Fremont County, ID",Dec-21,8295,8109,186,2.20000000
CN1604500000000,16,045,"Gem County, ID",Dec-21,8799,8540,259,2.90000000
CN1604700000000,16,047,"Gooding County, ID",Dec-21,8373,8166,207,2.50000000
CN1604900000000,16,049,"Idaho County, ID",Dec-21,6529,6299,230,3.50000000
CN1605100000000,16,051,"Jefferson County, ID",Dec-21,14752,14461,291,2.00000000
CN1605300000000,16,053,"Jerome County, ID",Dec-21,12391,12062,329,2.70000000
CN1605500000000,16,055,"Kootenai County, ID",Dec-21,82918,80143,2775,3.30000000
CN1605700000000,16,057,"Latah County, ID",Dec-21,19940,19470,470,2.40000000
CN1605900000000,16,059,"Lemhi County, ID",Dec-21,3509,3343,166,4.70000000
CN1606100000000,16,061,"Lewis County, ID",Dec-21,1566,1501,65,4.20000000
CN1606300000000,16,063,"Lincoln County, ID",Dec-21,2660,2569,91,3.40000000
CN1606500000000,16,065,"Madison County, ID",Dec-21,23871,23499,372,1.60000000
CN1606700000000,16,067,"Minidoka County, ID",Dec-21,11609,11313,296,2.50000000
CN1606900000000,16,069,"Nez Perce County, ID",Dec-21,20942,20418,524,2.50000000
CN1607100000000,16,071,"Oneida County, ID",Dec-21,2626,2572,54,2.10000000
CN1607300000000,16,073,"Owyhee County, ID",Dec-21,5438,5260,178,3.30000000
CN1607500000000,16,075,"Payette County, ID",Dec-21,12026,11666,360,3.00000000
CN1607700000000,16,077,"Power County, ID",Dec-21,3920,3788,132,3.40000000
CN1607900000000,16,079,"Shoshone County, ID",Dec-21,5450,5173,277,5.10000000
CN1608100000000,16,081,"Teton County, ID",Dec-21,6853,6716,137,2.00000000
CN1608300000000,16,083,"Twin Falls County, ID",Dec-21,42333,41237,1096,2.60000000
CN1608500000000,16,085,"Valley County, ID",Dec-21,5519,5287,232,4.20000000
CN1608700000000,16,087,"Washington County, ID",Dec-21,4776,4625,151,3.20000000
CN1700100000000,17,001,"Adams County, IL",Dec-21,30196,29324,872,2.90000000
CN1700300000000,17,003,"Alexander County, IL",Dec-21,1814,1696,118,6.50000000
CN1700500000000,17,005,"Bond County, IL",Dec-21,7279,7027,252,3.50000000
CN1700700000000,17,007,"Boone County, IL",Dec-21,24925,23212,1713,6.90000000
CN1700900000000,17,009,"Brown County, IL",Dec-21,3007,2944,63,2.10000000
CN1701100000000,17,011,"Bureau County, IL",Dec-21,15644,15002,642,4.10000000
CN1701300000000,17,013,"Calhoun County, IL",Dec-21,2121,2044,77,3.60000000
CN1701500000000,17,015,"Carroll County, IL",Dec-21,7244,6988,256,3.50000000
CN1701700000000,17,017,"Cass County, IL",Dec-21,5459,5240,219,4.00000000
CN1701900000000,17,019,"Champaign County, IL",Dec-21,109782,105976,3806,3.50000000
CN1702100000000,17,021,"Christian County, IL",Dec-21,13114,12562,552,4.20000000
CN1702300000000,17,023,"Clark County, IL",Dec-21,6974,6701,273,3.90000000
CN1702500000000,17,025,"Clay County, IL",Dec-21,5667,5406,261,4.60000000
CN1702700000000,17,027,"Clinton County, IL",Dec-21,19494,18993,501,2.60000000
CN1702900000000,17,029,"Coles County, IL",Dec-21,22551,21686,865,3.80000000
CN1703100000000,17,031,"Cook County, IL",Dec-21,2639936,2517151,122785,4.70000000
CN1703300000000,17,033,"Crawford County, IL",Dec-21,8577,8231,346,4.00000000
CN1703500000000,17,035,"Cumberland County, IL",Dec-21,5860,5675,185,3.20000000
CN1703700000000,17,037,"DeKalb County, IL",Dec-21,53031,50769,2262,4.30000000
CN1703900000000,17,039,"De Witt County, IL",Dec-21,7079,6805,274,3.90000000
CN1704100000000,17,041,"Douglas County, IL",Dec-21,10019,9739,280,2.80000000
CN1704300000000,17,043,"DuPage County, IL",Dec-21,512491,498027,14464,2.80000000
CN1704500000000,17,045,"Edgar County, IL",Dec-21,8765,8492,273,3.10000000
CN1704700000000,17,047,"Edwards County, IL",Dec-21,2464,2373,91,3.70000000
CN1704900000000,17,049,"Effingham County, IL",Dec-21,19444,18893,551,2.80000000
CN1705100000000,17,051,"Fayette County, IL",Dec-21,9536,9157,379,4.00000000
CN1705300000000,17,053,"Ford County, IL",Dec-21,6148,5943,205,3.30000000
CN1705500000000,17,055,"Franklin County, IL",Dec-21,15512,14710,802,5.20000000
CN1705700000000,17,057,"Fulton County, IL",Dec-21,14072,13418,654,4.60000000
CN1705900000000,17,059,"Gallatin County, IL",Dec-21,1971,1882,89,4.50000000
CN1706100000000,17,061,"Greene County, IL",Dec-21,5647,5442,205,3.60000000
CN1706300000000,17,063,"Grundy County, IL",Dec-21,25695,24777,918,3.60000000
CN1706500000000,17,065,"Hamilton County, IL",Dec-21,4119,3987,132,3.20000000
CN1706700000000,17,067,"Hancock County, IL",Dec-21,7897,7641,256,3.20000000
CN1706900000000,17,069,"Hardin County, IL",Dec-21,1340,1267,73,5.40000000
CN1707100000000,17,071,"Henderson County, IL",Dec-21,3439,3327,112,3.30000000
CN1707300000000,17,073,"Henry County, IL",Dec-21,23388,22514,874,3.70000000
CN1707500000000,17,075,"Iroquois County, IL",Dec-21,12620,12115,505,4.00000000
CN1707700000000,17,077,"Jackson County, IL",Dec-21,27467,26381,1086,4.00000000
CN1707900000000,17,079,"Jasper County, IL",Dec-21,4547,4403,144,3.20000000
CN1708100000000,17,081,"Jefferson County, IL",Dec-21,16205,15437,768,4.70000000
CN1708300000000,17,083,"Jersey County, IL",Dec-21,10424,10080,344,3.30000000
CN1708500000000,17,085,"Jo Daviess County, IL",Dec-21,10199,9845,354,3.50000000
CN1708700000000,17,087,"Johnson County, IL",Dec-21,4005,3806,199,5.00000000
CN1708900000000,17,089,"Kane County, IL",Dec-21,261205,249044,12161,4.70000000
CN1709100000000,17,091,"Kankakee County, IL",Dec-21,51748,48985,2763,5.30000000
CN1709300000000,17,093,"Kendall County, IL",Dec-21,71361,69218,2143,3.00000000
CN1709500000000,17,095,"Knox County, IL",Dec-21,19704,18676,1028,5.20000000
CN1709700000000,17,097,"Lake County, IL",Dec-21,364462,349038,15424,4.20000000
CN1709900000000,17,099,"LaSalle County, IL",Dec-21,51873,49427,2446,4.70000000
CN1710100000000,17,101,"Lawrence County, IL",Dec-21,5533,5256,277,5.00000000
CN1710300000000,17,103,"Lee County, IL",Dec-21,16456,15855,601,3.70000000
CN1710500000000,17,105,"Livingston County, IL",Dec-21,15050,14501,549,3.60000000
CN1710700000000,17,107,"Logan County, IL",Dec-21,11546,11127,419,3.60000000
CN1710900000000,17,109,"McDonough County, IL",Dec-21,12777,12334,443,3.50000000
CN1711100000000,17,111,"McHenry County, IL",Dec-21,167125,161959,5166,3.10000000
CN1711300000000,17,113,"McLean County, IL",Dec-21,86267,83400,2867,3.30000000
CN1711500000000,17,115,"Macon County, IL",Dec-21,46032,43247,2785,6.10000000
CN1711700000000,17,117,"Macoupin County, IL",Dec-21,21660,20911,749,3.50000000
CN1711900000000,17,119,"Madison County, IL",Dec-21,129515,124931,4584,3.50000000
CN1712100000000,17,121,"Marion County, IL",Dec-21,16539,15783,756,4.60000000
CN1712300000000,17,123,"Marshall County, IL",Dec-21,4967,4745,222,4.50000000
CN1712500000000,17,125,"Mason County, IL",Dec-21,5668,5415,253,4.50000000
CN1712700000000,17,127,"Massac County, IL",Dec-21,5235,5030,205,3.90000000
CN1712900000000,17,129,"Menard County, IL",Dec-21,6137,5939,198,3.20000000
CN1713100000000,17,131,"Mercer County, IL",Dec-21,7429,7149,280,3.80000000
CN1713300000000,17,133,"Monroe County, IL",Dec-21,18342,17933,409,2.20000000
CN1713500000000,17,135,"Montgomery County, IL",Dec-21,10859,10382,477,4.40000000
CN1713700000000,17,137,"Morgan County, IL",Dec-21,15323,14721,602,3.90000000
CN1713900000000,17,139,"Moultrie County, IL",Dec-21,7261,7063,198,2.70000000
CN1714100000000,17,141,"Ogle County, IL",Dec-21,23032,21929,1103,4.80000000
CN1714300000000,17,143,"Peoria County, IL",Dec-21,81574,77002,4572,5.60000000
CN1714500000000,17,145,"Perry County, IL",Dec-21,7830,7484,346,4.40000000
CN1714700000000,17,147,"Piatt County, IL",Dec-21,8526,8270,256,3.00000000
CN1714900000000,17,149,"Pike County, IL",Dec-21,6511,6269,242,3.70000000
CN1715100000000,17,151,"Pope County, IL",Dec-21,1634,1568,66,4.00000000
CN1715300000000,17,153,"Pulaski County, IL",Dec-21,1652,1535,117,7.10000000
CN1715500000000,17,155,"Putnam County, IL",Dec-21,2831,2722,109,3.90000000
CN1715700000000,17,157,"Randolph County, IL",Dec-21,13361,12945,416,3.10000000
CN1715900000000,17,159,"Richland County, IL",Dec-21,6944,6718,226,3.30000000
CN1716100000000,17,161,"Rock Island County, IL",Dec-21,67332,64540,2792,4.10000000
CN1716300000000,17,163,"St. Clair County, IL",Dec-21,122251,116753,5498,4.50000000
CN1716500000000,17,165,"Saline County, IL",Dec-21,9093,8631,462,5.10000000
CN1716700000000,17,167,"Sangamon County, IL",Dec-21,97770,93764,4006,4.10000000
CN1716900000000,17,169,"Schuyler County, IL",Dec-21,3041,2930,111,3.70000000
CN1717100000000,17,171,"Scott County, IL",Dec-21,2230,2112,118,5.30000000
CN1717300000000,17,173,"Shelby County, IL",Dec-21,9993,9665,328,3.30000000
CN1717500000000,17,175,"Stark County, IL",Dec-21,2299,2187,112,4.90000000
CN1717700000000,17,177,"Stephenson County, IL",Dec-21,20196,19306,890,4.40000000
CN1717900000000,17,179,"Tazewell County, IL",Dec-21,60626,58338,2288,3.80000000
CN1718100000000,17,181,"Union County, IL",Dec-21,7097,6764,333,4.70000000
CN1718300000000,17,183,"Vermilion County, IL",Dec-21,31098,29548,1550,5.00000000
CN1718500000000,17,185,"Wabash County, IL",Dec-21,5349,5170,179,3.30000000
CN1718700000000,17,187,"Warren County, IL",Dec-21,7456,7200,256,3.40000000
CN1718900000000,17,189,"Washington County, IL",Dec-21,9385,9170,215,2.30000000
CN1719100000000,17,191,"Wayne County, IL",Dec-21,6726,6490,236,3.50000000
CN1719300000000,17,193,"White County, IL",Dec-21,5824,5602,222,3.80000000
CN1719500000000,17,195,"Whiteside County, IL",Dec-21,27001,26032,969,3.60000000
CN1719700000000,17,197,"Will County, IL",Dec-21,363257,349370,13887,3.80000000
CN1719900000000,17,199,"Williamson County, IL",Dec-21,31545,30229,1316,4.20000000
CN1720100000000,17,201,"Winnebago County, IL",Dec-21,133415,124458,8957,6.70000000
CN1720300000000,17,203,"Woodford County, IL",Dec-21,17781,17243,538,3.00000000
CN1800100000000,18,001,"Adams County, IN",Dec-21,16555,16400,155,0.90000000
CN1800300000000,18,003,"Allen County, IN",Dec-21,182098,179416,2682,1.50000000
CN1800500000000,18,005,"Bartholomew County, IN",Dec-21,42442,41947,495,1.20000000
CN1800700000000,18,007,"Benton County, IN",Dec-21,4309,4262,47,1.10000000
CN1800900000000,18,009,"Blackford County, IN",Dec-21,4571,4499,72,1.60000000
CN1801100000000,18,011,"Boone County, IN",Dec-21,37118,36809,309,0.80000000
CN1801300000000,18,013,"Brown County, IN",Dec-21,7606,7507,99,1.30000000
CN1801500000000,18,015,"Carroll County, IN",Dec-21,9698,9568,130,1.30000000
CN1801700000000,18,017,"Cass County, IN",Dec-21,16728,16446,282,1.70000000
CN1801900000000,18,019,"Clark County, IN",Dec-21,61109,60267,842,1.40000000
CN1802100000000,18,021,"Clay County, IN",Dec-21,11394,11228,166,1.50000000
CN1802300000000,18,023,"Clinton County, IN",Dec-21,16639,16448,191,1.10000000
CN1802500000000,18,025,"Crawford County, IN",Dec-21,4642,4567,75,1.60000000
CN1802700000000,18,027,"Daviess County, IN",Dec-21,16250,16085,165,1.00000000
CN1802900000000,18,029,"Dearborn County, IN",Dec-21,24774,24458,316,1.30000000
CN1803100000000,18,031,"Decatur County, IN",Dec-21,14613,14431,182,1.20000000
CN1803300000000,18,033,"DeKalb County, IN",Dec-21,21687,21453,234,1.10000000
CN1803500000000,18,035,"Delaware County, IN",Dec-21,51484,50629,855,1.70000000
CN1803700000000,18,037,"Dubois County, IN",Dec-21,21661,21473,188,0.90000000
CN1803900000000,18,039,"Elkhart County, IN",Dec-21,115874,114734,1140,1.00000000
CN1804100000000,18,041,"Fayette County, IN",Dec-21,8144,7963,181,2.20000000
CN1804300000000,18,043,"Floyd County, IN",Dec-21,41168,40698,470,1.10000000
CN1804500000000,18,045,"Fountain County, IN",Dec-21,7525,7441,84,1.10000000
CN1804700000000,18,047,"Franklin County, IN",Dec-21,11066,10941,125,1.10000000
CN1804900000000,18,049,"Fulton County, IN",Dec-21,9261,9129,132,1.40000000
CN1805100000000,18,051,"Gibson County, IN",Dec-21,18725,18524,201,1.10000000
CN1805300000000,18,053,"Grant County, IN",Dec-21,30822,30316,506,1.60000000
CN1805500000000,18,055,"Greene County, IN",Dec-21,13366,13167,199,1.50000000
CN1805700000000,18,057,"Hamilton County, IN",Dec-21,189110,187465,1645,0.90000000
CN1805900000000,18,059,"Hancock County, IN",Dec-21,41374,40924,450,1.10000000
CN1806100000000,18,061,"Harrison County, IN",Dec-21,19946,19725,221,1.10000000
CN1806300000000,18,063,"Hendricks County, IN",Dec-21,91970,91046,924,1.00000000
CN1806500000000,18,065,"Henry County, IN",Dec-21,21413,21095,318,1.50000000
CN1806700000000,18,067,"Howard County, IN",Dec-21,33030,32081,949,2.90000000
CN1806900000000,18,069,"Huntington County, IN",Dec-21,17570,17370,200,1.10000000
CN1807100000000,18,071,"Jackson County, IN",Dec-21,22869,22589,280,1.20000000
CN1807300000000,18,073,"Jasper County, IN",Dec-21,15332,15100,232,1.50000000
CN1807500000000,18,075,"Jay County, IN",Dec-21,8638,8533,105,1.20000000
CN1807700000000,18,077,"Jefferson County, IN",Dec-21,14688,14503,185,1.30000000
CN1807900000000,18,079,"Jennings County, IN",Dec-21,13121,12911,210,1.60000000
CN1808100000000,18,081,"Johnson County, IN",Dec-21,84134,83254,880,1.00000000
CN1808300000000,18,083,"Knox County, IN",Dec-21,18056,17847,209,1.20000000
CN1808500000000,18,085,"Kosciusko County, IN",Dec-21,39675,39229,446,1.10000000
CN1808700000000,18,087,"LaGrange County, IN",Dec-21,20509,20347,162,0.80000000
CN1808900000000,18,089,"Lake County, IN",Dec-21,218143,212015,6128,2.80000000
CN1809100000000,18,091,"LaPorte County, IN",Dec-21,45482,44498,984,2.20000000
CN1809300000000,18,093,"Lawrence County, IN",Dec-21,20444,20135,309,1.50000000
CN1809500000000,18,095,"Madison County, IN",Dec-21,58164,57189,975,1.70000000
CN1809700000000,18,097,"Marion County, IN",Dec-21,491322,482103,9219,1.90000000
CN1809900000000,18,099,"Marshall County, IN",Dec-21,22083,21851,232,1.10000000
CN1810100000000,18,101,"Martin County, IN",Dec-21,5313,5257,56,1.10000000
CN1810300000000,18,103,"Miami County, IN",Dec-21,14184,13901,283,2.00000000
CN1810500000000,18,105,"Monroe County, IN",Dec-21,70106,69347,759,1.10000000
CN1810700000000,18,107,"Montgomery County, IN",Dec-21,18066,17860,206,1.10000000
CN1810900000000,18,109,"Morgan County, IN",Dec-21,36173,35724,449,1.20000000
CN1811100000000,18,111,"Newton County, IN",Dec-21,6517,6407,110,1.70000000
CN1811300000000,18,113,"Noble County, IN",Dec-21,21506,21221,285,1.30000000
CN1811500000000,18,115,"Ohio County, IN",Dec-21,3063,3032,31,1.00000000
CN1811700000000,18,117,"Orange County, IN",Dec-21,8041,7897,144,1.80000000
CN1811900000000,18,119,"Owen County, IN",Dec-21,9276,9136,140,1.50000000
CN1812100000000,18,121,"Parke County, IN",Dec-21,6806,6720,86,1.30000000
CN1812300000000,18,123,"Perry County, IN",Dec-21,8465,8349,116,1.40000000
CN1812500000000,18,125,"Pike County, IN",Dec-21,5605,5519,86,1.50000000
CN1812700000000,18,127,"Porter County, IN",Dec-21,82357,81029,1328,1.60000000
CN1812900000000,18,129,"Posey County, IN",Dec-21,12717,12579,138,1.10000000
CN1813100000000,18,131,"Pulaski County, IN",Dec-21,6238,6157,81,1.30000000
CN1813300000000,18,133,"Putnam County, IN",Dec-21,16320,16135,185,1.10000000
CN1813500000000,18,135,"Randolph County, IN",Dec-21,12145,12007,138,1.10000000
CN1813700000000,18,137,"Ripley County, IN",Dec-21,13196,13041,155,1.20000000
CN1813900000000,18,139,"Rush County, IN",Dec-21,8755,8656,99,1.10000000
CN1814100000000,18,141,"St. Joseph County, IN",Dec-21,128499,126261,2238,1.70000000
CN1814300000000,18,143,"Scott County, IN",Dec-21,10257,10083,174,1.70000000
CN1814500000000,18,145,"Shelby County, IN",Dec-21,23009,22715,294,1.30000000
CN1814700000000,18,147,"Spencer County, IN",Dec-21,9861,9741,120,1.20000000
CN1814900000000,18,149,"Starke County, IN",Dec-21,9257,9087,170,1.80000000
CN1815100000000,18,151,"Steuben County, IN",Dec-21,19403,19208,195,1.00000000
CN1815300000000,18,153,"Sullivan County, IN",Dec-21,7810,7671,139,1.80000000
CN1815500000000,18,155,"Switzerland County, IN",Dec-21,4558,4495,63,1.40000000
CN1815700000000,18,157,"Tippecanoe County, IN",Dec-21,94217,92971,1246,1.30000000
CN1815900000000,18,159,"Tipton County, IN",Dec-21,8778,8662,116,1.30000000
CN1816100000000,18,161,"Union County, IN",Dec-21,3429,3397,32,0.90000000
CN1816300000000,18,163,"Vanderburgh County, IN",Dec-21,89791,88394,1397,1.60000000
CN1816500000000,18,165,"Vermillion County, IN",Dec-21,6449,6329,120,1.90000000
CN1816700000000,18,167,"Vigo County, IN",Dec-21,44924,44070,854,1.90000000
CN1816900000000,18,169,"Wabash County, IN",Dec-21,14118,13941,177,1.30000000
CN1817100000000,18,171,"Warren County, IN",Dec-21,3978,3935,43,1.10000000
CN1817300000000,18,173,"Warrick County, IN",Dec-21,31486,31142,344,1.10000000
CN1817500000000,18,175,"Washington County, IN",Dec-21,13500,13330,170,1.30000000
CN1817700000000,18,177,"Wayne County, IN",Dec-21,28835,28373,462,1.60000000
CN1817900000000,18,179,"Wells County, IN",Dec-21,13855,13717,138,1.00000000
CN1818100000000,18,181,"White County, IN",Dec-21,12909,12758,151,1.20000000
CN1818300000000,18,183,"Whitley County, IN",Dec-21,17200,17024,176,1.00000000
CN1900100000000,19,001,"Adair County, IA",Dec-21,4405,4283,122,2.80000000
CN1900300000000,19,003,"Adams County, IA",Dec-21,2050,2003,47,2.30000000
CN1900500000000,19,005,"Allamakee County, IA",Dec-21,7085,6744,341,4.80000000
CN1900700000000,19,007,"Appanoose County, IA",Dec-21,5973,5732,241,4.00000000
CN1900900000000,19,009,"Audubon County, IA",Dec-21,3077,2995,82,2.70000000
CN1901100000000,19,011,"Benton County, IA",Dec-21,12862,12381,481,3.70000000
CN1901300000000,19,013,"Black Hawk County, IA",Dec-21,67565,64905,2660,3.90000000
CN1901500000000,19,015,"Boone County, IA",Dec-21,14562,14133,429,2.90000000
CN1901700000000,19,017,"Bremer County, IA",Dec-21,13968,13560,408,2.90000000
CN1901900000000,19,019,"Buchanan County, IA",Dec-21,11123,10736,387,3.50000000
CN1902100000000,19,021,"Buena Vista County, IA",Dec-21,11990,11711,279,2.30000000
CN1902300000000,19,023,"Butler County, IA",Dec-21,8059,7750,309,3.80000000
CN1902500000000,19,025,"Calhoun County, IA",Dec-21,4053,3917,136,3.40000000
CN1902700000000,19,027,"Carroll County, IA",Dec-21,10639,10363,276,2.60000000
CN1902900000000,19,029,"Cass County, IA",Dec-21,6756,6533,223,3.30000000
CN1903100000000,19,031,"Cedar County, IA",Dec-21,10470,10147,323,3.10000000
CN1903300000000,19,033,"Cerro Gordo County, IA",Dec-21,22232,21400,832,3.70000000
CN1903500000000,19,035,"Cherokee County, IA",Dec-21,6061,5902,159,2.60000000
CN1903700000000,19,037,"Chickasaw County, IA",Dec-21,6466,6244,222,3.40000000
CN1903900000000,19,039,"Clarke County, IA",Dec-21,4839,4673,166,3.40000000
CN1904100000000,19,041,"Clay County, IA",Dec-21,8535,8273,262,3.10000000
CN1904300000000,19,043,"Clayton County, IA",Dec-21,9577,9074,503,5.30000000
CN1904500000000,19,045,"Clinton County, IA",Dec-21,21952,20965,987,4.50000000
CN1904700000000,19,047,"Crawford County, IA",Dec-21,8138,7651,487,6.00000000
CN1904900000000,19,049,"Dallas County, IA",Dec-21,52144,50892,1252,2.40000000
CN1905100000000,19,051,"Davis County, IA",Dec-21,4204,4076,128,3.00000000
CN1905300000000,19,053,"Decatur County, IA",Dec-21,4405,4283,122,2.80000000
CN1905500000000,19,055,"Delaware County, IA",Dec-21,10554,10266,288,2.70000000
CN1905700000000,19,057,"Des Moines County, IA",Dec-21,18174,17207,967,5.30000000
CN1905900000000,19,059,"Dickinson County, IA",Dec-21,9729,9368,361,3.70000000
CN1906100000000,19,061,"Dubuque County, IA",Dec-21,55177,53108,2069,3.70000000
CN1906300000000,19,063,"Emmet County, IA",Dec-21,4891,4708,183,3.70000000
CN1906500000000,19,065,"Fayette County, IA",Dec-21,10241,9797,444,4.30000000
CN1906700000000,19,067,"Floyd County, IA",Dec-21,8257,7942,315,3.80000000
CN1906900000000,19,069,"Franklin County, IA",Dec-21,5583,5400,183,3.30000000
CN1907100000000,19,071,"Fremont County, IA",Dec-21,3726,3618,108,2.90000000
CN1907300000000,19,073,"Greene County, IA",Dec-21,5427,5273,154,2.80000000
CN1907500000000,19,075,"Grundy County, IA",Dec-21,6418,6220,198,3.10000000
CN1907700000000,19,077,"Guthrie County, IA",Dec-21,5538,5336,202,3.60000000
CN1907900000000,19,079,"Hamilton County, IA",Dec-21,6928,6687,241,3.50000000
CN1908100000000,19,081,"Hancock County, IA",Dec-21,5749,5566,183,3.20000000
CN1908300000000,19,083,"Hardin County, IA",Dec-21,7878,7595,283,3.60000000
CN1908500000000,19,085,"Harrison County, IA",Dec-21,7058,6821,237,3.40000000
CN1908700000000,19,087,"Henry County, IA",Dec-21,9562,9257,305,3.20000000
CN1908900000000,19,089,"Howard County, IA",Dec-21,5188,4998,190,3.70000000
CN1909100000000,19,091,"Humboldt County, IA",Dec-21,4977,4830,147,3.00000000
CN1909300000000,19,093,"Ida County, IA",Dec-21,3970,3870,100,2.50000000
CN1909500000000,19,095,"Iowa County, IA",Dec-21,10019,9713,306,3.10000000
CN1909700000000,19,097,"Jackson County, IA",Dec-21,10555,10122,433,4.10000000
CN1909900000000,19,099,"Jasper County, IA",Dec-21,18674,17965,709,3.80000000
CN1910100000000,19,101,"Jefferson County, IA",Dec-21,9909,9569,340,3.40000000
CN1910300000000,19,103,"Johnson County, IA",Dec-21,85003,82486,2517,3.00000000
CN1910500000000,19,105,"Jones County, IA",Dec-21,10194,9808,386,3.80000000
CN1910700000000,19,107,"Keokuk County, IA",Dec-21,5170,4974,196,3.80000000
CN1910900000000,19,109,"Kossuth County, IA",Dec-21,8203,7969,234,2.90000000
CN1911100000000,19,111,"Lee County, IA",Dec-21,15158,14402,756,5.00000000
CN1911300000000,19,113,"Linn County, IA",Dec-21,117712,112981,4731,4.00000000
CN1911500000000,19,115,"Louisa County, IA",Dec-21,5843,5616,227,3.90000000
CN1911700000000,19,117,"Lucas County, IA",Dec-21,4661,4547,114,2.40000000
CN1911900000000,19,119,"Lyon County, IA",Dec-21,7048,6904,144,2.00000000
CN1912100000000,19,121,"Madison County, IA",Dec-21,8516,8200,316,3.70000000
CN1912300000000,19,123,"Mahaska County, IA",Dec-21,11945,11602,343,2.90000000
CN1912500000000,19,125,"Marion County, IA",Dec-21,18721,18251,470,2.50000000
CN1912700000000,19,127,"Marshall County, IA",Dec-21,17298,16109,1189,6.90000000
CN1912900000000,19,129,"Mills County, IA",Dec-21,7009,6809,200,2.90000000
CN1913100000000,19,131,"Mitchell County, IA",Dec-21,5788,5641,147,2.50000000
CN1913300000000,19,133,"Monona County, IA",Dec-21,4427,4252,175,4.00000000
CN1913500000000,19,135,"Monroe County, IA",Dec-21,3954,3804,150,3.80000000
CN1913700000000,19,137,"Montgomery County, IA",Dec-21,4927,4763,164,3.30000000
CN1913900000000,19,139,"Muscatine County, IA",Dec-21,20515,19700,815,4.00000000
CN1914100000000,19,141,"O'Brien County, IA",Dec-21,8112,7897,215,2.70000000
CN1914300000000,19,143,"Osceola County, IA",Dec-21,3648,3577,71,1.90000000
CN1914500000000,19,145,"Page County, IA",Dec-21,6269,6057,212,3.40000000
CN1914700000000,19,147,"Palo Alto County, IA",Dec-21,4481,4359,122,2.70000000
CN1914900000000,19,149,"Plymouth County, IA",Dec-21,14549,14157,392,2.70000000
CN1915100000000,19,151,"Pocahontas County, IA",Dec-21,4345,4247,98,2.30000000
CN1915300000000,19,153,"Polk County, IA",Dec-21,267830,258313,9517,3.60000000
CN1915500000000,19,155,"Pottawattamie County, IA",Dec-21,46908,45217,1691,3.60000000
CN1915700000000,19,157,"Poweshiek County, IA",Dec-21,10315,9956,359,3.50000000
CN1915900000000,19,159,"Ringgold County, IA",Dec-21,2393,2331,62,2.60000000
CN1916100000000,19,161,"Sac County, IA",Dec-21,5243,5082,161,3.10000000
CN1916300000000,19,163,"Scott County, IA",Dec-21,87336,83612,3724,4.30000000
CN1916500000000,19,165,"Shelby County, IA",Dec-21,6278,6081,197,3.10000000
CN1916700000000,19,167,"Sioux County, IA",Dec-21,22343,21876,467,2.10000000
CN1916900000000,19,169,"Story County, IA",Dec-21,58970,57565,1405,2.40000000
CN1917100000000,19,171,"Tama County, IA",Dec-21,9329,8849,480,5.10000000
CN1917300000000,19,173,"Taylor County, IA",Dec-21,3124,3041,83,2.70000000
CN1917500000000,19,175,"Union County, IA",Dec-21,6197,5983,214,3.50000000
CN1917700000000,19,177,"Van Buren County, IA",Dec-21,3615,3511,104,2.90000000
CN1917900000000,19,179,"Wapello County, IA",Dec-21,16805,16138,667,4.00000000
CN1918100000000,19,181,"Warren County, IA",Dec-21,28294,27451,843,3.00000000
CN1918300000000,19,183,"Washington County, IA",Dec-21,11551,11210,341,3.00000000
CN1918500000000,19,185,"Wayne County, IA",Dec-21,2863,2770,93,3.20000000
CN1918700000000,19,187,"Webster County, IA",Dec-21,18364,17644,720,3.90000000
CN1918900000000,19,189,"Winnebago County, IA",Dec-21,4826,4633,193,4.00000000
CN1919100000000,19,191,"Winneshiek County, IA",Dec-21,11551,11121,430,3.70000000
CN1919300000000,19,193,"Woodbury County, IA",Dec-21,54933,52890,2043,3.70000000
CN1919500000000,19,195,"Worth County, IA",Dec-21,4015,3865,150,3.70000000
CN1919700000000,19,197,"Wright County, IA",Dec-21,6637,6394,243,3.70000000
CN2000100000000,20,001,"Allen County, KS",Dec-21,6603,6476,127,1.90000000
CN2000300000000,20,003,"Anderson County, KS",Dec-21,4755,4683,72,1.50000000
CN2000500000000,20,005,"Atchison County, KS",Dec-21,6757,6604,153,2.30000000
CN2000700000000,20,007,"Barber County, KS",Dec-21,2313,2284,29,1.30000000
CN2000900000000,20,009,"Barton County, KS",Dec-21,13455,13204,251,1.90000000
CN2001100000000,20,011,"Bourbon County, KS",Dec-21,6439,6280,159,2.50000000
CN2001300000000,20,013,"Brown County, KS",Dec-21,5127,5044,83,1.60000000
CN2001500000000,20,015,"Butler County, KS",Dec-21,32489,31795,694,2.10000000
CN2001700000000,20,017,"Chase County, KS",Dec-21,1389,1369,20,1.40000000
CN2001900000000,20,019,"Chautauqua County, KS",Dec-21,1429,1399,30,2.10000000
CN2002100000000,20,021,"Cherokee County, KS",Dec-21,9937,9769,168,1.70000000
CN2002300000000,20,023,"Cheyenne County, KS",Dec-21,1336,1318,18,1.30000000
CN2002500000000,20,025,"Clark County, KS",Dec-21,1152,1137,15,1.30000000
CN2002700000000,20,027,"Clay County, KS",Dec-21,3823,3765,58,1.50000000
CN2002900000000,20,029,"Cloud County, KS",Dec-21,3906,3845,61,1.60000000
CN2003100000000,20,031,"Coffey County, KS",Dec-21,3743,3658,85,2.30000000
CN2003300000000,20,033,"Comanche County, KS",Dec-21,898,886,12,1.30000000
CN2003500000000,20,035,"Cowley County, KS",Dec-21,16543,16201,342,2.10000000
CN2003700000000,20,037,"Crawford County, KS",Dec-21,19116,18737,379,2.00000000
CN2003900000000,20,039,"Decatur County, KS",Dec-21,1248,1227,21,1.70000000
CN2004100000000,20,041,"Dickinson County, KS",Dec-21,9151,8968,183,2.00000000
CN2004300000000,20,043,"Doniphan County, KS",Dec-21,4148,4092,56,1.40000000
CN2004500000000,20,045,"Douglas County, KS",Dec-21,65523,64326,1197,1.80000000
CN2004700000000,20,047,"Edwards County, KS",Dec-21,1500,1481,19,1.30000000
CN2004900000000,20,049,"Elk County, KS",Dec-21,1231,1210,21,1.70000000
CN2005100000000,20,051,"Ellis County, KS",Dec-21,17175,16969,206,1.20000000
CN2005300000000,20,053,"Ellsworth County, KS",Dec-21,2728,2690,38,1.40000000
CN2005500000000,20,055,"Finney County, KS",Dec-21,20283,20013,270,1.30000000
CN2005700000000,20,057,"Ford County, KS",Dec-21,17765,17520,245,1.40000000
CN2005900000000,20,059,"Franklin County, KS",Dec-21,14602,14318,284,1.90000000
CN2006100000000,20,061,"Geary County, KS",Dec-21,11278,10976,302,2.70000000
CN2006300000000,20,063,"Gove County, KS",Dec-21,1514,1495,19,1.30000000
CN2006500000000,20,065,"Graham County, KS",Dec-21,1121,1103,18,1.60000000
CN2006700000000,20,067,"Grant County, KS",Dec-21,2936,2876,60,2.00000000
CN2006900000000,20,069,"Gray County, KS",Dec-21,3307,3275,32,1.00000000
CN2007100000000,20,071,"Greeley County, KS",Dec-21,838,831,7,0.80000000
CN2007300000000,20,073,"Greenwood County, KS",Dec-21,3097,3041,56,1.80000000
CN2007500000000,20,075,"Hamilton County, KS",Dec-21,1639,1626,13,0.80000000
CN2007700000000,20,077,"Harper County, KS",Dec-21,2779,2731,48,1.70000000
CN2007900000000,20,079,"Harvey County, KS",Dec-21,16971,16673,298,1.80000000
CN2008100000000,20,081,"Haskell County, KS",Dec-21,2260,2232,28,1.20000000
CN2008300000000,20,083,"Hodgeman County, KS",Dec-21,1064,1052,12,1.10000000
CN2008500000000,20,085,"Jackson County, KS",Dec-21,7091,6965,126,1.80000000
CN2008700000000,20,087,"Jefferson County, KS",Dec-21,10105,9904,201,2.00000000
CN2008900000000,20,089,"Jewell County, KS",Dec-21,1236,1218,18,1.50000000
CN2009100000000,20,091,"Johnson County, KS",Dec-21,343732,338373,5359,1.60000000
CN2009300000000,20,093,"Kearny County, KS",Dec-21,2105,2083,22,1.00000000
CN2009500000000,20,095,"Kingman County, KS",Dec-21,3287,3232,55,1.70000000
CN2009700000000,20,097,"Kiowa County, KS",Dec-21,1245,1229,16,1.30000000
CN2009900000000,20,099,"Labette County, KS",Dec-21,9379,9176,203,2.20000000
CN2010100000000,20,101,"Lane County, KS",Dec-21,778,767,11,1.40000000
CN2010300000000,20,103,"Leavenworth County, KS",Dec-21,36804,36053,751,2.00000000
CN2010500000000,20,105,"Lincoln County, KS",Dec-21,1692,1670,22,1.30000000
CN2010700000000,20,107,"Linn County, KS",Dec-21,4304,4191,113,2.60000000
CN2010900000000,20,109,"Logan County, KS",Dec-21,1660,1643,17,1.00000000
CN2011100000000,20,111,"Lyon County, KS",Dec-21,17098,16812,286,1.70000000
CN2011300000000,20,113,"McPherson County, KS",Dec-21,17110,16893,217,1.30000000
CN2011500000000,20,115,"Marion County, KS",Dec-21,6084,5992,92,1.50000000
CN2011700000000,20,117,"Marshall County, KS",Dec-21,5417,5353,64,1.20000000
CN2011900000000,20,119,"Meade County, KS",Dec-21,2222,2188,34,1.50000000
CN2012100000000,20,121,"Miami County, KS",Dec-21,17749,17429,320,1.80000000
CN2012300000000,20,123,"Mitchell County, KS",Dec-21,3438,3399,39,1.10000000
CN2012500000000,20,125,"Montgomery County, KS",Dec-21,14642,14291,351,2.40000000
CN2012700000000,20,127,"Morris County, KS",Dec-21,3020,2976,44,1.50000000
CN2012900000000,20,129,"Morton County, KS",Dec-21,1113,1092,21,1.90000000
CN2013100000000,20,131,"Nemaha County, KS",Dec-21,5588,5534,54,1.00000000
CN2013300000000,20,133,"Neosho County, KS",Dec-21,5978,5816,162,2.70000000
CN2013500000000,20,135,"Ness County, KS",Dec-21,1355,1336,19,1.40000000
CN2013700000000,20,137,"Norton County, KS",Dec-21,2658,2630,28,1.10000000
CN2013900000000,20,139,"Osage County, KS",Dec-21,7817,7661,156,2.00000000
CN2014100000000,20,141,"Osborne County, KS",Dec-21,1965,1940,25,1.30000000
CN2014300000000,20,143,"Ottawa County, KS",Dec-21,2988,2938,50,1.70000000
CN2014500000000,20,145,"Pawnee County, KS",Dec-21,2837,2796,41,1.40000000
CN2014700000000,20,147,"Phillips County, KS",Dec-21,2659,2619,40,1.50000000
CN2014900000000,20,149,"Pottawatomie County, KS",Dec-21,12259,12061,198,1.60000000
CN2015100000000,20,151,"Pratt County, KS",Dec-21,4982,4917,65,1.30000000
CN2015300000000,20,153,"Rawlins County, KS",Dec-21,1683,1665,18,1.10000000
CN2015500000000,20,155,"Reno County, KS",Dec-21,29623,29024,599,2.00000000
CN2015700000000,20,157,"Republic County, KS",Dec-21,2397,2361,36,1.50000000
CN2015900000000,20,159,"Rice County, KS",Dec-21,5538,5454,84,1.50000000
CN2016100000000,20,161,"Riley County, KS",Dec-21,33711,33147,564,1.70000000
CN2016300000000,20,163,"Rooks County, KS",Dec-21,2405,2366,39,1.60000000
CN2016500000000,20,165,"Rush County, KS",Dec-21,1601,1578,23,1.40000000
CN2016700000000,20,167,"Russell County, KS",Dec-21,3405,3351,54,1.60000000
CN2016900000000,20,169,"Saline County, KS",Dec-21,29193,28630,563,1.90000000
CN2017100000000,20,171,"Scott County, KS",Dec-21,2888,2862,26,0.90000000
CN2017300000000,20,173,"Sedgwick County, KS",Dec-21,254014,246927,7087,2.80000000
CN2017500000000,20,175,"Seward County, KS",Dec-21,9795,9622,173,1.80000000
CN2017700000000,20,177,"Shawnee County, KS",Dec-21,88938,87156,1782,2.00000000
CN2017900000000,20,179,"Sheridan County, KS",Dec-21,1493,1476,17,1.10000000
CN2018100000000,20,181,"Sherman County, KS",Dec-21,2866,2826,40,1.40000000
CN2018300000000,20,183,"Smith County, KS",Dec-21,2032,2011,21,1.00000000
CN2018500000000,20,185,"Stafford County, KS",Dec-21,2052,2026,26,1.30000000
CN2018700000000,20,187,"Stanton County, KS",Dec-21,1169,1156,13,1.10000000
CN2018900000000,20,189,"Stevens County, KS",Dec-21,2982,2947,35,1.20000000
CN2019100000000,20,191,"Sumner County, KS",Dec-21,10737,10477,260,2.40000000
CN2019300000000,20,193,"Thomas County, KS",Dec-21,4304,4258,46,1.10000000
CN2019500000000,20,195,"Trego County, KS",Dec-21,1414,1396,18,1.30000000
CN2019700000000,20,197,"Wabaunsee County, KS",Dec-21,3661,3603,58,1.60000000
CN2019900000000,20,199,"Wallace County, KS",Dec-21,887,877,10,1.10000000
CN2020100000000,20,201,"Washington County, KS",Dec-21,3107,3073,34,1.10000000
CN2020300000000,20,203,"Wichita County, KS",Dec-21,1197,1182,15,1.30000000
CN2020500000000,20,205,"Wilson County, KS",Dec-21,3814,3713,101,2.60000000
CN2020700000000,20,207,"Woodson County, KS",Dec-21,1554,1517,37,2.40000000
CN2020900000000,20,209,"Wyandotte County, KS",Dec-21,76894,74807,2087,2.70000000
CN2100100000000,21,001,"Adair County, KY",Dec-21,7380,7080,300,4.10000000
CN2100300000000,21,003,"Allen County, KY",Dec-21,9050,8749,301,3.30000000
CN2100500000000,21,005,"Anderson County, KY",Dec-21,12238,11853,385,3.10000000
CN2100700000000,21,007,"Ballard County, KY",Dec-21,3516,3354,162,4.60000000
CN2100900000000,21,009,"Barren County, KY",Dec-21,17980,17240,740,4.10000000
CN2101100000000,21,011,"Bath County, KY",Dec-21,4746,4486,260,5.50000000
CN2101300000000,21,013,"Bell County, KY",Dec-21,8227,7831,396,4.80000000
CN2101500000000,21,015,"Boone County, KY",Dec-21,71619,69450,2169,3.00000000
CN2101700000000,21,017,"Bourbon County, KY",Dec-21,9892,9569,323,3.30000000
CN2101900000000,21,019,"Boyd County, KY",Dec-21,17480,16540,940,5.40000000
CN2102100000000,21,021,"Boyle County, KY",Dec-21,12714,12221,493,3.90000000
CN2102300000000,21,023,"Bracken County, KY",Dec-21,3780,3636,144,3.80000000
CN2102500000000,21,025,"Breathitt County, KY",Dec-21,3326,3033,293,8.80000000
CN2102700000000,21,027,"Breckinridge County, KY",Dec-21,8017,7648,369,4.60000000
CN2102900000000,21,029,"Bullitt County, KY",Dec-21,43732,41815,1917,4.40000000
CN2103100000000,21,031,"Butler County, KY",Dec-21,5004,4818,186,3.70000000
CN2103300000000,21,033,"Caldwell County, KY",Dec-21,6063,5851,212,3.50000000
CN2103500000000,21,035,"Calloway County, KY",Dec-21,17599,16947,652,3.70000000
CN2103700000000,21,037,"Campbell County, KY",Dec-21,50338,48691,1647,3.30000000
CN2103900000000,21,039,"Carlisle County, KY",Dec-21,2228,2152,76,3.40000000
CN2104100000000,21,041,"Carroll County, KY",Dec-21,5520,5341,179,3.20000000
CN2104300000000,21,043,"Carter County, KY",Dec-21,9914,9159,755,7.60000000
CN2104500000000,21,045,"Casey County, KY",Dec-21,6756,6504,252,3.70000000
CN2104700000000,21,047,"Christian County, KY",Dec-21,25329,23991,1338,5.30000000
CN2104900000000,21,049,"Clark County, KY",Dec-21,17326,16716,610,3.50000000
CN2105100000000,21,051,"Clay County, KY",Dec-21,5178,4896,282,5.40000000
CN2105300000000,21,053,"Clinton County, KY",Dec-21,3957,3792,165,4.20000000
CN2105500000000,21,055,"Crittenden County, KY",Dec-21,3861,3725,136,3.50000000
CN2105700000000,21,057,"Cumberland County, KY",Dec-21,3334,3228,106,3.20000000
CN2105900000000,21,059,"Daviess County, KY",Dec-21,46745,45151,1594,3.40000000
CN2106100000000,21,061,"Edmonson County, KY",Dec-21,4716,4521,195,4.10000000
CN2106300000000,21,063,"Elliott County, KY",Dec-21,1911,1735,176,9.20000000
CN2106500000000,21,065,"Estill County, KY",Dec-21,5177,4953,224,4.30000000
CN2106700000000,21,067,"Fayette County, KY",Dec-21,175989,170668,5321,3.00000000
CN2106900000000,21,069,"Fleming County, KY",Dec-21,6080,5823,257,4.20000000
CN2107100000000,21,071,"Floyd County, KY",Dec-21,11001,10302,699,6.40000000
CN2107300000000,21,073,"Franklin County, KY",Dec-21,25685,24797,888,3.50000000
CN2107500000000,21,075,"Fulton County, KY",Dec-21,2100,2018,82,3.90000000
CN2107700000000,21,077,"Gallatin County, KY",Dec-21,4013,3873,140,3.50000000
CN2107900000000,21,079,"Garrard County, KY",Dec-21,7758,7455,303,3.90000000
CN2108100000000,21,081,"Grant County, KY",Dec-21,11645,11225,420,3.60000000
CN2108300000000,21,083,"Graves County, KY",Dec-21,16150,15555,595,3.70000000
CN2108500000000,21,085,"Grayson County, KY",Dec-21,10567,10068,499,4.70000000
CN2108700000000,21,087,"Green County, KY",Dec-21,5294,5128,166,3.10000000
CN2108900000000,21,089,"Greenup County, KY",Dec-21,13184,12383,801,6.10000000
CN2109100000000,21,091,"Hancock County, KY",Dec-21,3893,3753,140,3.60000000
CN2109300000000,21,093,"Hardin County, KY",Dec-21,47416,45493,1923,4.10000000
CN2109500000000,21,095,"Harlan County, KY",Dec-21,6601,6144,457,6.90000000
CN2109700000000,21,097,"Harrison County, KY",Dec-21,8901,8627,274,3.10000000
CN2109900000000,21,099,"Hart County, KY",Dec-21,7638,7362,276,3.60000000
CN2110100000000,21,101,"Henderson County, KY",Dec-21,20901,20175,726,3.50000000
CN2110300000000,21,103,"Henry County, KY",Dec-21,8298,8027,271,3.30000000
CN2110500000000,21,105,"Hickman County, KY",Dec-21,1712,1647,65,3.80000000
CN2110700000000,21,107,"Hopkins County, KY",Dec-21,18165,17329,836,4.60000000
CN2110900000000,21,109,"Jackson County, KY",Dec-21,4154,3929,225,5.40000000
CN2111100000000,21,111,"Jefferson County, KY",Dec-21,400329,384379,15950,4.00000000
CN2111300000000,21,113,"Jessamine County, KY",Dec-21,26629,25790,839,3.20000000
CN2111500000000,21,115,"Johnson County, KY",Dec-21,6706,6281,425,6.30000000
CN2111700000000,21,117,"Kenton County, KY",Dec-21,87155,84279,2876,3.30000000
CN2111900000000,21,119,"Knott County, KY",Dec-21,4315,4053,262,6.10000000
CN2112100000000,21,121,"Knox County, KY",Dec-21,10191,9679,512,5.00000000
CN2112300000000,21,123,"Larue County, KY",Dec-21,5832,5594,238,4.10000000
CN2112500000000,21,125,"Laurel County, KY",Dec-21,25701,24753,948,3.70000000
CN2112700000000,21,127,"Lawrence County, KY",Dec-21,5548,5229,319,5.70000000
CN2112900000000,21,129,"Lee County, KY",Dec-21,1970,1870,100,5.10000000
CN2113100000000,21,131,"Leslie County, KY",Dec-21,2552,2378,174,6.80000000
CN2113300000000,21,133,"Letcher County, KY",Dec-21,6104,5711,393,6.40000000
CN2113500000000,21,135,"Lewis County, KY",Dec-21,4777,4441,336,7.00000000
CN2113700000000,21,137,"Lincoln County, KY",Dec-21,9335,8904,431,4.60000000
CN2113900000000,21,139,"Livingston County, KY",Dec-21,3682,3493,189,5.10000000
CN2114100000000,21,141,"Logan County, KY",Dec-21,12486,12090,396,3.20000000
CN2114300000000,21,143,"Lyon County, KY",Dec-21,3091,2970,121,3.90000000
CN2114500000000,21,145,"McCracken County, KY",Dec-21,30046,28817,1229,4.10000000
CN2114700000000,21,147,"McCreary County, KY",Dec-21,4851,4634,217,4.50000000
CN2114900000000,21,149,"McLean County, KY",Dec-21,4084,3933,151,3.70000000
CN2115100000000,21,151,"Madison County, KY",Dec-21,47489,45884,1605,3.40000000
CN2115300000000,21,153,"Magoffin County, KY",Dec-21,3277,2898,379,11.60000000
CN2115500000000,21,155,"Marion County, KY",Dec-21,9284,8956,328,3.50000000
CN2115700000000,21,157,"Marshall County, KY",Dec-21,14331,13765,566,3.90000000
CN2115900000000,21,159,"Martin County, KY",Dec-21,2288,2099,189,8.30000000
CN2116100000000,21,161,"Mason County, KY",Dec-21,6845,6523,322,4.70000000
CN2116300000000,21,163,"Meade County, KY",Dec-21,11762,11229,533,4.50000000
CN2116500000000,21,165,"Menifee County, KY",Dec-21,2347,2209,138,5.90000000
CN2116700000000,21,167,"Mercer County, KY",Dec-21,9979,9595,384,3.80000000
CN2116900000000,21,169,"Metcalfe County, KY",Dec-21,3990,3808,182,4.60000000
CN2117100000000,21,171,"Monroe County, KY",Dec-21,4693,4546,147,3.10000000
CN2117300000000,21,173,"Montgomery County, KY",Dec-21,11767,11225,542,4.60000000
CN2117500000000,21,175,"Morgan County, KY",Dec-21,4369,4153,216,4.90000000
CN2117700000000,21,177,"Muhlenberg County, KY",Dec-21,9716,9164,552,5.70000000
CN2117900000000,21,179,"Nelson County, KY",Dec-21,23642,22732,910,3.80000000
CN2118100000000,21,181,"Nicholas County, KY",Dec-21,3377,3250,127,3.80000000
CN2118300000000,21,183,"Ohio County, KY",Dec-21,8942,8517,425,4.80000000
CN2118500000000,21,185,"Oldham County, KY",Dec-21,33645,32703,942,2.80000000
CN2118700000000,21,187,"Owen County, KY",Dec-21,5050,4877,173,3.40000000
CN2118900000000,21,189,"Owsley County, KY",Dec-21,1041,974,67,6.40000000
CN2119100000000,21,191,"Pendleton County, KY",Dec-21,6914,6675,239,3.50000000
CN2119300000000,21,193,"Perry County, KY",Dec-21,8070,7648,422,5.20000000
CN2119500000000,21,195,"Pike County, KY",Dec-21,19068,18045,1023,5.40000000
CN2119700000000,21,197,"Powell County, KY",Dec-21,5282,5062,220,4.20000000
CN2119900000000,21,199,"Pulaski County, KY",Dec-21,26242,25150,1092,4.20000000
CN2120100000000,21,201,"Robertson County, KY",Dec-21,816,786,30,3.70000000
CN2120300000000,21,203,"Rockcastle County, KY",Dec-21,6568,6294,274,4.20000000
CN2120500000000,21,205,"Rowan County, KY",Dec-21,9921,9491,430,4.30000000
CN2120700000000,21,207,"Russell County, KY",Dec-21,6146,5861,285,4.60000000
CN2120900000000,21,209,"Scott County, KY",Dec-21,30421,29530,891,2.90000000
CN2121100000000,21,211,"Shelby County, KY",Dec-21,26321,25492,829,3.10000000
CN2121300000000,21,213,"Simpson County, KY",Dec-21,8903,8610,293,3.30000000
CN2121500000000,21,215,"Spencer County, KY",Dec-21,10739,10328,411,3.80000000
CN2121700000000,21,217,"Taylor County, KY",Dec-21,12703,12291,412,3.20000000
CN2121900000000,21,219,"Todd County, KY",Dec-21,5613,5435,178,3.20000000
CN2122100000000,21,221,"Trigg County, KY",Dec-21,6202,5921,281,4.50000000
CN2122300000000,21,223,"Trimble County, KY",Dec-21,3882,3742,140,3.60000000
CN2122500000000,21,225,"Union County, KY",Dec-21,6080,5861,219,3.60000000
CN2122700000000,21,227,"Warren County, KY",Dec-21,65329,63206,2123,3.20000000
CN2122900000000,21,229,"Washington County, KY",Dec-21,6229,6029,200,3.20000000
CN2123100000000,21,231,"Wayne County, KY",Dec-21,7355,7027,328,4.50000000
CN2123300000000,21,233,"Webster County, KY",Dec-21,5364,5172,192,3.60000000
CN2123500000000,21,235,"Whitley County, KY",Dec-21,14232,13674,558,3.90000000
CN2123700000000,21,237,"Wolfe County, KY",Dec-21,2206,2089,117,5.30000000
CN2123900000000,21,239,"Woodford County, KY",Dec-21,15365,14965,400,2.60000000
CN2200100000000,22,001,"Acadia Parish, LA",Dec-21,23536,22806,730,3.10000000
CN2200300000000,22,003,"Allen Parish, LA",Dec-21,8074,7784,290,3.60000000
CN2200500000000,22,005,"Ascension Parish, LA",Dec-21,65695,63997,1698,2.60000000
CN2200700000000,22,007,"Assumption Parish, LA",Dec-21,8593,8176,417,4.90000000
CN2200900000000,22,009,"Avoyelles Parish, LA",Dec-21,14551,14052,499,3.40000000
CN2201100000000,22,011,"Beauregard Parish, LA",Dec-21,14594,14196,398,2.70000000
CN2201300000000,22,013,"Bienville Parish, LA",Dec-21,5200,5008,192,3.70000000
CN2201500000000,22,015,"Bossier Parish, LA",Dec-21,57476,56060,1416,2.50000000
CN2201700000000,22,017,"Caddo Parish, LA",Dec-21,101368,97188,4180,4.10000000
CN2201900000000,22,019,"Calcasieu Parish, LA",Dec-21,97414,93970,3444,3.50000000
CN2202100000000,22,021,"Caldwell Parish, LA",Dec-21,3638,3532,106,2.90000000
CN2202300000000,22,023,"Cameron Parish, LA",Dec-21,3592,3512,80,2.20000000
CN2202500000000,22,025,"Catahoula Parish, LA",Dec-21,3411,3300,111,3.30000000
CN2202700000000,22,027,"Claiborne Parish, LA",Dec-21,5428,5261,167,3.10000000
CN2202900000000,22,029,"Concordia Parish, LA",Dec-21,6825,6551,274,4.00000000
CN2203100000000,22,031,"De Soto Parish, LA",Dec-21,10784,10452,332,3.10000000
CN2203300000000,22,033,"East Baton Rouge Parish, LA",Dec-21,229805,222189,7616,3.30000000
CN2203500000000,22,035,"East Carroll Parish, LA",Dec-21,1665,1546,119,7.10000000
CN2203700000000,22,037,"East Feliciana Parish, LA",Dec-21,7740,7518,222,2.90000000
CN2203900000000,22,039,"Evangeline Parish, LA",Dec-21,11743,11326,417,3.60000000
CN2204100000000,22,041,"Franklin Parish, LA",Dec-21,7361,7068,293,4.00000000
CN2204300000000,22,043,"Grant Parish, LA",Dec-21,8242,8012,230,2.80000000
CN2204500000000,22,045,"Iberia Parish, LA",Dec-21,27408,26174,1234,4.50000000
CN2204700000000,22,047,"Iberville Parish, LA",Dec-21,13763,13106,657,4.80000000
CN2204900000000,22,049,"Jackson Parish, LA",Dec-21,6801,6635,166,2.40000000
CN2205100000000,22,051,"Jefferson Parish, LA",Dec-21,208077,199915,8162,3.90000000
CN2205300000000,22,053,"Jefferson Davis Parish, LA",Dec-21,12724,12350,374,2.90000000
CN2205500000000,22,055,"Lafayette Parish, LA",Dec-21,115037,111827,3210,2.80000000
CN2205700000000,22,057,"Lafourche Parish, LA",Dec-21,39237,38007,1230,3.10000000
CN2205900000000,22,059,"LaSalle Parish, LA",Dec-21,6588,6446,142,2.20000000
CN2206100000000,22,061,"Lincoln Parish, LA",Dec-21,21380,20804,576,2.70000000
CN2206300000000,22,063,"Livingston Parish, LA",Dec-21,70274,68608,1666,2.40000000
CN2206500000000,22,065,"Madison Parish, LA",Dec-21,3426,3272,154,4.50000000
CN2206700000000,22,067,"Morehouse Parish, LA",Dec-21,9944,9422,522,5.20000000
CN2206900000000,22,069,"Natchitoches Parish, LA",Dec-21,16269,15770,499,3.10000000
CN2207100000000,22,071,"Orleans Parish, LA",Dec-21,175708,166032,9676,5.50000000
CN2207300000000,22,073,"Ouachita Parish, LA",Dec-21,69272,67049,2223,3.20000000
CN2207500000000,22,075,"Plaquemines Parish, LA",Dec-21,9586,9325,261,2.70000000
CN2207700000000,22,077,"Pointe Coupee Parish, LA",Dec-21,9609,9260,349,3.60000000
CN2207900000000,22,079,"Rapides Parish, LA",Dec-21,55680,54242,1438,2.60000000
CN2208100000000,22,081,"Red River Parish, LA",Dec-21,3672,3569,103,2.80000000
CN2208300000000,22,083,"Richland Parish, LA",Dec-21,8106,7833,273,3.40000000
CN2208500000000,22,085,"Sabine Parish, LA",Dec-21,9182,8965,217,2.40000000
CN2208700000000,22,087,"St. Bernard Parish, LA",Dec-21,19769,18870,899,4.50000000
CN2208900000000,22,089,"St. Charles Parish, LA",Dec-21,24411,23622,789,3.20000000
CN2209100000000,22,091,"St. Helena Parish, LA",Dec-21,4244,3985,259,6.10000000
CN2209300000000,22,093,"St. James Parish, LA",Dec-21,8835,8388,447,5.10000000
CN2209500000000,22,095,"St. John the Baptist Parish, LA",Dec-21,19076,17903,1173,6.10000000
CN2209700000000,22,097,"St. Landry Parish, LA",Dec-21,31626,30266,1360,4.30000000
CN2209900000000,22,099,"St. Martin Parish, LA",Dec-21,21904,21124,780,3.60000000
CN2210100000000,22,101,"St. Mary Parish, LA",Dec-21,19015,18170,845,4.40000000
CN2210300000000,22,103,"St. Tammany Parish, LA",Dec-21,117178,114320,2858,2.40000000
CN2210500000000,22,105,"Tangipahoa Parish, LA",Dec-21,55862,53429,2433,4.40000000
CN2210700000000,22,107,"Tensas Parish, LA",Dec-21,1283,1229,54,4.20000000
CN2210900000000,22,109,"Terrebonne Parish, LA",Dec-21,43400,41620,1780,4.10000000
CN2211100000000,22,111,"Union Parish, LA",Dec-21,9005,8716,289,3.20000000
CN2211300000000,22,113,"Vermilion Parish, LA",Dec-21,23717,22963,754,3.20000000
CN2211500000000,22,115,"Vernon Parish, LA",Dec-21,15753,15225,528,3.40000000
CN2211700000000,22,117,"Washington Parish, LA",Dec-21,17024,16383,641,3.80000000
CN2211900000000,22,119,"Webster Parish, LA",Dec-21,14010,13526,484,3.50000000
CN2212100000000,22,121,"West Baton Rouge Parish, LA",Dec-21,13773,13358,415,3.00000000
CN2212300000000,22,123,"West Carroll Parish, LA",Dec-21,3478,3308,170,4.90000000
CN2212500000000,22,125,"West Feliciana Parish, LA",Dec-21,5336,5215,121,2.30000000
CN2212700000000,22,127,"Winn Parish, LA",Dec-21,4533,4388,145,3.20000000
CN2300100000000,23,001,"Androscoggin County, ME",Dec-21,54028,52123,1905,3.50000000
CN2300300000000,23,003,"Aroostook County, ME",Dec-21,28365,27066,1299,4.60000000
CN2300500000000,23,005,"Cumberland County, ME",Dec-21,160734,156097,4637,2.90000000
CN2300700000000,23,007,"Franklin County, ME",Dec-21,13789,13233,556,4.00000000
CN2300900000000,23,009,"Hancock County, ME",Dec-21,26474,25265,1209,4.60000000
CN2301100000000,23,011,"Kennebec County, ME",Dec-21,60968,58886,2082,3.40000000
CN2301300000000,23,013,"Knox County, ME",Dec-21,19246,18598,648,3.40000000
CN2301500000000,23,015,"Lincoln County, ME",Dec-21,15984,15404,580,3.60000000
CN2301700000000,23,017,"Oxford County, ME",Dec-21,26102,25054,1048,4.00000000
CN2301900000000,23,019,"Penobscot County, ME",Dec-21,75132,72416,2716,3.60000000
CN2302100000000,23,021,"Piscataquis County, ME",Dec-21,7194,6890,304,4.20000000
CN2302300000000,23,023,"Sagadahoc County, ME",Dec-21,19034,18501,533,2.80000000
CN2302500000000,23,025,"Somerset County, ME",Dec-21,21666,20611,1055,4.90000000
CN2302700000000,23,027,"Waldo County, ME",Dec-21,19802,19055,747,3.80000000
CN2302900000000,23,029,"Washington County, ME",Dec-21,13142,12509,633,4.80000000
CN2303100000000,23,031,"York County, ME",Dec-21,111271,107623,3648,3.30000000
CN2400100000000,24,001,"Allegany County, MD",Dec-21,30813,29088,1725,5.60000000
CN2400300000000,24,003,"Anne Arundel County, MD",Dec-21,316739,304588,12151,3.80000000
CN2400500000000,24,005,"Baltimore County, MD",Dec-21,450041,429393,20648,4.60000000
CN2400900000000,24,009,"Calvert County, MD",Dec-21,49376,47446,1930,3.90000000
CN2401100000000,24,011,"Caroline County, MD",Dec-21,17334,16637,697,4.00000000
CN2401300000000,24,013,"Carroll County, MD",Dec-21,95224,91955,3269,3.40000000
CN2401500000000,24,015,"Cecil County, MD",Dec-21,52760,50392,2368,4.50000000
CN2401700000000,24,017,"Charles County, MD",Dec-21,87116,83127,3989,4.60000000
CN2401900000000,24,019,"Dorchester County, MD",Dec-21,16278,15485,793,4.90000000
CN2402100000000,24,021,"Frederick County, MD",Dec-21,136427,131044,5383,3.90000000
CN2402300000000,24,023,"Garrett County, MD",Dec-21,15216,14475,741,4.90000000
CN2402500000000,24,025,"Harford County, MD",Dec-21,141556,135993,5563,3.90000000
CN2402700000000,24,027,"Howard County, MD",Dec-21,189120,182458,6662,3.50000000
CN2402900000000,24,029,"Kent County, MD",Dec-21,9548,9092,456,4.80000000
CN2403100000000,24,031,"Montgomery County, MD",Dec-21,547420,524366,23054,4.20000000
CN2403300000000,24,033,"Prince George's County, MD",Dec-21,504502,475144,29358,5.80000000
CN2403500000000,24,035,"Queen Anne's County, MD",Dec-21,28117,27101,1016,3.60000000
CN2403700000000,24,037,"St. Mary's County, MD",Dec-21,57646,55410,2236,3.90000000
CN2403900000000,24,039,"Somerset County, MD",Dec-21,8751,8150,601,6.90000000
CN2404100000000,24,041,"Talbot County, MD",Dec-21,17636,16816,820,4.60000000
CN2404300000000,24,043,"Washington County, MD",Dec-21,73881,70711,3170,4.30000000
CN2404500000000,24,045,"Wicomico County, MD",Dec-21,49261,46469,2792,5.70000000
CN2404700000000,24,047,"Worcester County, MD",Dec-21,24627,22581,2046,8.30000000
CN2451000000000,24,510,"Baltimore city, MD",Dec-21,280450,262676,17774,6.30000000
CN2500100000000,25,001,"Barnstable County, MA",Dec-21,108638,102375,6263,5.80000000
CN2500300000000,25,003,"Berkshire County, MA",Dec-21,62074,58870,3204,5.20000000
CN2500500000000,25,005,"Bristol County, MA",Dec-21,300849,285674,15175,5.00000000
CN2500700000000,25,007,"Dukes County, MA",Dec-21,8937,8357,580,6.50000000
CN2500900000000,25,009,"Essex County, MA",Dec-21,424369,405127,19242,4.50000000
CN2501100000000,25,011,"Franklin County, MA",Dec-21,41038,39568,1470,3.60000000
CN2501300000000,25,013,"Hampden County, MA",Dec-21,228421,215487,12934,5.70000000
CN2501500000000,25,015,"Hampshire County, MA",Dec-21,90574,87459,3115,3.40000000
CN2501700000000,25,017,"Middlesex County, MA",Dec-21,913115,884601,28514,3.10000000
CN2501900000000,25,019,"Nantucket County/town, MA",Dec-21,6847,6261,586,8.60000000
CN2502100000000,25,021,"Norfolk County, MA",Dec-21,393550,379370,14180,3.60000000
CN2502300000000,25,023,"Plymouth County, MA",Dec-21,284604,271672,12932,4.50000000
CN2502500000000,25,025,"Suffolk County, MA",Dec-21,454625,436460,18165,4.00000000
CN2502700000000,25,027,"Worcester County, MA",Dec-21,445783,426715,19068,4.30000000
CN2600100000000,26,001,"Alcona County, MI",Dec-21,3589,3343,246,6.90000000
CN2600300000000,26,003,"Alger County, MI",Dec-21,2957,2733,224,7.60000000
CN2600500000000,26,005,"Allegan County, MI",Dec-21,60247,58185,2062,3.40000000
CN2600700000000,26,007,"Alpena County, MI",Dec-21,13239,12667,572,4.30000000
CN2600900000000,26,009,"Antrim County, MI",Dec-21,9303,8747,556,6.00000000
CN2601100000000,26,011,"Arenac County, MI",Dec-21,5580,5161,419,7.50000000
CN2601300000000,26,013,"Baraga County, MI",Dec-21,3001,2790,211,7.00000000
CN2601500000000,26,015,"Barry County, MI",Dec-21,30798,29740,1058,3.40000000
CN2601700000000,26,017,"Bay County, MI",Dec-21,47845,45564,2281,4.80000000
CN2601900000000,26,019,"Benzie County, MI",Dec-21,8350,7899,451,5.40000000
CN2602100000000,26,021,"Berrien County, MI",Dec-21,69629,66626,3003,4.30000000
CN2602300000000,26,023,"Branch County, MI",Dec-21,18870,18191,679,3.60000000
CN2602500000000,26,025,"Calhoun County, MI",Dec-21,59118,56265,2853,4.80000000
CN2602700000000,26,027,"Cass County, MI",Dec-21,23122,22272,850,3.70000000
CN2602900000000,26,029,"Charlevoix County, MI",Dec-21,11650,11086,564,4.80000000
CN2603100000000,26,031,"Cheboygan County, MI",Dec-21,9329,8507,822,8.80000000
CN2603300000000,26,033,"Chippewa County, MI",Dec-21,15909,14983,926,5.80000000
CN2603500000000,26,035,"Clare County, MI",Dec-21,10872,10153,719,6.60000000
CN2603700000000,26,037,"Clinton County, MI",Dec-21,38864,37682,1182,3.00000000
CN2603900000000,26,039,"Crawford County, MI",Dec-21,5192,4877,315,6.10000000
CN2604100000000,26,041,"Delta County, MI",Dec-21,15974,15141,833,5.20000000
CN2604300000000,26,043,"Dickinson County, MI",Dec-21,12112,11663,449,3.70000000
CN2604500000000,26,045,"Eaton County, MI",Dec-21,53984,52113,1871,3.50000000
CN2604700000000,26,047,"Emmet County, MI",Dec-21,15654,14741,913,5.80000000
CN2604900000000,26,049,"Genesee County, MI",Dec-21,173854,164168,9686,5.60000000
CN2605100000000,26,051,"Gladwin County, MI",Dec-21,9237,8706,531,5.70000000
CN2605300000000,26,053,"Gogebic County, MI",Dec-21,5661,5405,256,4.50000000
CN2605500000000,26,055,"Grand Traverse County, MI",Dec-21,47158,45311,1847,3.90000000
CN2605700000000,26,057,"Gratiot County, MI",Dec-21,16902,16204,698,4.10000000
CN2605900000000,26,059,"Hillsdale County, MI",Dec-21,19503,18680,823,4.20000000
CN2606100000000,26,061,"Houghton County, MI",Dec-21,16048,15413,635,4.00000000
CN2606300000000,26,063,"Huron County, MI",Dec-21,14428,13832,596,4.10000000
CN2606500000000,26,065,"Ingham County, MI",Dec-21,141527,136227,5300,3.70000000
CN2606700000000,26,067,"Ionia County, MI",Dec-21,29270,28307,963,3.30000000
CN2606900000000,26,069,"Iosco County, MI",Dec-21,9679,9040,639,6.60000000
CN2607100000000,26,071,"Iron County, MI",Dec-21,4717,4464,253,5.40000000
CN2607300000000,26,073,"Isabella County, MI",Dec-21,31909,30700,1209,3.80000000
CN2607500000000,26,075,"Jackson County, MI",Dec-21,72291,69272,3019,4.20000000
CN2607700000000,26,077,"Kalamazoo County, MI",Dec-21,129196,124673,4523,3.50000000
CN2607900000000,26,079,"Kalkaska County, MI",Dec-21,7545,7058,487,6.50000000
CN2608100000000,26,081,"Kent County, MI",Dec-21,349092,337779,11313,3.20000000
CN2608300000000,26,083,"Keweenaw County, MI",Dec-21,904,847,57,6.30000000
CN2608500000000,26,085,"Lake County, MI",Dec-21,3785,3520,265,7.00000000
CN2608700000000,26,087,"Lapeer County, MI",Dec-21,40429,38585,1844,4.60000000
CN2608900000000,26,089,"Leelanau County, MI",Dec-21,9817,9417,400,4.10000000
CN2609100000000,26,091,"Lenawee County, MI",Dec-21,44620,42882,1738,3.90000000
CN2609300000000,26,093,"Livingston County, MI",Dec-21,102997,99985,3012,2.90000000
CN2609500000000,26,095,"Luce County, MI",Dec-21,1992,1862,130,6.50000000
CN2609700000000,26,097,"Mackinac County, MI",Dec-21,3880,3383,497,12.80000000
CN2609900000000,26,099,"Macomb County, MI",Dec-21,442992,425200,17792,4.00000000
CN2610100000000,26,101,"Manistee County, MI",Dec-21,9518,8949,569,6.00000000
CN2610300000000,26,103,"Marquette County, MI",Dec-21,30738,29410,1328,4.30000000
CN2610500000000,26,105,"Mason County, MI",Dec-21,12624,11922,702,5.60000000
CN2610700000000,26,107,"Mecosta County, MI",Dec-21,17920,17051,869,4.80000000
CN2610900000000,26,109,"Menominee County, MI",Dec-21,10300,9928,372,3.60000000
CN2611100000000,26,111,"Midland County, MI",Dec-21,38165,36770,1395,3.70000000
CN2611300000000,26,113,"Missaukee County, MI",Dec-21,6630,6336,294,4.40000000
CN2611500000000,26,115,"Monroe County, MI",Dec-21,72278,69449,2829,3.90000000
CN2611700000000,26,117,"Montcalm County, MI",Dec-21,26977,25873,1104,4.10000000
CN2611900000000,26,119,"Montmorency County, MI",Dec-21,2879,2635,244,8.50000000
CN2612100000000,26,121,"Muskegon County, MI",Dec-21,75324,71230,4094,5.40000000
CN2612300000000,26,123,"Newaygo County, MI",Dec-21,22729,21750,979,4.30000000
CN2612500000000,26,125,"Oakland County, MI",Dec-21,666967,645547,21420,3.20000000
CN2612700000000,26,127,"Oceana County, MI",Dec-21,11067,10343,724,6.50000000
CN2612900000000,26,129,"Ogemaw County, MI",Dec-21,7625,7080,545,7.10000000
CN2613100000000,26,131,"Ontonagon County, MI",Dec-21,2001,1875,126,6.30000000
CN2613300000000,26,133,"Osceola County, MI",Dec-21,11236,10755,481,4.30000000
CN2613500000000,26,135,"Oscoda County, MI",Dec-21,2419,2234,185,7.60000000
CN2613700000000,26,137,"Otsego County, MI",Dec-21,11101,10525,576,5.20000000
CN2613900000000,26,139,"Ottawa County, MI",Dec-21,157002,152421,4581,2.90000000
CN2614100000000,26,141,"Presque Isle County, MI",Dec-21,4659,4333,326,7.00000000
CN2614300000000,26,143,"Roscommon County, MI",Dec-21,7025,6399,626,8.90000000
CN2614500000000,26,145,"Saginaw County, MI",Dec-21,81064,76778,4286,5.30000000
CN2614700000000,26,147,"St. Clair County, MI",Dec-21,74729,71555,3174,4.20000000
CN2614900000000,26,149,"St. Joseph County, MI",Dec-21,27328,26384,944,3.50000000
CN2615100000000,26,151,"Sanilac County, MI",Dec-21,18697,17832,865,4.60000000
CN2615300000000,26,153,"Schoolcraft County, MI",Dec-21,3089,2868,221,7.20000000
CN2615500000000,26,155,"Shiawassee County, MI",Dec-21,31582,30280,1302,4.10000000
CN2615700000000,26,157,"Tuscola County, MI",Dec-21,22417,21350,1067,4.80000000
CN2615900000000,26,159,"Van Buren County, MI",Dec-21,33825,32236,1589,4.70000000
CN2616100000000,26,161,"Washtenaw County, MI",Dec-21,192598,187000,5598,2.90000000
CN2616300000000,26,163,"Wayne County, MI",Dec-21,806245,763751,42494,5.30000000
CN2616500000000,26,165,"Wexford County, MI",Dec-21,14327,13640,687,4.80000000
CN2700100000000,27,001,"Aitkin County, MN",Dec-21,7288,6937,351,4.80000000
CN2700300000000,27,003,"Anoka County, MN",Dec-21,196309,191437,4872,2.50000000
CN2700500000000,27,005,"Becker County, MN",Dec-21,18740,18148,592,3.20000000
CN2700700000000,27,007,"Beltrami County, MN",Dec-21,23993,23209,784,3.30000000
CN2700900000000,27,009,"Benton County, MN",Dec-21,21693,20914,779,3.60000000
CN2701100000000,27,011,"Big Stone County, MN",Dec-21,2379,2310,69,2.90000000
CN2701300000000,27,013,"Blue Earth County, MN",Dec-21,39849,38976,873,2.20000000
CN2701500000000,27,015,"Brown County, MN",Dec-21,13494,13178,316,2.30000000
CN2701700000000,27,017,"Carlton County, MN",Dec-21,17420,16760,660,3.80000000
CN2701900000000,27,019,"Carver County, MN",Dec-21,58753,57576,1177,2.00000000
CN2702100000000,27,021,"Cass County, MN",Dec-21,15230,14532,698,4.60000000
CN2702300000000,27,023,"Chippewa County, MN",Dec-21,6534,6396,138,2.10000000
CN2702500000000,27,025,"Chisago County, MN",Dec-21,29740,28781,959,3.20000000
CN2702700000000,27,027,"Clay County, MN",Dec-21,36738,35983,755,2.10000000
CN2702900000000,27,029,"Clearwater County, MN",Dec-21,4542,4228,314,6.90000000
CN2703100000000,27,031,"Cook County, MN",Dec-21,2716,2594,122,4.50000000
CN2703300000000,27,033,"Cottonwood County, MN",Dec-21,6696,6553,143,2.10000000
CN2703500000000,27,035,"Crow Wing County, MN",Dec-21,31099,29914,1185,3.80000000
CN2703700000000,27,037,"Dakota County, MN",Dec-21,239370,233974,5396,2.30000000
CN2703900000000,27,039,"Dodge County, MN",Dec-21,11933,11624,309,2.60000000
CN2704100000000,27,041,"Douglas County, MN",Dec-21,20681,20159,522,2.50000000
CN2704300000000,27,043,"Faribault County, MN",Dec-21,6913,6694,219,3.20000000
CN2704500000000,27,045,"Fillmore County, MN",Dec-21,11522,11250,272,2.40000000
CN2704700000000,27,047,"Freeborn County, MN",Dec-21,15330,14922,408,2.70000000
CN2704900000000,27,049,"Goodhue County, MN",Dec-21,26283,25631,652,2.50000000
CN2705100000000,27,051,"Grant County, MN",Dec-21,3292,3172,120,3.60000000
CN2705300000000,27,053,"Hennepin County, MN",Dec-21,695630,679478,16152,2.30000000
CN2705500000000,27,055,"Houston County, MN",Dec-21,10386,10151,235,2.30000000
CN2705700000000,27,057,"Hubbard County, MN",Dec-21,9771,9307,464,4.70000000
CN2705900000000,27,059,"Isanti County, MN",Dec-21,21608,20818,790,3.70000000
CN2706100000000,27,061,"Itasca County, MN",Dec-21,20825,19840,985,4.70000000
CN2706300000000,27,063,"Jackson County, MN",Dec-21,5455,5338,117,2.10000000
CN2706500000000,27,065,"Kanabec County, MN",Dec-21,9072,8589,483,5.30000000
CN2706700000000,27,067,"Kandiyohi County, MN",Dec-21,23195,22448,747,3.20000000
CN2706900000000,27,069,"Kittson County, MN",Dec-21,2297,2229,68,3.00000000
CN2707100000000,27,071,"Koochiching County, MN",Dec-21,5533,5320,213,3.80000000
CN2707300000000,27,073,"Lac qui Parle County, MN",Dec-21,3416,3339,77,2.30000000
CN2707500000000,27,075,"Lake County, MN",Dec-21,5081,4936,145,2.90000000
CN2707700000000,27,077,"Lake of the Woods County, MN",Dec-21,2401,2331,70,2.90000000
CN2707900000000,27,079,"Le Sueur County, MN",Dec-21,15954,15289,665,4.20000000
CN2708100000000,27,081,"Lincoln County, MN",Dec-21,3029,2953,76,2.50000000
CN2708300000000,27,083,"Lyon County, MN",Dec-21,14205,13876,329,2.30000000
CN2708500000000,27,085,"McLeod County, MN",Dec-21,18898,18333,565,3.00000000
CN2708700000000,27,087,"Mahnomen County, MN",Dec-21,2251,2113,138,6.10000000
CN2708900000000,27,089,"Marshall County, MN",Dec-21,5359,5092,267,5.00000000
CN2709100000000,27,091,"Martin County, MN",Dec-21,9527,9285,242,2.50000000
CN2709300000000,27,093,"Meeker County, MN",Dec-21,13171,12767,404,3.10000000
CN2709500000000,27,095,"Mille Lacs County, MN",Dec-21,12658,12023,635,5.00000000
CN2709700000000,27,097,"Morrison County, MN",Dec-21,17506,16651,855,4.90000000
CN2709900000000,27,099,"Mower County, MN",Dec-21,20410,19930,480,2.40000000
CN2710100000000,27,101,"Murray County, MN",Dec-21,4691,4532,159,3.40000000
CN2710300000000,27,103,"Nicollet County, MN",Dec-21,20490,20079,411,2.00000000
CN2710500000000,27,105,"Nobles County, MN",Dec-21,11343,11125,218,1.90000000
CN2710700000000,27,107,"Norman County, MN",Dec-21,3359,3243,116,3.50000000
CN2710900000000,27,109,"Olmsted County, MN",Dec-21,90404,88521,1883,2.10000000
CN2711100000000,27,111,"Otter Tail County, MN",Dec-21,30700,29694,1006,3.30000000
CN2711300000000,27,113,"Pennington County, MN",Dec-21,8692,8346,346,4.00000000
CN2711500000000,27,115,"Pine County, MN",Dec-21,14199,13510,689,4.90000000
CN2711700000000,27,117,"Pipestone County, MN",Dec-21,4471,4383,88,2.00000000
CN2711900000000,27,119,"Polk County, MN",Dec-21,15937,15478,459,2.90000000
CN2712100000000,27,121,"Pope County, MN",Dec-21,6318,6161,157,2.50000000
CN2712300000000,27,123,"Ramsey County, MN",Dec-21,282137,274802,7335,2.60000000
CN2712500000000,27,125,"Red Lake County, MN",Dec-21,2189,2112,77,3.50000000
CN2712700000000,27,127,"Redwood County, MN",Dec-21,7567,7371,196,2.60000000
CN2712900000000,27,129,"Renville County, MN",Dec-21,8353,8089,264,3.20000000
CN2713100000000,27,131,"Rice County, MN",Dec-21,36515,35528,987,2.70000000
CN2713300000000,27,133,"Rock County, MN",Dec-21,6026,5933,93,1.50000000
CN2713500000000,27,135,"Roseau County, MN",Dec-21,7962,7755,207,2.60000000
CN2713700000000,27,137,"St. Louis County, MN",Dec-21,98913,95807,3106,3.10000000
CN2713900000000,27,139,"Scott County, MN",Dec-21,83381,81590,1791,2.10000000
CN2714100000000,27,141,"Sherburne County, MN",Dec-21,52633,51141,1492,2.80000000
CN2714300000000,27,143,"Sibley County, MN",Dec-21,8221,7925,296,3.60000000
CN2714500000000,27,145,"Stearns County, MN",Dec-21,89824,87331,2493,2.80000000
CN2714700000000,27,147,"Steele County, MN",Dec-21,19696,19174,522,2.70000000
CN2714900000000,27,149,"Stevens County, MN",Dec-21,5341,5214,127,2.40000000
CN2715100000000,27,151,"Swift County, MN",Dec-21,4773,4614,159,3.30000000
CN2715300000000,27,153,"Todd County, MN",Dec-21,13523,13063,460,3.40000000
CN2715500000000,27,155,"Traverse County, MN",Dec-21,1701,1654,47,2.80000000
CN2715700000000,27,157,"Wabasha County, MN",Dec-21,12244,11950,294,2.40000000
CN2715900000000,27,159,"Wadena County, MN",Dec-21,5966,5705,261,4.40000000
CN2716100000000,27,161,"Waseca County, MN",Dec-21,8643,8367,276,3.20000000
CN2716300000000,27,163,"Washington County, MN",Dec-21,143158,140133,3025,2.10000000
CN2716500000000,27,165,"Watonwan County, MN",Dec-21,6568,6434,134,2.00000000
CN2716700000000,27,167,"Wilkin County, MN",Dec-21,3390,3323,67,2.00000000
CN2716900000000,27,169,"Winona County, MN",Dec-21,27548,26969,579,2.10000000
CN2717100000000,27,171,"Wright County, MN",Dec-21,75917,73984,1933,2.50000000
CN2717300000000,27,173,"Yellow Medicine County, MN",Dec-21,5122,4992,130,2.50000000
CN2800100000000,28,001,"Adams County, MS",Dec-21,10644,10075,569,5.30000000
CN2800300000000,28,003,"Alcorn County, MS",Dec-21,15343,14893,450,2.90000000
CN2800500000000,28,005,"Amite County, MS",Dec-21,4328,4097,231,5.30000000
CN2800700000000,28,007,"Attala County, MS",Dec-21,7024,6761,263,3.70000000
CN2800900000000,28,009,"Benton County, MS",Dec-21,3049,2928,121,4.00000000
CN2801100000000,28,011,"Bolivar County, MS",Dec-21,11073,10591,482,4.40000000
CN2801300000000,28,013,"Calhoun County, MS",Dec-21,5248,5078,170,3.20000000
CN2801500000000,28,015,"Carroll County, MS",Dec-21,3524,3391,133,3.80000000
CN2801700000000,28,017,"Chickasaw County, MS",Dec-21,6818,6556,262,3.80000000
CN2801900000000,28,019,"Choctaw County, MS",Dec-21,3504,3392,112,3.20000000
CN2802100000000,28,021,"Claiborne County, MS",Dec-21,2877,2657,220,7.60000000
CN2802300000000,28,023,"Clarke County, MS",Dec-21,5596,5360,236,4.20000000
CN2802500000000,28,025,"Clay County, MS",Dec-21,8076,7708,368,4.60000000
CN2802700000000,28,027,"Coahoma County, MS",Dec-21,7700,7269,431,5.60000000
CN2802900000000,28,029,"Copiah County, MS",Dec-21,10624,10193,431,4.10000000
CN2803100000000,28,031,"Covington County, MS",Dec-21,8109,7859,250,3.10000000
CN2803300000000,28,033,"DeSoto County, MS",Dec-21,94044,91466,2578,2.70000000
CN2803500000000,28,035,"Forrest County, MS",Dec-21,33275,32154,1121,3.40000000
CN2803700000000,28,037,"Franklin County, MS",Dec-21,2582,2457,125,4.80000000
CN2803900000000,28,039,"George County, MS",Dec-21,8499,8073,426,5.00000000
CN2804100000000,28,041,"Greene County, MS",Dec-21,4098,3868,230,5.60000000
CN2804300000000,28,043,"Grenada County, MS",Dec-21,8967,8696,271,3.00000000
CN2804500000000,28,045,"Hancock County, MS",Dec-21,18952,18245,707,3.70000000
CN2804700000000,28,047,"Harrison County, MS",Dec-21,87119,84109,3010,3.50000000
CN2804900000000,28,049,"Hinds County, MS",Dec-21,101071,97193,3878,3.80000000
CN2805100000000,28,051,"Holmes County, MS",Dec-21,4963,4612,351,7.10000000
CN2805300000000,28,053,"Humphreys County, MS",Dec-21,1896,1735,161,8.50000000
CN2805500000000,28,055,"Issaquena County, MS",Dec-21,304,281,23,7.60000000
CN2805700000000,28,057,"Itawamba County, MS",Dec-21,10309,10038,271,2.60000000
CN2805900000000,28,059,"Jackson County, MS",Dec-21,58443,56072,2371,4.10000000
CN2806100000000,28,061,"Jasper County, MS",Dec-21,5682,5411,271,4.80000000
CN2806300000000,28,063,"Jefferson County, MS",Dec-21,1823,1593,230,12.60000000
CN2806500000000,28,065,"Jefferson Davis County, MS",Dec-21,3844,3648,196,5.10000000
CN2806700000000,28,067,"Jones County, MS",Dec-21,24217,23357,860,3.60000000
CN2806900000000,28,069,"Kemper County, MS",Dec-21,3201,3040,161,5.00000000
CN2807100000000,28,071,"Lafayette County, MS",Dec-21,27636,26962,674,2.40000000
CN2807300000000,28,073,"Lamar County, MS",Dec-21,31662,30827,835,2.60000000
CN2807500000000,28,075,"Lauderdale County, MS",Dec-21,28830,27827,1003,3.50000000
CN2807700000000,28,077,"Lawrence County, MS",Dec-21,4517,4299,218,4.80000000
CN2807900000000,28,079,"Leake County, MS",Dec-21,7822,7541,281,3.60000000
CN2808100000000,28,081,"Lee County, MS",Dec-21,41225,40074,1151,2.80000000
CN2808300000000,28,083,"Leflore County, MS",Dec-21,10012,9506,506,5.10000000
CN2808500000000,28,085,"Lincoln County, MS",Dec-21,14907,14413,494,3.30000000
CN2808700000000,28,087,"Lowndes County, MS",Dec-21,25090,24143,947,3.80000000
CN2808900000000,28,089,"Madison County, MS",Dec-21,52805,51387,1418,2.70000000
CN2809100000000,28,091,"Marion County, MS",Dec-21,10375,10036,339,3.30000000
CN2809300000000,28,093,"Marshall County, MS",Dec-21,14272,13769,503,3.50000000
CN2809500000000,28,095,"Monroe County, MS",Dec-21,15821,15296,525,3.30000000
CN2809700000000,28,097,"Montgomery County, MS",Dec-21,3869,3718,151,3.90000000
CN2809900000000,28,099,"Neshoba County, MS",Dec-21,9831,9455,376,3.80000000
CN2810100000000,28,101,"Newton County, MS",Dec-21,8149,7866,283,3.50000000
CN2810300000000,28,103,"Noxubee County, MS",Dec-21,3448,3232,216,6.30000000
CN2810500000000,28,105,"Oktibbeha County, MS",Dec-21,22230,21486,744,3.30000000
CN2810700000000,28,107,"Panola County, MS",Dec-21,12578,12016,562,4.50000000
CN2810900000000,28,109,"Pearl River County, MS",Dec-21,23257,22433,824,3.50000000
CN2811100000000,28,111,"Perry County, MS",Dec-21,4230,4047,183,4.30000000
CN2811300000000,28,113,"Pike County, MS",Dec-21,14205,13543,662,4.70000000
CN2811500000000,28,115,"Pontotoc County, MS",Dec-21,14994,14599,395,2.60000000
CN2811700000000,28,117,"Prentiss County, MS",Dec-21,11363,11055,308,2.70000000
CN2811900000000,28,119,"Quitman County, MS",Dec-21,2245,2127,118,5.30000000
CN2812100000000,28,121,"Rankin County, MS",Dec-21,75673,73879,1794,2.40000000
CN2812300000000,28,123,"Scott County, MS",Dec-21,12128,11772,356,2.90000000
CN2812500000000,28,125,"Sharkey County, MS",Dec-21,1322,1239,83,6.30000000
CN2812700000000,28,127,"Simpson County, MS",Dec-21,10444,10094,350,3.40000000
CN2812900000000,28,129,"Smith County, MS",Dec-21,6524,6332,192,2.90000000
CN2813100000000,28,131,"Stone County, MS",Dec-21,6898,6638,260,3.80000000
CN2813300000000,28,133,"Sunflower County, MS",Dec-21,7215,6789,426,5.90000000
CN2813500000000,28,135,"Tallahatchie County, MS",Dec-21,4637,4452,185,4.00000000
CN2813700000000,28,137,"Tate County, MS",Dec-21,12119,11713,406,3.40000000
CN2813900000000,28,139,"Tippah County, MS",Dec-21,9579,9312,267,2.80000000
CN2814100000000,28,141,"Tishomingo County, MS",Dec-21,8344,8083,261,3.10000000
CN2814300000000,28,143,"Tunica County, MS",Dec-21,4207,3969,238,5.70000000
CN2814500000000,28,145,"Union County, MS",Dec-21,14357,14016,341,2.40000000
CN2814700000000,28,147,"Walthall County, MS",Dec-21,4893,4673,220,4.50000000
CN2814900000000,28,149,"Warren County, MS",Dec-21,19209,18435,774,4.00000000
CN2815100000000,28,151,"Washington County, MS",Dec-21,15610,14762,848,5.40000000
CN2815300000000,28,153,"Wayne County, MS",Dec-21,7279,6961,318,4.40000000
CN2815500000000,28,155,"Webster County, MS",Dec-21,3883,3752,131,3.40000000
CN2815700000000,28,157,"Wilkinson County, MS",Dec-21,2602,2408,194,7.50000000
CN2815900000000,28,159,"Winston County, MS",Dec-21,6979,6693,286,4.10000000
CN2816100000000,28,161,"Yalobusha County, MS",Dec-21,4835,4673,162,3.40000000
CN2816300000000,28,163,"Yazoo County, MS",Dec-21,8769,8353,416,4.70000000
CN2900100000000,29,001,"Adair County, MO",Dec-21,9849,9524,325,3.30000000
CN2900300000000,29,003,"Andrew County, MO",Dec-21,9728,9493,235,2.40000000
CN2900500000000,29,005,"Atchison County, MO",Dec-21,2604,2527,77,3.00000000
CN2900700000000,29,007,"Audrain County, MO",Dec-21,10277,9951,326,3.20000000
CN2900900000000,29,009,"Barry County, MO",Dec-21,14822,14279,543,3.70000000
CN2901100000000,29,011,"Barton County, MO",Dec-21,5154,5004,150,2.90000000
CN2901300000000,29,013,"Bates County, MO",Dec-21,7571,7306,265,3.50000000
CN2901500000000,29,015,"Benton County, MO",Dec-21,7261,6924,337,4.60000000
CN2901700000000,29,017,"Bollinger County, MO",Dec-21,5369,5189,180,3.40000000
CN2901900000000,29,019,"Boone County, MO",Dec-21,100630,98278,2352,2.30000000
CN2902100000000,29,021,"Buchanan County, MO",Dec-21,43668,42376,1292,3.00000000
CN2902300000000,29,023,"Butler County, MO",Dec-21,18307,17637,670,3.70000000
CN2902500000000,29,025,"Caldwell County, MO",Dec-21,4201,4060,141,3.40000000
CN2902700000000,29,027,"Callaway County, MO",Dec-21,21335,20754,581,2.70000000
CN2902900000000,29,029,"Camden County, MO",Dec-21,18581,17733,848,4.60000000
CN2903100000000,29,031,"Cape Girardeau County, MO",Dec-21,40959,39825,1134,2.80000000
CN2903300000000,29,033,"Carroll County, MO",Dec-21,4420,4255,165,3.70000000
CN2903500000000,29,035,"Carter County, MO",Dec-21,2540,2432,108,4.30000000
CN2903700000000,29,037,"Cass County, MO",Dec-21,54340,52718,1622,3.00000000
CN2903900000000,29,039,"Cedar County, MO",Dec-21,5711,5541,170,3.00000000
CN2904100000000,29,041,"Chariton County, MO",Dec-21,3756,3661,95,2.50000000
CN2904300000000,29,043,"Christian County, MO",Dec-21,47148,45970,1178,2.50000000
CN2904500000000,29,045,"Clark County, MO",Dec-21,3054,2949,105,3.40000000
CN2904700000000,29,047,"Clay County, MO",Dec-21,137562,132762,4800,3.50000000
CN2904900000000,29,049,"Clinton County, MO",Dec-21,10480,10108,372,3.50000000
CN2905100000000,29,051,"Cole County, MO",Dec-21,38812,37860,952,2.50000000
CN2905300000000,29,053,"Cooper County, MO",Dec-21,7049,6848,201,2.90000000
CN2905500000000,29,055,"Crawford County, MO",Dec-21,10766,10385,381,3.50000000
CN2905700000000,29,057,"Dade County, MO",Dec-21,3471,3380,91,2.60000000
CN2905900000000,29,059,"Dallas County, MO",Dec-21,7176,6918,258,3.60000000
CN2906100000000,29,061,"Daviess County, MO",Dec-21,3982,3865,117,2.90000000
CN2906300000000,29,063,"DeKalb County, MO",Dec-21,4131,4017,114,2.80000000
CN2906500000000,29,065,"Dent County, MO",Dec-21,6186,5950,236,3.80000000
CN2906700000000,29,067,"Douglas County, MO",Dec-21,5157,4986,171,3.30000000
CN2906900000000,29,069,"Dunklin County, MO",Dec-21,10933,10410,523,4.80000000
CN2907100000000,29,071,"Franklin County, MO",Dec-21,53013,51359,1654,3.10000000
CN2907300000000,29,073,"Gasconade County, MO",Dec-21,7623,7417,206,2.70000000
CN2907500000000,29,075,"Gentry County, MO",Dec-21,3254,3182,72,2.20000000
CN2907700000000,29,077,"Greene County, MO",Dec-21,153771,149701,4070,2.60000000
CN2907900000000,29,079,"Grundy County, MO",Dec-21,4106,3979,127,3.10000000
CN2908100000000,29,081,"Harrison County, MO",Dec-21,3725,3618,107,2.90000000
CN2908300000000,29,083,"Henry County, MO",Dec-21,10021,9727,294,2.90000000
CN2908500000000,29,085,"Hickory County, MO",Dec-21,3898,3760,138,3.50000000
CN2908700000000,29,087,"Holt County, MO",Dec-21,2406,2353,53,2.20000000
CN2908900000000,29,089,"Howard County, MO",Dec-21,4849,4720,129,2.70000000
CN2909100000000,29,091,"Howell County, MO",Dec-21,16262,15657,605,3.70000000
CN2909300000000,29,093,"Iron County, MO",Dec-21,3451,3282,169,4.90000000
CN2909500000000,29,095,"Jackson County, MO",Dec-21,358046,343818,14228,4.00000000
CN2909700000000,29,097,"Jasper County, MO",Dec-21,57671,56019,1652,2.90000000
CN2909900000000,29,099,"Jefferson County, MO",Dec-21,118507,114793,3714,3.10000000
CN2910100000000,29,101,"Johnson County, MO",Dec-21,22915,22181,734,3.20000000
CN2910300000000,29,103,"Knox County, MO",Dec-21,1716,1669,47,2.70000000
CN2910500000000,29,105,"Laclede County, MO",Dec-21,16357,15776,581,3.60000000
CN2910700000000,29,107,"Lafayette County, MO",Dec-21,16473,15954,519,3.20000000
CN2910900000000,29,109,"Lawrence County, MO",Dec-21,17332,16821,511,2.90000000
CN2911100000000,29,111,"Lewis County, MO",Dec-21,4780,4643,137,2.90000000
CN2911300000000,29,113,"Lincoln County, MO",Dec-21,29684,28291,1393,4.70000000
CN2911500000000,29,115,"Linn County, MO",Dec-21,5005,4811,194,3.90000000
CN2911700000000,29,117,"Livingston County, MO",Dec-21,7201,7025,176,2.40000000
CN2911900000000,29,119,"McDonald County, MO",Dec-21,10785,10458,327,3.00000000
CN2912100000000,29,121,"Macon County, MO",Dec-21,7375,7157,218,3.00000000
CN2912300000000,29,123,"Madison County, MO",Dec-21,5467,5279,188,3.40000000
CN2912500000000,29,125,"Maries County, MO",Dec-21,3908,3793,115,2.90000000
CN2912700000000,29,127,"Marion County, MO",Dec-21,14142,13757,385,2.70000000
CN2912900000000,29,129,"Mercer County, MO",Dec-21,1739,1692,47,2.70000000
CN2913100000000,29,131,"Miller County, MO",Dec-21,12479,12076,403,3.20000000
CN2913300000000,29,133,"Mississippi County, MO",Dec-21,5268,5081,187,3.50000000
CN2913500000000,29,135,"Moniteau County, MO",Dec-21,6963,6766,197,2.80000000
CN2913700000000,29,137,"Monroe County, MO",Dec-21,3734,3596,138,3.70000000
CN2913900000000,29,139,"Montgomery County, MO",Dec-21,5800,5593,207,3.60000000
CN2914100000000,29,141,"Morgan County, MO",Dec-21,8515,8189,326,3.80000000
CN2914300000000,29,143,"New Madrid County, MO",Dec-21,8148,7842,306,3.80000000
CN2914500000000,29,145,"Newton County, MO",Dec-21,27283,26469,814,3.00000000
CN2914700000000,29,147,"Nodaway County, MO",Dec-21,10888,10657,231,2.10000000
CN2914900000000,29,149,"Oregon County, MO",Dec-21,3810,3640,170,4.50000000
CN2915100000000,29,151,"Osage County, MO",Dec-21,6967,6810,157,2.30000000
CN2915300000000,29,153,"Ozark County, MO",Dec-21,3341,3156,185,5.50000000
CN2915500000000,29,155,"Pemiscot County, MO",Dec-21,5869,5542,327,5.60000000
CN2915700000000,29,157,"Perry County, MO",Dec-21,9735,9483,252,2.60000000
CN2915900000000,29,159,"Pettis County, MO",Dec-21,20116,19496,620,3.10000000
CN2916100000000,29,161,"Phelps County, MO",Dec-21,20145,19564,581,2.90000000
CN2916300000000,29,163,"Pike County, MO",Dec-21,7405,7163,242,3.30000000
CN2916500000000,29,165,"Platte County, MO",Dec-21,59299,57538,1761,3.00000000
CN2916700000000,29,167,"Polk County, MO",Dec-21,14702,14286,416,2.80000000
CN2916900000000,29,169,"Pulaski County, MO",Dec-21,14552,14007,545,3.70000000
CN2917100000000,29,171,"Putnam County, MO",Dec-21,2150,2095,55,2.60000000
CN2917300000000,29,173,"Ralls County, MO",Dec-21,5554,5407,147,2.60000000
CN2917500000000,29,175,"Randolph County, MO",Dec-21,10359,10027,332,3.20000000
CN2917700000000,29,177,"Ray County, MO",Dec-21,10831,10336,495,4.60000000
CN2917900000000,29,179,"Reynolds County, MO",Dec-21,2869,2762,107,3.70000000
CN2918100000000,29,181,"Ripley County, MO",Dec-21,5062,4846,216,4.30000000
CN2918300000000,29,183,"St. Charles County, MO",Dec-21,229640,222515,7125,3.10000000
CN2918500000000,29,185,"St. Clair County, MO",Dec-21,3835,3691,144,3.80000000
CN2918600000000,29,186,"Ste. Genevieve County, MO",Dec-21,9185,8918,267,2.90000000
CN2918700000000,29,187,"St. Francois County, MO",Dec-21,26072,25046,1026,3.90000000
CN2918900000000,29,189,"St. Louis County, MO",Dec-21,529251,510684,18567,3.50000000
CN2919500000000,29,195,"Saline County, MO",Dec-21,10506,10206,300,2.90000000
CN2919700000000,29,197,"Schuyler County, MO",Dec-21,1798,1739,59,3.30000000
CN2919900000000,29,199,"Scotland County, MO",Dec-21,2247,2198,49,2.20000000
CN2920100000000,29,201,"Scott County, MO",Dec-21,20103,19493,610,3.00000000
CN2920300000000,29,203,"Shannon County, MO",Dec-21,3284,3116,168,5.10000000
CN2920500000000,29,205,"Shelby County, MO",Dec-21,2927,2853,74,2.50000000
CN2920700000000,29,207,"Stoddard County, MO",Dec-21,13222,12756,466,3.50000000
CN2920900000000,29,209,"Stone County, MO",Dec-21,13617,12979,638,4.70000000
CN2921100000000,29,211,"Sullivan County, MO",Dec-21,2567,2469,98,3.80000000
CN2921300000000,29,213,"Taney County, MO",Dec-21,26029,24749,1280,4.90000000
CN2921500000000,29,215,"Texas County, MO",Dec-21,8942,8591,351,3.90000000
CN2921700000000,29,217,"Vernon County, MO",Dec-21,9378,9115,263,2.80000000
CN2921900000000,29,219,"Warren County, MO",Dec-21,18915,18177,738,3.90000000
CN2922100000000,29,221,"Washington County, MO",Dec-21,10114,9708,406,4.00000000
CN2922300000000,29,223,"Wayne County, MO",Dec-21,4754,4550,204,4.30000000
CN2922500000000,29,225,"Webster County, MO",Dec-21,17480,17004,476,2.70000000
CN2922700000000,29,227,"Worth County, MO",Dec-21,1171,1145,26,2.20000000
CN2922900000000,29,229,"Wright County, MO",Dec-21,7512,7266,246,3.30000000
CN2951000000000,29,510,"St. Louis city, MO",Dec-21,150418,143212,7206,4.80000000
CN3000100000000,30,001,"Beaverhead County, MT",Dec-21,5166,5033,133,2.60000000
CN3000300000000,30,003,"Big Horn County, MT",Dec-21,4604,4352,252,5.50000000
CN3000500000000,30,005,"Blaine County, MT",Dec-21,2274,2204,70,3.10000000
CN3000700000000,30,007,"Broadwater County, MT",Dec-21,2675,2587,88,3.30000000
CN3000900000000,30,009,"Carbon County, MT",Dec-21,5748,5597,151,2.60000000
CN3001100000000,30,011,"Carter County, MT",Dec-21,692,677,15,2.20000000
CN3001300000000,30,013,"Cascade County, MT",Dec-21,38163,37246,917,2.40000000
CN3001500000000,30,015,"Chouteau County, MT",Dec-21,2528,2475,53,2.10000000
CN3001700000000,30,017,"Custer County, MT",Dec-21,6205,6064,141,2.30000000
CN3001900000000,30,019,"Daniels County, MT",Dec-21,895,881,14,1.60000000
CN3002100000000,30,021,"Dawson County, MT",Dec-21,4570,4475,95,2.10000000
CN3002300000000,30,023,"Deer Lodge County, MT",Dec-21,4990,4861,129,2.60000000
CN3002500000000,30,025,"Fallon County, MT",Dec-21,1637,1606,31,1.90000000
CN3002700000000,30,027,"Fergus County, MT",Dec-21,5878,5696,182,3.10000000
CN3002900000000,30,029,"Flathead County, MT",Dec-21,50901,49308,1593,3.10000000
CN3003100000000,30,031,"Gallatin County, MT",Dec-21,74232,72898,1334,1.80000000
CN3003300000000,30,033,"Garfield County, MT",Dec-21,788,765,23,2.90000000
CN3003500000000,30,035,"Glacier County, MT",Dec-21,5430,5145,285,5.20000000
CN3003700000000,30,037,"Golden Valley County, MT",Dec-21,379,368,11,2.90000000
CN3003900000000,30,039,"Granite County, MT",Dec-21,1669,1601,68,4.10000000
CN3004100000000,30,041,"Hill County, MT",Dec-21,7552,7380,172,2.30000000
CN3004300000000,30,043,"Jefferson County, MT",Dec-21,5884,5747,137,2.30000000
CN3004500000000,30,045,"Judith Basin County, MT",Dec-21,1019,995,24,2.40000000
CN3004700000000,30,047,"Lake County, MT",Dec-21,14012,13601,411,2.90000000
CN3004900000000,30,049,"Lewis and Clark County, MT",Dec-21,37064,36207,857,2.30000000
CN3005100000000,30,051,"Liberty County, MT",Dec-21,1020,998,22,2.20000000
CN3005300000000,30,053,"Lincoln County, MT",Dec-21,7985,7575,410,5.10000000
CN3005500000000,30,055,"McCone County, MT",Dec-21,1003,990,13,1.30000000
CN3005700000000,30,057,"Madison County, MT",Dec-21,5151,5041,110,2.10000000
CN3005900000000,30,059,"Meagher County, MT",Dec-21,1046,1023,23,2.20000000
CN3006100000000,30,061,"Mineral County, MT",Dec-21,1832,1720,112,6.10000000
CN3006300000000,30,063,"Missoula County, MT",Dec-21,65872,64126,1746,2.70000000
CN3006500000000,30,065,"Musselshell County, MT",Dec-21,2382,2306,76,3.20000000
CN3006700000000,30,067,"Park County, MT",Dec-21,9025,8761,264,2.90000000
CN3006900000000,30,069,"Petroleum County, MT",Dec-21,284,278,6,2.10000000
CN3007100000000,30,071,"Phillips County, MT",Dec-21,1874,1819,55,2.90000000
CN3007300000000,30,073,"Pondera County, MT",Dec-21,2658,2600,58,2.20000000
CN3007500000000,30,075,"Powder River County, MT",Dec-21,1018,995,23,2.30000000
CN3007700000000,30,077,"Powell County, MT",Dec-21,3055,2995,60,2.00000000
CN3007900000000,30,079,"Prairie County, MT",Dec-21,509,496,13,2.60000000
CN3008100000000,30,081,"Ravalli County, MT",Dec-21,21243,20613,630,3.00000000
CN3008300000000,30,083,"Richland County, MT",Dec-21,5976,5828,148,2.50000000
CN3008500000000,30,085,"Roosevelt County, MT",Dec-21,4311,4186,125,2.90000000
CN3008700000000,30,087,"Rosebud County, MT",Dec-21,3531,3422,109,3.10000000
CN3008900000000,30,089,"Sanders County, MT",Dec-21,5172,4954,218,4.20000000
CN3009100000000,30,091,"Sheridan County, MT",Dec-21,1784,1749,35,2.00000000
CN3009300000000,30,093,"Silver Bow County, MT",Dec-21,17363,16886,477,2.70000000
CN3009500000000,30,095,"Stillwater County, MT",Dec-21,5541,5424,117,2.10000000
CN3009700000000,30,097,"Sweet Grass County, MT",Dec-21,1944,1913,31,1.60000000
CN3009900000000,30,099,"Teton County, MT",Dec-21,2868,2795,73,2.50000000
CN3010100000000,30,101,"Toole County, MT",Dec-21,2056,2016,40,1.90000000
CN3010300000000,30,103,"Treasure County, MT",Dec-21,351,343,8,2.30000000
CN3010500000000,30,105,"Valley County, MT",Dec-21,4065,3970,95,2.30000000
CN3010700000000,30,107,"Wheatland County, MT",Dec-21,784,755,29,3.70000000
CN3010900000000,30,109,"Wibaux County, MT",Dec-21,416,404,12,2.90000000
CN3011100000000,30,111,"Yellowstone County, MT",Dec-21,85229,83267,1962,2.30000000
CN3100100000000,31,001,"Adams County, NE",Dec-21,16828,16493,335,2.00000000
CN3100300000000,31,003,"Antelope County, NE",Dec-21,3710,3664,46,1.20000000
CN3100500000000,31,005,"Arthur County, NE",Dec-21,237,233,4,1.70000000
CN3100700000000,31,007,"Banner County, NE",Dec-21,401,392,9,2.20000000
CN3100900000000,31,009,"Blaine County, NE",Dec-21,252,245,7,2.80000000
CN3101100000000,31,011,"Boone County, NE",Dec-21,2984,2955,29,1.00000000
CN3101300000000,31,013,"Box Butte County, NE",Dec-21,5442,5341,101,1.90000000
CN3101500000000,31,015,"Boyd County, NE",Dec-21,1060,1040,20,1.90000000
CN3101700000000,31,017,"Brown County, NE",Dec-21,1426,1401,25,1.80000000
CN3101900000000,31,019,"Buffalo County, NE",Dec-21,28515,28161,354,1.20000000
CN3102100000000,31,021,"Burt County, NE",Dec-21,3770,3700,70,1.90000000
CN3102300000000,31,023,"Butler County, NE",Dec-21,4707,4648,59,1.30000000
CN3102500000000,31,025,"Cass County, NE",Dec-21,13620,13385,235,1.70000000
CN3102700000000,31,027,"Cedar County, NE",Dec-21,4719,4667,52,1.10000000
CN3102900000000,31,029,"Chase County, NE",Dec-21,2283,2260,23,1.00000000
CN3103100000000,31,031,"Cherry County, NE",Dec-21,3445,3410,35,1.00000000
CN3103300000000,31,033,"Cheyenne County, NE",Dec-21,4248,4165,83,2.00000000
CN3103500000000,31,035,"Clay County, NE",Dec-21,3257,3199,58,1.80000000
CN3103700000000,31,037,"Colfax County, NE",Dec-21,5767,5693,74,1.30000000
CN3103900000000,31,039,"Cuming County, NE",Dec-21,4973,4918,55,1.10000000
CN3104100000000,31,041,"Custer County, NE",Dec-21,6456,6385,71,1.10000000
CN3104300000000,31,043,"Dakota County, NE",Dec-21,10953,10692,261,2.40000000
CN3104500000000,31,045,"Dawes County, NE",Dec-21,5094,5032,62,1.20000000
CN3104700000000,31,047,"Dawson County, NE",Dec-21,13629,13397,232,1.70000000
CN3104900000000,31,049,"Deuel County, NE",Dec-21,983,966,17,1.70000000
CN3105100000000,31,051,"Dixon County, NE",Dec-21,3032,2982,50,1.60000000
CN3105300000000,31,053,"Dodge County, NE",Dec-21,20379,20025,354,1.70000000
CN3105500000000,31,055,"Douglas County, NE",Dec-21,305083,298455,6628,2.20000000
CN3105700000000,31,057,"Dundy County, NE",Dec-21,1183,1170,13,1.10000000
CN3105900000000,31,059,"Fillmore County, NE",Dec-21,3301,3254,47,1.40000000
CN3106100000000,31,061,"Franklin County, NE",Dec-21,1519,1495,24,1.60000000
CN3106300000000,31,063,"Frontier County, NE",Dec-21,1616,1596,20,1.20000000
CN3106500000000,31,065,"Furnas County, NE",Dec-21,2567,2531,36,1.40000000
CN3106700000000,31,067,"Gage County, NE",Dec-21,10958,10780,178,1.60000000
CN3106900000000,31,069,"Garden County, NE",Dec-21,1142,1121,21,1.80000000
CN3107100000000,31,071,"Garfield County, NE",Dec-21,1141,1125,16,1.40000000
CN3107300000000,31,073,"Gosper County, NE",Dec-21,1185,1170,15,1.30000000
CN3107500000000,31,075,"Grant County, NE",Dec-21,435,431,4,0.90000000
CN3107700000000,31,077,"Greeley County, NE",Dec-21,1251,1231,20,1.60000000
CN3107900000000,31,079,"Hall County, NE",Dec-21,32438,31766,672,2.10000000
CN3108100000000,31,081,"Hamilton County, NE",Dec-21,4863,4796,67,1.40000000
CN3108300000000,31,083,"Harlan County, NE",Dec-21,1768,1745,23,1.30000000
CN3108500000000,31,085,"Hayes County, NE",Dec-21,635,628,7,1.10000000
CN3108700000000,31,087,"Hitchcock County, NE",Dec-21,1330,1306,24,1.80000000
CN3108900000000,31,089,"Holt County, NE",Dec-21,5771,5697,74,1.30000000
CN3109100000000,31,091,"Hooker County, NE",Dec-21,394,387,7,1.80000000
CN3109300000000,31,093,"Howard County, NE",Dec-21,3453,3395,58,1.70000000
CN3109500000000,31,095,"Jefferson County, NE",Dec-21,4260,4214,46,1.10000000
CN3109700000000,31,097,"Johnson County, NE",Dec-21,2003,1968,35,1.70000000
CN3109900000000,31,099,"Kearney County, NE",Dec-21,3850,3808,42,1.10000000
CN3110100000000,31,101,"Keith County, NE",Dec-21,4720,4654,66,1.40000000
CN3110300000000,31,103,"Keya Paha County, NE",Dec-21,612,604,8,1.30000000
CN3110500000000,31,105,"Kimball County, NE",Dec-21,1961,1930,31,1.60000000
CN3110700000000,31,107,"Knox County, NE",Dec-21,4728,4661,67,1.40000000
CN3110900000000,31,109,"Lancaster County, NE",Dec-21,179296,176400,2896,1.60000000
CN3111100000000,31,111,"Lincoln County, NE",Dec-21,18464,18184,280,1.50000000
CN3111300000000,31,113,"Logan County, NE",Dec-21,478,471,7,1.50000000
CN3111500000000,31,115,"Loup County, NE",Dec-21,409,400,9,2.20000000
CN3111700000000,31,117,"McPherson County, NE",Dec-21,439,435,4,0.90000000
CN3111900000000,31,119,"Madison County, NE",Dec-21,20128,19841,287,1.40000000
CN3112100000000,31,121,"Merrick County, NE",Dec-21,4155,4089,66,1.60000000
CN3112300000000,31,123,"Morrill County, NE",Dec-21,2629,2581,48,1.80000000
CN3112500000000,31,125,"Nance County, NE",Dec-21,1982,1955,27,1.40000000
CN3112700000000,31,127,"Nemaha County, NE",Dec-21,3706,3651,55,1.50000000
CN3112900000000,31,129,"Nuckolls County, NE",Dec-21,2537,2499,38,1.50000000
CN3113100000000,31,131,"Otoe County, NE",Dec-21,8590,8456,134,1.60000000
CN3113300000000,31,133,"Pawnee County, NE",Dec-21,1549,1525,24,1.50000000
CN3113500000000,31,135,"Perkins County, NE",Dec-21,1886,1869,17,0.90000000
CN3113700000000,31,137,"Phelps County, NE",Dec-21,4984,4926,58,1.20000000
CN3113900000000,31,139,"Pierce County, NE",Dec-21,4193,4142,51,1.20000000
CN3114100000000,31,141,"Platte County, NE",Dec-21,18517,18261,256,1.40000000
CN3114300000000,31,143,"Polk County, NE",Dec-21,2980,2942,38,1.30000000
CN3114500000000,31,145,"Red Willow County, NE",Dec-21,5864,5789,75,1.30000000
CN3114700000000,31,147,"Richardson County, NE",Dec-21,4296,4229,67,1.60000000
CN3114900000000,31,149,"Rock County, NE",Dec-21,909,901,8,0.90000000
CN3115100000000,31,151,"Saline County, NE",Dec-21,7276,7147,129,1.80000000
CN3115300000000,31,153,"Sarpy County, NE",Dec-21,99326,97619,1707,1.70000000
CN3115500000000,31,155,"Saunders County, NE",Dec-21,11561,11377,184,1.60000000
CN3115700000000,31,157,"Scotts Bluff County, NE",Dec-21,17996,17631,365,2.00000000
CN3115900000000,31,159,"Seward County, NE",Dec-21,8870,8743,127,1.40000000
CN3116100000000,31,161,"Sheridan County, NE",Dec-21,2786,2754,32,1.10000000
CN3116300000000,31,163,"Sherman County, NE",Dec-21,1706,1685,21,1.20000000
CN3116500000000,31,165,"Sioux County, NE",Dec-21,783,772,11,1.40000000
CN3116700000000,31,167,"Stanton County, NE",Dec-21,3639,3595,44,1.20000000
CN3116900000000,31,169,"Thayer County, NE",Dec-21,2742,2708,34,1.20000000
CN3117100000000,31,171,"Thomas County, NE",Dec-21,430,418,12,2.80000000
CN3117300000000,31,173,"Thurston County, NE",Dec-21,3149,3067,82,2.60000000
CN3117500000000,31,175,"Valley County, NE",Dec-21,2125,2091,34,1.60000000
CN3117700000000,31,177,"Washington County, NE",Dec-21,11435,11273,162,1.40000000
CN3117900000000,31,179,"Wayne County, NE",Dec-21,5845,5771,74,1.30000000
CN3118100000000,31,181,"Webster County, NE",Dec-21,1669,1644,25,1.50000000
CN3118300000000,31,183,"Wheeler County, NE",Dec-21,585,581,4,0.70000000
CN3118500000000,31,185,"York County, NE",Dec-21,7291,7197,94,1.30000000
CN3200100000000,32,001,"Churchill County, NV",Dec-21,10479,10244,235,2.20000000
CN3200300000000,32,003,"Clark County, NV",Dec-21,1093227,1039029,54198,5.00000000
CN3200500000000,32,005,"Douglas County, NV",Dec-21,20964,20373,591,2.80000000
CN3200700000000,32,007,"Elko County, NV",Dec-21,24061,23575,486,2.00000000
CN3200900000000,32,009,"Esmeralda County, NV",Dec-21,373,363,10,2.70000000
CN3201100000000,32,011,"Eureka County, NV",Dec-21,882,866,16,1.80000000
CN3201300000000,32,013,"Humboldt County, NV",Dec-21,7431,7281,150,2.00000000
CN3201500000000,32,015,"Lander County, NV",Dec-21,2967,2901,66,2.20000000
CN3201700000000,32,017,"Lincoln County, NV",Dec-21,2011,1969,42,2.10000000
CN3201900000000,32,019,"Lyon County, NV",Dec-21,22562,21819,743,3.30000000
CN3202100000000,32,021,"Mineral County, NV",Dec-21,1984,1933,51,2.60000000
CN3202300000000,32,023,"Nye County, NV",Dec-21,16524,15856,668,4.00000000
CN3202700000000,32,027,"Pershing County, NV",Dec-21,2326,2266,60,2.60000000
CN3202900000000,32,029,"Storey County, NV",Dec-21,2013,1962,51,2.50000000
CN3203100000000,32,031,"Washoe County, NV",Dec-21,247146,241196,5950,2.40000000
CN3203300000000,32,033,"White Pine County, NV",Dec-21,4320,4237,83,1.90000000
CN3251000000000,32,510,"Carson City, NV",Dec-21,25001,24312,689,2.80000000
CN3300100000000,33,001,"Belknap County, NH",Dec-21,30312,29560,752,2.50000000
CN3300300000000,33,003,"Carroll County, NH",Dec-21,22111,21564,547,2.50000000
CN3300500000000,33,005,"Cheshire County, NH",Dec-21,39438,38388,1050,2.70000000
CN3300700000000,33,007,"Coos County, NH",Dec-21,14176,13736,440,3.10000000
CN3300900000000,33,009,"Grafton County, NH",Dec-21,48784,47719,1065,2.20000000
CN3301100000000,33,011,"Hillsborough County, NH",Dec-21,238102,232301,5801,2.40000000
CN3301300000000,33,013,"Merrimack County, NH",Dec-21,80917,79236,1681,2.10000000
CN3301500000000,33,015,"Rockingham County, NH",Dec-21,185718,181182,4536,2.40000000
CN3301700000000,33,017,"Strafford County, NH",Dec-21,72699,71154,1545,2.10000000
CN3301900000000,33,019,"Sullivan County, NH",Dec-21,22793,22288,505,2.20000000
CN3400100000000,34,001,"Atlantic County, NJ",Dec-21,124181,116181,8000,6.40000000
CN3400300000000,34,003,"Bergen County, NJ",Dec-21,496615,477051,19564,3.90000000
CN3400500000000,34,005,"Burlington County, NJ",Dec-21,243276,234841,8435,3.50000000
CN3400700000000,34,007,"Camden County, NJ",Dec-21,267460,254992,12468,4.70000000
CN3400900000000,34,009,"Cape May County, NJ",Dec-21,42429,38931,3498,8.20000000
CN3401100000000,34,011,"Cumberland County, NJ",Dec-21,67454,63539,3915,5.80000000
CN3401300000000,34,013,"Essex County, NJ",Dec-21,383361,362626,20735,5.40000000
CN3401500000000,34,015,"Gloucester County, NJ",Dec-21,158835,152389,6446,4.10000000
CN3401700000000,34,017,"Hudson County, NJ",Dec-21,372300,355709,16591,4.50000000
CN3401900000000,34,019,"Hunterdon County, NJ",Dec-21,66405,64455,1950,2.90000000
CN3402100000000,34,021,"Mercer County, NJ",Dec-21,211815,204639,7176,3.40000000
CN3402300000000,34,023,"Middlesex County, NJ",Dec-21,449296,432454,16842,3.70000000
CN3402500000000,34,025,"Monmouth County, NJ",Dec-21,338349,326033,12316,3.60000000
CN3402700000000,34,027,"Morris County, NJ",Dec-21,263319,254874,8445,3.20000000
CN3402900000000,34,029,"Ocean County, NJ",Dec-21,290505,278605,11900,4.10000000
CN3403100000000,34,031,"Passaic County, NJ",Dec-21,250166,235911,14255,5.70000000
CN3403300000000,34,033,"Salem County, NJ",Dec-21,29564,27958,1606,5.40000000
CN3403500000000,34,035,"Somerset County, NJ",Dec-21,175504,169724,5780,3.30000000
CN3403700000000,34,037,"Sussex County, NJ",Dec-21,76119,73012,3107,4.10000000
CN3403900000000,34,039,"Union County, NJ",Dec-21,284890,271960,12930,4.50000000
CN3404100000000,34,041,"Warren County, NJ",Dec-21,58377,56277,2100,3.60000000
CN3500100000000,35,001,"Bernalillo County, NM",Dec-21,340074,324167,15907,4.70000000
CN3500300000000,35,003,"Catron County, NM",Dec-21,1098,1042,56,5.10000000
CN3500500000000,35,005,"Chaves County, NM",Dec-21,27769,26196,1573,5.70000000
CN3500600000000,35,006,"Cibola County, NM",Dec-21,9062,8441,621,6.90000000
CN3500700000000,35,007,"Colfax County, NM",Dec-21,5628,5378,250,4.40000000
CN3500900000000,35,009,"Curry County, NM",Dec-21,21479,20672,807,3.80000000
CN3501100000000,35,011,"De Baca County, NM",Dec-21,681,653,28,4.10000000
CN3501300000000,35,013,"Dona Ana County, NM",Dec-21,99600,94429,5171,5.20000000
CN3501500000000,35,015,"Eddy County, NM",Dec-21,31770,30255,1515,4.80000000
CN3501700000000,35,017,"Grant County, NM",Dec-21,11688,11035,653,5.60000000
CN3501900000000,35,019,"Guadalupe County, NM",Dec-21,1726,1620,106,6.10000000
CN3502100000000,35,021,"Harding County, NM",Dec-21,290,279,11,3.80000000
CN3502300000000,35,023,"Hidalgo County, NM",Dec-21,1847,1772,75,4.10000000
CN3502500000000,35,025,"Lea County, NM",Dec-21,28219,26221,1998,7.10000000
CN3502700000000,35,027,"Lincoln County, NM",Dec-21,8810,8303,507,5.80000000
CN3502800000000,35,028,"Los Alamos County, NM",Dec-21,10069,9831,238,2.40000000
CN3502900000000,35,029,"Luna County, NM",Dec-21,9489,8125,1364,14.40000000
CN3503100000000,35,031,"McKinley County, NM",Dec-21,24204,22429,1775,7.30000000
CN3503300000000,35,033,"Mora County, NM",Dec-21,1983,1881,102,5.10000000
CN3503500000000,35,035,"Otero County, NM",Dec-21,25070,23816,1254,5.00000000
CN3503700000000,35,037,"Quay County, NM",Dec-21,2997,2825,172,5.70000000
CN3503900000000,35,039,"Rio Arriba County, NM",Dec-21,16715,15769,946,5.70000000
CN3504100000000,35,041,"Roosevelt County, NM",Dec-21,7850,7515,335,4.30000000
CN3504300000000,35,043,"Sandoval County, NM",Dec-21,68813,65403,3410,5.00000000
CN3504500000000,35,045,"San Juan County, NM",Dec-21,50180,47091,3089,6.20000000
CN3504700000000,35,047,"San Miguel County, NM",Dec-21,10760,10161,599,5.60000000
CN3504900000000,35,049,"Santa Fe County, NM",Dec-21,73822,70405,3417,4.60000000
CN3505100000000,35,051,"Sierra County, NM",Dec-21,3996,3722,274,6.90000000
CN3505300000000,35,053,"Socorro County, NM",Dec-21,6102,5801,301,4.90000000
CN3505500000000,35,055,"Taos County, NM",Dec-21,14653,13640,1013,6.90000000
CN3505700000000,35,057,"Torrance County, NM",Dec-21,5486,5129,357,6.50000000
CN3505900000000,35,059,"Union County, NM",Dec-21,1565,1510,55,3.50000000
CN3506100000000,35,061,"Valencia County, NM",Dec-21,31353,29697,1656,5.30000000
CN3600100000000,36,001,"Albany County, NY",Dec-21,154719,150688,4031,2.60000000
CN3600300000000,36,003,"Allegany County, NY",Dec-21,19224,18582,642,3.30000000
CN3600500000000,36,005,"Bronx County, NY",Dec-21,589130,533554,55576,9.40000000
CN3600700000000,36,007,"Broome County, NY",Dec-21,80167,77476,2691,3.40000000
CN3600900000000,36,009,"Cattaraugus County, NY",Dec-21,32678,31494,1184,3.60000000
CN3601100000000,36,011,"Cayuga County, NY",Dec-21,34480,33442,1038,3.00000000
CN3601300000000,36,013,"Chautauqua County, NY",Dec-21,51211,49333,1878,3.70000000
CN3601500000000,36,015,"Chemung County, NY",Dec-21,34008,32894,1114,3.30000000
CN3601700000000,36,017,"Chenango County, NY",Dec-21,21207,20600,607,2.90000000
CN3601900000000,36,019,"Clinton County, NY",Dec-21,34798,33830,968,2.80000000
CN3602100000000,36,021,"Columbia County, NY",Dec-21,29703,29025,678,2.30000000
CN3602300000000,36,023,"Cortland County, NY",Dec-21,22002,21253,749,3.40000000
CN3602500000000,36,025,"Delaware County, NY",Dec-21,18984,18450,534,2.80000000
CN3602700000000,36,027,"Dutchess County, NY",Dec-21,140987,137226,3761,2.70000000
CN3602900000000,36,029,"Erie County, NY",Dec-21,428817,414143,14674,3.40000000
CN3603100000000,36,031,"Essex County, NY",Dec-21,16417,15876,541,3.30000000
CN3603300000000,36,033,"Franklin County, NY",Dec-21,18753,18183,570,3.00000000
CN3603500000000,36,035,"Fulton County, NY",Dec-21,22074,21266,808,3.70000000
CN3603700000000,36,037,"Genesee County, NY",Dec-21,28988,28192,796,2.70000000
CN3603900000000,36,039,"Greene County, NY",Dec-21,20314,19692,622,3.10000000
CN3604100000000,36,041,"Hamilton County, NY",Dec-21,2097,2011,86,4.10000000
CN3604300000000,36,043,"Herkimer County, NY",Dec-21,26986,25945,1041,3.90000000
CN3604500000000,36,045,"Jefferson County, NY",Dec-21,43228,41712,1516,3.50000000
CN3604700000000,36,047,"Kings County, NY",Dec-21,1170888,1090750,80138,6.80000000
CN3604900000000,36,049,"Lewis County, NY",Dec-21,11429,11009,420,3.70000000
CN3605100000000,36,051,"Livingston County, NY",Dec-21,29715,28892,823,2.80000000
CN3605300000000,36,053,"Madison County, NY",Dec-21,32113,31172,941,2.90000000
CN3605500000000,36,055,"Monroe County, NY",Dec-21,357630,346424,11206,3.10000000
CN3605700000000,36,057,"Montgomery County, NY",Dec-21,21698,20893,805,3.70000000
CN3605900000000,36,059,"Nassau County, NY",Dec-21,706460,688135,18325,2.60000000
CN3606100000000,36,061,"New York County, NY",Dec-21,885473,840686,44787,5.10000000
CN3606300000000,36,063,"Niagara County, NY",Dec-21,94765,91260,3505,3.70000000
CN3606500000000,36,065,"Oneida County, NY",Dec-21,98332,95235,3097,3.10000000
CN3606700000000,36,067,"Onondaga County, NY",Dec-21,218592,212159,6433,2.90000000
CN3606900000000,36,069,"Ontario County, NY",Dec-21,54797,53306,1491,2.70000000
CN3607100000000,36,071,"Orange County, NY",Dec-21,182139,176934,5205,2.90000000
CN3607300000000,36,073,"Orleans County, NY",Dec-21,16850,16303,547,3.20000000
CN3607500000000,36,075,"Oswego County, NY",Dec-21,51603,49699,1904,3.70000000
CN3607700000000,36,077,"Otsego County, NY",Dec-21,26338,25573,765,2.90000000
CN3607900000000,36,079,"Putnam County, NY",Dec-21,49984,48739,1245,2.50000000
CN3608100000000,36,081,"Queens County, NY",Dec-21,1107667,1036676,70991,6.40000000
CN3608300000000,36,083,"Rensselaer County, NY",Dec-21,79858,77731,2127,2.70000000
CN3608500000000,36,085,"Richmond County, NY",Dec-21,218640,205599,13041,6.00000000
CN3608700000000,36,087,"Rockland County, NY",Dec-21,152477,148503,3974,2.60000000
CN3608900000000,36,089,"St. Lawrence County, NY",Dec-21,42772,41344,1428,3.30000000
CN3609100000000,36,091,"Saratoga County, NY",Dec-21,118188,115514,2674,2.30000000
CN3609300000000,36,093,"Schenectady County, NY",Dec-21,75724,73462,2262,3.00000000
CN3609500000000,36,095,"Schoharie County, NY",Dec-21,14357,13935,422,2.90000000
CN3609700000000,36,097,"Schuyler County, NY",Dec-21,7741,7462,279,3.60000000
CN3609900000000,36,099,"Seneca County, NY",Dec-21,14644,14224,420,2.90000000
CN3610100000000,36,101,"Steuben County, NY",Dec-21,40646,39304,1342,3.30000000
CN3610300000000,36,103,"Suffolk County, NY",Dec-21,774883,753664,21219,2.70000000
CN3610500000000,36,105,"Sullivan County, NY",Dec-21,35100,33998,1102,3.10000000
CN3610700000000,36,107,"Tioga County, NY",Dec-21,21690,21092,598,2.80000000
CN3610900000000,36,109,"Tompkins County, NY",Dec-21,48471,47408,1063,2.20000000
CN3611100000000,36,111,"Ulster County, NY",Dec-21,85697,83306,2391,2.80000000
CN3611300000000,36,113,"Warren County, NY",Dec-21,30310,29299,1011,3.30000000
CN3611500000000,36,115,"Washington County, NY",Dec-21,26730,25938,792,3.00000000
CN3611700000000,36,117,"Wayne County, NY",Dec-21,42661,41468,1193,2.80000000
CN3611900000000,36,119,"Westchester County, NY",Dec-21,474967,461375,13592,2.90000000
CN3612100000000,36,121,"Wyoming County, NY",Dec-21,17637,17091,546,3.10000000
CN3612300000000,36,123,"Yates County, NY",Dec-21,11489,11205,284,2.50000000
CN3700100000000,37,001,"Alamance County, NC",Dec-21,81214,78636,2578,3.20000000
CN3700300000000,37,003,"Alexander County, NC",Dec-21,17405,16944,461,2.60000000
CN3700500000000,37,005,"Alleghany County, NC",Dec-21,4114,3983,131,3.20000000
CN3700700000000,37,007,"Anson County, NC",Dec-21,10005,9553,452,4.50000000
CN3700900000000,37,009,"Ashe County, NC",Dec-21,12542,12225,317,2.50000000
CN3701100000000,37,011,"Avery County, NC",Dec-21,7063,6877,186,2.60000000
CN3701300000000,37,013,"Beaufort County, NC",Dec-21,19391,18755,636,3.30000000
CN3701500000000,37,015,"Bertie County, NC",Dec-21,7034,6736,298,4.20000000
CN3701700000000,37,017,"Bladen County, NC",Dec-21,13778,13188,590,4.30000000
CN3701900000000,37,019,"Brunswick County, NC",Dec-21,53618,51359,2259,4.20000000
CN3702100000000,37,021,"Buncombe County, NC",Dec-21,137774,134210,3564,2.60000000
CN3702300000000,37,023,"Burke County, NC",Dec-21,39577,38417,1160,2.90000000
CN3702500000000,37,025,"Cabarrus County, NC",Dec-21,111070,107845,3225,2.90000000
CN3702700000000,37,027,"Caldwell County, NC",Dec-21,35284,34186,1098,3.10000000
CN3702900000000,37,029,"Camden County, NC",Dec-21,4483,4362,121,2.70000000
CN3703100000000,37,031,"Carteret County, NC",Dec-21,30878,30028,850,2.80000000
CN3703300000000,37,033,"Caswell County, NC",Dec-21,9542,9216,326,3.40000000
CN3703500000000,37,035,"Catawba County, NC",Dec-21,77047,74756,2291,3.00000000
CN3703700000000,37,037,"Chatham County, NC",Dec-21,36675,35825,850,2.30000000
CN3703900000000,37,039,"Cherokee County, NC",Dec-21,10439,10108,331,3.20000000
CN3704100000000,37,041,"Chowan County, NC",Dec-21,5714,5529,185,3.20000000
CN3704300000000,37,043,"Clay County, NC",Dec-21,3926,3802,124,3.20000000
CN3704500000000,37,045,"Cleveland County, NC",Dec-21,47926,46201,1725,3.60000000
CN3704700000000,37,047,"Columbus County, NC",Dec-21,22510,21491,1019,4.50000000
CN3704900000000,37,049,"Craven County, NC",Dec-21,40726,39489,1237,3.00000000
CN3705100000000,37,051,"Cumberland County, NC",Dec-21,126565,120413,6152,4.90000000
CN3705300000000,37,053,"Currituck County, NC",Dec-21,14184,13798,386,2.70000000
CN3705500000000,37,055,"Dare County, NC",Dec-21,17548,16740,808,4.60000000
CN3705700000000,37,057,"Davidson County, NC",Dec-21,79538,77176,2362,3.00000000
CN3705900000000,37,059,"Davie County, NC",Dec-21,20237,19679,558,2.80000000
CN3706100000000,37,061,"Duplin County, NC",Dec-21,23906,23196,710,3.00000000
CN3706300000000,37,063,"Durham County, NC",Dec-21,176148,171442,4706,2.70000000
CN3706500000000,37,065,"Edgecombe County, NC",Dec-21,20423,19095,1328,6.50000000
CN3706700000000,37,067,"Forsyth County, NC",Dec-21,184481,178462,6019,3.30000000
CN3706900000000,37,069,"Franklin County, NC",Dec-21,32426,31390,1036,3.20000000
CN3707100000000,37,071,"Gaston County, NC",Dec-21,110144,106273,3871,3.50000000
CN3707300000000,37,073,"Gates County, NC",Dec-21,4926,4793,133,2.70000000
CN3707500000000,37,075,"Graham County, NC",Dec-21,2840,2676,164,5.80000000
CN3707700000000,37,077,"Granville County, NC",Dec-21,29867,29076,791,2.60000000
CN3707900000000,37,079,"Greene County, NC",Dec-21,9314,9055,259,2.80000000
CN3708100000000,37,081,"Guilford County, NC",Dec-21,257207,247357,9850,3.80000000
CN3708300000000,37,083,"Halifax County, NC",Dec-21,18944,17931,1013,5.30000000
CN3708500000000,37,085,"Harnett County, NC",Dec-21,52926,51013,1913,3.60000000
CN3708700000000,37,087,"Haywood County, NC",Dec-21,29242,28457,785,2.70000000
CN3708900000000,37,089,"Henderson County, NC",Dec-21,53679,52299,1380,2.60000000
CN3709100000000,37,091,"Hertford County, NC",Dec-21,8402,8003,399,4.70000000
CN3709300000000,37,093,"Hoke County, NC",Dec-21,20038,19134,904,4.50000000
CN3709500000000,37,095,"Hyde County, NC",Dec-21,1686,1584,102,6.00000000
CN3709700000000,37,097,"Iredell County, NC",Dec-21,90629,87907,2722,3.00000000
CN3709900000000,37,099,"Jackson County, NC",Dec-21,19235,18668,567,2.90000000
CN3710100000000,37,101,"Johnston County, NC",Dec-21,102882,100024,2858,2.80000000
CN3710300000000,37,103,"Jones County, NC",Dec-21,4133,4018,115,2.80000000
CN3710500000000,37,105,"Lee County, NC",Dec-21,25397,24435,962,3.80000000
CN3710700000000,37,107,"Lenoir County, NC",Dec-21,26855,25961,894,3.30000000
CN3710900000000,37,109,"Lincoln County, NC",Dec-21,44395,43223,1172,2.60000000
CN3711100000000,37,111,"McDowell County, NC",Dec-21,19505,18933,572,2.90000000
CN3711300000000,37,113,"Macon County, NC",Dec-21,15103,14709,394,2.60000000
CN3711500000000,37,115,"Madison County, NC",Dec-21,9736,9472,264,2.70000000
CN3711700000000,37,117,"Martin County, NC",Dec-21,8580,8261,319,3.70000000
CN3711900000000,37,119,"Mecklenburg County, NC",Dec-21,626506,605767,20739,3.30000000
CN3712100000000,37,121,"Mitchell County, NC",Dec-21,5866,5653,213,3.60000000
CN3712300000000,37,123,"Montgomery County, NC",Dec-21,10799,10461,338,3.10000000
CN3712500000000,37,125,"Moore County, NC",Dec-21,40258,39067,1191,3.00000000
CN3712700000000,37,127,"Nash County, NC",Dec-21,42501,40629,1872,4.40000000
CN3712900000000,37,129,"New Hanover County, NC",Dec-21,124774,121375,3399,2.70000000
CN3713100000000,37,131,"Northampton County, NC",Dec-21,7090,6786,304,4.30000000
CN3713300000000,37,133,"Onslow County, NC",Dec-21,65646,63445,2201,3.40000000
CN3713500000000,37,135,"Orange County, NC",Dec-21,79996,78211,1785,2.20000000
CN3713700000000,37,137,"Pamlico County, NC",Dec-21,5294,5147,147,2.80000000
CN3713900000000,37,139,"Pasquotank County, NC",Dec-21,16123,15529,594,3.70000000
CN3714100000000,37,141,"Pender County, NC",Dec-21,29493,28676,817,2.80000000
CN3714300000000,37,143,"Perquimans County, NC",Dec-21,4769,4588,181,3.80000000
CN3714500000000,37,145,"Person County, NC",Dec-21,18485,17876,609,3.30000000
CN3714700000000,37,147,"Pitt County, NC",Dec-21,88266,85253,3013,3.40000000
CN3714900000000,37,149,"Polk County, NC",Dec-21,9009,8705,304,3.40000000
CN3715100000000,37,151,"Randolph County, NC",Dec-21,64224,62299,1925,3.00000000
CN3715300000000,37,153,"Richmond County, NC",Dec-21,16162,15279,883,5.50000000
CN3715500000000,37,155,"Robeson County, NC",Dec-21,47914,45275,2639,5.50000000
CN3715700000000,37,157,"Rockingham County, NC",Dec-21,38886,37458,1428,3.70000000
CN3715900000000,37,159,"Rowan County, NC",Dec-21,64876,62790,2086,3.20000000
CN3716100000000,37,161,"Rutherford County, NC",Dec-21,23901,22813,1088,4.60000000
CN3716300000000,37,163,"Sampson County, NC",Dec-21,27214,26368,846,3.10000000
CN3716500000000,37,165,"Scotland County, NC",Dec-21,11016,10250,766,7.00000000
CN3716700000000,37,167,"Stanly County, NC",Dec-21,29645,28801,844,2.80000000
CN3716900000000,37,169,"Stokes County, NC",Dec-21,21118,20551,567,2.70000000
CN3717100000000,37,171,"Surry County, NC",Dec-21,31933,31039,894,2.80000000
CN3717300000000,37,173,"Swain County, NC",Dec-21,6734,6533,201,3.00000000
CN3717500000000,37,175,"Transylvania County, NC",Dec-21,13906,13538,368,2.60000000
CN3717700000000,37,177,"Tyrrell County, NC",Dec-21,1153,1079,74,6.40000000
CN3717900000000,37,179,"Union County, NC",Dec-21,124609,121388,3221,2.60000000
CN3718100000000,37,181,"Vance County, NC",Dec-21,16677,15724,953,5.70000000
CN3718300000000,37,183,"Wake County, NC",Dec-21,602341,586678,15663,2.60000000
CN3718500000000,37,185,"Warren County, NC",Dec-21,6291,5936,355,5.60000000
CN3718700000000,37,187,"Washington County, NC",Dec-21,4140,3933,207,5.00000000
CN3718900000000,37,189,"Watauga County, NC",Dec-21,29228,28550,678,2.30000000
CN3719100000000,37,191,"Wayne County, NC",Dec-21,50545,48822,1723,3.40000000
CN3719300000000,37,193,"Wilkes County, NC",Dec-21,27205,26375,830,3.10000000
CN3719500000000,37,195,"Wilson County, NC",Dec-21,32865,31299,1566,4.80000000
CN3719700000000,37,197,"Yadkin County, NC",Dec-21,17150,16684,466,2.70000000
CN3719900000000,37,199,"Yancey County, NC",Dec-21,7904,7691,213,2.70000000
CN3800100000000,38,001,"Adams County, ND",Dec-21,945,917,28,3.00000000
CN3800300000000,38,003,"Barnes County, ND",Dec-21,5222,5092,130,2.50000000
CN3800500000000,38,005,"Benson County, ND",Dec-21,2295,2212,83,3.60000000
CN3800700000000,38,007,"Billings County, ND",Dec-21,378,367,11,2.90000000
CN3800900000000,38,009,"Bottineau County, ND",Dec-21,2905,2792,113,3.90000000
CN3801100000000,38,011,"Bowman County, ND",Dec-21,1563,1531,32,2.00000000
CN3801300000000,38,013,"Burke County, ND",Dec-21,1038,1003,35,3.40000000
CN3801500000000,38,015,"Burleigh County, ND",Dec-21,51394,50075,1319,2.60000000
CN3801700000000,38,017,"Cass County, ND",Dec-21,106875,104515,2360,2.20000000
CN3801900000000,38,019,"Cavalier County, ND",Dec-21,1833,1778,55,3.00000000
CN3802100000000,38,021,"Dickey County, ND",Dec-21,2233,2183,50,2.20000000
CN3802300000000,38,023,"Divide County, ND",Dec-21,1381,1346,35,2.50000000
CN3802500000000,38,025,"Dunn County, ND",Dec-21,3151,3074,77,2.40000000
CN3802700000000,38,027,"Eddy County, ND",Dec-21,1199,1156,43,3.60000000
CN3802900000000,38,029,"Emmons County, ND",Dec-21,1475,1398,77,5.20000000
CN3803100000000,38,031,"Foster County, ND",Dec-21,1491,1451,40,2.70000000
CN3803300000000,38,033,"Golden Valley County, ND",Dec-21,816,798,18,2.20000000
CN3803500000000,38,035,"Grand Forks County, ND",Dec-21,36773,35829,944,2.60000000
CN3803700000000,38,037,"Grant County, ND",Dec-21,1236,1200,36,2.90000000
CN3803900000000,38,039,"Griggs County, ND",Dec-21,1000,978,22,2.20000000
CN3804100000000,38,041,"Hettinger County, ND",Dec-21,1392,1363,29,2.10000000
CN3804300000000,38,043,"Kidder County, ND",Dec-21,1323,1247,76,5.70000000
CN3804500000000,38,045,"LaMoure County, ND",Dec-21,2017,1971,46,2.30000000
CN3804700000000,38,047,"Logan County, ND",Dec-21,855,836,19,2.20000000
CN3804900000000,38,049,"McHenry County, ND",Dec-21,3155,3027,128,4.10000000
CN3805100000000,38,051,"McIntosh County, ND",Dec-21,1071,1035,36,3.40000000
CN3805300000000,38,053,"McKenzie County, ND",Dec-21,8625,8265,360,4.20000000
CN3805500000000,38,055,"McLean County, ND",Dec-21,4570,4417,153,3.30000000
CN3805700000000,38,057,"Mercer County, ND",Dec-21,3452,3288,164,4.80000000
CN3805900000000,38,059,"Morton County, ND",Dec-21,17021,16394,627,3.70000000
CN3806100000000,38,061,"Mountrail County, ND",Dec-21,6393,6237,156,2.40000000
CN3806300000000,38,063,"Nelson County, ND",Dec-21,1368,1329,39,2.90000000
CN3806500000000,38,065,"Oliver County, ND",Dec-21,874,835,39,4.50000000
CN3806700000000,38,067,"Pembina County, ND",Dec-21,3237,3093,144,4.40000000
CN3806900000000,38,069,"Pierce County, ND",Dec-21,1634,1594,40,2.40000000
CN3807100000000,38,071,"Ramsey County, ND",Dec-21,5593,5429,164,2.90000000
CN3807300000000,38,073,"Ransom County, ND",Dec-21,2656,2602,54,2.00000000
CN3807500000000,38,075,"Renville County, ND",Dec-21,1176,1150,26,2.20000000
CN3807700000000,38,077,"Richland County, ND",Dec-21,8559,8368,191,2.20000000
CN3807900000000,38,079,"Rolette County, ND",Dec-21,4790,4362,428,8.90000000
CN3808100000000,38,081,"Sargent County, ND",Dec-21,2354,2300,54,2.30000000
CN3808300000000,38,083,"Sheridan County, ND",Dec-21,656,626,30,4.60000000
CN3808500000000,38,085,"Sioux County, ND",Dec-21,1201,1166,35,2.90000000
CN3808700000000,38,087,"Slope County, ND",Dec-21,349,341,8,2.30000000
CN3808900000000,38,089,"Stark County, ND",Dec-21,17356,16802,554,3.20000000
CN3809100000000,38,091,"Steele County, ND",Dec-21,925,897,28,3.00000000
CN3809300000000,38,093,"Stutsman County, ND",Dec-21,10227,9972,255,2.50000000
CN3809500000000,38,095,"Towner County, ND",Dec-21,1104,1063,41,3.70000000
CN3809700000000,38,097,"Traill County, ND",Dec-21,4416,4312,104,2.40000000
CN3809900000000,38,099,"Walsh County, ND",Dec-21,5200,4972,228,4.40000000
CN3810100000000,38,101,"Ward County, ND",Dec-21,31335,30320,1015,3.20000000
CN3810300000000,38,103,"Wells County, ND",Dec-21,1863,1777,86,4.60000000
CN3810500000000,38,105,"Williams County, ND",Dec-21,20540,19464,1076,5.20000000
CN3900100000000,39,001,"Adams County, OH",Dec-21,10922,10401,521,4.80000000
CN3900300000000,39,003,"Allen County, OH",Dec-21,47309,45579,1730,3.70000000
CN3900500000000,39,005,"Ashland County, OH",Dec-21,25998,25144,854,3.30000000
CN3900700000000,39,007,"Ashtabula County, OH",Dec-21,42825,41075,1750,4.10000000
CN3900900000000,39,009,"Athens County, OH",Dec-21,25079,24028,1051,4.20000000
CN3901100000000,39,011,"Auglaize County, OH",Dec-21,24412,23803,609,2.50000000
CN3901300000000,39,013,"Belmont County, OH",Dec-21,28208,26960,1248,4.40000000
CN3901500000000,39,015,"Brown County, OH",Dec-21,19382,18613,769,4.00000000
CN3901700000000,39,017,"Butler County, OH",Dec-21,195015,189053,5962,3.10000000
CN3901900000000,39,019,"Carroll County, OH",Dec-21,12704,12188,516,4.10000000
CN3902100000000,39,021,"Champaign County, OH",Dec-21,19309,18719,590,3.10000000
CN3902300000000,39,023,"Clark County, OH",Dec-21,62169,60017,2152,3.50000000
CN3902500000000,39,025,"Clermont County, OH",Dec-21,107015,103833,3182,3.00000000
CN3902700000000,39,027,"Clinton County, OH",Dec-21,18118,17458,660,3.60000000
CN3902900000000,39,029,"Columbiana County, OH",Dec-21,45114,43370,1744,3.90000000
CN3903100000000,39,031,"Coshocton County, OH",Dec-21,13545,12958,587,4.30000000
CN3903300000000,39,033,"Crawford County, OH",Dec-21,17711,16958,753,4.30000000
CN3903500000000,39,035,"Cuyahoga County, OH",Dec-21,592994,563821,29173,4.90000000
CN3903700000000,39,037,"Darke County, OH",Dec-21,25730,24984,746,2.90000000
CN3903900000000,39,039,"Defiance County, OH",Dec-21,17546,16994,552,3.10000000
CN3904100000000,39,041,"Delaware County, OH",Dec-21,115518,112764,2754,2.40000000
CN3904300000000,39,043,"Erie County, OH",Dec-21,35999,34343,1656,4.60000000
CN3904500000000,39,045,"Fairfield County, OH",Dec-21,80306,77923,2383,3.00000000
CN3904700000000,39,047,"Fayette County, OH",Dec-21,13855,13426,429,3.10000000
CN3904900000000,39,049,"Franklin County, OH",Dec-21,709069,687632,21437,3.00000000
CN3905100000000,39,051,"Fulton County, OH",Dec-21,22001,21198,803,3.60000000
CN3905300000000,39,053,"Gallia County, OH",Dec-21,12102,11579,523,4.30000000
CN3905500000000,39,055,"Geauga County, OH",Dec-21,47814,46072,1742,3.60000000
CN3905700000000,39,057,"Greene County, OH",Dec-21,82954,80584,2370,2.90000000
CN3905900000000,39,059,"Guernsey County, OH",Dec-21,17623,16841,782,4.40000000
CN3906100000000,39,061,"Hamilton County, OH",Dec-21,413737,400645,13092,3.20000000
CN3906300000000,39,063,"Hancock County, OH",Dec-21,40750,39653,1097,2.70000000
CN3906500000000,39,065,"Hardin County, OH",Dec-21,13692,13227,465,3.40000000
CN3906700000000,39,067,"Harrison County, OH",Dec-21,6419,6117,302,4.70000000
CN3906900000000,39,069,"Henry County, OH",Dec-21,12668,12111,557,4.40000000
CN3907100000000,39,071,"Highland County, OH",Dec-21,17397,16617,780,4.50000000
CN3907300000000,39,073,"Hocking County, OH",Dec-21,12991,12506,485,3.70000000
CN3907500000000,39,075,"Holmes County, OH",Dec-21,21557,21115,442,2.10000000
CN3907700000000,39,077,"Huron County, OH",Dec-21,27397,26057,1340,4.90000000
CN3907900000000,39,079,"Jackson County, OH",Dec-21,12523,11941,582,4.60000000
CN3908100000000,39,081,"Jefferson County, OH",Dec-21,27331,26059,1272,4.70000000
CN3908300000000,39,083,"Knox County, OH",Dec-21,31024,30085,939,3.00000000
CN3908500000000,39,085,"Lake County, OH",Dec-21,122931,117917,5014,4.10000000
CN3908700000000,39,087,"Lawrence County, OH",Dec-21,23464,22616,848,3.60000000
CN3908900000000,39,089,"Licking County, OH",Dec-21,92046,89450,2596,2.80000000
CN3909100000000,39,091,"Logan County, OH",Dec-21,22493,21808,685,3.00000000
CN3909300000000,39,093,"Lorain County, OH",Dec-21,151432,144460,6972,4.60000000
CN3909500000000,39,095,"Lucas County, OH",Dec-21,205884,197565,8319,4.00000000
CN3909700000000,39,097,"Madison County, OH",Dec-21,20985,20439,546,2.60000000
CN3909900000000,39,099,"Mahoning County, OH",Dec-21,98303,94064,4239,4.30000000
CN3910100000000,39,101,"Marion County, OH",Dec-21,27886,26976,910,3.30000000
CN3910300000000,39,103,"Medina County, OH",Dec-21,96128,92699,3429,3.60000000
CN3910500000000,39,105,"Meigs County, OH",Dec-21,8612,8147,465,5.40000000
CN3910700000000,39,107,"Mercer County, OH",Dec-21,22732,22224,508,2.20000000
CN3910900000000,39,109,"Miami County, OH",Dec-21,53970,52348,1622,3.00000000
CN3911100000000,39,111,"Monroe County, OH",Dec-21,5197,4873,324,6.20000000
CN3911300000000,39,113,"Montgomery County, OH",Dec-21,248666,239643,9023,3.60000000
CN3911500000000,39,115,"Morgan County, OH",Dec-21,6699,6336,363,5.40000000
CN3911700000000,39,117,"Morrow County, OH",Dec-21,17067,16485,582,3.40000000
CN3911900000000,39,119,"Muskingum County, OH",Dec-21,40496,38901,1595,3.90000000
CN3912100000000,39,121,"Noble County, OH",Dec-21,4511,4259,252,5.60000000
CN3912300000000,39,123,"Ottawa County, OH",Dec-21,19765,18646,1119,5.70000000
CN3912500000000,39,125,"Paulding County, OH",Dec-21,8569,8317,252,2.90000000
CN3912700000000,39,127,"Perry County, OH",Dec-21,16013,15346,667,4.20000000
CN3912900000000,39,129,"Pickaway County, OH",Dec-21,26851,25992,859,3.20000000
CN3913100000000,39,131,"Pike County, OH",Dec-21,10789,10232,557,5.20000000
CN3913300000000,39,133,"Portage County, OH",Dec-21,84719,81820,2899,3.40000000
CN3913500000000,39,135,"Preble County, OH",Dec-21,21800,21177,623,2.90000000
CN3913700000000,39,137,"Putnam County, OH",Dec-21,18886,18415,471,2.50000000
CN3913900000000,39,139,"Richland County, OH",Dec-21,51717,49598,2119,4.10000000
CN3914100000000,39,141,"Ross County, OH",Dec-21,35033,33756,1277,3.60000000
CN3914300000000,39,143,"Sandusky County, OH",Dec-21,30081,29034,1047,3.50000000
CN3914500000000,39,145,"Scioto County, OH",Dec-21,29337,27933,1404,4.80000000
CN3914700000000,39,147,"Seneca County, OH",Dec-21,26517,25618,899,3.40000000
CN3914900000000,39,149,"Shelby County, OH",Dec-21,23697,23003,694,2.90000000
CN3915100000000,39,151,"Stark County, OH",Dec-21,181744,175160,6584,3.60000000
CN3915300000000,39,153,"Summit County, OH",Dec-21,263700,253874,9826,3.70000000
CN3915500000000,39,155,"Trumbull County, OH",Dec-21,83133,79390,3743,4.50000000
CN3915700000000,39,157,"Tuscarawas County, OH",Dec-21,44010,42527,1483,3.40000000
CN3915900000000,39,159,"Union County, OH",Dec-21,30292,29552,740,2.40000000
CN3916100000000,39,161,"Van Wert County, OH",Dec-21,14587,14192,395,2.70000000
CN3916300000000,39,163,"Vinton County, OH",Dec-21,5457,5194,263,4.80000000
CN3916500000000,39,165,"Warren County, OH",Dec-21,121363,118015,3348,2.80000000
CN3916700000000,39,167,"Washington County, OH",Dec-21,26649,25532,1117,4.20000000
CN3916900000000,39,169,"Wayne County, OH",Dec-21,59974,58428,1546,2.60000000
CN3917100000000,39,171,"Williams County, OH",Dec-21,18446,17890,556,3.00000000
CN3917300000000,39,173,"Wood County, OH",Dec-21,70100,68090,2010,2.90000000
CN3917500000000,39,175,"Wyandot County, OH",Dec-21,12919,12585,334,2.60000000
CN4000100000000,40,001,"Adair County, OK",Dec-21,8471,8270,201,2.40000000
CN4000300000000,40,003,"Alfalfa County, OK",Dec-21,2632,2599,33,1.30000000
CN4000500000000,40,005,"Atoka County, OK",Dec-21,4999,4859,140,2.80000000
CN4000700000000,40,007,"Beaver County, OK",Dec-21,2600,2575,25,1.00000000
CN4000900000000,40,009,"Beckham County, OK",Dec-21,9406,9188,218,2.30000000
CN4001100000000,40,011,"Blaine County, OK",Dec-21,4361,4292,69,1.60000000
CN4001300000000,40,013,"Bryan County, OK",Dec-21,21986,21596,390,1.80000000
CN4001500000000,40,015,"Caddo County, OK",Dec-21,12090,11834,256,2.10000000
CN4001700000000,40,017,"Canadian County, OK",Dec-21,78709,77319,1390,1.80000000
CN4001900000000,40,019,"Carter County, OK",Dec-21,21208,20655,553,2.60000000
CN4002100000000,40,021,"Cherokee County, OK",Dec-21,19515,19044,471,2.40000000
CN4002300000000,40,023,"Choctaw County, OK",Dec-21,5845,5653,192,3.30000000
CN4002500000000,40,025,"Cimarron County, OK",Dec-21,1486,1471,15,1.00000000
CN4002700000000,40,027,"Cleveland County, OK",Dec-21,145065,142629,2436,1.70000000
CN4002900000000,40,029,"Coal County, OK",Dec-21,2273,2223,50,2.20000000
CN4003100000000,40,031,"Comanche County, OK",Dec-21,46917,45766,1151,2.50000000
CN4003300000000,40,033,"Cotton County, OK",Dec-21,2644,2584,60,2.30000000
CN4003500000000,40,035,"Craig County, OK",Dec-21,5625,5506,119,2.10000000
CN4003700000000,40,037,"Creek County, OK",Dec-21,30982,30208,774,2.50000000
CN4003900000000,40,039,"Custer County, OK",Dec-21,15114,14839,275,1.80000000
CN4004100000000,40,041,"Delaware County, OK",Dec-21,18547,18160,387,2.10000000
CN4004300000000,40,043,"Dewey County, OK",Dec-21,2948,2910,38,1.30000000
CN4004500000000,40,045,"Ellis County, OK",Dec-21,2037,2007,30,1.50000000
CN4004700000000,40,047,"Garfield County, OK",Dec-21,26560,26050,510,1.90000000
CN4004900000000,40,049,"Garvin County, OK",Dec-21,12670,12410,260,2.10000000
CN4005100000000,40,051,"Grady County, OK",Dec-21,26687,26200,487,1.80000000
CN4005300000000,40,053,"Grant County, OK",Dec-21,2629,2589,40,1.50000000
CN4005500000000,40,055,"Greer County, OK",Dec-21,1788,1742,46,2.60000000
CN4005700000000,40,057,"Harmon County, OK",Dec-21,1164,1146,18,1.50000000
CN4005900000000,40,059,"Harper County, OK",Dec-21,1749,1726,23,1.30000000
CN4006100000000,40,061,"Haskell County, OK",Dec-21,4105,3983,122,3.00000000
CN4006300000000,40,063,"Hughes County, OK",Dec-21,5132,4971,161,3.10000000
CN4006500000000,40,065,"Jackson County, OK",Dec-21,10817,10644,173,1.60000000
CN4006700000000,40,067,"Jefferson County, OK",Dec-21,2423,2373,50,2.10000000
CN4006900000000,40,069,"Johnston County, OK",Dec-21,3615,3517,98,2.70000000
CN4007100000000,40,071,"Kay County, OK",Dec-21,18090,17618,472,2.60000000
CN4007300000000,40,073,"Kingfisher County, OK",Dec-21,8656,8538,118,1.40000000
CN4007500000000,40,075,"Kiowa County, OK",Dec-21,3559,3492,67,1.90000000
CN4007700000000,40,077,"Latimer County, OK",Dec-21,3009,2872,137,4.60000000
CN4007900000000,40,079,"Le Flore County, OK",Dec-21,19152,18608,544,2.80000000
CN4008100000000,40,081,"Lincoln County, OK",Dec-21,15809,15492,317,2.00000000
CN4008300000000,40,083,"Logan County, OK",Dec-21,22808,22402,406,1.80000000
CN4008500000000,40,085,"Love County, OK",Dec-21,5873,5791,82,1.40000000
CN4008700000000,40,087,"McClain County, OK",Dec-21,20411,20065,346,1.70000000
CN4008900000000,40,089,"McCurtain County, OK",Dec-21,15512,15040,472,3.00000000
CN4009100000000,40,091,"McIntosh County, OK",Dec-21,6937,6667,270,3.90000000
CN4009300000000,40,093,"Major County, OK",Dec-21,3619,3566,53,1.50000000
CN4009500000000,40,095,"Marshall County, OK",Dec-21,6932,6781,151,2.20000000
CN4009700000000,40,097,"Mayes County, OK",Dec-21,19187,18759,428,2.20000000
CN4009900000000,40,099,"Murray County, OK",Dec-21,5961,5833,128,2.10000000
CN4010100000000,40,101,"Muskogee County, OK",Dec-21,28422,27667,755,2.70000000
CN4010300000000,40,103,"Noble County, OK",Dec-21,5576,5498,78,1.40000000
CN4010500000000,40,105,"Nowata County, OK",Dec-21,4607,4514,93,2.00000000
CN4010700000000,40,107,"Okfuskee County, OK",Dec-21,4336,4209,127,2.90000000
CN4010900000000,40,109,"Oklahoma County, OK",Dec-21,389689,381365,8324,2.10000000
CN4011100000000,40,111,"Okmulgee County, OK",Dec-21,15333,14849,484,3.20000000
CN4011300000000,40,113,"Osage County, OK",Dec-21,20176,19677,499,2.50000000
CN4011500000000,40,115,"Ottawa County, OK",Dec-21,14464,14206,258,1.80000000
CN4011700000000,40,117,"Pawnee County, OK",Dec-21,7245,7058,187,2.60000000
CN4011900000000,40,119,"Payne County, OK",Dec-21,38425,37744,681,1.80000000
CN4012100000000,40,121,"Pittsburg County, OK",Dec-21,16080,15536,544,3.40000000
CN4012300000000,40,123,"Pontotoc County, OK",Dec-21,19054,18683,371,1.90000000
CN4012500000000,40,125,"Pottawatomie County, OK",Dec-21,32753,31988,765,2.30000000
CN4012700000000,40,127,"Pushmataha County, OK",Dec-21,4663,4546,117,2.50000000
CN4012900000000,40,129,"Roger Mills County, OK",Dec-21,1767,1741,26,1.50000000
CN4013100000000,40,131,"Rogers County, OK",Dec-21,44856,43956,900,2.00000000
CN4013300000000,40,133,"Seminole County, OK",Dec-21,9007,8743,264,2.90000000
CN4013500000000,40,135,"Sequoyah County, OK",Dec-21,16478,16049,429,2.60000000
CN4013700000000,40,137,"Stephens County, OK",Dec-21,18825,18355,470,2.50000000
CN4013900000000,40,139,"Texas County, OK",Dec-21,11166,11049,117,1.00000000
CN4014100000000,40,141,"Tillman County, OK",Dec-21,2790,2730,60,2.20000000
CN4014300000000,40,143,"Tulsa County, OK",Dec-21,322470,315218,7252,2.20000000
CN4014500000000,40,145,"Wagoner County, OK",Dec-21,38617,37811,806,2.10000000
CN4014700000000,40,147,"Washington County, OK",Dec-21,22217,21726,491,2.20000000
CN4014900000000,40,149,"Washita County, OK",Dec-21,4802,4673,129,2.70000000
CN4015100000000,40,151,"Woods County, OK",Dec-21,4681,4633,48,1.00000000
CN4015300000000,40,153,"Woodward County, OK",Dec-21,8413,8219,194,2.30000000
CN4100100000000,41,001,"Baker County, OR",Dec-21,7474,7167,307,4.10000000
CN4100300000000,41,003,"Benton County, OR",Dec-21,48492,47275,1217,2.50000000
CN4100500000000,41,005,"Clackamas County, OR",Dec-21,226486,219163,7323,3.20000000
CN4100700000000,41,007,"Clatsop County, OR",Dec-21,19111,18340,771,4.00000000
CN4100900000000,41,009,"Columbia County, OR",Dec-21,25029,24010,1019,4.10000000
CN4101100000000,41,011,"Coos County, OR",Dec-21,26874,25657,1217,4.50000000
CN4101300000000,41,013,"Crook County, OR",Dec-21,10883,10313,570,5.20000000
CN4101500000000,41,015,"Curry County, OR",Dec-21,8888,8430,458,5.20000000
CN4101700000000,41,017,"Deschutes County, OR",Dec-21,103724,99929,3795,3.70000000
CN4101900000000,41,019,"Douglas County, OR",Dec-21,47298,45236,2062,4.40000000
CN4102100000000,41,021,"Gilliam County, OR",Dec-21,989,956,33,3.30000000
CN4102300000000,41,023,"Grant County, OR",Dec-21,3142,2967,175,5.60000000
CN4102500000000,41,025,"Harney County, OR",Dec-21,3653,3491,162,4.40000000
CN4102700000000,41,027,"Hood River County, OR",Dec-21,13965,13566,399,2.90000000
CN4102900000000,41,029,"Jackson County, OR",Dec-21,107391,103416,3975,3.70000000
CN4103100000000,41,031,"Jefferson County, OR",Dec-21,10203,9708,495,4.90000000
CN4103300000000,41,033,"Josephine County, OR",Dec-21,36951,35240,1711,4.60000000
CN4103500000000,41,035,"Klamath County, OR",Dec-21,29249,27699,1550,5.30000000
CN4103700000000,41,037,"Lake County, OR",Dec-21,3573,3404,169,4.70000000
CN4103900000000,41,039,"Lane County, OR",Dec-21,182517,175629,6888,3.80000000
CN4104100000000,41,041,"Lincoln County, OR",Dec-21,20450,19406,1044,5.10000000
CN4104300000000,41,043,"Linn County, OR",Dec-21,61000,58593,2407,3.90000000
CN4104500000000,41,045,"Malheur County, OR",Dec-21,12454,12058,396,3.20000000
CN4104700000000,41,047,"Marion County, OR",Dec-21,167718,161817,5901,3.50000000
CN4104900000000,41,049,"Morrow County, OR",Dec-21,5855,5660,195,3.30000000
CN4105100000000,41,051,"Multnomah County, OR",Dec-21,468815,451537,17278,3.70000000
CN4105300000000,41,053,"Polk County, OR",Dec-21,42325,40916,1409,3.30000000
CN4105500000000,41,055,"Sherman County, OR",Dec-21,931,900,31,3.30000000
CN4105700000000,41,057,"Tillamook County, OR",Dec-21,11742,11280,462,3.90000000
CN4105900000000,41,059,"Umatilla County, OR",Dec-21,37071,35647,1424,3.80000000
CN4106100000000,41,061,"Union County, OR",Dec-21,12144,11647,497,4.10000000
CN4106300000000,41,063,"Wallowa County, OR",Dec-21,3478,3306,172,4.90000000
CN4106500000000,41,065,"Wasco County, OR",Dec-21,13050,12529,521,4.00000000
CN4106700000000,41,067,"Washington County, OR",Dec-21,333410,323816,9594,2.90000000
CN4106900000000,41,069,"Wheeler County, OR",Dec-21,715,697,18,2.50000000
CN4107100000000,41,071,"Yamhill County, OR",Dec-21,55851,54073,1778,3.20000000
CN4200100000000,42,001,"Adams County, PA",Dec-21,54041,52464,1577,2.90000000
CN4200300000000,42,003,"Allegheny County, PA",Dec-21,614635,589137,25498,4.10000000
CN4200500000000,42,005,"Armstrong County, PA",Dec-21,30439,28787,1652,5.40000000
CN4200700000000,42,007,"Beaver County, PA",Dec-21,79703,75505,4198,5.30000000
CN4200900000000,42,009,"Bedford County, PA",Dec-21,23275,22220,1055,4.50000000
CN4201100000000,42,011,"Berks County, PA",Dec-21,207345,197982,9363,4.50000000
CN4201300000000,42,013,"Blair County, PA",Dec-21,58229,55748,2481,4.30000000
CN4201500000000,42,015,"Bradford County, PA",Dec-21,27292,26229,1063,3.90000000
CN4201700000000,42,017,"Bucks County, PA",Dec-21,338227,326024,12203,3.60000000
CN4201900000000,42,019,"Butler County, PA",Dec-21,95892,92186,3706,3.90000000
CN4202100000000,42,021,"Cambria County, PA",Dec-21,54531,51711,2820,5.20000000
CN4202300000000,42,023,"Cameron County, PA",Dec-21,1935,1817,118,6.10000000
CN4202500000000,42,025,"Carbon County, PA",Dec-21,32037,30513,1524,4.80000000
CN4202700000000,42,027,"Centre County, PA",Dec-21,76815,74359,2456,3.20000000
CN4202900000000,42,029,"Chester County, PA",Dec-21,285025,277068,7957,2.80000000
CN4203100000000,42,031,"Clarion County, PA",Dec-21,16087,15295,792,4.90000000
CN4203300000000,42,033,"Clearfield County, PA",Dec-21,34715,32821,1894,5.50000000
CN4203500000000,42,035,"Clinton County, PA",Dec-21,16914,16006,908,5.40000000
CN4203700000000,42,037,"Columbia County, PA",Dec-21,32822,31411,1411,4.30000000
CN4203900000000,42,039,"Crawford County, PA",Dec-21,36751,34988,1763,4.80000000
CN4204100000000,42,041,"Cumberland County, PA",Dec-21,131115,127088,4027,3.10000000
CN4204300000000,42,043,"Dauphin County, PA",Dec-21,142545,136594,5951,4.20000000
CN4204500000000,42,045,"Delaware County, PA",Dec-21,291666,279074,12592,4.30000000
CN4204700000000,42,047,"Elk County, PA",Dec-21,14411,13683,728,5.10000000
CN4204900000000,42,049,"Erie County, PA",Dec-21,123703,117144,6559,5.30000000
CN4205100000000,42,051,"Fayette County, PA",Dec-21,54004,50430,3574,6.60000000
CN4205300000000,42,053,"Forest County, PA",Dec-21,1677,1568,109,6.50000000
CN4205500000000,42,055,"Franklin County, PA",Dec-21,76233,73662,2571,3.40000000
CN4205700000000,42,057,"Fulton County, PA",Dec-21,6994,6682,312,4.50000000
CN4205900000000,42,059,"Greene County, PA",Dec-21,15186,14388,798,5.30000000
CN4206100000000,42,061,"Huntingdon County, PA",Dec-21,18648,17577,1071,5.70000000
CN4206300000000,42,063,"Indiana County, PA",Dec-21,36132,34307,1825,5.10000000
CN4206500000000,42,065,"Jefferson County, PA",Dec-21,19085,18171,914,4.80000000
CN4206700000000,42,067,"Juniata County, PA",Dec-21,12273,11813,460,3.70000000
CN4206900000000,42,069,"Lackawanna County, PA",Dec-21,102401,97562,4839,4.70000000
CN4207100000000,42,071,"Lancaster County, PA",Dec-21,280206,270972,9234,3.30000000
CN4207300000000,42,073,"Lawrence County, PA",Dec-21,38541,36323,2218,5.80000000
CN4207500000000,42,075,"Lebanon County, PA",Dec-21,71651,69093,2558,3.60000000
CN4207700000000,42,077,"Lehigh County, PA",Dec-21,195031,186165,8866,4.50000000
CN4207900000000,42,079,"Luzerne County, PA",Dec-21,154967,145960,9007,5.80000000
CN4208100000000,42,081,"Lycoming County, PA",Dec-21,53907,51226,2681,5.00000000
CN4208300000000,42,083,"McKean County, PA",Dec-21,16337,15466,871,5.30000000
CN4208500000000,42,085,"Mercer County, PA",Dec-21,46573,44227,2346,5.00000000
CN4208700000000,42,087,"Mifflin County, PA",Dec-21,20297,19353,944,4.70000000
CN4208900000000,42,089,"Monroe County, PA",Dec-21,80778,76194,4584,5.70000000
CN4209100000000,42,091,"Montgomery County, PA",Dec-21,449994,435160,14834,3.30000000
CN4209300000000,42,093,"Montour County, PA",Dec-21,8914,8637,277,3.10000000
CN4209500000000,42,095,"Northampton County, PA",Dec-21,161906,155332,6574,4.10000000
CN4209700000000,42,097,"Northumberland County, PA",Dec-21,40647,38536,2111,5.20000000
CN4209900000000,42,099,"Perry County, PA",Dec-21,24016,23250,766,3.20000000
CN4210100000000,42,101,"Philadelphia County/city, PA",Dec-21,712569,667785,44784,6.30000000
CN4210300000000,42,103,"Pike County, PA",Dec-21,24994,23616,1378,5.50000000
CN4210500000000,42,105,"Potter County, PA",Dec-21,6930,6561,369,5.30000000
CN4210700000000,42,107,"Schuylkill County, PA",Dec-21,63791,60734,3057,4.80000000
CN4210900000000,42,109,"Snyder County, PA",Dec-21,19292,18553,739,3.80000000
CN4211100000000,42,111,"Somerset County, PA",Dec-21,32086,30374,1712,5.30000000
CN4211300000000,42,113,"Sullivan County, PA",Dec-21,2494,2356,138,5.50000000
CN4211500000000,42,115,"Susquehanna County, PA",Dec-21,19762,18974,788,4.00000000
CN4211700000000,42,117,"Tioga County, PA",Dec-21,18416,17489,927,5.00000000
CN4211900000000,42,119,"Union County, PA",Dec-21,19150,18495,655,3.40000000
CN4212100000000,42,121,"Venango County, PA",Dec-21,20987,19921,1066,5.10000000
CN4212300000000,42,123,"Warren County, PA",Dec-21,17251,16400,851,4.90000000
CN4212500000000,42,125,"Washington County, PA",Dec-21,102138,97332,4806,4.70000000
CN4212700000000,42,127,"Wayne County, PA",Dec-21,21601,20536,1065,4.90000000
CN4212900000000,42,129,"Westmoreland County, PA",Dec-21,170994,163332,7662,4.50000000
CN4213100000000,42,131,"Wyoming County, PA",Dec-21,13156,12562,594,4.50000000
CN4213300000000,42,133,"York County, PA",Dec-21,231328,223097,8231,3.60000000
CN4400100000000,44,001,"Bristol County, RI",Dec-21,26537,25817,720,2.70000000
CN4400300000000,44,003,"Kent County, RI",Dec-21,93805,90862,2943,3.10000000
CN4400500000000,44,005,"Newport County, RI",Dec-21,45071,43807,1264,2.80000000
CN4400700000000,44,007,"Providence County, RI",Dec-21,335221,322548,12673,3.80000000
CN4400900000000,44,009,"Washington County, RI",Dec-21,69985,67951,2034,2.90000000
CN4500100000000,45,001,"Abbeville County, SC",Dec-21,9654,9301,353,3.70000000
CN4500300000000,45,003,"Aiken County, SC",Dec-21,73787,71644,2143,2.90000000
CN4500500000000,45,005,"Allendale County, SC",Dec-21,2367,2211,156,6.60000000
CN4500700000000,45,007,"Anderson County, SC",Dec-21,90397,87703,2694,3.00000000
CN4500900000000,45,009,"Bamberg County, SC",Dec-21,4658,4368,290,6.20000000
CN4501100000000,45,011,"Barnwell County, SC",Dec-21,7467,7036,431,5.80000000
CN4501300000000,45,013,"Beaufort County, SC",Dec-21,76193,73931,2262,3.00000000
CN4501500000000,45,015,"Berkeley County, SC",Dec-21,108424,105212,3212,3.00000000
CN4501700000000,45,017,"Calhoun County, SC",Dec-21,6367,6128,239,3.80000000
CN4501900000000,45,019,"Charleston County, SC",Dec-21,213073,206934,6139,2.90000000
CN4502100000000,45,021,"Cherokee County, SC",Dec-21,24823,23806,1017,4.10000000
CN4502300000000,45,023,"Chester County, SC",Dec-21,13405,12727,678,5.10000000
CN4502500000000,45,025,"Chesterfield County, SC",Dec-21,21481,20620,861,4.00000000
CN4502700000000,45,027,"Clarendon County, SC",Dec-21,11987,11489,498,4.20000000
CN4502900000000,45,029,"Colleton County, SC",Dec-21,16053,15487,566,3.50000000
CN4503100000000,45,031,"Darlington County, SC",Dec-21,29691,28595,1096,3.70000000
CN4503300000000,45,033,"Dillon County, SC",Dec-21,13017,12339,678,5.20000000
CN4503500000000,45,035,"Dorchester County, SC",Dec-21,78674,76383,2291,2.90000000
CN4503700000000,45,037,"Edgefield County, SC",Dec-21,10273,9981,292,2.80000000
CN4503900000000,45,039,"Fairfield County, SC",Dec-21,9196,8722,474,5.20000000
CN4504100000000,45,041,"Florence County, SC",Dec-21,65954,63745,2209,3.30000000
CN4504300000000,45,043,"Georgetown County, SC",Dec-21,25510,24462,1048,4.10000000
CN4504500000000,45,045,"Greenville County, SC",Dec-21,257085,249874,7211,2.80000000
CN4504700000000,45,047,"Greenwood County, SC",Dec-21,30361,29262,1099,3.60000000
CN4504900000000,45,049,"Hampton County, SC",Dec-21,7917,7687,230,2.90000000
CN4505100000000,45,051,"Horry County, SC",Dec-21,147766,141224,6542,4.40000000
CN4505300000000,45,053,"Jasper County, SC",Dec-21,13092,12713,379,2.90000000
CN4505500000000,45,055,"Kershaw County, SC",Dec-21,29114,28195,919,3.20000000
CN4505700000000,45,057,"Lancaster County, SC",Dec-21,43533,41870,1663,3.80000000
CN4505900000000,45,059,"Laurens County, SC",Dec-21,29781,28704,1077,3.60000000
CN4506100000000,45,061,"Lee County, SC",Dec-21,6493,6185,308,4.70000000
CN4506300000000,45,063,"Lexington County, SC",Dec-21,150130,146222,3908,2.60000000
CN4506500000000,45,065,"McCormick County, SC",Dec-21,3290,3165,125,3.80000000
CN4506700000000,45,067,"Marion County, SC",Dec-21,12727,11973,754,5.90000000
CN4506900000000,45,069,"Marlboro County, SC",Dec-21,8773,8113,660,7.50000000
CN4507100000000,45,071,"Newberry County, SC",Dec-21,18973,18457,516,2.70000000
CN4507300000000,45,073,"Oconee County, SC",Dec-21,33813,32809,1004,3.00000000
CN4507500000000,45,075,"Orangeburg County, SC",Dec-21,33976,31881,2095,6.20000000
CN4507700000000,45,077,"Pickens County, SC",Dec-21,57192,55540,1652,2.90000000
CN4507900000000,45,079,"Richland County, SC",Dec-21,196483,189914,6569,3.30000000
CN4508100000000,45,081,"Saluda County, SC",Dec-21,8221,8001,220,2.70000000
CN4508300000000,45,083,"Spartanburg County, SC",Dec-21,157320,152290,5030,3.20000000
CN4508500000000,45,085,"Sumter County, SC",Dec-21,42180,40574,1606,3.80000000
CN4508700000000,45,087,"Union County, SC",Dec-21,11498,10877,621,5.40000000
CN4508900000000,45,089,"Williamsburg County, SC",Dec-21,10872,10298,574,5.30000000
CN4509100000000,45,091,"York County, SC",Dec-21,147982,143133,4849,3.30000000
CN4600300000000,46,003,"Aurora County, SD",Dec-21,1454,1424,30,2.10000000
CN4600500000000,46,005,"Beadle County, SD",Dec-21,9148,8917,231,2.50000000
CN4600700000000,46,007,"Bennett County, SD",Dec-21,1057,1016,41,3.90000000
CN4600900000000,46,009,"Bon Homme County, SD",Dec-21,2792,2725,67,2.40000000
CN4601100000000,46,011,"Brookings County, SD",Dec-21,18898,18331,567,3.00000000
CN4601300000000,46,013,"Brown County, SD",Dec-21,20514,19905,609,3.00000000
CN4601500000000,46,015,"Brule County, SD",Dec-21,2600,2545,55,2.10000000
CN4601700000000,46,017,"Buffalo County, SD",Dec-21,687,657,30,4.40000000
CN4601900000000,46,019,"Butte County, SD",Dec-21,4963,4815,148,3.00000000
CN4602100000000,46,021,"Campbell County, SD",Dec-21,770,746,24,3.10000000
CN4602300000000,46,023,"Charles Mix County, SD",Dec-21,3738,3622,116,3.10000000
CN4602500000000,46,025,"Clark County, SD",Dec-21,1870,1808,62,3.30000000
CN4602700000000,46,027,"Clay County, SD",Dec-21,7448,7226,222,3.00000000
CN4602900000000,46,029,"Codington County, SD",Dec-21,15831,15409,422,2.70000000
CN4603100000000,46,031,"Corson County, SD",Dec-21,1311,1259,52,4.00000000
CN4603300000000,46,033,"Custer County, SD",Dec-21,4069,3901,168,4.10000000
CN4603500000000,46,035,"Davison County, SD",Dec-21,10861,10593,268,2.50000000
CN4603700000000,46,037,"Day County, SD",Dec-21,2614,2501,113,4.30000000
CN4603900000000,46,039,"Deuel County, SD",Dec-21,2233,2137,96,4.30000000
CN4604100000000,46,041,"Dewey County, SD",Dec-21,2273,2160,113,5.00000000
CN4604300000000,46,043,"Douglas County, SD",Dec-21,1522,1485,37,2.40000000
CN4604500000000,46,045,"Edmunds County, SD",Dec-21,1994,1947,47,2.40000000
CN4604700000000,46,047,"Fall River County, SD",Dec-21,3025,2917,108,3.60000000
CN4604900000000,46,049,"Faulk County, SD",Dec-21,1076,1049,27,2.50000000
CN4605100000000,46,051,"Grant County, SD",Dec-21,4316,4173,143,3.30000000
CN4605300000000,46,053,"Gregory County, SD",Dec-21,2112,2060,52,2.50000000
CN4605500000000,46,055,"Haakon County, SD",Dec-21,1035,1008,27,2.60000000
CN4605700000000,46,057,"Hamlin County, SD",Dec-21,3462,3375,87,2.50000000
CN4605900000000,46,059,"Hand County, SD",Dec-21,1774,1733,41,2.30000000
CN4606100000000,46,061,"Hanson County, SD",Dec-21,1762,1683,79,4.50000000
CN4606300000000,46,063,"Harding County, SD",Dec-21,720,702,18,2.50000000
CN4606500000000,46,065,"Hughes County, SD",Dec-21,9824,9612,212,2.20000000
CN4606700000000,46,067,"Hutchinson County, SD",Dec-21,3599,3488,111,3.10000000
CN4606900000000,46,069,"Hyde County, SD",Dec-21,647,629,18,2.80000000
CN4607100000000,46,071,"Jackson County, SD",Dec-21,1149,1094,55,4.80000000
CN4607300000000,46,073,"Jerauld County, SD",Dec-21,1342,1316,26,1.90000000
CN4607500000000,46,075,"Jones County, SD",Dec-21,502,487,15,3.00000000
CN4607700000000,46,077,"Kingsbury County, SD",Dec-21,2660,2599,61,2.30000000
CN4607900000000,46,079,"Lake County, SD",Dec-21,6536,6364,172,2.60000000
CN4608100000000,46,081,"Lawrence County, SD",Dec-21,13684,13317,367,2.70000000
CN4608300000000,46,083,"Lincoln County, SD",Dec-21,36826,36065,761,2.10000000
CN4608500000000,46,085,"Lyman County, SD",Dec-21,1704,1645,59,3.50000000
CN4608700000000,46,087,"McCook County, SD",Dec-21,3034,2965,69,2.30000000
CN4608900000000,46,089,"McPherson County, SD",Dec-21,965,919,46,4.80000000
CN4609100000000,46,091,"Marshall County, SD",Dec-21,2428,2344,84,3.50000000
CN4609300000000,46,093,"Meade County, SD",Dec-21,13917,13559,358,2.60000000
CN4609500000000,46,095,"Mellette County, SD",Dec-21,731,701,30,4.10000000
CN4609700000000,46,097,"Miner County, SD",Dec-21,1173,1143,30,2.60000000
CN4609900000000,46,099,"Minnehaha County, SD",Dec-21,114669,111840,2829,2.50000000
CN4610100000000,46,101,"Moody County, SD",Dec-21,3946,3849,97,2.50000000
CN4610200000000,46,102,"Oglala Lakota County, SD",Dec-21,4333,4039,294,6.80000000
CN4610300000000,46,103,"Pennington County, SD",Dec-21,57529,55950,1579,2.70000000
CN4610500000000,46,105,"Perkins County, SD",Dec-21,1380,1343,37,2.70000000
CN4610700000000,46,107,"Potter County, SD",Dec-21,1046,1011,35,3.30000000
CN4610900000000,46,109,"Roberts County, SD",Dec-21,4808,4573,235,4.90000000
CN4611100000000,46,111,"Sanborn County, SD",Dec-21,1188,1159,29,2.40000000
CN4611500000000,46,115,"Spink County, SD",Dec-21,3041,2957,84,2.80000000
CN4611700000000,46,117,"Stanley County, SD",Dec-21,1898,1851,47,2.50000000
CN4611900000000,46,119,"Sully County, SD",Dec-21,790,770,20,2.50000000
CN4612100000000,46,121,"Todd County, SD",Dec-21,3199,3068,131,4.10000000
CN4612300000000,46,123,"Tripp County, SD",Dec-21,2985,2920,65,2.20000000
CN4612500000000,46,125,"Turner County, SD",Dec-21,4639,4522,117,2.50000000
CN4612700000000,46,127,"Union County, SD",Dec-21,8682,8411,271,3.10000000
CN4612900000000,46,129,"Walworth County, SD",Dec-21,2128,2026,102,4.80000000
CN4613500000000,46,135,"Yankton County, SD",Dec-21,11629,11358,271,2.30000000
CN4613700000000,46,137,"Ziebach County, SD",Dec-21,954,911,43,4.50000000
CN4700100000000,47,001,"Anderson County, TN",Dec-21,35230,34244,986,2.80000000
CN4700300000000,47,003,"Bedford County, TN",Dec-21,21180,20546,634,3.00000000
CN4700500000000,47,005,"Benton County, TN",Dec-21,6745,6494,251,3.70000000
CN4700700000000,47,007,"Bledsoe County, TN",Dec-21,4253,4071,182,4.30000000
CN4700900000000,47,009,"Blount County, TN",Dec-21,65357,63667,1690,2.60000000
CN4701100000000,47,011,"Bradley County, TN",Dec-21,50981,49466,1515,3.00000000
CN4701300000000,47,013,"Campbell County, TN",Dec-21,14896,14371,525,3.50000000
CN4701500000000,47,015,"Cannon County, TN",Dec-21,6828,6658,170,2.50000000
CN4701700000000,47,017,"Carroll County, TN",Dec-21,11429,11035,394,3.40000000
CN4701900000000,47,019,"Carter County, TN",Dec-21,24322,23533,789,3.20000000
CN4702100000000,47,021,"Cheatham County, TN",Dec-21,22458,21948,510,2.30000000
CN4702300000000,47,023,"Chester County, TN",Dec-21,8525,8315,210,2.50000000
CN4702500000000,47,025,"Claiborne County, TN",Dec-21,12826,12433,393,3.10000000
CN4702700000000,47,027,"Clay County, TN",Dec-21,2766,2638,128,4.60000000
CN4702900000000,47,029,"Cocke County, TN",Dec-21,14470,13774,696,4.80000000
CN4703100000000,47,031,"Coffee County, TN",Dec-21,25154,24385,769,3.10000000
CN4703300000000,47,033,"Crockett County, TN",Dec-21,6783,6600,183,2.70000000
CN4703500000000,47,035,"Cumberland County, TN",Dec-21,22370,21447,923,4.10000000
CN4703700000000,47,037,"Davidson County, TN",Dec-21,413734,402245,11489,2.80000000
CN4703900000000,47,039,"Decatur County, TN",Dec-21,4260,4065,195,4.60000000
CN4704100000000,47,041,"DeKalb County, TN",Dec-21,7754,7493,261,3.40000000
CN4704300000000,47,043,"Dickson County, TN",Dec-21,27835,27147,688,2.50000000
CN4704500000000,47,045,"Dyer County, TN",Dec-21,16081,15545,536,3.30000000
CN4704700000000,47,047,"Fayette County, TN",Dec-21,19489,18882,607,3.10000000
CN4704900000000,47,049,"Fentress County, TN",Dec-21,7468,7218,250,3.30000000
CN4705100000000,47,051,"Franklin County, TN",Dec-21,19491,18918,573,2.90000000
CN4705300000000,47,053,"Gibson County, TN",Dec-21,21499,20811,688,3.20000000
CN4705500000000,47,055,"Giles County, TN",Dec-21,14764,14317,447,3.00000000
CN4705700000000,47,057,"Grainger County, TN",Dec-21,9645,9330,315,3.30000000
CN4705900000000,47,059,"Greene County, TN",Dec-21,28742,27743,999,3.50000000
CN4706100000000,47,061,"Grundy County, TN",Dec-21,5021,4817,204,4.10000000
CN4706300000000,47,063,"Hamblen County, TN",Dec-21,28253,27359,894,3.20000000
CN4706500000000,47,065,"Hamilton County, TN",Dec-21,185234,179788,5446,2.90000000
CN4706700000000,47,067,"Hancock County, TN",Dec-21,2260,2176,84,3.70000000
CN4706900000000,47,069,"Hardeman County, TN",Dec-21,8787,8413,374,4.30000000
CN4707100000000,47,071,"Hardin County, TN",Dec-21,9960,9622,338,3.40000000
CN4707300000000,47,073,"Hawkins County, TN",Dec-21,23306,22537,769,3.30000000
CN4707500000000,47,075,"Haywood County, TN",Dec-21,7563,7255,308,4.10000000
CN4707700000000,47,077,"Henderson County, TN",Dec-21,11864,11484,380,3.20000000
CN4707900000000,47,079,"Henry County, TN",Dec-21,14155,13706,449,3.20000000
CN4708100000000,47,081,"Hickman County, TN",Dec-21,11676,11369,307,2.60000000
CN4708300000000,47,083,"Houston County, TN",Dec-21,3170,3052,118,3.70000000
CN4708500000000,47,085,"Humphreys County, TN",Dec-21,8622,8364,258,3.00000000
CN4708700000000,47,087,"Jackson County, TN",Dec-21,4798,4641,157,3.30000000
CN4708900000000,47,089,"Jefferson County, TN",Dec-21,25067,24306,761,3.00000000
CN4709100000000,47,091,"Johnson County, TN",Dec-21,7736,7530,206,2.70000000
CN4709300000000,47,093,"Knox County, TN",Dec-21,250833,244833,6000,2.40000000
CN4709500000000,47,095,"Lake County, TN",Dec-21,1624,1550,74,4.60000000
CN4709700000000,47,097,"Lauderdale County, TN",Dec-21,9577,9171,406,4.20000000
CN4709900000000,47,099,"Lawrence County, TN",Dec-21,19475,18890,585,3.00000000
CN4710100000000,47,101,"Lewis County, TN",Dec-21,5559,5372,187,3.40000000
CN4710300000000,47,103,"Lincoln County, TN",Dec-21,15997,15509,488,3.10000000
CN4710500000000,47,105,"Loudon County, TN",Dec-21,24233,23597,636,2.60000000
CN4710700000000,47,107,"McMinn County, TN",Dec-21,21969,21227,742,3.40000000
CN4710900000000,47,109,"McNairy County, TN",Dec-21,8249,7919,330,4.00000000
CN4711100000000,47,111,"Macon County, TN",Dec-21,11525,11216,309,2.70000000
CN4711300000000,47,113,"Madison County, TN",Dec-21,49292,47713,1579,3.20000000
CN4711500000000,47,115,"Marion County, TN",Dec-21,12393,11977,416,3.40000000
CN4711700000000,47,117,"Marshall County, TN",Dec-21,15518,15041,477,3.10000000
CN4711900000000,47,119,"Maury County, TN",Dec-21,53094,51444,1650,3.10000000
CN4712100000000,47,121,"Meigs County, TN",Dec-21,5122,4941,181,3.50000000
CN4712300000000,47,123,"Monroe County, TN",Dec-21,20714,20120,594,2.90000000
CN4712500000000,47,125,"Montgomery County, TN",Dec-21,88780,85883,2897,3.30000000
CN4712700000000,47,127,"Moore County, TN",Dec-21,3641,3569,72,2.00000000
CN4712900000000,47,129,"Morgan County, TN",Dec-21,7822,7579,243,3.10000000
CN4713100000000,47,131,"Obion County, TN",Dec-21,12241,11810,431,3.50000000
CN4713300000000,47,133,"Overton County, TN",Dec-21,9897,9635,262,2.60000000
CN4713500000000,47,135,"Perry County, TN",Dec-21,2824,2621,203,7.20000000
CN4713700000000,47,137,"Pickett County, TN",Dec-21,2125,2056,69,3.20000000
CN4713900000000,47,139,"Polk County, TN",Dec-21,7132,6910,222,3.10000000
CN4714100000000,47,141,"Putnam County, TN",Dec-21,35818,34797,1021,2.90000000
CN4714300000000,47,143,"Rhea County, TN",Dec-21,13883,13397,486,3.50000000
CN4714500000000,47,145,"Roane County, TN",Dec-21,23701,22982,719,3.00000000
CN4714700000000,47,147,"Robertson County, TN",Dec-21,39055,38104,951,2.40000000
CN4714900000000,47,149,"Rutherford County, TN",Dec-21,195682,190983,4699,2.40000000
CN4715100000000,47,151,"Scott County, TN",Dec-21,7971,7635,336,4.20000000
CN4715300000000,47,153,"Sequatchie County, TN",Dec-21,6181,5974,207,3.30000000
CN4715500000000,47,155,"Sevier County, TN",Dec-21,54807,53361,1446,2.60000000
CN4715700000000,47,157,"Shelby County, TN",Dec-21,450259,429198,21061,4.70000000
CN4715900000000,47,159,"Smith County, TN",Dec-21,9696,9449,247,2.50000000
CN4716100000000,47,161,"Stewart County, TN",Dec-21,5333,5155,178,3.30000000
CN4716300000000,47,163,"Sullivan County, TN",Dec-21,69313,67162,2151,3.10000000
CN4716500000000,47,165,"Sumner County, TN",Dec-21,108457,105911,2546,2.30000000
CN4716700000000,47,167,"Tipton County, TN",Dec-21,28134,27252,882,3.10000000
CN4716900000000,47,169,"Trousdale County, TN",Dec-21,5707,5554,153,2.70000000
CN4717100000000,47,171,"Unicoi County, TN",Dec-21,7122,6840,282,4.00000000
CN4717300000000,47,173,"Union County, TN",Dec-21,7787,7548,239,3.10000000
CN4717500000000,47,175,"Van Buren County, TN",Dec-21,1989,1913,76,3.80000000
CN4717700000000,47,177,"Warren County, TN",Dec-21,16581,16007,574,3.50000000
CN4717900000000,47,179,"Washington County, TN",Dec-21,62165,60491,1674,2.70000000
CN4718100000000,47,181,"Wayne County, TN",Dec-21,6282,6064,218,3.50000000
CN4718300000000,47,183,"Weakley County, TN",Dec-21,15515,15064,451,2.90000000
CN4718500000000,47,185,"White County, TN",Dec-21,11736,11374,362,3.10000000
CN4718700000000,47,187,"Williamson County, TN",Dec-21,137363,134765,2598,1.90000000
CN4718900000000,47,189,"Wilson County, TN",Dec-21,81800,79939,1861,2.30000000
CN4800100000000,48,001,"Anderson County, TX",Dec-21,23120,22327,793,3.40000000
CN4800300000000,48,003,"Andrews County, TX",Dec-21,8848,8464,384,4.30000000
CN4800500000000,48,005,"Angelina County, TX",Dec-21,35714,33880,1834,5.10000000
CN4800700000000,48,007,"Aransas County, TX",Dec-21,9231,8691,540,5.80000000
CN4800900000000,48,009,"Archer County, TX",Dec-21,3925,3801,124,3.20000000
CN4801100000000,48,011,"Armstrong County, TX",Dec-21,906,883,23,2.50000000
CN4801300000000,48,013,"Atascosa County, TX",Dec-21,21901,20886,1015,4.60000000
CN4801500000000,48,015,"Austin County, TX",Dec-21,13776,13209,567,4.10000000
CN4801700000000,48,017,"Bailey County, TX",Dec-21,2252,2158,94,4.20000000
CN4801900000000,48,019,"Bandera County, TX",Dec-21,10272,9909,363,3.50000000
CN4802100000000,48,021,"Bastrop County, TX",Dec-21,46129,44603,1526,3.30000000
CN4802300000000,48,023,"Baylor County, TX",Dec-21,1784,1737,47,2.60000000
CN4802500000000,48,025,"Bee County, TX",Dec-21,8961,8334,627,7.00000000
CN4802700000000,48,027,"Bell County, TX",Dec-21,148168,141586,6582,4.40000000
CN4802900000000,48,029,"Bexar County, TX",Dec-21,952211,915317,36894,3.90000000
CN4803100000000,48,031,"Blanco County, TX",Dec-21,7008,6832,176,2.50000000
CN4803300000000,48,033,"Borden County, TX",Dec-21,626,613,13,2.10000000
CN4803500000000,48,035,"Bosque County, TX",Dec-21,8403,8106,297,3.50000000
CN4803700000000,48,037,"Bowie County, TX",Dec-21,39347,37499,1848,4.70000000
CN4803900000000,48,039,"Brazoria County, TX",Dec-21,182180,172396,9784,5.40000000
CN4804100000000,48,041,"Brazos County, TX",Dec-21,122902,119206,3696,3.00000000
CN4804300000000,48,043,"Brewster County, TX",Dec-21,4087,3949,138,3.40000000
CN4804500000000,48,045,"Briscoe County, TX",Dec-21,541,519,22,4.10000000
CN4804700000000,48,047,"Brooks County, TX",Dec-21,2450,2279,171,7.00000000
CN4804900000000,48,049,"Brown County, TX",Dec-21,15026,14433,593,3.90000000
CN4805100000000,48,051,"Burleson County, TX",Dec-21,8459,8148,311,3.70000000
CN4805300000000,48,053,"Burnet County, TX",Dec-21,24506,23815,691,2.80000000
CN4805500000000,48,055,"Caldwell County, TX",Dec-21,20408,19690,718,3.50000000
CN4805700000000,48,057,"Calhoun County, TX",Dec-21,12121,11638,483,4.00000000
CN4805900000000,48,059,"Callahan County, TX",Dec-21,6158,5941,217,3.50000000
CN4806100000000,48,061,"Cameron County, TX",Dec-21,175175,163657,11518,6.60000000
CN4806300000000,48,063,"Camp County, TX",Dec-21,5122,4882,240,4.70000000
CN4806500000000,48,065,"Carson County, TX",Dec-21,2923,2836,87,3.00000000
CN4806700000000,48,067,"Cass County, TX",Dec-21,12199,11580,619,5.10000000
CN4806900000000,48,069,"Castro County, TX",Dec-21,3197,3114,83,2.60000000
CN4807100000000,48,071,"Chambers County, TX",Dec-21,20882,19500,1382,6.60000000
CN4807300000000,48,073,"Cherokee County, TX",Dec-21,20616,19578,1038,5.00000000
CN4807500000000,48,075,"Childress County, TX",Dec-21,2911,2829,82,2.80000000
CN4807700000000,48,077,"Clay County, TX",Dec-21,4747,4570,177,3.70000000
CN4807900000000,48,079,"Cochran County, TX",Dec-21,980,923,57,5.80000000
CN4808100000000,48,081,"Coke County, TX",Dec-21,1340,1294,46,3.40000000
CN4808300000000,48,083,"Coleman County, TX",Dec-21,2874,2738,136,4.70000000
CN4808500000000,48,085,"Collin County, TX",Dec-21,611774,592799,18975,3.10000000
CN4808700000000,48,087,"Collingsworth County, TX",Dec-21,1043,1011,32,3.10000000
CN4808900000000,48,089,"Colorado County, TX",Dec-21,9806,9450,356,3.60000000
CN4809100000000,48,091,"Comal County, TX",Dec-21,79856,77193,2663,3.30000000
CN4809300000000,48,093,"Comanche County, TX",Dec-21,6052,5831,221,3.70000000
CN4809500000000,48,095,"Concho County, TX",Dec-21,1259,1217,42,3.30000000
CN4809700000000,48,097,"Cooke County, TX",Dec-21,19243,18573,670,3.50000000
CN4809900000000,48,099,"Coryell County, TX",Dec-21,24431,23372,1059,4.30000000
CN4810100000000,48,101,"Cottle County, TX",Dec-21,611,592,19,3.10000000
CN4810300000000,48,103,"Crane County, TX",Dec-21,1595,1484,111,7.00000000
CN4810500000000,48,105,"Crockett County, TX",Dec-21,1406,1327,79,5.60000000
CN4810700000000,48,107,"Crosby County, TX",Dec-21,2289,2196,93,4.10000000
CN4810900000000,48,109,"Culberson County, TX",Dec-21,1048,1012,36,3.40000000
CN4811100000000,48,111,"Dallam County, TX",Dec-21,3677,3603,74,2.00000000
CN4811300000000,48,113,"Dallas County, TX",Dec-21,1395947,1339969,55978,4.00000000
CN4811500000000,48,115,"Dawson County, TX",Dec-21,4460,4223,237,5.30000000
CN4811700000000,48,117,"Deaf Smith County, TX",Dec-21,8472,8220,252,3.00000000
CN4811900000000,48,119,"Delta County, TX",Dec-21,2427,2333,94,3.90000000
CN4812100000000,48,121,"Denton County, TX",Dec-21,539377,522486,16891,3.10000000
CN4812300000000,48,123,"DeWitt County, TX",Dec-21,9416,9087,329,3.50000000
CN4812500000000,48,125,"Dickens County, TX",Dec-21,659,634,25,3.80000000
CN4812700000000,48,127,"Dimmit County, TX",Dec-21,5766,5517,249,4.30000000
CN4812900000000,48,129,"Donley County, TX",Dec-21,1450,1404,46,3.20000000
CN4813100000000,48,131,"Duval County, TX",Dec-21,5431,5096,335,6.20000000
CN4813300000000,48,133,"Eastland County, TX",Dec-21,7255,6947,308,4.20000000
CN4813500000000,48,135,"Ector County, TX",Dec-21,81054,76357,4697,5.80000000
CN4813700000000,48,137,"Edwards County, TX",Dec-21,1187,1142,45,3.80000000
CN4813900000000,48,139,"Ellis County, TX",Dec-21,100914,97582,3332,3.30000000
CN4814100000000,48,141,"El Paso County, TX",Dec-21,363442,346240,17202,4.70000000
CN4814300000000,48,143,"Erath County, TX",Dec-21,20262,19569,693,3.40000000
CN4814500000000,48,145,"Falls County, TX",Dec-21,6588,6319,269,4.10000000
CN4814700000000,48,147,"Fannin County, TX",Dec-21,17196,16673,523,3.00000000
CN4814900000000,48,149,"Fayette County, TX",Dec-21,11652,11262,390,3.30000000
CN4815100000000,48,151,"Fisher County, TX",Dec-21,1539,1491,48,3.10000000
CN4815300000000,48,153,"Floyd County, TX",Dec-21,2379,2277,102,4.30000000
CN4815500000000,48,155,"Foard County, TX",Dec-21,592,574,18,3.00000000
CN4815700000000,48,157,"Fort Bend County, TX",Dec-21,412114,394068,18046,4.40000000
CN4815900000000,48,159,"Franklin County, TX",Dec-21,5115,4943,172,3.40000000
CN4816100000000,48,161,"Freestone County, TX",Dec-21,6103,5778,325,5.30000000
CN4816300000000,48,163,"Frio County, TX",Dec-21,9055,8722,333,3.70000000
CN4816500000000,48,165,"Gaines County, TX",Dec-21,9561,9260,301,3.10000000
CN4816700000000,48,167,"Galveston County, TX",Dec-21,166713,158244,8469,5.10000000
CN4816900000000,48,169,"Garza County, TX",Dec-21,1932,1861,71,3.70000000
CN4817100000000,48,171,"Gillespie County, TX",Dec-21,14268,13906,362,2.50000000
CN4817300000000,48,173,"Glasscock County, TX",Dec-21,771,752,19,2.50000000
CN4817500000000,48,175,"Goliad County, TX",Dec-21,3158,3004,154,4.90000000
CN4817700000000,48,177,"Gonzales County, TX",Dec-21,9354,9052,302,3.20000000
CN4817900000000,48,179,"Gray County, TX",Dec-21,7556,7184,372,4.90000000
CN4818100000000,48,181,"Grayson County, TX",Dec-21,66158,63869,2289,3.50000000
CN4818300000000,48,183,"Gregg County, TX",Dec-21,56101,53400,2701,4.80000000
CN4818500000000,48,185,"Grimes County, TX",Dec-21,10960,10379,581,5.30000000
CN4818700000000,48,187,"Guadalupe County, TX",Dec-21,82983,80241,2742,3.30000000
CN4818900000000,48,189,"Hale County, TX",Dec-21,11564,11025,539,4.70000000
CN4819100000000,48,191,"Hall County, TX",Dec-21,1041,999,42,4.00000000
CN4819300000000,48,193,"Hamilton County, TX",Dec-21,3720,3607,113,3.00000000
CN4819500000000,48,195,"Hansford County, TX",Dec-21,2471,2411,60,2.40000000
CN4819700000000,48,197,"Hardeman County, TX",Dec-21,1658,1602,56,3.40000000
CN4819900000000,48,199,"Hardin County, TX",Dec-21,24800,23194,1606,6.50000000
CN4820100000000,48,201,"Harris County, TX",Dec-21,2308130,2196197,111933,4.80000000
CN4820300000000,48,203,"Harrison County, TX",Dec-21,28259,26792,1467,5.20000000
CN4820500000000,48,205,"Hartley County, TX",Dec-21,2680,2632,48,1.80000000
CN4820700000000,48,207,"Haskell County, TX",Dec-21,2675,2590,85,3.20000000
CN4820900000000,48,209,"Hays County, TX",Dec-21,132993,128989,4004,3.00000000
CN4821100000000,48,211,"Hemphill County, TX",Dec-21,1595,1540,55,3.40000000
CN4821300000000,48,213,"Henderson County, TX",Dec-21,38356,36891,1465,3.80000000
CN4821500000000,48,215,"Hidalgo County, TX",Dec-21,368989,340222,28767,7.80000000
CN4821700000000,48,217,"Hill County, TX",Dec-21,16939,16284,655,3.90000000
CN4821900000000,48,219,"Hockley County, TX",Dec-21,10528,10065,463,4.40000000
CN4822100000000,48,221,"Hood County, TX",Dec-21,29217,28118,1099,3.80000000
CN4822300000000,48,223,"Hopkins County, TX",Dec-21,17848,17265,583,3.30000000
CN4822500000000,48,225,"Houston County, TX",Dec-21,10638,10238,400,3.80000000
CN4822700000000,48,227,"Howard County, TX",Dec-21,13152,12483,669,5.10000000
CN4822900000000,48,229,"Hudspeth County, TX",Dec-21,1791,1713,78,4.40000000
CN4823100000000,48,231,"Hunt County, TX",Dec-21,45731,43986,1745,3.80000000
CN4823300000000,48,233,"Hutchinson County, TX",Dec-21,8203,7807,396,4.80000000
CN4823500000000,48,235,"Irion County, TX",Dec-21,755,730,25,3.30000000
CN4823700000000,48,237,"Jack County, TX",Dec-21,3393,3257,136,4.00000000
CN4823900000000,48,239,"Jackson County, TX",Dec-21,6950,6673,277,4.00000000
CN4824100000000,48,241,"Jasper County, TX",Dec-21,12785,11750,1035,8.10000000
CN4824300000000,48,243,"Jeff Davis County, TX",Dec-21,964,930,34,3.50000000
CN4824500000000,48,245,"Jefferson County, TX",Dec-21,101135,93130,8005,7.90000000
CN4824700000000,48,247,"Jim Hogg County, TX",Dec-21,1849,1718,131,7.10000000
CN4824900000000,48,249,"Jim Wells County, TX",Dec-21,15256,14077,1179,7.70000000
CN4825100000000,48,251,"Johnson County, TX",Dec-21,87049,83989,3060,3.50000000
CN4825300000000,48,253,"Jones County, TX",Dec-21,5670,5405,265,4.70000000
CN4825500000000,48,255,"Karnes County, TX",Dec-21,6715,6460,255,3.80000000
CN4825700000000,48,257,"Kaufman County, TX",Dec-21,73382,70724,2658,3.60000000
CN4825900000000,48,259,"Kendall County, TX",Dec-21,22918,22251,667,2.90000000
CN4826100000000,48,261,"Kenedy County, TX",Dec-21,180,171,9,5.00000000
CN4826300000000,48,263,"Kent County, TX",Dec-21,426,416,10,2.30000000
CN4826500000000,48,265,"Kerr County, TX",Dec-21,22009,21251,758,3.40000000
CN4826700000000,48,267,"Kimble County, TX",Dec-21,1877,1820,57,3.00000000
CN4826900000000,48,269,"King County, TX",Dec-21,543,539,4,0.70000000
CN4827100000000,48,271,"Kinney County, TX",Dec-21,1205,1149,56,4.60000000
CN4827300000000,48,273,"Kleberg County, TX",Dec-21,13052,12348,704,5.40000000
CN4827500000000,48,275,"Knox County, TX",Dec-21,1384,1333,51,3.70000000
CN4827700000000,48,277,"Lamar County, TX",Dec-21,24213,23150,1063,4.40000000
CN4827900000000,48,279,"Lamb County, TX",Dec-21,4995,4805,190,3.80000000
CN4828100000000,48,281,"Lampasas County, TX",Dec-21,9314,8970,344,3.70000000
CN4828300000000,48,283,"La Salle County, TX",Dec-21,3918,3805,113,2.90000000
CN4828500000000,48,285,"Lavaca County, TX",Dec-21,8623,8332,291,3.40000000
CN4828700000000,48,287,"Lee County, TX",Dec-21,8918,8620,298,3.30000000
CN4828900000000,48,289,"Leon County, TX",Dec-21,6032,5697,335,5.60000000
CN4829100000000,48,291,"Liberty County, TX",Dec-21,34976,32470,2506,7.20000000
CN4829300000000,48,293,"Limestone County, TX",Dec-21,8411,8007,404,4.80000000
CN4829500000000,48,295,"Lipscomb County, TX",Dec-21,1459,1418,41,2.80000000
CN4829700000000,48,297,"Live Oak County, TX",Dec-21,4834,4580,254,5.30000000
CN4829900000000,48,299,"Llano County, TX",Dec-21,8855,8521,334,3.80000000
CN4830100000000,48,301,"Loving County, TX",Dec-21,446,442,4,0.90000000
CN4830300000000,48,303,"Lubbock County, TX",Dec-21,161296,156025,5271,3.30000000
CN4830500000000,48,305,"Lynn County, TX",Dec-21,2733,2640,93,3.40000000
CN4830700000000,48,307,"McCulloch County, TX",Dec-21,3085,2927,158,5.10000000
CN4830900000000,48,309,"McLennan County, TX",Dec-21,123759,119407,4352,3.50000000
CN4831100000000,48,311,"McMullen County, TX",Dec-21,758,743,15,2.00000000
CN4831300000000,48,313,"Madison County, TX",Dec-21,4690,4466,224,4.80000000
CN4831500000000,48,315,"Marion County, TX",Dec-21,4226,3999,227,5.40000000
CN4831700000000,48,317,"Martin County, TX",Dec-21,2609,2512,97,3.70000000
CN4831900000000,48,319,"Mason County, TX",Dec-21,1762,1701,61,3.50000000
CN4832100000000,48,321,"Matagorda County, TX",Dec-21,16205,15055,1150,7.10000000
CN4832300000000,48,323,"Maverick County, TX",Dec-21,23436,21107,2329,9.90000000
CN4832500000000,48,325,"Medina County, TX",Dec-21,21894,21065,829,3.80000000
CN4832700000000,48,327,"Menard County, TX",Dec-21,809,777,32,4.00000000
CN4832900000000,48,329,"Midland County, TX",Dec-21,101040,97007,4033,4.00000000
CN4833100000000,48,331,"Milam County, TX",Dec-21,10147,9698,449,4.40000000
CN4833300000000,48,333,"Mills County, TX",Dec-21,1825,1754,71,3.90000000
CN4833500000000,48,335,"Mitchell County, TX",Dec-21,2312,2179,133,5.80000000
CN4833700000000,48,337,"Montague County, TX",Dec-21,9165,8816,349,3.80000000
CN4833900000000,48,339,"Montgomery County, TX",Dec-21,297163,284194,12969,4.40000000
CN4834100000000,48,341,"Moore County, TX",Dec-21,10768,10493,275,2.60000000
CN4834300000000,48,343,"Morris County, TX",Dec-21,4530,4172,358,7.90000000
CN4834500000000,48,345,"Motley County, TX",Dec-21,429,411,18,4.20000000
CN4834700000000,48,347,"Nacogdoches County, TX",Dec-21,27836,26657,1179,4.20000000
CN4834900000000,48,349,"Navarro County, TX",Dec-21,23589,22678,911,3.90000000
CN4835100000000,48,351,"Newton County, TX",Dec-21,4871,4447,424,8.70000000
CN4835300000000,48,353,"Nolan County, TX",Dec-21,6931,6689,242,3.50000000
CN4835500000000,48,355,"Nueces County, TX",Dec-21,163800,154893,8907,5.40000000
CN4835700000000,48,357,"Ochiltree County, TX",Dec-21,3816,3687,129,3.40000000
CN4835900000000,48,359,"Oldham County, TX",Dec-21,902,877,25,2.80000000
CN4836100000000,48,361,"Orange County, TX",Dec-21,34795,32309,2486,7.10000000
CN4836300000000,48,363,"Palo Pinto County, TX",Dec-21,12725,12192,533,4.20000000
CN4836500000000,48,365,"Panola County, TX",Dec-21,9628,9133,495,5.10000000
CN4836700000000,48,367,"Parker County, TX",Dec-21,72867,70487,2380,3.30000000
CN4836900000000,48,369,"Parmer County, TX",Dec-21,4832,4717,115,2.40000000
CN4837100000000,48,371,"Pecos County, TX",Dec-21,5867,5533,334,5.70000000
CN4837300000000,48,373,"Polk County, TX",Dec-21,18480,17310,1170,6.30000000
CN4837500000000,48,375,"Potter County, TX",Dec-21,54463,52728,1735,3.20000000
CN4837700000000,48,377,"Presidio County, TX",Dec-21,3041,2814,227,7.50000000
CN4837900000000,48,379,"Rains County, TX",Dec-21,6441,6256,185,2.90000000
CN4838100000000,48,381,"Randall County, TX",Dec-21,74897,72929,1968,2.60000000
CN4838300000000,48,383,"Reagan County, TX",Dec-21,1575,1492,83,5.30000000
CN4838500000000,48,385,"Real County, TX",Dec-21,1057,1007,50,4.70000000
CN4838700000000,48,387,"Red River County, TX",Dec-21,5276,5010,266,5.00000000
CN4838900000000,48,389,"Reeves County, TX",Dec-21,8663,8286,377,4.40000000
CN4839100000000,48,391,"Refugio County, TX",Dec-21,2986,2829,157,5.30000000
CN4839300000000,48,393,"Roberts County, TX",Dec-21,384,367,17,4.40000000
CN4839500000000,48,395,"Robertson County, TX",Dec-21,7580,7282,298,3.90000000
CN4839700000000,48,397,"Rockwall County, TX",Dec-21,57899,56074,1825,3.20000000
CN4839900000000,48,399,"Runnels County, TX",Dec-21,4512,4371,141,3.10000000
CN4840100000000,48,401,"Rusk County, TX",Dec-21,21969,20991,978,4.50000000
CN4840300000000,48,403,"Sabine County, TX",Dec-21,3874,3544,330,8.50000000
CN4840500000000,48,405,"San Augustine County, TX",Dec-21,2943,2749,194,6.60000000
CN4840700000000,48,407,"San Jacinto County, TX",Dec-21,11837,11169,668,5.60000000
CN4840900000000,48,409,"San Patricio County, TX",Dec-21,29379,27168,2211,7.50000000
CN4841100000000,48,411,"San Saba County, TX",Dec-21,2180,2107,73,3.30000000
CN4841300000000,48,413,"Schleicher County, TX",Dec-21,1185,1134,51,4.30000000
CN4841500000000,48,415,"Scurry County, TX",Dec-21,5942,5632,310,5.20000000
CN4841700000000,48,417,"Shackelford County, TX",Dec-21,1807,1751,56,3.10000000
CN4841900000000,48,419,"Shelby County, TX",Dec-21,11322,10844,478,4.20000000
CN4842100000000,48,421,"Sherman County, TX",Dec-21,1362,1328,34,2.50000000
CN4842300000000,48,423,"Smith County, TX",Dec-21,111105,106948,4157,3.70000000
CN4842500000000,48,425,"Somervell County, TX",Dec-21,4474,4303,171,3.80000000
CN4842700000000,48,427,"Starr County, TX",Dec-21,24582,21073,3509,14.30000000
CN4842900000000,48,429,"Stephens County, TX",Dec-21,4252,4099,153,3.60000000
CN4843100000000,48,431,"Sterling County, TX",Dec-21,510,487,23,4.50000000
CN4843300000000,48,433,"Stonewall County, TX",Dec-21,565,546,19,3.40000000
CN4843500000000,48,435,"Sutton County, TX",Dec-21,1076,1008,68,6.30000000
CN4843700000000,48,437,"Swisher County, TX",Dec-21,2514,2427,87,3.50000000
CN4843900000000,48,439,"Tarrant County, TX",Dec-21,1118243,1076152,42091,3.80000000
CN4844100000000,48,441,"Taylor County, TX",Dec-21,67556,65376,2180,3.20000000
CN4844300000000,48,443,"Terrell County, TX",Dec-21,405,390,15,3.70000000
CN4844500000000,48,445,"Terry County, TX",Dec-21,4539,4311,228,5.00000000
CN4844700000000,48,447,"Throckmorton County, TX",Dec-21,1140,1118,22,1.90000000
CN4844900000000,48,449,"Titus County, TX",Dec-21,13565,12997,568,4.20000000
CN4845100000000,48,451,"Tom Green County, TX",Dec-21,53855,51912,1943,3.60000000
CN4845300000000,48,453,"Travis County, TX",Dec-21,790558,768168,22390,2.80000000
CN4845500000000,48,455,"Trinity County, TX",Dec-21,5175,4861,314,6.10000000
CN4845700000000,48,457,"Tyler County, TX",Dec-21,7330,6802,528,7.20000000
CN4845900000000,48,459,"Upshur County, TX",Dec-21,17532,16670,862,4.90000000
CN4846100000000,48,461,"Upton County, TX",Dec-21,1668,1597,71,4.30000000
CN4846300000000,48,463,"Uvalde County, TX",Dec-21,10964,10501,463,4.20000000
CN4846500000000,48,465,"Val Verde County, TX",Dec-21,22256,21206,1050,4.70000000
CN4846700000000,48,467,"Van Zandt County, TX",Dec-21,26706,25784,922,3.50000000
CN4846900000000,48,469,"Victoria County, TX",Dec-21,41150,39141,2009,4.90000000
CN4847100000000,48,471,"Walker County, TX",Dec-21,23490,22335,1155,4.90000000
CN4847300000000,48,473,"Waller County, TX",Dec-21,24898,23737,1161,4.70000000
CN4847500000000,48,475,"Ward County, TX",Dec-21,5913,5613,300,5.10000000
CN4847700000000,48,477,"Washington County, TX",Dec-21,14769,14192,577,3.90000000
CN4847900000000,48,479,"Webb County, TX",Dec-21,117470,111955,5515,4.70000000
CN4848100000000,48,481,"Wharton County, TX",Dec-21,20780,19880,900,4.30000000
CN4848300000000,48,483,"Wheeler County, TX",Dec-21,1937,1849,88,4.50000000
CN4848500000000,48,485,"Wichita County, TX",Dec-21,54959,52823,2136,3.90000000
CN4848700000000,48,487,"Wilbarger County, TX",Dec-21,4717,4474,243,5.20000000
CN4848900000000,48,489,"Willacy County, TX",Dec-21,6802,6226,576,8.50000000
CN4849100000000,48,491,"Williamson County, TX",Dec-21,349746,339633,10113,2.90000000
CN4849300000000,48,493,"Wilson County, TX",Dec-21,25182,24362,820,3.30000000
CN4849500000000,48,495,"Winkler County, TX",Dec-21,3725,3499,226,6.10000000
CN4849700000000,48,497,"Wise County, TX",Dec-21,33445,32274,1171,3.50000000
CN4849900000000,48,499,"Wood County, TX",Dec-21,17723,16921,802,4.50000000
CN4850100000000,48,501,"Yoakum County, TX",Dec-21,3156,2980,176,5.60000000
CN4850300000000,48,503,"Young County, TX",Dec-21,7929,7659,270,3.40000000
CN4850500000000,48,505,"Zapata County, TX",Dec-21,4511,4070,441,9.80000000
CN4850700000000,48,507,"Zavala County, TX",Dec-21,3232,2908,324,10.00000000
CN4900100000000,49,001,"Beaver County, UT",Dec-21,2750,2686,64,2.30000000
CN4900300000000,49,003,"Box Elder County, UT",Dec-21,26965,26507,458,1.70000000
CN4900500000000,49,005,"Cache County, UT",Dec-21,70388,69387,1001,1.40000000
CN4900700000000,49,007,"Carbon County, UT",Dec-21,8334,8106,228,2.70000000
CN4900900000000,49,009,"Daggett County, UT",Dec-21,362,345,17,4.70000000
CN4901100000000,49,011,"Davis County, UT",Dec-21,179946,176968,2978,1.70000000
CN4901300000000,49,013,"Duchesne County, UT",Dec-21,7726,7482,244,3.20000000
CN4901500000000,49,015,"Emery County, UT",Dec-21,4352,4241,111,2.60000000
CN4901700000000,49,017,"Garfield County, UT",Dec-21,2342,2139,203,8.70000000
CN4901900000000,49,019,"Grand County, UT",Dec-21,5967,5698,269,4.50000000
CN4902100000000,49,021,"Iron County, UT",Dec-21,26750,26167,583,2.20000000
CN4902300000000,49,023,"Juab County, UT",Dec-21,6312,6223,89,1.40000000
CN4902500000000,49,025,"Kane County, UT",Dec-21,3734,3646,88,2.40000000
CN4902700000000,49,027,"Millard County, UT",Dec-21,5886,5783,103,1.70000000
CN4902900000000,49,029,"Morgan County, UT",Dec-21,5806,5721,85,1.50000000
CN4903100000000,49,031,"Piute County, UT",Dec-21,472,452,20,4.20000000
CN4903300000000,49,033,"Rich County, UT",Dec-21,1008,988,20,2.00000000
CN4903500000000,49,035,"Salt Lake County, UT",Dec-21,661892,649720,12172,1.80000000
CN4903700000000,49,037,"San Juan County, UT",Dec-21,5222,4978,244,4.70000000
CN4903900000000,49,039,"Sanpete County, UT",Dec-21,13095,12832,263,2.00000000
CN4904100000000,49,041,"Sevier County, UT",Dec-21,9913,9669,244,2.50000000
CN4904300000000,49,043,"Summit County, UT",Dec-21,26401,25963,438,1.70000000
CN4904500000000,49,045,"Tooele County, UT",Dec-21,37304,36589,715,1.90000000
CN4904700000000,49,047,"Uintah County, UT",Dec-21,13541,13057,484,3.60000000
CN4904900000000,49,049,"Utah County, UT",Dec-21,339409,334041,5368,1.60000000
CN4905100000000,49,051,"Wasatch County, UT",Dec-21,17092,16768,324,1.90000000
CN4905300000000,49,053,"Washington County, UT",Dec-21,84533,82812,1721,2.00000000
CN4905500000000,49,055,"Wayne County, UT",Dec-21,1408,1337,71,5.00000000
CN4905700000000,49,057,"Weber County, UT",Dec-21,132184,129562,2622,2.00000000
CN5000100000000,50,001,"Addison County, VT",Dec-21,19804,19364,440,2.20000000
CN5000300000000,50,003,"Bennington County, VT",Dec-21,16980,16400,580,3.40000000
CN5000500000000,50,005,"Caledonia County, VT",Dec-21,13721,13334,387,2.80000000
CN5000700000000,50,007,"Chittenden County, VT",Dec-21,92855,91159,1696,1.80000000
CN5000900000000,50,009,"Essex County, VT",Dec-21,2556,2459,97,3.80000000
CN5001100000000,50,011,"Franklin County, VT",Dec-21,26746,26011,735,2.70000000
CN5001300000000,50,013,"Grand Isle County, VT",Dec-21,4007,3824,183,4.60000000
CN5001500000000,50,015,"Lamoille County, VT",Dec-21,13307,12832,475,3.60000000
CN5001700000000,50,017,"Orange County, VT",Dec-21,15147,14758,389,2.60000000
CN5001900000000,50,019,"Orleans County, VT",Dec-21,12845,12295,550,4.30000000
CN5002100000000,50,021,"Rutland County, VT",Dec-21,29087,28174,913,3.10000000
CN5002300000000,50,023,"Washington County, VT",Dec-21,32364,31657,707,2.20000000
CN5002500000000,50,025,"Windham County, VT",Dec-21,20287,19695,592,2.90000000
CN5002700000000,50,027,"Windsor County, VT",Dec-21,28407,27815,592,2.10000000
CN5100100000000,51,001,"Accomack County, VA",Dec-21,15200,14753,447,2.90000000
CN5100300000000,51,003,"Albemarle County, VA",Dec-21,55935,54730,1205,2.20000000
CN5100500000000,51,005,"Alleghany County, VA",Dec-21,6558,6355,203,3.10000000
CN5100700000000,51,007,"Amelia County, VA",Dec-21,5977,5834,143,2.40000000
CN5100900000000,51,009,"Amherst County, VA",Dec-21,14353,13967,386,2.70000000
CN5101100000000,51,011,"Appomattox County, VA",Dec-21,6906,6727,179,2.60000000
CN5101300000000,51,013,"Arlington County, VA",Dec-21,150569,147747,2822,1.90000000
CN5101500000000,51,015,"Augusta County, VA",Dec-21,36679,35869,810,2.20000000
CN5101700000000,51,017,"Bath County, VA",Dec-21,2247,2184,63,2.80000000
CN5101900000000,51,019,"Bedford County, VA",Dec-21,37268,36391,877,2.40000000
CN5102100000000,51,021,"Bland County, VA",Dec-21,2745,2672,73,2.70000000
CN5102300000000,51,023,"Botetourt County, VA",Dec-21,16995,16656,339,2.00000000
CN5102500000000,51,025,"Brunswick County, VA",Dec-21,5861,5515,346,5.90000000
CN5102700000000,51,027,"Buchanan County, VA",Dec-21,6323,6037,286,4.50000000
CN5102900000000,51,029,"Buckingham County, VA",Dec-21,6244,6003,241,3.90000000
CN5103100000000,51,031,"Campbell County, VA",Dec-21,24980,24304,676,2.70000000
CN5103300000000,51,033,"Caroline County, VA",Dec-21,14600,14131,469,3.20000000
CN5103500000000,51,035,"Carroll County, VA",Dec-21,13025,12674,351,2.70000000
CN5103600000000,51,036,"Charles City County, VA",Dec-21,3432,3325,107,3.10000000
CN5103700000000,51,037,"Charlotte County, VA",Dec-21,5573,5441,132,2.40000000
CN5104100000000,51,041,"Chesterfield County, VA",Dec-21,183704,178624,5080,2.80000000
CN5104300000000,51,043,"Clarke County, VA",Dec-21,7426,7253,173,2.30000000
CN5104500000000,51,045,"Craig County, VA",Dec-21,2228,2176,52,2.30000000
CN5104700000000,51,047,"Culpeper County, VA",Dec-21,24632,24049,583,2.40000000
CN5104900000000,51,049,"Cumberland County, VA",Dec-21,4599,4465,134,2.90000000
CN5105100000000,51,051,"Dickenson County, VA",Dec-21,4792,4626,166,3.50000000
CN5105300000000,51,053,"Dinwiddie County, VA",Dec-21,13350,12740,610,4.60000000
CN5105700000000,51,057,"Essex County, VA",Dec-21,5253,5071,182,3.50000000
CN5105900000000,51,059,"Fairfax County, VA",Dec-21,613925,600009,13916,2.30000000
CN5106100000000,51,061,"Fauquier County, VA",Dec-21,36421,35593,828,2.30000000
CN5106300000000,51,063,"Floyd County, VA",Dec-21,8407,8243,164,2.00000000
CN5106500000000,51,065,"Fluvanna County, VA",Dec-21,13695,13387,308,2.20000000
CN5106700000000,51,067,"Franklin County, VA",Dec-21,25557,24944,613,2.40000000
CN5106900000000,51,069,"Frederick County, VA",Dec-21,49649,48389,1260,2.50000000
CN5107100000000,51,071,"Giles County, VA",Dec-21,7975,7793,182,2.30000000
CN5107300000000,51,073,"Gloucester County, VA",Dec-21,18734,18282,452,2.40000000
CN5107500000000,51,075,"Goochland County, VA",Dec-21,11248,10992,256,2.30000000
CN5107700000000,51,077,"Grayson County, VA",Dec-21,8300,8138,162,2.00000000
CN5107900000000,51,079,"Greene County, VA",Dec-21,10263,10061,202,2.00000000
CN5108100000000,51,081,"Greensville County, VA",Dec-21,4518,4216,302,6.70000000
CN5108300000000,51,083,"Halifax County, VA",Dec-21,15078,14577,501,3.30000000
CN5108500000000,51,085,"Hanover County, VA",Dec-21,56907,55660,1247,2.20000000
CN5108700000000,51,087,"Henrico County, VA",Dec-21,175951,170818,5133,2.90000000
CN5108900000000,51,089,"Henry County, VA",Dec-21,24304,23586,718,3.00000000
CN5109100000000,51,091,"Highland County, VA",Dec-21,1254,1231,23,1.80000000
CN5109300000000,51,093,"Isle of Wight County, VA",Dec-21,18943,18453,490,2.60000000
CN5109500000000,51,095,"James City County, VA",Dec-21,35483,34546,937,2.60000000
CN5109700000000,51,097,"King and Queen County, VA",Dec-21,3883,3806,77,2.00000000
CN5109900000000,51,099,"King George County, VA",Dec-21,14036,13729,307,2.20000000
CN5110100000000,51,101,"King William County, VA",Dec-21,9109,8894,215,2.40000000
CN5110300000000,51,103,"Lancaster County, VA",Dec-21,5411,5212,199,3.70000000
CN5110500000000,51,105,"Lee County, VA",Dec-21,8247,8043,204,2.50000000
CN5110700000000,51,107,"Loudoun County, VA",Dec-21,223037,218079,4958,2.20000000
CN5110900000000,51,109,"Louisa County, VA",Dec-21,20289,19790,499,2.50000000
CN5111100000000,51,111,"Lunenburg County, VA",Dec-21,5140,5003,137,2.70000000
CN5111300000000,51,113,"Madison County, VA",Dec-21,7580,7457,123,1.60000000
CN5111500000000,51,115,"Mathews County, VA",Dec-21,3922,3828,94,2.40000000
CN5111700000000,51,117,"Mecklenburg County, VA",Dec-21,12934,12491,443,3.40000000
CN5111900000000,51,119,"Middlesex County, VA",Dec-21,5137,5021,116,2.30000000
CN5112100000000,51,121,"Montgomery County, VA",Dec-21,50894,49901,993,2.00000000
CN5112500000000,51,125,"Nelson County, VA",Dec-21,7168,7010,158,2.20000000
CN5112700000000,51,127,"New Kent County, VA",Dec-21,12544,12289,255,2.00000000
CN5113100000000,51,131,"Northampton County, VA",Dec-21,5378,5168,210,3.90000000
CN5113300000000,51,133,"Northumberland County, VA",Dec-21,5682,5501,181,3.20000000
CN5113500000000,51,135,"Nottoway County, VA",Dec-21,7125,6932,193,2.70000000
CN5113700000000,51,137,"Orange County, VA",Dec-21,17217,16766,451,2.60000000
CN5113900000000,51,139,"Page County, VA",Dec-21,11992,11609,383,3.20000000
CN5114100000000,51,141,"Patrick County, VA",Dec-21,7123,6903,220,3.10000000
CN5114300000000,51,143,"Pittsylvania County, VA",Dec-21,30275,29464,811,2.70000000
CN5114500000000,51,145,"Powhatan County, VA",Dec-21,13887,13608,279,2.00000000
CN5114700000000,51,147,"Prince Edward County, VA",Dec-21,10217,9890,327,3.20000000
CN5114900000000,51,149,"Prince George County, VA",Dec-21,14719,14107,612,4.20000000
CN5115300000000,51,153,"Prince William County, VA",Dec-21,241174,234675,6499,2.70000000
CN5115500000000,51,155,"Pulaski County, VA",Dec-21,16348,15945,403,2.50000000
CN5115700000000,51,157,"Rappahannock County, VA",Dec-21,3612,3534,78,2.20000000
CN5115900000000,51,159,"Richmond County, VA",Dec-21,3957,3860,97,2.50000000
CN5116100000000,51,161,"Roanoke County, VA",Dec-21,47929,46909,1020,2.10000000
CN5116300000000,51,163,"Rockbridge County, VA",Dec-21,10580,10332,248,2.30000000
CN5116500000000,51,165,"Rockingham County, VA",Dec-21,42062,41208,854,2.00000000
CN5116700000000,51,167,"Russell County, VA",Dec-21,10838,10550,288,2.70000000
CN5116900000000,51,169,"Scott County, VA",Dec-21,8820,8619,201,2.30000000
CN5117100000000,51,171,"Shenandoah County, VA",Dec-21,21997,21444,553,2.50000000
CN5117300000000,51,173,"Smyth County, VA",Dec-21,14281,13919,362,2.50000000
CN5117500000000,51,175,"Southampton County, VA",Dec-21,8928,8654,274,3.10000000
CN5117700000000,51,177,"Spotsylvania County, VA",Dec-21,66660,64853,1807,2.70000000
CN5117900000000,51,179,"Stafford County, VA",Dec-21,72455,70581,1874,2.60000000
CN5118100000000,51,181,"Surry County, VA",Dec-21,3484,3383,101,2.90000000
CN5118300000000,51,183,"Sussex County, VA",Dec-21,3642,3409,233,6.40000000
CN5118500000000,51,185,"Tazewell County, VA",Dec-21,15563,14822,741,4.80000000
CN5118700000000,51,187,"Warren County, VA",Dec-21,20050,19455,595,3.00000000
CN5119100000000,51,191,"Washington County, VA",Dec-21,25320,24741,579,2.30000000
CN5119300000000,51,193,"Westmoreland County, VA",Dec-21,9655,9367,288,3.00000000
CN5119500000000,51,195,"Wise County, VA",Dec-21,13373,12937,436,3.30000000
CN5119700000000,51,197,"Wythe County, VA",Dec-21,14038,13676,362,2.60000000
CN5119900000000,51,199,"York County, VA",Dec-21,31690,30973,717,2.30000000
CN5151000000000,51,510,"Alexandria city, VA",Dec-21,96916,94683,2233,2.30000000
CN5152000000000,51,520,"Bristol city, VA",Dec-21,7292,7079,213,2.90000000
CN5153000000000,51,530,"Buena Vista city, VA",Dec-21,3007,2930,77,2.60000000
CN5154000000000,51,540,"Charlottesville city, VA",Dec-21,24729,24159,570,2.30000000
CN5155000000000,51,550,"Chesapeake city, VA",Dec-21,118694,115430,3264,2.70000000
CN5157000000000,51,570,"Colonial Heights city, VA",Dec-21,8217,7837,380,4.60000000
CN5158000000000,51,580,"Covington city, VA",Dec-21,2293,2195,98,4.30000000
CN5159000000000,51,590,"Danville city, VA",Dec-21,18884,18034,850,4.50000000
CN5159500000000,51,595,"Emporia city, VA",Dec-21,2477,2263,214,8.60000000
CN5160000000000,51,600,"Fairfax city, VA",Dec-21,12430,12136,294,2.40000000
CN5161000000000,51,610,"Falls Church city, VA",Dec-21,8211,8065,146,1.80000000
CN5162000000000,51,620,"Franklin city, VA",Dec-21,3481,3295,186,5.30000000
CN5163000000000,51,630,"Fredericksburg city, VA",Dec-21,13787,13340,447,3.20000000
CN5164000000000,51,640,"Galax city, VA",Dec-21,2879,2802,77,2.70000000
CN5165000000000,51,650,"Hampton city, VA",Dec-21,61974,59428,2546,4.10000000
CN5166000000000,51,660,"Harrisonburg city, VA",Dec-21,24267,23595,672,2.80000000
CN5167000000000,51,670,"Hopewell city, VA",Dec-21,9297,8726,571,6.10000000
CN5167800000000,51,678,"Lexington city, VA",Dec-21,2069,1998,71,3.40000000
CN5168000000000,51,680,"Lynchburg city, VA",Dec-21,34470,33277,1193,3.50000000
CN5168300000000,51,683,"Manassas city, VA",Dec-21,20963,20376,587,2.80000000
CN5168500000000,51,685,"Manassas Park city, VA",Dec-21,9451,9206,245,2.60000000
CN5169000000000,51,690,"Martinsville city, VA",Dec-21,5662,5388,274,4.80000000
CN5170000000000,51,700,"Newport News city, VA",Dec-21,85113,81716,3397,4.00000000
CN5171000000000,51,710,"Norfolk city, VA",Dec-21,106252,101930,4322,4.10000000
CN5172000000000,51,720,"Norton city, VA",Dec-21,1679,1624,55,3.30000000
CN5173000000000,51,730,"Petersburg city, VA",Dec-21,12457,11294,1163,9.30000000
CN5173500000000,51,735,"Poquoson city, VA",Dec-21,6113,5988,125,2.00000000
CN5174000000000,51,740,"Portsmouth city, VA",Dec-21,42712,40674,2038,4.80000000
CN5175000000000,51,750,"Radford city, VA",Dec-21,8758,8546,212,2.40000000
CN5176000000000,51,760,"Richmond city, VA",Dec-21,115165,110750,4415,3.80000000
CN5177000000000,51,770,"Roanoke city, VA",Dec-21,47406,45855,1551,3.30000000
CN5177500000000,51,775,"Salem city, VA",Dec-21,12391,12076,315,2.50000000
CN5179000000000,51,790,"Staunton city, VA",Dec-21,11927,11596,331,2.80000000
CN5180000000000,51,800,"Suffolk city, VA",Dec-21,43814,42394,1420,3.20000000
CN5181000000000,51,810,"Virginia Beach city, VA",Dec-21,222270,216500,5770,2.60000000
CN5182000000000,51,820,"Waynesboro city, VA",Dec-21,10343,10042,301,2.90000000
CN5183000000000,51,830,"Williamsburg city, VA",Dec-21,6485,6276,209,3.20000000
CN5184000000000,51,840,"Winchester city, VA",Dec-21,14578,14173,405,2.80000000
CN5300100000000,53,001,"Adams County, WA",Dec-21,9047,8514,533,5.90000000
CN5300300000000,53,003,"Asotin County, WA",Dec-21,10840,10510,330,3.00000000
CN5300500000000,53,005,"Benton County, WA",Dec-21,105488,100655,4833,4.60000000
CN5300700000000,53,007,"Chelan County, WA",Dec-21,43562,41662,1900,4.40000000
CN5300900000000,53,009,"Clallam County, WA",Dec-21,30181,28682,1499,5.00000000
CN5301100000000,53,011,"Clark County, WA",Dec-21,254328,244124,10204,4.00000000
CN5301300000000,53,013,"Columbia County, WA",Dec-21,1828,1757,71,3.90000000
CN5301500000000,53,015,"Cowlitz County, WA",Dec-21,49359,46951,2408,4.90000000
CN5301700000000,53,017,"Douglas County, WA",Dec-21,21372,20389,983,4.60000000
CN5301900000000,53,019,"Ferry County, WA",Dec-21,2331,2150,181,7.80000000
CN5302100000000,53,021,"Franklin County, WA",Dec-21,42793,40246,2547,6.00000000
CN5302300000000,53,023,"Garfield County, WA",Dec-21,844,803,41,4.90000000
CN5302500000000,53,025,"Grant County, WA",Dec-21,45884,42941,2943,6.40000000
CN5302700000000,53,027,"Grays Harbor County, WA",Dec-21,29531,27714,1817,6.20000000
CN5302900000000,53,029,"Island County, WA",Dec-21,37094,35572,1522,4.10000000
CN5303100000000,53,031,"Jefferson County, WA",Dec-21,13101,12502,599,4.60000000
CN5303300000000,53,033,"King County, WA",Dec-21,1294891,1255831,39060,3.00000000
CN5303500000000,53,035,"Kitsap County, WA",Dec-21,132451,127671,4780,3.60000000
CN5303700000000,53,037,"Kittitas County, WA",Dec-21,22322,21156,1166,5.20000000
CN5303900000000,53,039,"Klickitat County, WA",Dec-21,9985,9485,500,5.00000000
CN5304100000000,53,041,"Lewis County, WA",Dec-21,35062,33298,1764,5.00000000
CN5304300000000,53,043,"Lincoln County, WA",Dec-21,4733,4525,208,4.40000000
CN5304500000000,53,045,"Mason County, WA",Dec-21,25710,24292,1418,5.50000000
CN5304700000000,53,047,"Okanogan County, WA",Dec-21,18943,17817,1126,5.90000000
CN5304900000000,53,049,"Pacific County, WA",Dec-21,8651,8134,517,6.00000000
CN5305100000000,53,051,"Pend Oreille County, WA",Dec-21,5281,4964,317,6.00000000
CN5305300000000,53,053,"Pierce County, WA",Dec-21,457121,436442,20679,4.50000000
CN5305500000000,53,055,"San Juan County, WA",Dec-21,8435,8122,313,3.70000000
CN5305700000000,53,057,"Skagit County, WA",Dec-21,63210,60180,3030,4.80000000
CN5305900000000,53,059,"Skamania County, WA",Dec-21,5688,5410,278,4.90000000
CN5306100000000,53,061,"Snohomish County, WA",Dec-21,441868,425820,16048,3.60000000
CN5306300000000,53,063,"Spokane County, WA",Dec-21,268056,257053,11003,4.10000000
CN5306500000000,53,065,"Stevens County, WA",Dec-21,19662,18513,1149,5.80000000
CN5306700000000,53,067,"Thurston County, WA",Dec-21,149394,143645,5749,3.80000000
CN5306900000000,53,069,"Wahkiakum County, WA",Dec-21,1380,1309,71,5.10000000
CN5307100000000,53,071,"Walla Walla County, WA",Dec-21,31473,30248,1225,3.90000000
CN5307300000000,53,073,"Whatcom County, WA",Dec-21,116826,111680,5146,4.40000000
CN5307500000000,53,075,"Whitman County, WA",Dec-21,23378,22521,857,3.70000000
CN5307700000000,53,077,"Yakima County, WA",Dec-21,126455,118244,8211,6.50000000
CN5400100000000,54,001,"Barbour County, WV",Dec-21,7204,6931,273,3.80000000
CN5400300000000,54,003,"Berkeley County, WV",Dec-21,61008,59573,1435,2.40000000
CN5400500000000,54,005,"Boone County, WV",Dec-21,7152,6860,292,4.10000000
CN5400700000000,54,007,"Braxton County, WV",Dec-21,5030,4752,278,5.50000000
CN5400900000000,54,009,"Brooke County, WV",Dec-21,9886,9475,411,4.20000000
CN5401100000000,54,011,"Cabell County, WV",Dec-21,41385,40089,1296,3.10000000
CN5401300000000,54,013,"Calhoun County, WV",Dec-21,2538,2341,197,7.80000000
CN5401500000000,54,015,"Clay County, WV",Dec-21,3011,2844,167,5.50000000
CN5401700000000,54,017,"Doddridge County, WV",Dec-21,3815,3700,115,3.00000000
CN5401900000000,54,019,"Fayette County, WV",Dec-21,15910,15191,719,4.50000000
CN5402100000000,54,021,"Gilmer County, WV",Dec-21,2351,2226,125,5.30000000
CN5402300000000,54,023,"Grant County, WV",Dec-21,5954,5754,200,3.40000000
CN5402500000000,54,025,"Greenbrier County, WV",Dec-21,15626,15154,472,3.00000000
CN5402700000000,54,027,"Hampshire County, WV",Dec-21,11297,11034,263,2.30000000
CN5402900000000,54,029,"Hancock County, WV",Dec-21,12978,12426,552,4.30000000
CN5403100000000,54,031,"Hardy County, WV",Dec-21,5782,5559,223,3.90000000
CN5403300000000,54,033,"Harrison County, WV",Dec-21,33807,32681,1126,3.30000000
CN5403500000000,54,035,"Jackson County, WV",Dec-21,11944,11462,482,4.00000000
CN5403700000000,54,037,"Jefferson County, WV",Dec-21,30505,29877,628,2.10000000
CN5403900000000,54,039,"Kanawha County, WV",Dec-21,80800,77995,2805,3.50000000
CN5404100000000,54,041,"Lewis County, WV",Dec-21,5995,5691,304,5.10000000
CN5404300000000,54,043,"Lincoln County, WV",Dec-21,7029,6709,320,4.60000000
CN5404500000000,54,045,"Logan County, WV",Dec-21,11025,10534,491,4.50000000
CN5404700000000,54,047,"McDowell County, WV",Dec-21,4199,3946,253,6.00000000
CN5404900000000,54,049,"Marion County, WV",Dec-21,25148,24171,977,3.90000000
CN5405100000000,54,051,"Marshall County, WV",Dec-21,13364,12756,608,4.50000000
CN5405300000000,54,053,"Mason County, WV",Dec-21,10139,9720,419,4.10000000
CN5405500000000,54,055,"Mercer County, WV",Dec-21,20412,19567,845,4.10000000
CN5405700000000,54,057,"Mineral County, WV",Dec-21,12407,11994,413,3.30000000
CN5405900000000,54,059,"Mingo County, WV",Dec-21,6018,5634,384,6.40000000
CN5406100000000,54,061,"Monongalia County, WV",Dec-21,56605,54927,1678,3.00000000
CN5406300000000,54,063,"Monroe County, WV",Dec-21,6285,6131,154,2.50000000
CN5406500000000,54,065,"Morgan County, WV",Dec-21,8645,8441,204,2.40000000
CN5406700000000,54,067,"Nicholas County, WV",Dec-21,8996,8610,386,4.30000000
CN5406900000000,54,069,"Ohio County, WV",Dec-21,20339,19632,707,3.50000000
CN5407100000000,54,071,"Pendleton County, WV",Dec-21,3863,3775,88,2.30000000
CN5407300000000,54,073,"Pleasants County, WV",Dec-21,2703,2560,143,5.30000000
CN5407500000000,54,075,"Pocahontas County, WV",Dec-21,4246,4118,128,3.00000000
CN5407700000000,54,077,"Preston County, WV",Dec-21,15957,15418,539,3.40000000
CN5407900000000,54,079,"Putnam County, WV",Dec-21,26996,26202,794,2.90000000
CN5408100000000,54,081,"Raleigh County, WV",Dec-21,29935,28892,1043,3.50000000
CN5408300000000,54,083,"Randolph County, WV",Dec-21,12052,11559,493,4.10000000
CN5408500000000,54,085,"Ritchie County, WV",Dec-21,4260,4082,178,4.20000000
CN5408700000000,54,087,"Roane County, WV",Dec-21,5039,4732,307,6.10000000
CN5408900000000,54,089,"Summers County, WV",Dec-21,4455,4306,149,3.30000000
CN5409100000000,54,091,"Taylor County, WV",Dec-21,7844,7566,278,3.50000000
CN5409300000000,54,093,"Tucker County, WV",Dec-21,3349,3217,132,3.90000000
CN5409500000000,54,095,"Tyler County, WV",Dec-21,3001,2829,172,5.70000000
CN5409700000000,54,097,"Upshur County, WV",Dec-21,9682,9241,441,4.60000000
CN5409900000000,54,099,"Wayne County, WV",Dec-21,15567,15002,565,3.60000000
CN5410100000000,54,101,"Webster County, WV",Dec-21,3294,3147,147,4.50000000
CN5410300000000,54,103,"Wetzel County, WV",Dec-21,6976,6635,341,4.90000000
CN5410500000000,54,105,"Wirt County, WV",Dec-21,2284,2152,132,5.80000000
CN5410700000000,54,107,"Wood County, WV",Dec-21,36434,35064,1370,3.80000000
CN5410900000000,54,109,"Wyoming County, WV",Dec-21,7181,6896,285,4.00000000
CN5500100000000,55,001,"Adams County, WI",Dec-21,7792,7437,355,4.60000000
CN5500300000000,55,003,"Ashland County, WI",Dec-21,7433,7185,248,3.30000000
CN5500500000000,55,005,"Barron County, WI",Dec-21,24163,23535,628,2.60000000
CN5500700000000,55,007,"Bayfield County, WI",Dec-21,7359,7044,315,4.30000000
CN5500900000000,55,009,"Brown County, WI",Dec-21,142210,139306,2904,2.00000000
CN5501100000000,55,011,"Buffalo County, WI",Dec-21,6273,6079,194,3.10000000
CN5501300000000,55,013,"Burnett County, WI",Dec-21,7291,6990,301,4.10000000
CN5501500000000,55,015,"Calumet County, WI",Dec-21,27772,27313,459,1.70000000
CN5501700000000,55,017,"Chippewa County, WI",Dec-21,33808,32875,933,2.80000000
CN5501900000000,55,019,"Clark County, WI",Dec-21,17790,17410,380,2.10000000
CN5502100000000,55,021,"Columbia County, WI",Dec-21,32051,31413,638,2.00000000
CN5502300000000,55,023,"Crawford County, WI",Dec-21,7478,7240,238,3.20000000
CN5502500000000,55,025,"Dane County, WI",Dec-21,333642,328297,5345,1.60000000
CN5502700000000,55,027,"Dodge County, WI",Dec-21,48152,47249,903,1.90000000
CN5502900000000,55,029,"Door County, WI",Dec-21,14399,13933,466,3.20000000
CN5503100000000,55,031,"Douglas County, WI",Dec-21,23297,22573,724,3.10000000
CN5503300000000,55,033,"Dunn County, WI",Dec-21,24628,24060,568,2.30000000
CN5503500000000,55,035,"Eau Claire County, WI",Dec-21,60057,58923,1134,1.90000000
CN5503700000000,55,037,"Florence County, WI",Dec-21,2219,2148,71,3.20000000
CN5503900000000,55,039,"Fond du Lac County, WI",Dec-21,57496,56447,1049,1.80000000
CN5504100000000,55,041,"Forest County, WI",Dec-21,3916,3751,165,4.20000000
CN5504300000000,55,043,"Grant County, WI",Dec-21,27768,27286,482,1.70000000
CN5504500000000,55,045,"Green County, WI",Dec-21,20980,20589,391,1.90000000
CN5504700000000,55,047,"Green Lake County, WI",Dec-21,9178,8917,261,2.80000000
CN5504900000000,55,049,"Iowa County, WI",Dec-21,13682,13419,263,1.90000000
CN5505100000000,55,051,"Iron County, WI",Dec-21,2561,2443,118,4.60000000
CN5505300000000,55,053,"Jackson County, WI",Dec-21,9357,8989,368,3.90000000
CN5505500000000,55,055,"Jefferson County, WI",Dec-21,46600,45685,915,2.00000000
CN5505700000000,55,057,"Juneau County, WI",Dec-21,13288,12924,364,2.70000000
CN5505900000000,55,059,"Kenosha County, WI",Dec-21,91881,89478,2403,2.60000000
CN5506100000000,55,061,"Kewaunee County, WI",Dec-21,10839,10637,202,1.90000000
CN5506300000000,55,063,"La Crosse County, WI",Dec-21,67902,66694,1208,1.80000000
CN5506500000000,55,065,"Lafayette County, WI",Dec-21,10253,10106,147,1.40000000
CN5506700000000,55,067,"Langlade County, WI",Dec-21,9378,9098,280,3.00000000
CN5506900000000,55,069,"Lincoln County, WI",Dec-21,14770,14413,357,2.40000000
CN5507100000000,55,071,"Manitowoc County, WI",Dec-21,41014,40123,891,2.20000000
CN5507300000000,55,073,"Marathon County, WI",Dec-21,74452,73115,1337,1.80000000
CN5507500000000,55,075,"Marinette County, WI",Dec-21,19271,18716,555,2.90000000
CN5507700000000,55,077,"Marquette County, WI",Dec-21,7749,7502,247,3.20000000
CN5507800000000,55,078,"Menominee County, WI",Dec-21,1530,1453,77,5.00000000
CN5507900000000,55,079,"Milwaukee County, WI",Dec-21,465231,450126,15105,3.20000000
CN5508100000000,55,081,"Monroe County, WI",Dec-21,23521,23036,485,2.10000000
CN5508300000000,55,083,"Oconto County, WI",Dec-21,20748,20228,520,2.50000000
CN5508500000000,55,085,"Oneida County, WI",Dec-21,17565,17002,563,3.20000000
CN5508700000000,55,087,"Outagamie County, WI",Dec-21,105197,103201,1996,1.90000000
CN5508900000000,55,089,"Ozaukee County, WI",Dec-21,49396,48554,842,1.70000000
CN5509100000000,55,091,"Pepin County, WI",Dec-21,4018,3910,108,2.70000000
CN5509300000000,55,093,"Pierce County, WI",Dec-21,25141,24534,607,2.40000000
CN5509500000000,55,095,"Polk County, WI",Dec-21,24923,24112,811,3.30000000
CN5509700000000,55,097,"Portage County, WI",Dec-21,38660,37819,841,2.20000000
CN5509900000000,55,099,"Price County, WI",Dec-21,6282,6108,174,2.80000000
CN5510100000000,55,101,"Racine County, WI",Dec-21,98234,95425,2809,2.90000000
CN5510300000000,55,103,"Richland County, WI",Dec-21,9045,8849,196,2.20000000
CN5510500000000,55,105,"Rock County, WI",Dec-21,86604,84206,2398,2.80000000
CN5510700000000,55,107,"Rusk County, WI",Dec-21,6563,6360,203,3.10000000
CN5510900000000,55,109,"St. Croix County, WI",Dec-21,51142,49993,1149,2.20000000
CN5511100000000,55,111,"Sauk County, WI",Dec-21,34359,33517,842,2.50000000
CN5511300000000,55,113,"Sawyer County, WI",Dec-21,7811,7533,278,3.60000000
CN5511500000000,55,115,"Shawano County, WI",Dec-21,20869,20392,477,2.30000000
CN5511700000000,55,117,"Sheboygan County, WI",Dec-21,62380,61259,1121,1.80000000
CN5511900000000,55,119,"Taylor County, WI",Dec-21,11012,10707,305,2.80000000
CN5512100000000,55,121,"Trempealeau County, WI",Dec-21,15483,15093,390,2.50000000
CN5512300000000,55,123,"Vernon County, WI",Dec-21,15460,15166,294,1.90000000
CN5512500000000,55,125,"Vilas County, WI",Dec-21,10009,9643,366,3.70000000
CN5512700000000,55,127,"Walworth County, WI",Dec-21,58059,56810,1249,2.20000000
CN5512900000000,55,129,"Washburn County, WI",Dec-21,7768,7530,238,3.10000000
CN5513100000000,55,131,"Washington County, WI",Dec-21,77166,75798,1368,1.80000000
CN5513300000000,55,133,"Waukesha County, WI",Dec-21,225789,221718,4071,1.80000000
CN5513500000000,55,135,"Waupaca County, WI",Dec-21,25760,25199,561,2.20000000
CN5513700000000,55,137,"Waushara County, WI",Dec-21,11409,11093,316,2.80000000
CN5513900000000,55,139,"Winnebago County, WI",Dec-21,93142,91375,1767,1.90000000
CN5514100000000,55,141,"Wood County, WI",Dec-21,34326,33384,942,2.70000000
CN5600100000000,56,001,"Albany County, WY",Dec-21,21377,20861,516,2.40000000
CN5600300000000,56,003,"Big Horn County, WY",Dec-21,5068,4887,181,3.60000000
CN5600500000000,56,005,"Campbell County, WY",Dec-21,21985,21191,794,3.60000000
CN5600700000000,56,007,"Carbon County, WY",Dec-21,7617,7387,230,3.00000000
CN5600900000000,56,009,"Converse County, WY",Dec-21,7497,7252,245,3.30000000
CN5601100000000,56,011,"Crook County, WY",Dec-21,3672,3582,90,2.50000000
CN5601300000000,56,013,"Fremont County, WY",Dec-21,18745,18107,638,3.40000000
CN5601500000000,56,015,"Goshen County, WY",Dec-21,6378,6216,162,2.50000000
CN5601700000000,56,017,"Hot Springs County, WY",Dec-21,2193,2131,62,2.80000000
CN5601900000000,56,019,"Johnson County, WY",Dec-21,4076,3945,131,3.20000000
CN5602100000000,56,021,"Laramie County, WY",Dec-21,50117,48671,1446,2.90000000
CN5602300000000,56,023,"Lincoln County, WY",Dec-21,9394,9131,263,2.80000000
CN5602500000000,56,025,"Natrona County, WY",Dec-21,39111,37460,1651,4.20000000
CN5602700000000,56,027,"Niobrara County, WY",Dec-21,1206,1177,29,2.40000000
CN5602900000000,56,029,"Park County, WY",Dec-21,14623,14138,485,3.30000000
CN5603100000000,56,031,"Platte County, WY",Dec-21,4349,4216,133,3.10000000
CN5603300000000,56,033,"Sheridan County, WY",Dec-21,15876,15392,484,3.00000000
CN5603500000000,56,035,"Sublette County, WY",Dec-21,3835,3683,152,4.00000000
CN5603700000000,56,037,"Sweetwater County, WY",Dec-21,19331,18569,762,3.90000000
CN5603900000000,56,039,"Teton County, WY",Dec-21,15504,15140,364,2.30000000
CN5604100000000,56,041,"Uinta County, WY",Dec-21,8620,8312,308,3.60000000
CN5604300000000,56,043,"Washakie County, WY",Dec-21,3956,3838,118,3.00000000
CN5604500000000,56,045,"Weston County, WY",Dec-21,3742,3654,88,2.40000000
CN7200100000000,72,001,"Adjuntas Municipio, PR",Dec-21,4755,4282,473,9.90000000
CN7200300000000,72,003,"Aguada Municipio, PR",Dec-21,13705,12634,1071,7.80000000
CN7200500000000,72,005,"Aguadilla Municipio, PR",Dec-21,16501,15163,1338,8.10000000
CN7200700000000,72,007,"Aguas Buenas Municipio, PR",Dec-21,7391,6815,576,7.80000000
CN7200900000000,72,009,"Aibonito Municipio, PR",Dec-21,7108,6610,498,7.00000000
CN7201100000000,72,011,"Anasco Municipio, PR",Dec-21,10238,9555,683,6.70000000
CN7201300000000,72,013,"Arecibo Municipio, PR",Dec-21,27086,25129,1957,7.20000000
CN7201500000000,72,015,"Arroyo Municipio, PR",Dec-21,5195,4807,388,7.50000000
CN7201700000000,72,017,"Barceloneta Municipio, PR",Dec-21,6744,6136,608,9.00000000
CN7201900000000,72,019,"Barranquitas Municipio, PR",Dec-21,8164,7582,582,7.10000000
CN7202100000000,72,021,"Bayamon Municipio, PR",Dec-21,73800,69416,4384,5.90000000
CN7202300000000,72,023,"Cabo Rojo Municipio, PR",Dec-21,15944,14809,1135,7.10000000
CN7202500000000,72,025,"Caguas Municipio, PR",Dec-21,54042,51131,2911,5.40000000
CN7202700000000,72,027,"Camuy Municipio, PR",Dec-21,10794,10129,665,6.20000000
CN7202900000000,72,029,"Canovanas Municipio, PR",Dec-21,18528,17473,1055,5.70000000
CN7203100000000,72,031,"Carolina Municipio, PR",Dec-21,69801,65752,4049,5.80000000
CN7203300000000,72,033,"Catano Municipio, PR",Dec-21,8890,8285,605,6.80000000
CN7203500000000,72,035,"Cayey Municipio, PR",Dec-21,18215,17325,890,4.90000000
CN7203700000000,72,037,"Ceiba Municipio, PR",Dec-21,4078,3765,313,7.70000000
CN7203900000000,72,039,"Ciales Municipio, PR",Dec-21,4151,3740,411,9.90000000
CN7204100000000,72,041,"Cidra Municipio, PR",Dec-21,17368,16573,795,4.60000000
CN7204300000000,72,043,"Coamo Municipio, PR",Dec-21,11589,10698,891,7.70000000
CN7204500000000,72,045,"Comerio Municipio, PR",Dec-21,5534,5116,418,7.60000000
CN7204700000000,72,047,"Corozal Municipio, PR",Dec-21,10051,9215,836,8.30000000
CN7204900000000,72,049,"Culebra Municipio, PR",Dec-21,1054,1008,46,4.40000000
CN7205100000000,72,051,"Dorado Municipio, PR",Dec-21,15312,14559,753,4.90000000
CN7205300000000,72,053,"Fajardo Municipio, PR",Dec-21,12023,11073,950,7.90000000
CN7205400000000,72,054,"Florida Municipio, PR",Dec-21,3703,3379,324,8.70000000
CN7205500000000,72,055,"Guanica Municipio, PR",Dec-21,4467,3930,537,12.00000000
CN7205700000000,72,057,"Guayama Municipio, PR",Dec-21,12297,11486,811,6.60000000
CN7205900000000,72,059,"Guayanilla Municipio, PR",Dec-21,5510,4907,603,10.90000000
CN7206100000000,72,061,"Guaynabo Municipio, PR",Dec-21,43145,41595,1550,3.60000000
CN7206300000000,72,063,"Gurabo Municipio, PR",Dec-21,21147,20297,850,4.00000000
CN7206500000000,72,065,"Hatillo Municipio, PR",Dec-21,15207,14116,1091,7.20000000
CN7206700000000,72,067,"Hormigueros Municipio, PR",Dec-21,6301,5812,489,7.80000000
CN7206900000000,72,069,"Humacao Municipio, PR",Dec-21,19695,18327,1368,6.90000000
CN7207100000000,72,071,"Isabela Municipio, PR",Dec-21,13479,12545,934,6.90000000
CN7207300000000,72,073,"Jayuya Municipio, PR",Dec-21,4733,4217,516,10.90000000
CN7207500000000,72,075,"Juana Diaz Municipio, PR",Dec-21,17652,16522,1130,6.40000000
CN7207700000000,72,077,"Juncos Municipio, PR",Dec-21,14109,13109,1000,7.10000000
CN7207900000000,72,079,"Lajas Municipio, PR",Dec-21,5997,5340,657,11.00000000
CN7208100000000,72,081,"Lares Municipio, PR",Dec-21,7834,6944,890,11.40000000
CN7208300000000,72,083,"Las Marias Municipio, PR",Dec-21,2960,2672,288,9.70000000
CN7208500000000,72,085,"Las Piedras Municipio, PR",Dec-21,12891,12080,811,6.30000000
CN7208700000000,72,087,"Loiza Municipio, PR",Dec-21,9502,8785,717,7.50000000
CN7208900000000,72,089,"Luquillo Municipio, PR",Dec-21,6972,6474,498,7.10000000
CN7209100000000,72,091,"Manati Municipio, PR",Dec-21,12695,11898,797,6.30000000
CN7209300000000,72,093,"Maricao Municipio, PR",Dec-21,2129,1896,233,10.90000000
CN7209500000000,72,095,"Maunabo Municipio, PR",Dec-21,3188,2843,345,10.80000000
CN7209700000000,72,097,"Mayaguez Municipio, PR",Dec-21,24888,22979,1909,7.70000000
CN7209900000000,72,099,"Moca Municipio, PR",Dec-21,11945,10965,980,8.20000000
CN7210100000000,72,101,"Morovis Municipio, PR",Dec-21,9141,8419,722,7.90000000
CN7210300000000,72,103,"Naguabo Municipio, PR",Dec-21,9378,8759,619,6.60000000
CN7210500000000,72,105,"Naranjito Municipio, PR",Dec-21,8097,7385,712,8.80000000
CN7210700000000,72,107,"Orocovis Municipio, PR",Dec-21,5454,4993,461,8.50000000
CN7210900000000,72,109,"Patillas Municipio, PR",Dec-21,4736,4281,455,9.60000000
CN7211100000000,72,111,"Penuelas Municipio, PR",Dec-21,6442,5819,623,9.70000000
CN7211300000000,72,113,"Ponce Municipio, PR",Dec-21,51529,47480,4049,7.90000000
CN7211500000000,72,115,"Quebradillas Municipio, PR",Dec-21,6846,6312,534,7.80000000
CN7211700000000,72,117,"Rincon Municipio, PR",Dec-21,5370,4861,509,9.50000000
CN7211900000000,72,119,"Rio Grande Municipio, PR",Dec-21,19393,18060,1333,6.90000000
CN7212100000000,72,121,"Sabana Grande Municipio, PR",Dec-21,6786,6201,585,8.60000000
CN7212300000000,72,123,"Salinas Municipio, PR",Dec-21,7907,7170,737,9.30000000
CN7212500000000,72,125,"San German Municipio, PR",Dec-21,11037,10105,932,8.40000000
CN7212700000000,72,127,"San Juan Municipio, PR",Dec-21,152234,144276,7958,5.20000000
CN7212900000000,72,129,"San Lorenzo Municipio, PR",Dec-21,13047,12214,833,6.40000000
CN7213100000000,72,131,"San Sebastian Municipio, PR",Dec-21,11489,10322,1167,10.20000000
CN7213300000000,72,133,"Santa Isabel Municipio, PR",Dec-21,9731,8875,856,8.80000000
CN7213500000000,72,135,"Toa Alta Municipio, PR",Dec-21,31698,30004,1694,5.30000000
CN7213700000000,72,137,"Toa Baja Municipio, PR",Dec-21,32965,31141,1824,5.50000000
CN7213900000000,72,139,"Trujillo Alto Municipio, PR",Dec-21,30818,29475,1343,4.40000000
CN7214100000000,72,141,"Utuado Municipio, PR",Dec-21,7438,6796,642,8.60000000
CN7214300000000,72,143,"Vega Alta Municipio, PR",Dec-21,11160,10295,865,7.80000000
CN7214500000000,72,145,"Vega Baja Municipio, PR",Dec-21,15057,13762,1295,8.60000000
CN7214700000000,72,147,"Vieques Municipio, PR",Dec-21,2998,2674,324,10.80000000
CN7214900000000,72,149,"Villalba Municipio, PR",Dec-21,8098,7296,802,9.90000000
CN7215100000000,72,151,"Yabucoa Municipio, PR",Dec-21,9665,8823,842,8.70000000
CN7215300000000,72,153,"Yauco Municipio, PR",Dec-21,10865,9714,1151,10.60000000
CN0100100000000,01,001,"Autauga County, AL",Jan-22,26530,25789,741,2.80000000
CN0100300000000,01,003,"Baldwin County, AL",Jan-22,99644,96680,2964,3.00000000
CN0100500000000,01,005,"Barbour County, AL",Jan-22,8056,7627,429,5.30000000
CN0100700000000,01,007,"Bibb County, AL",Jan-22,8630,8358,272,3.20000000
CN0100900000000,01,009,"Blount County, AL",Jan-22,25430,24770,660,2.60000000
CN0101100000000,01,011,"Bullock County, AL",Jan-22,4496,4329,167,3.70000000
CN0101300000000,01,013,"Butler County, AL",Jan-22,8622,8188,434,5.00000000
CN0101500000000,01,015,"Calhoun County, AL",Jan-22,46295,44439,1856,4.00000000
CN0101700000000,01,017,"Chambers County, AL",Jan-22,15868,15326,542,3.40000000
CN0101900000000,01,019,"Cherokee County, AL",Jan-22,11793,11462,331,2.80000000
CN0102100000000,01,021,"Chilton County, AL",Jan-22,19998,19425,573,2.90000000
CN0102300000000,01,023,"Choctaw County, AL",Jan-22,4477,4288,189,4.20000000
CN0102500000000,01,025,"Clarke County, AL",Jan-22,7820,7342,478,6.10000000
CN0102700000000,01,027,"Clay County, AL",Jan-22,6146,5978,168,2.70000000
CN0102900000000,01,029,"Cleburne County, AL",Jan-22,6009,5840,169,2.80000000
CN0103100000000,01,031,"Coffee County, AL",Jan-22,21886,21208,678,3.10000000
CN0103300000000,01,033,"Colbert County, AL",Jan-22,23557,22610,947,4.00000000
CN0103500000000,01,035,"Conecuh County, AL",Jan-22,4310,4115,195,4.50000000
CN0103700000000,01,037,"Coosa County, AL",Jan-22,4316,4189,127,2.90000000
CN0103900000000,01,039,"Covington County, AL",Jan-22,15139,14676,463,3.10000000
CN0104100000000,01,041,"Crenshaw County, AL",Jan-22,5989,5782,207,3.50000000
CN0104300000000,01,043,"Cullman County, AL",Jan-22,39214,38247,967,2.50000000
CN0104500000000,01,045,"Dale County, AL",Jan-22,21094,20426,668,3.20000000
CN0104700000000,01,047,"Dallas County, AL",Jan-22,13827,12823,1004,7.30000000
CN0104900000000,01,049,"DeKalb County, AL",Jan-22,31053,30207,846,2.70000000
CN0105100000000,01,051,"Elmore County, AL",Jan-22,37861,36861,1000,2.60000000
CN0105300000000,01,053,"Escambia County, AL",Jan-22,13742,13235,507,3.70000000
CN0105500000000,01,055,"Etowah County, AL",Jan-22,39348,37783,1565,4.00000000
CN0105700000000,01,057,"Fayette County, AL",Jan-22,6685,6465,220,3.30000000
CN0105900000000,01,059,"Franklin County, AL",Jan-22,14379,13982,397,2.80000000
CN0106100000000,01,061,"Geneva County, AL",Jan-22,11072,10743,329,3.00000000
CN0106300000000,01,063,"Greene County, AL",Jan-22,2829,2646,183,6.50000000
CN0106500000000,01,065,"Hale County, AL",Jan-22,5884,5576,308,5.20000000
CN0106700000000,01,067,"Henry County, AL",Jan-22,6958,6727,231,3.30000000
CN0106900000000,01,069,"Houston County, AL",Jan-22,47462,45877,1585,3.30000000
CN0107100000000,01,071,"Jackson County, AL",Jan-22,23032,22347,685,3.00000000
CN0107300000000,01,073,"Jefferson County, AL",Jan-22,320848,309753,11095,3.50000000
CN0107500000000,01,075,"Lamar County, AL",Jan-22,5685,5515,170,3.00000000
CN0107700000000,01,077,"Lauderdale County, AL",Jan-22,42305,40904,1401,3.30000000
CN0107900000000,01,079,"Lawrence County, AL",Jan-22,14452,13999,453,3.10000000
CN0108100000000,01,081,"Lee County, AL",Jan-22,77491,75284,2207,2.80000000
CN0108300000000,01,083,"Limestone County, AL",Jan-22,47028,45832,1196,2.50000000
CN0108500000000,01,085,"Lowndes County, AL",Jan-22,3569,3263,306,8.60000000
CN0108700000000,01,087,"Macon County, AL",Jan-22,7933,7489,444,5.60000000
CN0108900000000,01,089,"Madison County, AL",Jan-22,194138,188993,5145,2.70000000
CN0109100000000,01,091,"Marengo County, AL",Jan-22,7660,7352,308,4.00000000
CN0109300000000,01,093,"Marion County, AL",Jan-22,13378,13004,374,2.80000000
CN0109500000000,01,095,"Marshall County, AL",Jan-22,44672,43576,1096,2.50000000
CN0109700000000,01,097,"Mobile County, AL",Jan-22,191737,183343,8394,4.40000000
CN0109900000000,01,099,"Monroe County, AL",Jan-22,7433,7020,413,5.60000000
CN0110100000000,01,101,"Montgomery County, AL",Jan-22,106969,102349,4620,4.30000000
CN0110300000000,01,103,"Morgan County, AL",Jan-22,59546,58003,1543,2.60000000
CN0110500000000,01,105,"Perry County, AL",Jan-22,3135,2871,264,8.40000000
CN0110700000000,01,107,"Pickens County, AL",Jan-22,7574,7271,303,4.00000000
CN0110900000000,01,109,"Pike County, AL",Jan-22,16263,15681,582,3.60000000
CN0111100000000,01,111,"Randolph County, AL",Jan-22,9423,9141,282,3.00000000
CN0111300000000,01,113,"Russell County, AL",Jan-22,23712,23011,701,3.00000000
CN0111500000000,01,115,"St. Clair County, AL",Jan-22,41723,40598,1125,2.70000000
CN0111700000000,01,117,"Shelby County, AL",Jan-22,119840,117173,2667,2.20000000
CN0111900000000,01,119,"Sumter County, AL",Jan-22,4450,4252,198,4.40000000
CN0112100000000,01,121,"Talladega County, AL",Jan-22,35997,34521,1476,4.10000000
CN0112300000000,01,123,"Tallapoosa County, AL",Jan-22,17452,16789,663,3.80000000
CN0112500000000,01,125,"Tuscaloosa County, AL",Jan-22,102431,99015,3416,3.30000000
CN0112700000000,01,127,"Walker County, AL",Jan-22,25379,24461,918,3.60000000
CN0112900000000,01,129,"Washington County, AL",Jan-22,6496,6197,299,4.60000000
CN0113100000000,01,131,"Wilcox County, AL",Jan-22,2624,2331,293,11.20000000
CN0113300000000,01,133,"Winston County, AL",Jan-22,10062,9776,286,2.80000000
CN0201300000000,02,013,"Aleutians East Borough, AK",Jan-22,2213,2147,66,3.00000000
CN0201600000000,02,016,"Aleutians West Census Area, AK",Jan-22,4233,4086,147,3.50000000
CN0202000000000,02,020,"Anchorage Borough/municipality, AK",Jan-22,153076,145720,7356,4.80000000
CN0205000000000,02,050,"Bethel Census Area, AK",Jan-22,7215,6389,826,11.40000000
CN0206000000000,02,060,"Bristol Bay Borough, AK",Jan-22,243,211,32,13.20000000
CN0206300000000,02,063,"Chugach Census Area, AK",Jan-22,2917,2716,201,6.90000000
CN0206600000000,02,066,"Copper River Census Area, AK",Jan-22,1267,1059,208,16.40000000
CN0206800000000,02,068,"Denali Borough, AK",Jan-22,598,495,103,17.20000000
CN0207000000000,02,070,"Dillingham Census Area, AK",Jan-22,1634,1513,121,7.40000000
CN0209000000000,02,090,"Fairbanks North Star Borough, AK",Jan-22,45653,43349,2304,5.00000000
CN0210000000000,02,100,"Haines Borough, AK",Jan-22,950,827,123,12.90000000
CN0210500000000,02,105,"Hoonah-Angoon Census Area, AK",Jan-22,1008,887,121,12.00000000
CN0211000000000,02,110,"Juneau Borough/city, AK",Jan-22,16940,16235,705,4.20000000
CN0212200000000,02,122,"Kenai Peninsula Borough, AK",Jan-22,26980,24985,1995,7.40000000
CN0213000000000,02,130,"Ketchikan Gateway Borough, AK",Jan-22,6395,5963,432,6.80000000
CN0215000000000,02,150,"Kodiak Island Borough, AK",Jan-22,6162,5700,462,7.50000000
CN0215800000000,02,158,"Kusilvak Census Area, AK",Jan-22,2433,2024,409,16.80000000
CN0216400000000,02,164,"Lake and Peninsula Borough, AK",Jan-22,574,520,54,9.40000000
CN0217000000000,02,170,"Matanuska-Susitna Borough, AK",Jan-22,50843,47463,3380,6.60000000
CN0218000000000,02,180,"Nome Census Area, AK",Jan-22,4175,3793,382,9.10000000
CN0218500000000,02,185,"North Slope Borough, AK",Jan-22,3029,2841,188,6.20000000
CN0218800000000,02,188,"Northwest Arctic Borough, AK",Jan-22,2958,2645,313,10.60000000
CN0219500000000,02,195,"Petersburg Borough, AK",Jan-22,1537,1406,131,8.50000000
CN0219800000000,02,198,"Prince of Wales-Hyder Census Area, AK",Jan-22,2822,2594,228,8.10000000
CN0222000000000,02,220,"Sitka Borough/city, AK",Jan-22,3914,3726,188,4.80000000
CN0223000000000,02,230,"Skagway Municipality, AK",Jan-22,610,503,107,17.50000000
CN0224000000000,02,240,"Southeast Fairbanks Census Area, AK",Jan-22,3286,3029,257,7.80000000
CN0227500000000,02,275,"Wrangell Borough/city, AK",Jan-22,979,906,73,7.50000000
CN0228200000000,02,282,"Yakutat Borough/city, AK",Jan-22,266,245,21,7.90000000
CN0229000000000,02,290,"Yukon-Koyukuk Census Area, AK",Jan-22,2450,2168,282,11.50000000
CN0400100000000,04,001,"Apache County, AZ",Jan-22,18736,17241,1495,8.00000000
CN0400300000000,04,003,"Cochise County, AZ",Jan-22,49514,47610,1904,3.80000000
CN0400500000000,04,005,"Coconino County, AZ",Jan-22,74297,70684,3613,4.90000000
CN0400700000000,04,007,"Gila County, AZ",Jan-22,20396,19631,765,3.80000000
CN0400900000000,04,009,"Graham County, AZ",Jan-22,15700,15226,474,3.00000000
CN0401100000000,04,011,"Greenlee County, AZ",Jan-22,4430,4307,123,2.80000000
CN0401200000000,04,012,"La Paz County, AZ",Jan-22,9371,9023,348,3.70000000
CN0401300000000,04,013,"Maricopa County, AZ",Jan-22,2330711,2257459,73252,3.10000000
CN0401500000000,04,015,"Mohave County, AZ",Jan-22,88307,84418,3889,4.40000000
CN0401700000000,04,017,"Navajo County, AZ",Jan-22,38925,36793,2132,5.50000000
CN0401900000000,04,019,"Pima County, AZ",Jan-22,486098,468617,17481,3.60000000
CN0402100000000,04,021,"Pinal County, AZ",Jan-22,196222,189437,6785,3.50000000
CN0402300000000,04,023,"Santa Cruz County, AZ",Jan-22,19660,18223,1437,7.30000000
CN0402500000000,04,025,"Yavapai County, AZ",Jan-22,106233,103114,3119,2.90000000
CN0402700000000,04,027,"Yuma County, AZ",Jan-22,100026,87602,12424,12.40000000
CN0500100000000,05,001,"Arkansas County, AR",Jan-22,9409,9040,369,3.90000000
CN0500300000000,05,003,"Ashley County, AR",Jan-22,6617,6133,484,7.30000000
CN0500500000000,05,005,"Baxter County, AR",Jan-22,16065,15474,591,3.70000000
CN0500700000000,05,007,"Benton County, AR",Jan-22,143380,139707,3673,2.60000000
CN0500900000000,05,009,"Boone County, AR",Jan-22,15651,15228,423,2.70000000
CN0501100000000,05,011,"Bradley County, AR",Jan-22,3987,3800,187,4.70000000
CN0501300000000,05,013,"Calhoun County, AR",Jan-22,2386,2316,70,2.90000000
CN0501500000000,05,015,"Carroll County, AR",Jan-22,12205,11772,433,3.50000000
CN0501700000000,05,017,"Chicot County, AR",Jan-22,3016,2756,260,8.60000000
CN0501900000000,05,019,"Clark County, AR",Jan-22,8631,8232,399,4.60000000
CN0502100000000,05,021,"Clay County, AR",Jan-22,5299,5074,225,4.20000000
CN0502300000000,05,023,"Cleburne County, AR",Jan-22,8781,8356,425,4.80000000
CN0502500000000,05,025,"Cleveland County, AR",Jan-22,3055,2937,118,3.90000000
CN0502700000000,05,027,"Columbia County, AR",Jan-22,8829,8375,454,5.10000000
CN0502900000000,05,029,"Conway County, AR",Jan-22,8201,7870,331,4.00000000
CN0503100000000,05,031,"Craighead County, AR",Jan-22,55698,54071,1627,2.90000000
CN0503300000000,05,033,"Crawford County, AR",Jan-22,25770,24876,894,3.50000000
CN0503500000000,05,035,"Crittenden County, AR",Jan-22,20437,19522,915,4.50000000
CN0503700000000,05,037,"Cross County, AR",Jan-22,6869,6561,308,4.50000000
CN0503900000000,05,039,"Dallas County, AR",Jan-22,2748,2634,114,4.10000000
CN0504100000000,05,041,"Desha County, AR",Jan-22,4929,4614,315,6.40000000
CN0504300000000,05,043,"Drew County, AR",Jan-22,7530,7170,360,4.80000000
CN0504500000000,05,045,"Faulkner County, AR",Jan-22,61195,59252,1943,3.20000000
CN0504700000000,05,047,"Franklin County, AR",Jan-22,7192,6939,253,3.50000000
CN0504900000000,05,049,"Fulton County, AR",Jan-22,4830,4669,161,3.30000000
CN0505100000000,05,051,"Garland County, AR",Jan-22,39636,37823,1813,4.60000000
CN0505300000000,05,053,"Grant County, AR",Jan-22,8206,7952,254,3.10000000
CN0505500000000,05,055,"Greene County, AR",Jan-22,19270,18635,635,3.30000000
CN0505700000000,05,057,"Hempstead County, AR",Jan-22,9030,8706,324,3.60000000
CN0505900000000,05,059,"Hot Spring County, AR",Jan-22,13767,13269,498,3.60000000
CN0506100000000,05,061,"Howard County, AR",Jan-22,5383,5212,171,3.20000000
CN0506300000000,05,063,"Independence County, AR",Jan-22,16258,15654,604,3.70000000
CN0506500000000,05,065,"Izard County, AR",Jan-22,4257,4020,237,5.60000000
CN0506700000000,05,067,"Jackson County, AR",Jan-22,5635,5332,303,5.40000000
CN0506900000000,05,069,"Jefferson County, AR",Jan-22,25738,24027,1711,6.60000000
CN0507100000000,05,071,"Johnson County, AR",Jan-22,9854,9392,462,4.70000000
CN0507300000000,05,073,"Lafayette County, AR",Jan-22,2292,2172,120,5.20000000
CN0507500000000,05,075,"Lawrence County, AR",Jan-22,6687,6425,262,3.90000000
CN0507700000000,05,077,"Lee County, AR",Jan-22,2512,2369,143,5.70000000
CN0507900000000,05,079,"Lincoln County, AR",Jan-22,3685,3498,187,5.10000000
CN0508100000000,05,081,"Little River County, AR",Jan-22,5269,5049,220,4.20000000
CN0508300000000,05,083,"Logan County, AR",Jan-22,8306,7978,328,3.90000000
CN0508500000000,05,085,"Lonoke County, AR",Jan-22,33281,32244,1037,3.10000000
CN0508700000000,05,087,"Madison County, AR",Jan-22,7429,7216,213,2.90000000
CN0508900000000,05,089,"Marion County, AR",Jan-22,5983,5738,245,4.10000000
CN0509100000000,05,091,"Miller County, AR",Jan-22,19001,18144,857,4.50000000
CN0509300000000,05,093,"Mississippi County, AR",Jan-22,16054,14941,1113,6.90000000
CN0509500000000,05,095,"Monroe County, AR",Jan-22,2614,2473,141,5.40000000
CN0509700000000,05,097,"Montgomery County, AR",Jan-22,2802,2642,160,5.70000000
CN0509900000000,05,099,"Nevada County, AR",Jan-22,3327,3175,152,4.60000000
CN0510100000000,05,101,"Newton County, AR",Jan-22,3165,3062,103,3.30000000
CN0510300000000,05,103,"Ouachita County, AR",Jan-22,9745,9350,395,4.10000000
CN0510500000000,05,105,"Perry County, AR",Jan-22,4121,3938,183,4.40000000
CN0510700000000,05,107,"Phillips County, AR",Jan-22,5779,5312,467,8.10000000
CN0510900000000,05,109,"Pike County, AR",Jan-22,4104,3924,180,4.40000000
CN0511100000000,05,111,"Poinsett County, AR",Jan-22,9716,9339,377,3.90000000
CN0511300000000,05,113,"Polk County, AR",Jan-22,7699,7372,327,4.20000000
CN0511500000000,05,115,"Pope County, AR",Jan-22,27031,25896,1135,4.20000000
CN0511700000000,05,117,"Prairie County, AR",Jan-22,3472,3361,111,3.20000000
CN0511900000000,05,119,"Pulaski County, AR",Jan-22,184962,176940,8022,4.30000000
CN0512100000000,05,121,"Randolph County, AR",Jan-22,7215,6953,262,3.60000000
CN0512300000000,05,123,"St. Francis County, AR",Jan-22,7589,7140,449,5.90000000
CN0512500000000,05,125,"Saline County, AR",Jan-22,58117,56428,1689,2.90000000
CN0512700000000,05,127,"Scott County, AR",Jan-22,4218,4090,128,3.00000000
CN0512900000000,05,129,"Searcy County, AR",Jan-22,2853,2711,142,5.00000000
CN0513100000000,05,131,"Sebastian County, AR",Jan-22,54151,52304,1847,3.40000000
CN0513300000000,05,133,"Sevier County, AR",Jan-22,5301,5079,222,4.20000000
CN0513500000000,05,135,"Sharp County, AR",Jan-22,5571,5306,265,4.80000000
CN0513700000000,05,137,"Stone County, AR",Jan-22,4376,4160,216,4.90000000
CN0513900000000,05,139,"Union County, AR",Jan-22,14875,13993,882,5.90000000
CN0514100000000,05,141,"Van Buren County, AR",Jan-22,5750,5468,282,4.90000000
CN0514300000000,05,143,"Washington County, AR",Jan-22,126767,123489,3278,2.60000000
CN0514500000000,05,145,"White County, AR",Jan-22,33783,32463,1320,3.90000000
CN0514700000000,05,147,"Woodruff County, AR",Jan-22,2812,2686,126,4.50000000
CN0514900000000,05,149,"Yell County, AR",Jan-22,7765,7448,317,4.10000000
CN0600100000000,06,001,"Alameda County, CA",Jan-22,819108,783386,35722,4.40000000
CN0600300000000,06,003,"Alpine County, CA",Jan-22,574,538,36,6.30000000
CN0600500000000,06,005,"Amador County, CA",Jan-22,14291,13446,845,5.90000000
CN0600700000000,06,007,"Butte County, CA",Jan-22,92085,86796,5289,5.70000000
CN0600900000000,06,009,"Calaveras County, CA",Jan-22,21372,20369,1003,4.70000000
CN0601100000000,06,011,"Colusa County, CA",Jan-22,10628,9011,1617,15.20000000
CN0601300000000,06,013,"Contra Costa County, CA",Jan-22,548199,522394,25805,4.70000000
CN0601500000000,06,015,"Del Norte County, CA",Jan-22,9243,8677,566,6.10000000
CN0601700000000,06,017,"El Dorado County, CA",Jan-22,92175,88071,4104,4.50000000
CN0601900000000,06,019,"Fresno County, CA",Jan-22,450043,413387,36656,8.10000000
CN0602100000000,06,021,"Glenn County, CA",Jan-22,12462,11646,816,6.50000000
CN0602300000000,06,023,"Humboldt County, CA",Jan-22,58745,55904,2841,4.80000000
CN0602500000000,06,025,"Imperial County, CA",Jan-22,70946,59899,11047,15.60000000
CN0602700000000,06,027,"Inyo County, CA",Jan-22,8184,7788,396,4.80000000
CN0602900000000,06,029,"Kern County, CA",Jan-22,387580,353548,34032,8.80000000
CN0603100000000,06,031,"Kings County, CA",Jan-22,56881,51755,5126,9.00000000
CN0603300000000,06,033,"Lake County, CA",Jan-22,28135,26222,1913,6.80000000
CN0603500000000,06,035,"Lassen County, CA",Jan-22,8873,8382,491,5.50000000
CN0603700000000,06,037,"Los Angeles County, CA",Jan-22,5035535,4707533,328002,6.50000000
CN0603900000000,06,039,"Madera County, CA",Jan-22,63621,58640,4981,7.80000000
CN0604100000000,06,041,"Marin County, CA",Jan-22,129828,125761,4067,3.10000000
CN0604300000000,06,043,"Mariposa County, CA",Jan-22,6267,5792,475,7.60000000
CN0604500000000,06,045,"Mendocino County, CA",Jan-22,36980,35058,1922,5.20000000
CN0604700000000,06,047,"Merced County, CA",Jan-22,116127,104734,11393,9.80000000
CN0604900000000,06,049,"Modoc County, CA",Jan-22,3110,2877,233,7.50000000
CN0605100000000,06,051,"Mono County, CA",Jan-22,9542,9104,438,4.60000000
CN0605300000000,06,053,"Monterey County, CA",Jan-22,201638,182939,18699,9.30000000
CN0605500000000,06,055,"Napa County, CA",Jan-22,68300,65171,3129,4.60000000
CN0605700000000,06,057,"Nevada County, CA",Jan-22,47642,45548,2094,4.40000000
CN0605900000000,06,059,"Orange County, CA",Jan-22,1573136,1507003,66133,4.20000000
CN0606100000000,06,061,"Placer County, CA",Jan-22,190332,183311,7021,3.70000000
CN0606300000000,06,063,"Plumas County, CA",Jan-22,6706,5996,710,10.60000000
CN0606500000000,06,065,"Riverside County, CA",Jan-22,1154663,1089799,64864,5.60000000
CN0606700000000,06,067,"Sacramento County, CA",Jan-22,720591,681530,39061,5.40000000
CN0606900000000,06,069,"San Benito County, CA",Jan-22,32353,30198,2155,6.70000000
CN0607100000000,06,071,"San Bernardino County, CA",Jan-22,1010588,952651,57937,5.70000000
CN0607300000000,06,073,"San Diego County, CA",Jan-22,1572006,1498635,73371,4.70000000
CN0607500000000,06,075,"San Francisco County/city, CA",Jan-22,562118,542716,19402,3.50000000
CN0607700000000,06,077,"San Joaquin County, CA",Jan-22,335945,311315,24630,7.30000000
CN0607900000000,06,079,"San Luis Obispo County, CA",Jan-22,136116,130992,5124,3.80000000
CN0608100000000,06,081,"San Mateo County, CA",Jan-22,444225,430444,13781,3.10000000
CN0608300000000,06,083,"Santa Barbara County, CA",Jan-22,215973,205595,10378,4.80000000
CN0608500000000,06,085,"Santa Clara County, CA",Jan-22,1031538,997884,33654,3.30000000
CN0608700000000,06,087,"Santa Cruz County, CA",Jan-22,132293,123920,8373,6.30000000
CN0608900000000,06,089,"Shasta County, CA",Jan-22,73680,69326,4354,5.90000000
CN0609100000000,06,091,"Sierra County, CA",Jan-22,1283,1211,72,5.60000000
CN0609300000000,06,093,"Siskiyou County, CA",Jan-22,16042,14738,1304,8.10000000
CN0609500000000,06,095,"Solano County, CA",Jan-22,200201,188112,12089,6.00000000
CN0609700000000,06,097,"Sonoma County, CA",Jan-22,245445,235563,9882,4.00000000
CN0609900000000,06,099,"Stanislaus County, CA",Jan-22,239519,222303,17216,7.20000000
CN0610100000000,06,101,"Sutter County, CA",Jan-22,45063,41163,3900,8.70000000
CN0610300000000,06,103,"Tehama County, CA",Jan-22,25184,23628,1556,6.20000000
CN0610500000000,06,105,"Trinity County, CA",Jan-22,4243,3983,260,6.10000000
CN0610700000000,06,107,"Tulare County, CA",Jan-22,205207,185365,19842,9.70000000
CN0610900000000,06,109,"Tuolumne County, CA",Jan-22,19708,18498,1210,6.10000000
CN0611100000000,06,111,"Ventura County, CA",Jan-22,407941,388506,19435,4.80000000
CN0611300000000,06,113,"Yolo County, CA",Jan-22,107239,101912,5327,5.00000000
CN0611500000000,06,115,"Yuba County, CA",Jan-22,31124,28837,2287,7.30000000
CN0800100000000,08,001,"Adams County, CO",Jan-22,280115,266905,13210,4.70000000
CN0800300000000,08,003,"Alamosa County, CO",Jan-22,8374,8007,367,4.40000000
CN0800500000000,08,005,"Arapahoe County, CO",Jan-22,371748,356104,15644,4.20000000
CN0800700000000,08,007,"Archuleta County, CO",Jan-22,7081,6803,278,3.90000000
CN0800900000000,08,009,"Baca County, CO",Jan-22,2107,2073,34,1.60000000
CN0801100000000,08,011,"Bent County, CO",Jan-22,1875,1787,88,4.70000000
CN0801300000000,08,013,"Boulder County, CO",Jan-22,197592,191446,6146,3.10000000
CN0801400000000,08,014,"Broomfield County/city, CO",Jan-22,41862,40540,1322,3.20000000
CN0801500000000,08,015,"Chaffee County, CO",Jan-22,10197,9883,314,3.10000000
CN0801700000000,08,017,"Cheyenne County, CO",Jan-22,1133,1115,18,1.60000000
CN0801900000000,08,019,"Clear Creek County, CO",Jan-22,6100,5850,250,4.10000000
CN0802100000000,08,021,"Conejos County, CO",Jan-22,4027,3880,147,3.70000000
CN0802300000000,08,023,"Costilla County, CO",Jan-22,1866,1773,93,5.00000000
CN0802500000000,08,025,"Crowley County, CO",Jan-22,1445,1389,56,3.90000000
CN0802700000000,08,027,"Custer County, CO",Jan-22,2298,2227,71,3.10000000
CN0802900000000,08,029,"Delta County, CO",Jan-22,13985,13386,599,4.30000000
CN0803100000000,08,031,"Denver County/city, CO",Jan-22,432553,413985,18568,4.30000000
CN0803300000000,08,033,"Dolores County, CO",Jan-22,1162,1121,41,3.50000000
CN0803500000000,08,035,"Douglas County, CO",Jan-22,204264,198312,5952,2.90000000
CN0803700000000,08,037,"Eagle County, CO",Jan-22,40704,39554,1150,2.80000000
CN0803900000000,08,039,"Elbert County, CO",Jan-22,15704,15261,443,2.80000000
CN0804100000000,08,041,"El Paso County, CO",Jan-22,353996,339335,14661,4.10000000
CN0804300000000,08,043,"Fremont County, CO",Jan-22,15668,14779,889,5.70000000
CN0804500000000,08,045,"Garfield County, CO",Jan-22,33508,32339,1169,3.50000000
CN0804700000000,08,047,"Gilpin County, CO",Jan-22,3899,3740,159,4.10000000
CN0804900000000,08,049,"Grand County, CO",Jan-22,10625,10323,302,2.80000000
CN0805100000000,08,051,"Gunnison County, CO",Jan-22,12193,11872,321,2.60000000
CN0805300000000,08,053,"Hinsdale County, CO",Jan-22,418,407,11,2.60000000
CN0805500000000,08,055,"Huerfano County, CO",Jan-22,2594,2405,189,7.30000000
CN0805700000000,08,057,"Jackson County, CO",Jan-22,963,937,26,2.70000000
CN0805900000000,08,059,"Jefferson County, CO",Jan-22,338616,326411,12205,3.60000000
CN0806100000000,08,061,"Kiowa County, CO",Jan-22,918,898,20,2.20000000
CN0806300000000,08,063,"Kit Carson County, CO",Jan-22,4234,4133,101,2.40000000
CN0806500000000,08,065,"Lake County, CO",Jan-22,5440,5285,155,2.80000000
CN0806700000000,08,067,"La Plata County, CO",Jan-22,30575,29351,1224,4.00000000
CN0806900000000,08,069,"Larimer County, CO",Jan-22,208131,201120,7011,3.40000000
CN0807100000000,08,071,"Las Animas County, CO",Jan-22,6291,5931,360,5.70000000
CN0807300000000,08,073,"Lincoln County, CO",Jan-22,2345,2275,70,3.00000000
CN0807500000000,08,075,"Logan County, CO",Jan-22,10861,10510,351,3.20000000
CN0807700000000,08,077,"Mesa County, CO",Jan-22,78309,74779,3530,4.50000000
CN0807900000000,08,079,"Mineral County, CO",Jan-22,516,500,16,3.10000000
CN0808100000000,08,081,"Moffat County, CO",Jan-22,7186,6899,287,4.00000000
CN0808300000000,08,083,"Montezuma County, CO",Jan-22,13207,12580,627,4.70000000
CN0808500000000,08,085,"Montrose County, CO",Jan-22,22704,21813,891,3.90000000
CN0808700000000,08,087,"Morgan County, CO",Jan-22,16429,15801,628,3.80000000
CN0808900000000,08,089,"Otero County, CO",Jan-22,8241,7838,403,4.90000000
CN0809100000000,08,091,"Ouray County, CO",Jan-22,2673,2583,90,3.40000000
CN0809300000000,08,093,"Park County, CO",Jan-22,11396,11051,345,3.00000000
CN0809500000000,08,095,"Phillips County, CO",Jan-22,2516,2460,56,2.20000000
CN0809700000000,08,097,"Pitkin County, CO",Jan-22,11394,11020,374,3.30000000
CN0809900000000,08,099,"Prowers County, CO",Jan-22,6328,6110,218,3.40000000
CN0810100000000,08,101,"Pueblo County, CO",Jan-22,78736,73821,4915,6.20000000
CN0810300000000,08,103,"Rio Blanco County, CO",Jan-22,2806,2674,132,4.70000000
CN0810500000000,08,105,"Rio Grande County, CO",Jan-22,5494,5175,319,5.80000000
CN0810700000000,08,107,"Routt County, CO",Jan-22,16544,16071,473,2.90000000
CN0810900000000,08,109,"Saguache County, CO",Jan-22,3534,3380,154,4.40000000
CN0811100000000,08,111,"San Juan County, CO",Jan-22,590,573,17,2.90000000
CN0811300000000,08,113,"San Miguel County, CO",Jan-22,6933,6751,182,2.60000000
CN0811500000000,08,115,"Sedgwick County, CO",Jan-22,1179,1146,33,2.80000000
CN0811700000000,08,117,"Summit County, CO",Jan-22,25890,25272,618,2.40000000
CN0811900000000,08,119,"Teller County, CO",Jan-22,13180,12694,486,3.70000000
CN0812100000000,08,121,"Washington County, CO",Jan-22,2743,2671,72,2.60000000
CN0812300000000,08,123,"Weld County, CO",Jan-22,167417,160313,7104,4.20000000
CN0812500000000,08,125,"Yuma County, CO",Jan-22,5691,5566,125,2.20000000
CN0900100000000,09,001,"Fairfield County, CT",Jan-22,470132,447307,22825,4.90000000
CN0900300000000,09,003,"Hartford County, CT",Jan-22,470073,446740,23333,5.00000000
CN0900500000000,09,005,"Litchfield County, CT",Jan-22,102555,97696,4859,4.70000000
CN0900700000000,09,007,"Middlesex County, CT",Jan-22,92071,87980,4091,4.40000000
CN0900900000000,09,009,"New Haven County, CT",Jan-22,457175,433675,23500,5.10000000
CN0901100000000,09,011,"New London County, CT",Jan-22,129230,122204,7026,5.40000000
CN0901300000000,09,013,"Tolland County, CT",Jan-22,85042,81137,3905,4.60000000
CN0901500000000,09,015,"Windham County, CT",Jan-22,62777,59389,3388,5.40000000
CN1000100000000,10,001,"Kent County, DE",Jan-22,82705,77887,4818,5.80000000
CN1000300000000,10,003,"New Castle County, DE",Jan-22,307602,292204,15398,5.00000000
CN1000500000000,10,005,"Sussex County, DE",Jan-22,109937,104162,5775,5.30000000
CN1100100000000,11,001,District of Columbia,Jan-22,380671,356734,23937,6.30000000
CN1200100000000,12,001,"Alachua County, FL",Jan-22,140617,136297,4320,3.10000000
CN1200300000000,12,003,"Baker County, FL",Jan-22,12328,11941,387,3.10000000
CN1200500000000,12,005,"Bay County, FL",Jan-22,85916,83002,2914,3.40000000
CN1200700000000,12,007,"Bradford County, FL",Jan-22,10910,10528,382,3.50000000
CN1200900000000,12,009,"Brevard County, FL",Jan-22,293700,284113,9587,3.30000000
CN1201100000000,12,011,"Broward County, FL",Jan-22,1045732,1007577,38155,3.60000000
CN1201300000000,12,013,"Calhoun County, FL",Jan-22,4888,4707,181,3.70000000
CN1201500000000,12,015,"Charlotte County, FL",Jan-22,75239,72461,2778,3.70000000
CN1201700000000,12,017,"Citrus County, FL",Jan-22,47391,45029,2362,5.00000000
CN1201900000000,12,019,"Clay County, FL",Jan-22,110028,106784,3244,2.90000000
CN1202100000000,12,021,"Collier County, FL",Jan-22,187544,182054,5490,2.90000000
CN1202300000000,12,023,"Columbia County, FL",Jan-22,29180,28077,1103,3.80000000
CN1202700000000,12,027,"DeSoto County, FL",Jan-22,15100,14633,467,3.10000000
CN1202900000000,12,029,"Dixie County, FL",Jan-22,5899,5688,211,3.60000000
CN1203100000000,12,031,"Duval County, FL",Jan-22,500683,482973,17710,3.50000000
CN1203300000000,12,033,"Escambia County, FL",Jan-22,147052,141629,5423,3.70000000
CN1203500000000,12,035,"Flagler County, FL",Jan-22,48925,47030,1895,3.90000000
CN1203700000000,12,037,"Franklin County, FL",Jan-22,4621,4453,168,3.60000000
CN1203900000000,12,039,"Gadsden County, FL",Jan-22,19965,19097,868,4.30000000
CN1204100000000,12,041,"Gilchrist County, FL",Jan-22,7329,7082,247,3.40000000
CN1204300000000,12,043,"Glades County, FL",Jan-22,5336,5159,177,3.30000000
CN1204500000000,12,045,"Gulf County, FL",Jan-22,5276,5105,171,3.20000000
CN1204700000000,12,047,"Hamilton County, FL",Jan-22,4091,3881,210,5.10000000
CN1204900000000,12,049,"Hardee County, FL",Jan-22,9167,8824,343,3.70000000
CN1205100000000,12,051,"Hendry County, FL",Jan-22,16492,15732,760,4.60000000
CN1205300000000,12,053,"Hernando County, FL",Jan-22,75007,71844,3163,4.20000000
CN1205500000000,12,055,"Highlands County, FL",Jan-22,34644,32943,1701,4.90000000
CN1205700000000,12,057,"Hillsborough County, FL",Jan-22,787020,761045,25975,3.30000000
CN1205900000000,12,059,"Holmes County, FL",Jan-22,6980,6727,253,3.60000000
CN1206100000000,12,061,"Indian River County, FL",Jan-22,66483,63925,2558,3.80000000
CN1206300000000,12,063,"Jackson County, FL",Jan-22,17196,16558,638,3.70000000
CN1206500000000,12,065,"Jefferson County, FL",Jan-22,5704,5500,204,3.60000000
CN1206700000000,12,067,"Lafayette County, FL",Jan-22,2792,2695,97,3.50000000
CN1206900000000,12,069,"Lake County, FL",Jan-22,164783,158643,6140,3.70000000
CN1207100000000,12,071,"Lee County, FL",Jan-22,365356,353032,12324,3.40000000
CN1207300000000,12,073,"Leon County, FL",Jan-22,156950,151570,5380,3.40000000
CN1207500000000,12,075,"Levy County, FL",Jan-22,16977,16315,662,3.90000000
CN1207700000000,12,077,"Liberty County, FL",Jan-22,2596,2495,101,3.90000000
CN1207900000000,12,079,"Madison County, FL",Jan-22,7870,7558,312,4.00000000
CN1208100000000,12,081,"Manatee County, FL",Jan-22,189919,183930,5989,3.20000000
CN1208300000000,12,083,"Marion County, FL",Jan-22,143242,137379,5863,4.10000000
CN1208500000000,12,085,"Martin County, FL",Jan-22,74586,72329,2257,3.00000000
CN1208600000000,12,086,"Miami-Dade County, FL",Jan-22,1358707,1314933,43774,3.20000000
CN1208700000000,12,087,"Monroe County, FL",Jan-22,48571,47468,1103,2.30000000
CN1208900000000,12,089,"Nassau County, FL",Jan-22,43584,42334,1250,2.90000000
CN1209100000000,12,091,"Okaloosa County, FL",Jan-22,99124,96331,2793,2.80000000
CN1209300000000,12,093,"Okeechobee County, FL",Jan-22,17897,17283,614,3.40000000
CN1209500000000,12,095,"Orange County, FL",Jan-22,763552,734306,29246,3.80000000
CN1209700000000,12,097,"Osceola County, FL",Jan-22,190918,181990,8928,4.70000000
CN1209900000000,12,099,"Palm Beach County, FL",Jan-22,750210,724895,25315,3.40000000
CN1210100000000,12,101,"Pasco County, FL",Jan-22,251435,242512,8923,3.50000000
CN1210300000000,12,103,"Pinellas County, FL",Jan-22,496572,480740,15832,3.20000000
CN1210500000000,12,105,"Polk County, FL",Jan-22,334708,320716,13992,4.20000000
CN1210700000000,12,107,"Putnam County, FL",Jan-22,27417,26031,1386,5.10000000
CN1210900000000,12,109,"St. Johns County, FL",Jan-22,145159,141416,3743,2.60000000
CN1211100000000,12,111,"St. Lucie County, FL",Jan-22,151990,145975,6015,4.00000000
CN1211300000000,12,113,"Santa Rosa County, FL",Jan-22,85924,83328,2596,3.00000000
CN1211500000000,12,115,"Sarasota County, FL",Jan-22,198524,192285,6239,3.10000000
CN1211700000000,12,117,"Seminole County, FL",Jan-22,253041,244911,8130,3.20000000
CN1211900000000,12,119,"Sumter County, FL",Jan-22,35561,33868,1693,4.80000000
CN1212100000000,12,121,"Suwannee County, FL",Jan-22,17313,16666,647,3.70000000
CN1212300000000,12,123,"Taylor County, FL",Jan-22,7865,7538,327,4.20000000
CN1212500000000,12,125,"Union County, FL",Jan-22,4606,4472,134,2.90000000
CN1212700000000,12,127,"Volusia County, FL",Jan-22,258184,248439,9745,3.80000000
CN1212900000000,12,129,"Wakulla County, FL",Jan-22,15757,15324,433,2.70000000
CN1213100000000,12,131,"Walton County, FL",Jan-22,33682,32661,1021,3.00000000
CN1213300000000,12,133,"Washington County, FL",Jan-22,9503,9136,367,3.90000000
CN1300100000000,13,001,"Appling County, GA",Jan-22,9297,8968,329,3.50000000
CN1300300000000,13,003,"Atkinson County, GA",Jan-22,4574,4441,133,2.90000000
CN1300500000000,13,005,"Bacon County, GA",Jan-22,4841,4691,150,3.10000000
CN1300700000000,13,007,"Baker County, GA",Jan-22,1151,1100,51,4.40000000
CN1300900000000,13,009,"Baldwin County, GA",Jan-22,17752,17022,730,4.10000000
CN1301100000000,13,011,"Banks County, GA",Jan-22,10272,10011,261,2.50000000
CN1301300000000,13,013,"Barrow County, GA",Jan-22,43146,42015,1131,2.60000000
CN1301500000000,13,015,"Bartow County, GA",Jan-22,52504,50821,1683,3.20000000
CN1301700000000,13,017,"Ben Hill County, GA",Jan-22,5489,5243,246,4.50000000
CN1301900000000,13,019,"Berrien County, GA",Jan-22,7702,7460,242,3.10000000
CN1302100000000,13,021,"Bibb County, GA",Jan-22,68598,65814,2784,4.10000000
CN1302300000000,13,023,"Bleckley County, GA",Jan-22,4648,4443,205,4.40000000
CN1302500000000,13,025,"Brantley County, GA",Jan-22,7339,7078,261,3.60000000
CN1302700000000,13,027,"Brooks County, GA",Jan-22,6826,6612,214,3.10000000
CN1302900000000,13,029,"Bryan County, GA",Jan-22,20338,19793,545,2.70000000
CN1303100000000,13,031,"Bulloch County, GA",Jan-22,38186,36797,1389,3.60000000
CN1303300000000,13,033,"Burke County, GA",Jan-22,9206,8700,506,5.50000000
CN1303500000000,13,035,"Butts County, GA",Jan-22,11365,11029,336,3.00000000
CN1303700000000,13,037,"Calhoun County, GA",Jan-22,2315,2234,81,3.50000000
CN1303900000000,13,039,"Camden County, GA",Jan-22,21910,21254,656,3.00000000
CN1304300000000,13,043,"Candler County, GA",Jan-22,6055,5891,164,2.70000000
CN1304500000000,13,045,"Carroll County, GA",Jan-22,57339,55456,1883,3.30000000
CN1304700000000,13,047,"Catoosa County, GA",Jan-22,33550,32578,972,2.90000000
CN1304900000000,13,049,"Charlton County, GA",Jan-22,4998,4839,159,3.20000000
CN1305100000000,13,051,"Chatham County, GA",Jan-22,146269,141139,5130,3.50000000
CN1305300000000,13,053,"Chattahoochee County, GA",Jan-22,1957,1860,97,5.00000000
CN1305500000000,13,055,"Chattooga County, GA",Jan-22,9493,9093,400,4.20000000
CN1305700000000,13,057,"Cherokee County, GA",Jan-22,142631,139210,3421,2.40000000
CN1305900000000,13,059,"Clarke County, GA",Jan-22,61171,59196,1975,3.20000000
CN1306100000000,13,061,"Clay County, GA",Jan-22,871,788,83,9.50000000
CN1306300000000,13,063,"Clayton County, GA",Jan-22,142330,134821,7509,5.30000000
CN1306500000000,13,065,"Clinch County, GA",Jan-22,3071,2984,87,2.80000000
CN1306700000000,13,067,"Cobb County, GA",Jan-22,431860,419953,11907,2.80000000
CN1306900000000,13,069,"Coffee County, GA",Jan-22,18681,18004,677,3.60000000
CN1307100000000,13,071,"Colquitt County, GA",Jan-22,22314,21687,627,2.80000000
CN1307300000000,13,073,"Columbia County, GA",Jan-22,76796,74738,2058,2.70000000
CN1307500000000,13,075,"Cook County, GA",Jan-22,8239,7985,254,3.10000000
CN1307700000000,13,077,"Coweta County, GA",Jan-22,77929,75678,2251,2.90000000
CN1307900000000,13,079,"Crawford County, GA",Jan-22,5618,5434,184,3.30000000
CN1308100000000,13,081,"Crisp County, GA",Jan-22,9664,9169,495,5.10000000
CN1308300000000,13,083,"Dade County, GA",Jan-22,7988,7779,209,2.60000000
CN1308500000000,13,085,"Dawson County, GA",Jan-22,13380,13050,330,2.50000000
CN1308700000000,13,087,"Decatur County, GA",Jan-22,11454,11071,383,3.30000000
CN1308900000000,13,089,"DeKalb County, GA",Jan-22,407444,392401,15043,3.70000000
CN1309100000000,13,091,"Dodge County, GA",Jan-22,6954,6693,261,3.80000000
CN1309300000000,13,093,"Dooly County, GA",Jan-22,4849,4626,223,4.60000000
CN1309500000000,13,095,"Dougherty County, GA",Jan-22,37319,35430,1889,5.10000000
CN1309700000000,13,097,"Douglas County, GA",Jan-22,75388,72648,2740,3.60000000
CN1309900000000,13,099,"Early County, GA",Jan-22,4354,4168,186,4.30000000
CN1310100000000,13,101,"Echols County, GA",Jan-22,1924,1874,50,2.60000000
CN1310300000000,13,103,"Effingham County, GA",Jan-22,34072,33160,912,2.70000000
CN1310500000000,13,105,"Elbert County, GA",Jan-22,7810,7450,360,4.60000000
CN1310700000000,13,107,"Emanuel County, GA",Jan-22,8670,8262,408,4.70000000
CN1310900000000,13,109,"Evans County, GA",Jan-22,5241,5087,154,2.90000000
CN1311100000000,13,111,"Fannin County, GA",Jan-22,11864,11545,319,2.70000000
CN1311300000000,13,113,"Fayette County, GA",Jan-22,59600,58032,1568,2.60000000
CN1311500000000,13,115,"Floyd County, GA",Jan-22,44135,42686,1449,3.30000000
CN1311700000000,13,117,"Forsyth County, GA",Jan-22,130201,127162,3039,2.30000000
CN1311900000000,13,119,"Franklin County, GA",Jan-22,10201,9864,337,3.30000000
CN1312100000000,13,121,"Fulton County, GA",Jan-22,578778,557191,21587,3.70000000
CN1312300000000,13,123,"Gilmer County, GA",Jan-22,12259,11885,374,3.10000000
CN1312500000000,13,125,"Glascock County, GA",Jan-22,1276,1244,32,2.50000000
CN1312700000000,13,127,"Glynn County, GA",Jan-22,39481,38226,1255,3.20000000
CN1312900000000,13,129,"Gordon County, GA",Jan-22,29347,28502,845,2.90000000
CN1313100000000,13,131,"Grady County, GA",Jan-22,11192,10855,337,3.00000000
CN1313300000000,13,133,"Greene County, GA",Jan-22,7222,6993,229,3.20000000
CN1313500000000,13,135,"Gwinnett County, GA",Jan-22,501800,487025,14775,2.90000000
CN1313700000000,13,137,"Habersham County, GA",Jan-22,18600,17991,609,3.30000000
CN1313900000000,13,139,"Hall County, GA",Jan-22,106499,103935,2564,2.40000000
CN1314100000000,13,141,"Hancock County, GA",Jan-22,2545,2404,141,5.50000000
CN1314300000000,13,143,"Haralson County, GA",Jan-22,13001,12602,399,3.10000000
CN1314500000000,13,145,"Harris County, GA",Jan-22,17091,16619,472,2.80000000
CN1314700000000,13,147,"Hart County, GA",Jan-22,11887,11475,412,3.50000000
CN1314900000000,13,149,"Heard County, GA",Jan-22,5348,5168,180,3.40000000
CN1315100000000,13,151,"Henry County, GA",Jan-22,121301,117060,4241,3.50000000
CN1315300000000,13,153,"Houston County, GA",Jan-22,72330,70124,2206,3.00000000
CN1315500000000,13,155,"Irwin County, GA",Jan-22,3581,3431,150,4.20000000
CN1315700000000,13,157,"Jackson County, GA",Jan-22,44273,43317,956,2.20000000
CN1315900000000,13,159,"Jasper County, GA",Jan-22,7209,7012,197,2.70000000
CN1316100000000,13,161,"Jeff Davis County, GA",Jan-22,6183,5954,229,3.70000000
CN1316300000000,13,163,"Jefferson County, GA",Jan-22,7068,6787,281,4.00000000
CN1316500000000,13,165,"Jenkins County, GA",Jan-22,3169,3035,134,4.20000000
CN1316700000000,13,167,"Johnson County, GA",Jan-22,4171,4034,137,3.30000000
CN1316900000000,13,169,"Jones County, GA",Jan-22,13894,13493,401,2.90000000
CN1317100000000,13,171,"Lamar County, GA",Jan-22,8390,8092,298,3.60000000
CN1317300000000,13,173,"Lanier County, GA",Jan-22,3846,3719,127,3.30000000
CN1317500000000,13,175,"Laurens County, GA",Jan-22,19838,19087,751,3.80000000
CN1317700000000,13,177,"Lee County, GA",Jan-22,15272,14838,434,2.80000000
CN1317900000000,13,179,"Liberty County, GA",Jan-22,26467,25558,909,3.40000000
CN1318100000000,13,181,"Lincoln County, GA",Jan-22,3579,3442,137,3.80000000
CN1318300000000,13,183,"Long County, GA",Jan-22,8549,8289,260,3.00000000
CN1318500000000,13,185,"Lowndes County, GA",Jan-22,51704,49955,1749,3.40000000
CN1318700000000,13,187,"Lumpkin County, GA",Jan-22,17603,17150,453,2.60000000
CN1318900000000,13,189,"McDuffie County, GA",Jan-22,8557,8159,398,4.70000000
CN1319100000000,13,191,"McIntosh County, GA",Jan-22,6196,5998,198,3.20000000
CN1319300000000,13,193,"Macon County, GA",Jan-22,4677,4465,212,4.50000000
CN1319500000000,13,195,"Madison County, GA",Jan-22,14042,13659,383,2.70000000
CN1319700000000,13,197,"Marion County, GA",Jan-22,3291,3176,115,3.50000000
CN1319900000000,13,199,"Meriwether County, GA",Jan-22,9043,8635,408,4.50000000
CN1320100000000,13,201,"Miller County, GA",Jan-22,2776,2700,76,2.70000000
CN1320500000000,13,205,"Mitchell County, GA",Jan-22,8213,7856,357,4.30000000
CN1320700000000,13,207,"Monroe County, GA",Jan-22,13310,12948,362,2.70000000
CN1320900000000,13,209,"Montgomery County, GA",Jan-22,3827,3670,157,4.10000000
CN1321100000000,13,211,"Morgan County, GA",Jan-22,9695,9417,278,2.90000000
CN1321300000000,13,213,"Murray County, GA",Jan-22,15746,15104,642,4.10000000
CN1321500000000,13,215,"Muscogee County, GA",Jan-22,77206,73549,3657,4.70000000
CN1321700000000,13,217,"Newton County, GA",Jan-22,54456,52464,1992,3.70000000
CN1321900000000,13,219,"Oconee County, GA",Jan-22,20996,20557,439,2.10000000
CN1322100000000,13,221,"Oglethorpe County, GA",Jan-22,7288,7096,192,2.60000000
CN1322300000000,13,223,"Paulding County, GA",Jan-22,91557,89093,2464,2.70000000
CN1322500000000,13,225,"Peach County, GA",Jan-22,12125,11645,480,4.00000000
CN1322700000000,13,227,"Pickens County, GA",Jan-22,15923,15506,417,2.60000000
CN1322900000000,13,229,"Pierce County, GA",Jan-22,8627,8387,240,2.80000000
CN1323100000000,13,231,"Pike County, GA",Jan-22,9196,8942,254,2.80000000
CN1323300000000,13,233,"Polk County, GA",Jan-22,18588,17968,620,3.30000000
CN1323500000000,13,235,"Pulaski County, GA",Jan-22,4084,3950,134,3.30000000
CN1323700000000,13,237,"Putnam County, GA",Jan-22,8815,8499,316,3.60000000
CN1323900000000,13,239,"Quitman County, GA",Jan-22,742,706,36,4.90000000
CN1324100000000,13,241,"Rabun County, GA",Jan-22,7360,7121,239,3.20000000
CN1324300000000,13,243,"Randolph County, GA",Jan-22,2405,2297,108,4.50000000
CN1324500000000,13,245,"Richmond County, GA",Jan-22,84378,80447,3931,4.70000000
CN1324700000000,13,247,"Rockdale County, GA",Jan-22,45435,43662,1773,3.90000000
CN1324900000000,13,249,"Schley County, GA",Jan-22,2130,2048,82,3.80000000
CN1325100000000,13,251,"Screven County, GA",Jan-22,5076,4835,241,4.70000000
CN1325300000000,13,253,"Seminole County, GA",Jan-22,2996,2886,110,3.70000000
CN1325500000000,13,255,"Spalding County, GA",Jan-22,29466,28370,1096,3.70000000
CN1325700000000,13,257,"Stephens County, GA",Jan-22,10501,10110,391,3.70000000
CN1325900000000,13,259,"Stewart County, GA",Jan-22,2654,2559,95,3.60000000
CN1326100000000,13,261,"Sumter County, GA",Jan-22,12183,11624,559,4.60000000
CN1326300000000,13,263,"Talbot County, GA",Jan-22,2805,2698,107,3.80000000
CN1326500000000,13,265,"Taliaferro County, GA",Jan-22,534,511,23,4.30000000
CN1326700000000,13,267,"Tattnall County, GA",Jan-22,9769,9482,287,2.90000000
CN1326900000000,13,269,"Taylor County, GA",Jan-22,2893,2742,151,5.20000000
CN1327100000000,13,271,"Telfair County, GA",Jan-22,3714,3475,239,6.40000000
CN1327300000000,13,273,"Terrell County, GA",Jan-22,3577,3378,199,5.60000000
CN1327500000000,13,275,"Thomas County, GA",Jan-22,17618,16981,637,3.60000000
CN1327700000000,13,277,"Tift County, GA",Jan-22,21535,20937,598,2.80000000
CN1327900000000,13,279,"Toombs County, GA",Jan-22,12019,11513,506,4.20000000
CN1328100000000,13,281,"Towns County, GA",Jan-22,4016,3853,163,4.10000000
CN1328300000000,13,283,"Treutlen County, GA",Jan-22,2634,2532,102,3.90000000
CN1328500000000,13,285,"Troup County, GA",Jan-22,37837,36531,1306,3.50000000
CN1328700000000,13,287,"Turner County, GA",Jan-22,3293,3136,157,4.80000000
CN1328900000000,13,289,"Twiggs County, GA",Jan-22,2859,2731,128,4.50000000
CN1329100000000,13,291,"Union County, GA",Jan-22,11224,10920,304,2.70000000
CN1329300000000,13,293,"Upson County, GA",Jan-22,11858,11466,392,3.30000000
CN1329500000000,13,295,"Walker County, GA",Jan-22,31388,30368,1020,3.20000000
CN1329700000000,13,297,"Walton County, GA",Jan-22,48061,46707,1354,2.80000000
CN1329900000000,13,299,"Ware County, GA",Jan-22,15372,14911,461,3.00000000
CN1330100000000,13,301,"Warren County, GA",Jan-22,2705,2586,119,4.40000000
CN1330300000000,13,303,"Washington County, GA",Jan-22,6747,6456,291,4.30000000
CN1330500000000,13,305,"Wayne County, GA",Jan-22,11964,11564,400,3.30000000
CN1330700000000,13,307,"Webster County, GA",Jan-22,1000,964,36,3.60000000
CN1330900000000,13,309,"Wheeler County, GA",Jan-22,1656,1567,89,5.40000000
CN1331100000000,13,311,"White County, GA",Jan-22,16483,16083,400,2.40000000
CN1331300000000,13,313,"Whitfield County, GA",Jan-22,44080,42482,1598,3.60000000
CN1331500000000,13,315,"Wilcox County, GA",Jan-22,2766,2666,100,3.60000000
CN1331700000000,13,317,"Wilkes County, GA",Jan-22,3674,3510,164,4.50000000
CN1331900000000,13,319,"Wilkinson County, GA",Jan-22,3632,3506,126,3.50000000
CN1332100000000,13,321,"Worth County, GA",Jan-22,8930,8630,300,3.40000000
CN1500100000000,15,001,"Hawaii County, HI",Jan-22,94282,90685,3597,3.80000000
CN1500300000000,15,003,"Honolulu County/city, HI",Jan-22,457167,440122,17045,3.70000000
CN1500700000000,15,007,"Kauai County, HI",Jan-22,36844,34969,1875,5.10000000
CN1500900000000,15,009,"Maui County, HI",Jan-22,88336,84026,4310,4.90000000
CN1600100000000,16,001,"Ada County, ID",Jan-22,273139,265449,7690,2.80000000
CN1600300000000,16,003,"Adams County, ID",Jan-22,1747,1624,123,7.00000000
CN1600500000000,16,005,"Bannock County, ID",Jan-22,43963,42482,1481,3.40000000
CN1600700000000,16,007,"Bear Lake County, ID",Jan-22,3171,3048,123,3.90000000
CN1600900000000,16,009,"Benewah County, ID",Jan-22,4030,3793,237,5.90000000
CN1601100000000,16,011,"Bingham County, ID",Jan-22,24334,23560,774,3.20000000
CN1601300000000,16,013,"Blaine County, ID",Jan-22,12999,12592,407,3.10000000
CN1601500000000,16,015,"Boise County, ID",Jan-22,3834,3616,218,5.70000000
CN1601700000000,16,017,"Bonner County, ID",Jan-22,21778,20728,1050,4.80000000
CN1601900000000,16,019,"Bonneville County, ID",Jan-22,61716,59928,1788,2.90000000
CN1602100000000,16,021,"Boundary County, ID",Jan-22,5442,5167,275,5.10000000
CN1602300000000,16,023,"Butte County, ID",Jan-22,1446,1394,52,3.60000000
CN1602500000000,16,025,"Camas County, ID",Jan-22,696,671,25,3.60000000
CN1602700000000,16,027,"Canyon County, ID",Jan-22,111967,107792,4175,3.70000000
CN1602900000000,16,029,"Caribou County, ID",Jan-22,4041,3880,161,4.00000000
CN1603100000000,16,031,"Cassia County, ID",Jan-22,12416,12075,341,2.70000000
CN1603300000000,16,033,"Clark County, ID",Jan-22,357,341,16,4.50000000
CN1603500000000,16,035,"Clearwater County, ID",Jan-22,2962,2756,206,7.00000000
CN1603700000000,16,037,"Custer County, ID",Jan-22,2046,1940,106,5.20000000
CN1603900000000,16,039,"Elmore County, ID",Jan-22,11917,11489,428,3.60000000
CN1604100000000,16,041,"Franklin County, ID",Jan-22,7460,7244,216,2.90000000
CN1604300000000,16,043,"Fremont County, ID",Jan-22,8158,7868,290,3.60000000
CN1604500000000,16,045,"Gem County, ID",Jan-22,8861,8498,363,4.10000000
CN1604700000000,16,047,"Gooding County, ID",Jan-22,8345,8073,272,3.30000000
CN1604900000000,16,049,"Idaho County, ID",Jan-22,6604,6281,323,4.90000000
CN1605100000000,16,051,"Jefferson County, ID",Jan-22,14801,14368,433,2.90000000
CN1605300000000,16,053,"Jerome County, ID",Jan-22,12557,12114,443,3.50000000
CN1605500000000,16,055,"Kootenai County, ID",Jan-22,84055,80287,3768,4.50000000
CN1605700000000,16,057,"Latah County, ID",Jan-22,20459,19851,608,3.00000000
CN1605900000000,16,059,"Lemhi County, ID",Jan-22,3515,3310,205,5.80000000
CN1606100000000,16,061,"Lewis County, ID",Jan-22,1564,1480,84,5.40000000
CN1606300000000,16,063,"Lincoln County, ID",Jan-22,2723,2577,146,5.40000000
CN1606500000000,16,065,"Madison County, ID",Jan-22,23589,23091,498,2.10000000
CN1606700000000,16,067,"Minidoka County, ID",Jan-22,11646,11265,381,3.30000000
CN1606900000000,16,069,"Nez Perce County, ID",Jan-22,21147,20441,706,3.30000000
CN1607100000000,16,071,"Oneida County, ID",Jan-22,2692,2605,87,3.20000000
CN1607300000000,16,073,"Owyhee County, ID",Jan-22,5527,5274,253,4.60000000
CN1607500000000,16,075,"Payette County, ID",Jan-22,12026,11560,466,3.90000000
CN1607700000000,16,077,"Power County, ID",Jan-22,3938,3754,184,4.70000000
CN1607900000000,16,079,"Shoshone County, ID",Jan-22,5627,5276,351,6.20000000
CN1608100000000,16,081,"Teton County, ID",Jan-22,6816,6651,165,2.40000000
CN1608300000000,16,083,"Twin Falls County, ID",Jan-22,42866,41433,1433,3.30000000
CN1608500000000,16,085,"Valley County, ID",Jan-22,5795,5494,301,5.20000000
CN1608700000000,16,087,"Washington County, ID",Jan-22,4804,4598,206,4.30000000
CN1700100000000,17,001,"Adams County, IL",Jan-22,30324,29194,1130,3.70000000
CN1700300000000,17,003,"Alexander County, IL",Jan-22,1832,1688,144,7.90000000
CN1700500000000,17,005,"Bond County, IL",Jan-22,7358,7025,333,4.50000000
CN1700700000000,17,007,"Boone County, IL",Jan-22,25665,23184,2481,9.70000000
CN1700900000000,17,009,"Brown County, IL",Jan-22,3069,2995,74,2.40000000
CN1701100000000,17,011,"Bureau County, IL",Jan-22,15845,14932,913,5.80000000
CN1701300000000,17,013,"Calhoun County, IL",Jan-22,2146,2041,105,4.90000000
CN1701500000000,17,015,"Carroll County, IL",Jan-22,7293,6940,353,4.80000000
CN1701700000000,17,017,"Cass County, IL",Jan-22,5568,5282,286,5.10000000
CN1701900000000,17,019,"Champaign County, IL",Jan-22,109206,104581,4625,4.20000000
CN1702100000000,17,021,"Christian County, IL",Jan-22,13194,12464,730,5.50000000
CN1702300000000,17,023,"Clark County, IL",Jan-22,7005,6645,360,5.10000000
CN1702500000000,17,025,"Clay County, IL",Jan-22,5770,5442,328,5.70000000
CN1702700000000,17,027,"Clinton County, IL",Jan-22,19657,18978,679,3.50000000
CN1702900000000,17,029,"Coles County, IL",Jan-22,22709,21648,1061,4.70000000
CN1703100000000,17,031,"Cook County, IL",Jan-22,2659433,2510536,148897,5.60000000
CN1703300000000,17,033,"Crawford County, IL",Jan-22,8599,8168,431,5.00000000
CN1703500000000,17,035,"Cumberland County, IL",Jan-22,5967,5717,250,4.20000000
CN1703700000000,17,037,"DeKalb County, IL",Jan-22,53561,50616,2945,5.50000000
CN1703900000000,17,039,"De Witt County, IL",Jan-22,7176,6832,344,4.80000000
CN1704100000000,17,041,"Douglas County, IL",Jan-22,10012,9638,374,3.70000000
CN1704300000000,17,043,"DuPage County, IL",Jan-22,514411,496766,17645,3.40000000
CN1704500000000,17,045,"Edgar County, IL",Jan-22,8915,8559,356,4.00000000
CN1704700000000,17,047,"Edwards County, IL",Jan-22,2478,2363,115,4.60000000
CN1704900000000,17,049,"Effingham County, IL",Jan-22,19681,18960,721,3.70000000
CN1705100000000,17,051,"Fayette County, IL",Jan-22,9590,9082,508,5.30000000
CN1705300000000,17,053,"Ford County, IL",Jan-22,6161,5871,290,4.70000000
CN1705500000000,17,055,"Franklin County, IL",Jan-22,15614,14642,972,6.20000000
CN1705700000000,17,057,"Fulton County, IL",Jan-22,14191,13289,902,6.40000000
CN1705900000000,17,059,"Gallatin County, IL",Jan-22,1959,1852,107,5.50000000
CN1706100000000,17,061,"Greene County, IL",Jan-22,5667,5401,266,4.70000000
CN1706300000000,17,063,"Grundy County, IL",Jan-22,26061,24723,1338,5.10000000
CN1706500000000,17,065,"Hamilton County, IL",Jan-22,4157,3983,174,4.20000000
CN1706700000000,17,067,"Hancock County, IL",Jan-22,7944,7583,361,4.50000000
CN1706900000000,17,069,"Hardin County, IL",Jan-22,1316,1229,87,6.60000000
CN1707100000000,17,071,"Henderson County, IL",Jan-22,3480,3299,181,5.20000000
CN1707300000000,17,073,"Henry County, IL",Jan-22,23653,22445,1208,5.10000000
CN1707500000000,17,075,"Iroquois County, IL",Jan-22,12415,11707,708,5.70000000
CN1707700000000,17,077,"Jackson County, IL",Jan-22,27120,25794,1326,4.90000000
CN1707900000000,17,079,"Jasper County, IL",Jan-22,4625,4417,208,4.50000000
CN1708100000000,17,081,"Jefferson County, IL",Jan-22,16341,15409,932,5.70000000
CN1708300000000,17,083,"Jersey County, IL",Jan-22,10509,10063,446,4.20000000
CN1708500000000,17,085,"Jo Daviess County, IL",Jan-22,10195,9679,516,5.10000000
CN1708700000000,17,087,"Johnson County, IL",Jan-22,4092,3833,259,6.30000000
CN1708900000000,17,089,"Kane County, IL",Jan-22,264013,248315,15698,5.90000000
CN1709100000000,17,091,"Kankakee County, IL",Jan-22,52436,48843,3593,6.90000000
CN1709300000000,17,093,"Kendall County, IL",Jan-22,71902,69108,2794,3.90000000
CN1709500000000,17,095,"Knox County, IL",Jan-22,19960,18623,1337,6.70000000
CN1709700000000,17,097,"Lake County, IL",Jan-22,367615,347528,20087,5.50000000
CN1709900000000,17,099,"LaSalle County, IL",Jan-22,52680,49301,3379,6.40000000
CN1710100000000,17,101,"Lawrence County, IL",Jan-22,5577,5235,342,6.10000000
CN1710300000000,17,103,"Lee County, IL",Jan-22,16659,15887,772,4.60000000
CN1710500000000,17,105,"Livingston County, IL",Jan-22,15108,14350,758,5.00000000
CN1710700000000,17,107,"Logan County, IL",Jan-22,11631,11080,551,4.70000000
CN1710900000000,17,109,"McDonough County, IL",Jan-22,12579,12013,566,4.50000000
CN1711100000000,17,111,"McHenry County, IL",Jan-22,168203,161553,6650,4.00000000
CN1711300000000,17,113,"McLean County, IL",Jan-22,87321,83779,3542,4.10000000
CN1711500000000,17,115,"Macon County, IL",Jan-22,46615,43145,3470,7.40000000
CN1711700000000,17,117,"Macoupin County, IL",Jan-22,21875,20887,988,4.50000000
CN1711900000000,17,119,"Madison County, IL",Jan-22,130484,124792,5692,4.40000000
CN1712100000000,17,121,"Marion County, IL",Jan-22,16515,15606,909,5.50000000
CN1712300000000,17,123,"Marshall County, IL",Jan-22,5019,4716,303,6.00000000
CN1712500000000,17,125,"Mason County, IL",Jan-22,5730,5397,333,5.80000000
CN1712700000000,17,127,"Massac County, IL",Jan-22,5290,5023,267,5.00000000
CN1712900000000,17,129,"Menard County, IL",Jan-22,6214,5948,266,4.30000000
CN1713100000000,17,131,"Mercer County, IL",Jan-22,7584,7128,456,6.00000000
CN1713300000000,17,133,"Monroe County, IL",Jan-22,18454,17916,538,2.90000000
CN1713500000000,17,135,"Montgomery County, IL",Jan-22,10982,10370,612,5.60000000
CN1713700000000,17,137,"Morgan County, IL",Jan-22,15438,14666,772,5.00000000
CN1713900000000,17,139,"Moultrie County, IL",Jan-22,7290,7037,253,3.50000000
CN1714100000000,17,141,"Ogle County, IL",Jan-22,23533,21983,1550,6.60000000
CN1714300000000,17,143,"Peoria County, IL",Jan-22,82372,76536,5836,7.10000000
CN1714500000000,17,145,"Perry County, IL",Jan-22,7897,7462,435,5.50000000
CN1714700000000,17,147,"Piatt County, IL",Jan-22,8509,8166,343,4.00000000
CN1714900000000,17,149,"Pike County, IL",Jan-22,6499,6169,330,5.10000000
CN1715100000000,17,151,"Pope County, IL",Jan-22,1654,1572,82,5.00000000
CN1715300000000,17,153,"Pulaski County, IL",Jan-22,1673,1524,149,8.90000000
CN1715500000000,17,155,"Putnam County, IL",Jan-22,2894,2710,184,6.40000000
CN1715700000000,17,157,"Randolph County, IL",Jan-22,13557,13015,542,4.00000000
CN1715900000000,17,159,"Richland County, IL",Jan-22,6979,6695,284,4.10000000
CN1716100000000,17,161,"Rock Island County, IL",Jan-22,68051,64307,3744,5.50000000
CN1716300000000,17,163,"St. Clair County, IL",Jan-22,123360,116606,6754,5.50000000
CN1716500000000,17,165,"Saline County, IL",Jan-22,9118,8564,554,6.10000000
CN1716700000000,17,167,"Sangamon County, IL",Jan-22,98983,93909,5074,5.10000000
CN1716900000000,17,169,"Schuyler County, IL",Jan-22,3129,2973,156,5.00000000
CN1717100000000,17,171,"Scott County, IL",Jan-22,2249,2097,152,6.80000000
CN1717300000000,17,173,"Shelby County, IL",Jan-22,10158,9718,440,4.30000000
CN1717500000000,17,175,"Stark County, IL",Jan-22,2327,2175,152,6.50000000
CN1717700000000,17,177,"Stephenson County, IL",Jan-22,20191,19024,1167,5.80000000
CN1717900000000,17,179,"Tazewell County, IL",Jan-22,61042,57998,3044,5.00000000
CN1718100000000,17,181,"Union County, IL",Jan-22,7125,6679,446,6.30000000
CN1718300000000,17,183,"Vermilion County, IL",Jan-22,31589,29601,1988,6.30000000
CN1718500000000,17,185,"Wabash County, IL",Jan-22,5367,5149,218,4.10000000
CN1718700000000,17,187,"Warren County, IL",Jan-22,7437,7095,342,4.60000000
CN1718900000000,17,189,"Washington County, IL",Jan-22,9547,9274,273,2.90000000
CN1719100000000,17,191,"Wayne County, IL",Jan-22,6633,6317,316,4.80000000
CN1719300000000,17,193,"White County, IL",Jan-22,5905,5626,279,4.70000000
CN1719500000000,17,195,"Whiteside County, IL",Jan-22,27210,25913,1297,4.80000000
CN1719700000000,17,197,"Will County, IL",Jan-22,366499,348748,17751,4.80000000
CN1719900000000,17,199,"Williamson County, IL",Jan-22,31202,29556,1646,5.30000000
CN1720100000000,17,201,"Winnebago County, IL",Jan-22,135823,124285,11538,8.50000000
CN1720300000000,17,203,"Woodford County, IL",Jan-22,17881,17142,739,4.10000000
CN1800100000000,18,001,"Adams County, IN",Jan-22,16645,16370,275,1.70000000
CN1800300000000,18,003,"Allen County, IN",Jan-22,183925,179701,4224,2.30000000
CN1800500000000,18,005,"Bartholomew County, IN",Jan-22,42707,41888,819,1.90000000
CN1800700000000,18,007,"Benton County, IN",Jan-22,4290,4205,85,2.00000000
CN1800900000000,18,009,"Blackford County, IN",Jan-22,4579,4465,114,2.50000000
CN1801100000000,18,011,"Boone County, IN",Jan-22,37222,36669,553,1.50000000
CN1801300000000,18,013,"Brown County, IN",Jan-22,7645,7467,178,2.30000000
CN1801500000000,18,015,"Carroll County, IN",Jan-22,9647,9439,208,2.20000000
CN1801700000000,18,017,"Cass County, IN",Jan-22,16840,16390,450,2.70000000
CN1801900000000,18,019,"Clark County, IN",Jan-22,61051,59699,1352,2.20000000
CN1802100000000,18,021,"Clay County, IN",Jan-22,11455,11185,270,2.40000000
CN1802300000000,18,023,"Clinton County, IN",Jan-22,16612,16287,325,2.00000000
CN1802500000000,18,025,"Crawford County, IN",Jan-22,4689,4540,149,3.20000000
CN1802700000000,18,027,"Daviess County, IN",Jan-22,16324,16043,281,1.70000000
CN1802900000000,18,029,"Dearborn County, IN",Jan-22,24989,24433,556,2.20000000
CN1803100000000,18,031,"Decatur County, IN",Jan-22,14799,14492,307,2.10000000
CN1803300000000,18,033,"DeKalb County, IN",Jan-22,21947,21541,406,1.80000000
CN1803500000000,18,035,"Delaware County, IN",Jan-22,51692,50309,1383,2.70000000
CN1803700000000,18,037,"Dubois County, IN",Jan-22,21720,21380,340,1.60000000
CN1803900000000,18,039,"Elkhart County, IN",Jan-22,118014,116157,1857,1.60000000
CN1804100000000,18,041,"Fayette County, IN",Jan-22,8229,7961,268,3.30000000
CN1804300000000,18,043,"Floyd County, IN",Jan-22,41092,40314,778,1.90000000
CN1804500000000,18,045,"Fountain County, IN",Jan-22,7547,7391,156,2.10000000
CN1804700000000,18,047,"Franklin County, IN",Jan-22,10974,10736,238,2.20000000
CN1804900000000,18,049,"Fulton County, IN",Jan-22,9210,8973,237,2.60000000
CN1805100000000,18,051,"Gibson County, IN",Jan-22,18933,18605,328,1.70000000
CN1805300000000,18,053,"Grant County, IN",Jan-22,29524,28742,782,2.60000000
CN1805500000000,18,055,"Greene County, IN",Jan-22,13461,13114,347,2.60000000
CN1805700000000,18,057,"Hamilton County, IN",Jan-22,189826,186961,2865,1.50000000
CN1805900000000,18,059,"Hancock County, IN",Jan-22,41562,40794,768,1.80000000
CN1806100000000,18,061,"Harrison County, IN",Jan-22,19915,19532,383,1.90000000
CN1806300000000,18,063,"Hendricks County, IN",Jan-22,92406,90832,1574,1.70000000
CN1806500000000,18,065,"Henry County, IN",Jan-22,21465,20954,511,2.40000000
CN1806700000000,18,067,"Howard County, IN",Jan-22,33159,31808,1351,4.10000000
CN1806900000000,18,069,"Huntington County, IN",Jan-22,17663,17310,353,2.00000000
CN1807100000000,18,071,"Jackson County, IN",Jan-22,23113,22665,448,1.90000000
CN1807300000000,18,073,"Jasper County, IN",Jan-22,15441,15027,414,2.70000000
CN1807500000000,18,075,"Jay County, IN",Jan-22,8658,8482,176,2.00000000
CN1807700000000,18,077,"Jefferson County, IN",Jan-22,14835,14531,304,2.00000000
CN1807900000000,18,079,"Jennings County, IN",Jan-22,13183,12842,341,2.60000000
CN1808100000000,18,081,"Johnson County, IN",Jan-22,84489,83023,1466,1.70000000
CN1808300000000,18,083,"Knox County, IN",Jan-22,17913,17559,354,2.00000000
CN1808500000000,18,085,"Kosciusko County, IN",Jan-22,39797,39069,728,1.80000000
CN1808700000000,18,087,"LaGrange County, IN",Jan-22,20534,20253,281,1.40000000
CN1808900000000,18,089,"Lake County, IN",Jan-22,220543,211236,9307,4.20000000
CN1809100000000,18,091,"LaPorte County, IN",Jan-22,45813,44268,1545,3.40000000
CN1809300000000,18,093,"Lawrence County, IN",Jan-22,20555,20034,521,2.50000000
CN1809500000000,18,095,"Madison County, IN",Jan-22,58596,57016,1580,2.70000000
CN1809700000000,18,097,"Marion County, IN",Jan-22,494326,480845,13481,2.70000000
CN1809900000000,18,099,"Marshall County, IN",Jan-22,22213,21800,413,1.90000000
CN1810100000000,18,101,"Martin County, IN",Jan-22,5391,5296,95,1.80000000
CN1810300000000,18,103,"Miami County, IN",Jan-22,14256,13824,432,3.00000000
CN1810500000000,18,105,"Monroe County, IN",Jan-22,70365,68968,1397,2.00000000
CN1810700000000,18,107,"Montgomery County, IN",Jan-22,18174,17827,347,1.90000000
CN1810900000000,18,109,"Morgan County, IN",Jan-22,36370,35595,775,2.10000000
CN1811100000000,18,111,"Newton County, IN",Jan-22,6561,6366,195,3.00000000
CN1811300000000,18,113,"Noble County, IN",Jan-22,21611,21147,464,2.10000000
CN1811500000000,18,115,"Ohio County, IN",Jan-22,3089,3030,59,1.90000000
CN1811700000000,18,117,"Orange County, IN",Jan-22,8286,8050,236,2.80000000
CN1811900000000,18,119,"Owen County, IN",Jan-22,9313,9075,238,2.60000000
CN1812100000000,18,121,"Parke County, IN",Jan-22,6806,6644,162,2.40000000
CN1812300000000,18,123,"Perry County, IN",Jan-22,8569,8369,200,2.30000000
CN1812500000000,18,125,"Pike County, IN",Jan-22,5620,5492,128,2.30000000
CN1812700000000,18,127,"Porter County, IN",Jan-22,82905,80715,2190,2.60000000
CN1812900000000,18,129,"Posey County, IN",Jan-22,12823,12582,241,1.90000000
CN1813100000000,18,131,"Pulaski County, IN",Jan-22,6277,6133,144,2.30000000
CN1813300000000,18,133,"Putnam County, IN",Jan-22,16415,16077,338,2.10000000
CN1813500000000,18,135,"Randolph County, IN",Jan-22,12200,11940,260,2.10000000
CN1813700000000,18,137,"Ripley County, IN",Jan-22,13235,12932,303,2.30000000
CN1813900000000,18,139,"Rush County, IN",Jan-22,8779,8607,172,2.00000000
CN1814100000000,18,141,"St. Joseph County, IN",Jan-22,129150,125734,3416,2.60000000
CN1814300000000,18,143,"Scott County, IN",Jan-22,10256,9988,268,2.60000000
CN1814500000000,18,145,"Shelby County, IN",Jan-22,23118,22640,478,2.10000000
CN1814700000000,18,147,"Spencer County, IN",Jan-22,9922,9709,213,2.10000000
CN1814900000000,18,149,"Starke County, IN",Jan-22,9268,8965,303,3.30000000
CN1815100000000,18,151,"Steuben County, IN",Jan-22,19569,19234,335,1.70000000
CN1815300000000,18,153,"Sullivan County, IN",Jan-22,7884,7643,241,3.10000000
CN1815500000000,18,155,"Switzerland County, IN",Jan-22,4584,4475,109,2.40000000
CN1815700000000,18,157,"Tippecanoe County, IN",Jan-22,93925,91907,2018,2.10000000
CN1815900000000,18,159,"Tipton County, IN",Jan-22,8829,8639,190,2.20000000
CN1816100000000,18,161,"Union County, IN",Jan-22,3456,3392,64,1.90000000
CN1816300000000,18,163,"Vanderburgh County, IN",Jan-22,90751,88555,2196,2.40000000
CN1816500000000,18,165,"Vermillion County, IN",Jan-22,6498,6302,196,3.00000000
CN1816700000000,18,167,"Vigo County, IN",Jan-22,45302,43938,1364,3.00000000
CN1816900000000,18,169,"Wabash County, IN",Jan-22,14098,13796,302,2.10000000
CN1817100000000,18,171,"Warren County, IN",Jan-22,3975,3905,70,1.80000000
CN1817300000000,18,173,"Warrick County, IN",Jan-22,31773,31175,598,1.90000000
CN1817500000000,18,175,"Washington County, IN",Jan-22,13474,13180,294,2.20000000
CN1817700000000,18,177,"Wayne County, IN",Jan-22,28838,28112,726,2.50000000
CN1817900000000,18,179,"Wells County, IN",Jan-22,13972,13722,250,1.80000000
CN1818100000000,18,181,"White County, IN",Jan-22,12919,12666,253,2.00000000
CN1818300000000,18,183,"Whitley County, IN",Jan-22,17363,17049,314,1.80000000
CN1900100000000,19,001,"Adair County, IA",Jan-22,4452,4300,152,3.40000000
CN1900300000000,19,003,"Adams County, IA",Jan-22,2063,2004,59,2.90000000
CN1900500000000,19,005,"Allamakee County, IA",Jan-22,7277,6759,518,7.10000000
CN1900700000000,19,007,"Appanoose County, IA",Jan-22,6120,5851,269,4.40000000
CN1900900000000,19,009,"Audubon County, IA",Jan-22,3154,3031,123,3.90000000
CN1901100000000,19,011,"Benton County, IA",Jan-22,13079,12416,663,5.10000000
CN1901300000000,19,013,"Black Hawk County, IA",Jan-22,67443,64308,3135,4.60000000
CN1901500000000,19,015,"Boone County, IA",Jan-22,14634,14111,523,3.60000000
CN1901700000000,19,017,"Bremer County, IA",Jan-22,13949,13444,505,3.60000000
CN1901900000000,19,019,"Buchanan County, IA",Jan-22,11342,10819,523,4.60000000
CN1902100000000,19,021,"Buena Vista County, IA",Jan-22,12099,11762,337,2.80000000
CN1902300000000,19,023,"Butler County, IA",Jan-22,8083,7676,407,5.00000000
CN1902500000000,19,025,"Calhoun County, IA",Jan-22,4104,3935,169,4.10000000
CN1902700000000,19,027,"Carroll County, IA",Jan-22,10810,10485,325,3.00000000
CN1902900000000,19,029,"Cass County, IA",Jan-22,6918,6620,298,4.30000000
CN1903100000000,19,031,"Cedar County, IA",Jan-22,10617,10158,459,4.30000000
CN1903300000000,19,033,"Cerro Gordo County, IA",Jan-22,22420,21465,955,4.30000000
CN1903500000000,19,035,"Cherokee County, IA",Jan-22,6199,5985,214,3.50000000
CN1903700000000,19,037,"Chickasaw County, IA",Jan-22,6538,6257,281,4.30000000
CN1903900000000,19,039,"Clarke County, IA",Jan-22,4973,4718,255,5.10000000
CN1904100000000,19,041,"Clay County, IA",Jan-22,8664,8295,369,4.30000000
CN1904300000000,19,043,"Clayton County, IA",Jan-22,9855,9049,806,8.20000000
CN1904500000000,19,045,"Clinton County, IA",Jan-22,22163,20938,1225,5.50000000
CN1904700000000,19,047,"Crawford County, IA",Jan-22,8245,7666,579,7.00000000
CN1904900000000,19,049,"Dallas County, IA",Jan-22,52686,51170,1516,2.90000000
CN1905100000000,19,051,"Davis County, IA",Jan-22,4297,4153,144,3.40000000
CN1905300000000,19,053,"Decatur County, IA",Jan-22,4452,4298,154,3.50000000
CN1905500000000,19,055,"Delaware County, IA",Jan-22,10782,10355,427,4.00000000
CN1905700000000,19,057,"Des Moines County, IA",Jan-22,18346,17172,1174,6.40000000
CN1905900000000,19,059,"Dickinson County, IA",Jan-22,9941,9397,544,5.50000000
CN1906100000000,19,061,"Dubuque County, IA",Jan-22,55864,53195,2669,4.80000000
CN1906300000000,19,063,"Emmet County, IA",Jan-22,4969,4732,237,4.80000000
CN1906500000000,19,065,"Fayette County, IA",Jan-22,10414,9800,614,5.90000000
CN1906700000000,19,067,"Floyd County, IA",Jan-22,8398,8000,398,4.70000000
CN1906900000000,19,069,"Franklin County, IA",Jan-22,5677,5434,243,4.30000000
CN1907100000000,19,071,"Fremont County, IA",Jan-22,3743,3623,120,3.20000000
CN1907300000000,19,073,"Greene County, IA",Jan-22,5419,5250,169,3.10000000
CN1907500000000,19,075,"Grundy County, IA",Jan-22,6476,6196,280,4.30000000
CN1907700000000,19,077,"Guthrie County, IA",Jan-22,5678,5401,277,4.90000000
CN1907900000000,19,079,"Hamilton County, IA",Jan-22,6944,6666,278,4.00000000
CN1908100000000,19,081,"Hancock County, IA",Jan-22,5811,5613,198,3.40000000
CN1908300000000,19,083,"Hardin County, IA",Jan-22,8004,7616,388,4.80000000
CN1908500000000,19,085,"Harrison County, IA",Jan-22,7188,6892,296,4.10000000
CN1908700000000,19,087,"Henry County, IA",Jan-22,9601,9218,383,4.00000000
CN1908900000000,19,089,"Howard County, IA",Jan-22,5371,5075,296,5.50000000
CN1909100000000,19,091,"Humboldt County, IA",Jan-22,5023,4822,201,4.00000000
CN1909300000000,19,093,"Ida County, IA",Jan-22,4047,3915,132,3.30000000
CN1909500000000,19,095,"Iowa County, IA",Jan-22,10186,9748,438,4.30000000
CN1909700000000,19,097,"Jackson County, IA",Jan-22,10811,10166,645,6.00000000
CN1909900000000,19,099,"Jasper County, IA",Jan-22,18859,17877,982,5.20000000
CN1910100000000,19,101,"Jefferson County, IA",Jan-22,10024,9638,386,3.90000000
CN1910300000000,19,103,"Johnson County, IA",Jan-22,85783,83001,2782,3.20000000
CN1910500000000,19,105,"Jones County, IA",Jan-22,10488,9874,614,5.90000000
CN1910700000000,19,107,"Keokuk County, IA",Jan-22,5255,4978,277,5.30000000
CN1910900000000,19,109,"Kossuth County, IA",Jan-22,8262,7969,293,3.50000000
CN1911100000000,19,111,"Lee County, IA",Jan-22,15413,14521,892,5.80000000
CN1911300000000,19,113,"Linn County, IA",Jan-22,119221,113489,5732,4.80000000
CN1911500000000,19,115,"Louisa County, IA",Jan-22,5944,5628,316,5.30000000
CN1911700000000,19,117,"Lucas County, IA",Jan-22,4756,4610,146,3.10000000
CN1911900000000,19,119,"Lyon County, IA",Jan-22,7089,6893,196,2.80000000
CN1912100000000,19,121,"Madison County, IA",Jan-22,8758,8265,493,5.60000000
CN1912300000000,19,123,"Mahaska County, IA",Jan-22,12096,11643,453,3.70000000
CN1912500000000,19,125,"Marion County, IA",Jan-22,18698,18084,614,3.30000000
CN1912700000000,19,127,"Marshall County, IA",Jan-22,18065,16168,1897,10.50000000
CN1912900000000,19,129,"Mills County, IA",Jan-22,7111,6863,248,3.50000000
CN1913100000000,19,131,"Mitchell County, IA",Jan-22,5825,5650,175,3.00000000
CN1913300000000,19,133,"Monona County, IA",Jan-22,4500,4277,223,5.00000000
CN1913500000000,19,135,"Monroe County, IA",Jan-22,3971,3790,181,4.60000000
CN1913700000000,19,137,"Montgomery County, IA",Jan-22,5018,4836,182,3.60000000
CN1913900000000,19,139,"Muscatine County, IA",Jan-22,20694,19688,1006,4.90000000
CN1914100000000,19,141,"O'Brien County, IA",Jan-22,8268,7991,277,3.40000000
CN1914300000000,19,143,"Osceola County, IA",Jan-22,3660,3569,91,2.50000000
CN1914500000000,19,145,"Page County, IA",Jan-22,6372,6136,236,3.70000000
CN1914700000000,19,147,"Palo Alto County, IA",Jan-22,4520,4368,152,3.40000000
CN1914900000000,19,149,"Plymouth County, IA",Jan-22,14683,14244,439,3.00000000
CN1915100000000,19,151,"Pocahontas County, IA",Jan-22,4365,4234,131,3.00000000
CN1915300000000,19,153,"Polk County, IA",Jan-22,271464,259587,11877,4.40000000
CN1915500000000,19,155,"Pottawattamie County, IA",Jan-22,47703,45613,2090,4.40000000
CN1915700000000,19,157,"Poweshiek County, IA",Jan-22,9613,9113,500,5.20000000
CN1915900000000,19,159,"Ringgold County, IA",Jan-22,2432,2359,73,3.00000000
CN1916100000000,19,161,"Sac County, IA",Jan-22,5347,5130,217,4.10000000
CN1916300000000,19,163,"Scott County, IA",Jan-22,88077,83612,4465,5.10000000
CN1916500000000,19,165,"Shelby County, IA",Jan-22,6350,6146,204,3.20000000
CN1916700000000,19,167,"Sioux County, IA",Jan-22,22660,21956,704,3.10000000
CN1916900000000,19,169,"Story County, IA",Jan-22,57851,56275,1576,2.70000000
CN1917100000000,19,171,"Tama County, IA",Jan-22,9449,8858,591,6.30000000
CN1917300000000,19,173,"Taylor County, IA",Jan-22,3182,3097,85,2.70000000
CN1917500000000,19,175,"Union County, IA",Jan-22,6290,5998,292,4.60000000
CN1917700000000,19,177,"Van Buren County, IA",Jan-22,3719,3562,157,4.20000000
CN1917900000000,19,179,"Wapello County, IA",Jan-22,17012,16206,806,4.70000000
CN1918100000000,19,181,"Warren County, IA",Jan-22,28777,27664,1113,3.90000000
CN1918300000000,19,183,"Washington County, IA",Jan-22,11884,11346,538,4.50000000
CN1918500000000,19,185,"Wayne County, IA",Jan-22,2902,2793,109,3.80000000
CN1918700000000,19,187,"Webster County, IA",Jan-22,18466,17609,857,4.60000000
CN1918900000000,19,189,"Winnebago County, IA",Jan-22,4931,4739,192,3.90000000
CN1919100000000,19,191,"Winneshiek County, IA",Jan-22,11425,10709,716,6.30000000
CN1919300000000,19,193,"Woodbury County, IA",Jan-22,55238,52883,2355,4.30000000
CN1919500000000,19,195,"Worth County, IA",Jan-22,4072,3884,188,4.60000000
CN1919700000000,19,197,"Wright County, IA",Jan-22,6772,6488,284,4.20000000
CN2000100000000,20,001,"Allen County, KS",Jan-22,6534,6360,174,2.70000000
CN2000300000000,20,003,"Anderson County, KS",Jan-22,4658,4565,93,2.00000000
CN2000500000000,20,005,"Atchison County, KS",Jan-22,6685,6458,227,3.40000000
CN2000700000000,20,007,"Barber County, KS",Jan-22,2249,2211,38,1.70000000
CN2000900000000,20,009,"Barton County, KS",Jan-22,13145,12802,343,2.60000000
CN2001100000000,20,011,"Bourbon County, KS",Jan-22,6366,6142,224,3.50000000
CN2001300000000,20,013,"Brown County, KS",Jan-22,5042,4933,109,2.20000000
CN2001500000000,20,015,"Butler County, KS",Jan-22,32622,31711,911,2.80000000
CN2001700000000,20,017,"Chase County, KS",Jan-22,1337,1309,28,2.10000000
CN2001900000000,20,019,"Chautauqua County, KS",Jan-22,1390,1356,34,2.40000000
CN2002100000000,20,021,"Cherokee County, KS",Jan-22,9859,9626,233,2.40000000
CN2002300000000,20,023,"Cheyenne County, KS",Jan-22,1289,1267,22,1.70000000
CN2002500000000,20,025,"Clark County, KS",Jan-22,1150,1133,17,1.50000000
CN2002700000000,20,027,"Clay County, KS",Jan-22,3749,3665,84,2.20000000
CN2002900000000,20,029,"Cloud County, KS",Jan-22,3884,3790,94,2.40000000
CN2003100000000,20,031,"Coffey County, KS",Jan-22,3803,3686,117,3.10000000
CN2003300000000,20,033,"Comanche County, KS",Jan-22,867,851,16,1.80000000
CN2003500000000,20,035,"Cowley County, KS",Jan-22,16420,15977,443,2.70000000
CN2003700000000,20,037,"Crawford County, KS",Jan-22,18844,18314,530,2.80000000
CN2003900000000,20,039,"Decatur County, KS",Jan-22,1164,1139,25,2.10000000
CN2004100000000,20,041,"Dickinson County, KS",Jan-22,9027,8785,242,2.70000000
CN2004300000000,20,043,"Doniphan County, KS",Jan-22,4142,4048,94,2.30000000
CN2004500000000,20,045,"Douglas County, KS",Jan-22,65930,64269,1661,2.50000000
CN2004700000000,20,047,"Edwards County, KS",Jan-22,1447,1419,28,1.90000000
CN2004900000000,20,049,"Elk County, KS",Jan-22,1180,1150,30,2.50000000
CN2005100000000,20,051,"Ellis County, KS",Jan-22,16904,16621,283,1.70000000
CN2005300000000,20,053,"Ellsworth County, KS",Jan-22,2712,2657,55,2.00000000
CN2005500000000,20,055,"Finney County, KS",Jan-22,20236,19869,367,1.80000000
CN2005700000000,20,057,"Ford County, KS",Jan-22,17555,17246,309,1.80000000
CN2005900000000,20,059,"Franklin County, KS",Jan-22,14533,14169,364,2.50000000
CN2006100000000,20,061,"Geary County, KS",Jan-22,11330,10951,379,3.30000000
CN2006300000000,20,063,"Gove County, KS",Jan-22,1482,1453,29,2.00000000
CN2006500000000,20,065,"Graham County, KS",Jan-22,1109,1088,21,1.90000000
CN2006700000000,20,067,"Grant County, KS",Jan-22,2857,2786,71,2.50000000
CN2006900000000,20,069,"Gray County, KS",Jan-22,3199,3156,43,1.30000000
CN2007100000000,20,071,"Greeley County, KS",Jan-22,819,810,9,1.10000000
CN2007300000000,20,073,"Greenwood County, KS",Jan-22,2934,2862,72,2.50000000
CN2007500000000,20,075,"Hamilton County, KS",Jan-22,1612,1592,20,1.20000000
CN2007700000000,20,077,"Harper County, KS",Jan-22,2809,2754,55,2.00000000
CN2007900000000,20,079,"Harvey County, KS",Jan-22,17016,16623,393,2.30000000
CN2008100000000,20,081,"Haskell County, KS",Jan-22,2225,2194,31,1.40000000
CN2008300000000,20,083,"Hodgeman County, KS",Jan-22,1025,1009,16,1.60000000
CN2008500000000,20,085,"Jackson County, KS",Jan-22,7175,6982,193,2.70000000
CN2008700000000,20,087,"Jefferson County, KS",Jan-22,10220,9925,295,2.90000000
CN2008900000000,20,089,"Jewell County, KS",Jan-22,1205,1183,22,1.80000000
CN2009100000000,20,091,"Johnson County, KS",Jan-22,344884,337361,7523,2.20000000
CN2009300000000,20,093,"Kearny County, KS",Jan-22,2060,2030,30,1.50000000
CN2009500000000,20,095,"Kingman County, KS",Jan-22,3280,3209,71,2.20000000
CN2009700000000,20,097,"Kiowa County, KS",Jan-22,1205,1184,21,1.70000000
CN2009900000000,20,099,"Labette County, KS",Jan-22,9212,8956,256,2.80000000
CN2010100000000,20,101,"Lane County, KS",Jan-22,726,712,14,1.90000000
CN2010300000000,20,103,"Leavenworth County, KS",Jan-22,37018,35933,1085,2.90000000
CN2010500000000,20,105,"Lincoln County, KS",Jan-22,1695,1662,33,1.90000000
CN2010700000000,20,107,"Linn County, KS",Jan-22,4357,4172,185,4.20000000
CN2010900000000,20,109,"Logan County, KS",Jan-22,1610,1590,20,1.20000000
CN2011100000000,20,111,"Lyon County, KS",Jan-22,16965,16544,421,2.50000000
CN2011300000000,20,113,"McPherson County, KS",Jan-22,17104,16824,280,1.60000000
CN2011500000000,20,115,"Marion County, KS",Jan-22,5959,5831,128,2.10000000
CN2011700000000,20,117,"Marshall County, KS",Jan-22,5346,5252,94,1.80000000
CN2011900000000,20,119,"Meade County, KS",Jan-22,2141,2106,35,1.60000000
CN2012100000000,20,121,"Miami County, KS",Jan-22,17843,17371,472,2.60000000
CN2012300000000,20,123,"Mitchell County, KS",Jan-22,3422,3366,56,1.60000000
CN2012500000000,20,125,"Montgomery County, KS",Jan-22,14466,14023,443,3.10000000
CN2012700000000,20,127,"Morris County, KS",Jan-22,3010,2952,58,1.90000000
CN2012900000000,20,129,"Morton County, KS",Jan-22,1107,1076,31,2.80000000
CN2013100000000,20,131,"Nemaha County, KS",Jan-22,5530,5447,83,1.50000000
CN2013300000000,20,133,"Neosho County, KS",Jan-22,5989,5790,199,3.30000000
CN2013500000000,20,135,"Ness County, KS",Jan-22,1317,1296,21,1.60000000
CN2013700000000,20,137,"Norton County, KS",Jan-22,2649,2611,38,1.40000000
CN2013900000000,20,139,"Osage County, KS",Jan-22,7893,7678,215,2.70000000
CN2014100000000,20,141,"Osborne County, KS",Jan-22,1936,1905,31,1.60000000
CN2014300000000,20,143,"Ottawa County, KS",Jan-22,2929,2866,63,2.20000000
CN2014500000000,20,145,"Pawnee County, KS",Jan-22,2799,2735,64,2.30000000
CN2014700000000,20,147,"Phillips County, KS",Jan-22,2633,2582,51,1.90000000
CN2014900000000,20,149,"Pottawatomie County, KS",Jan-22,12298,12002,296,2.40000000
CN2015100000000,20,151,"Pratt County, KS",Jan-22,4908,4823,85,1.70000000
CN2015300000000,20,153,"Rawlins County, KS",Jan-22,1672,1648,24,1.40000000
CN2015500000000,20,155,"Reno County, KS",Jan-22,29349,28582,767,2.60000000
CN2015700000000,20,157,"Republic County, KS",Jan-22,2318,2275,43,1.90000000
CN2015900000000,20,159,"Rice County, KS",Jan-22,5381,5266,115,2.10000000
CN2016100000000,20,161,"Riley County, KS",Jan-22,33869,33009,860,2.50000000
CN2016300000000,20,163,"Rooks County, KS",Jan-22,2389,2334,55,2.30000000
CN2016500000000,20,165,"Rush County, KS",Jan-22,1571,1543,28,1.80000000
CN2016700000000,20,167,"Russell County, KS",Jan-22,3346,3279,67,2.00000000
CN2016900000000,20,169,"Saline County, KS",Jan-22,28881,28117,764,2.60000000
CN2017100000000,20,171,"Scott County, KS",Jan-22,2808,2774,34,1.20000000
CN2017300000000,20,173,"Sedgwick County, KS",Jan-22,255480,246430,9050,3.50000000
CN2017500000000,20,175,"Seward County, KS",Jan-22,9778,9545,233,2.40000000
CN2017700000000,20,177,"Shawnee County, KS",Jan-22,90025,87490,2535,2.80000000
CN2017900000000,20,179,"Sheridan County, KS",Jan-22,1471,1449,22,1.50000000
CN2018100000000,20,181,"Sherman County, KS",Jan-22,2844,2786,58,2.00000000
CN2018300000000,20,183,"Smith County, KS",Jan-22,2007,1978,29,1.40000000
CN2018500000000,20,185,"Stafford County, KS",Jan-22,2010,1976,34,1.70000000
CN2018700000000,20,187,"Stanton County, KS",Jan-22,1166,1146,20,1.70000000
CN2018900000000,20,189,"Stevens County, KS",Jan-22,2946,2899,47,1.60000000
CN2019100000000,20,191,"Sumner County, KS",Jan-22,10760,10432,328,3.00000000
CN2019300000000,20,193,"Thomas County, KS",Jan-22,4262,4196,66,1.50000000
CN2019500000000,20,195,"Trego County, KS",Jan-22,1402,1378,24,1.70000000
CN2019700000000,20,197,"Wabaunsee County, KS",Jan-22,3690,3597,93,2.50000000
CN2019900000000,20,199,"Wallace County, KS",Jan-22,881,869,12,1.40000000
CN2020100000000,20,201,"Washington County, KS",Jan-22,3011,2964,47,1.60000000
CN2020300000000,20,203,"Wichita County, KS",Jan-22,1169,1152,17,1.50000000
CN2020500000000,20,205,"Wilson County, KS",Jan-22,3773,3645,128,3.40000000
CN2020700000000,20,207,"Woodson County, KS",Jan-22,1506,1454,52,3.50000000
CN2020900000000,20,209,"Wyandotte County, KS",Jan-22,77481,74563,2918,3.80000000
CN2100100000000,21,001,"Adair County, KY",Jan-22,7256,6908,348,4.80000000
CN2100300000000,21,003,"Allen County, KY",Jan-22,8950,8580,370,4.10000000
CN2100500000000,21,005,"Anderson County, KY",Jan-22,11825,11393,432,3.70000000
CN2100700000000,21,007,"Ballard County, KY",Jan-22,3459,3284,175,5.10000000
CN2100900000000,21,009,"Barren County, KY",Jan-22,18020,17157,863,4.80000000
CN2101100000000,21,011,"Bath County, KY",Jan-22,4799,4462,337,7.00000000
CN2101300000000,21,013,"Bell County, KY",Jan-22,8177,7738,439,5.40000000
CN2101500000000,21,015,"Boone County, KY",Jan-22,71080,68601,2479,3.50000000
CN2101700000000,21,017,"Bourbon County, KY",Jan-22,9860,9496,364,3.70000000
CN2101900000000,21,019,"Boyd County, KY",Jan-22,17250,16220,1030,6.00000000
CN2102100000000,21,021,"Boyle County, KY",Jan-22,12635,12090,545,4.30000000
CN2102300000000,21,023,"Bracken County, KY",Jan-22,3820,3610,210,5.50000000
CN2102500000000,21,025,"Breathitt County, KY",Jan-22,3343,3022,321,9.60000000
CN2102700000000,21,027,"Breckinridge County, KY",Jan-22,8013,7606,407,5.10000000
CN2102900000000,21,029,"Bullitt County, KY",Jan-22,43196,40941,2255,5.20000000
CN2103100000000,21,031,"Butler County, KY",Jan-22,4965,4738,227,4.60000000
CN2103300000000,21,033,"Caldwell County, KY",Jan-22,6047,5821,226,3.70000000
CN2103500000000,21,035,"Calloway County, KY",Jan-22,17038,16278,760,4.50000000
CN2103700000000,21,037,"Campbell County, KY",Jan-22,50014,48134,1880,3.80000000
CN2103900000000,21,039,"Carlisle County, KY",Jan-22,2241,2150,91,4.10000000
CN2104100000000,21,041,"Carroll County, KY",Jan-22,5428,5218,210,3.90000000
CN2104300000000,21,043,"Carter County, KY",Jan-22,9863,8981,882,8.90000000
CN2104500000000,21,045,"Casey County, KY",Jan-22,6813,6538,275,4.00000000
CN2104700000000,21,047,"Christian County, KY",Jan-22,25224,23929,1295,5.10000000
CN2104900000000,21,049,"Clark County, KY",Jan-22,17163,16497,666,3.90000000
CN2105100000000,21,051,"Clay County, KY",Jan-22,5214,4901,313,6.00000000
CN2105300000000,21,053,"Clinton County, KY",Jan-22,3994,3805,189,4.70000000
CN2105500000000,21,055,"Crittenden County, KY",Jan-22,3851,3687,164,4.30000000
CN2105700000000,21,057,"Cumberland County, KY",Jan-22,3362,3229,133,4.00000000
CN2105900000000,21,059,"Daviess County, KY",Jan-22,46239,44455,1784,3.90000000
CN2106100000000,21,061,"Edmonson County, KY",Jan-22,4651,4411,240,5.20000000
CN2106300000000,21,063,"Elliott County, KY",Jan-22,1937,1721,216,11.20000000
CN2106500000000,21,065,"Estill County, KY",Jan-22,5166,4907,259,5.00000000
CN2106700000000,21,067,"Fayette County, KY",Jan-22,173937,168120,5817,3.30000000
CN2106900000000,21,069,"Fleming County, KY",Jan-22,6148,5840,308,5.00000000
CN2107100000000,21,071,"Floyd County, KY",Jan-22,10897,10147,750,6.90000000
CN2107300000000,21,073,"Franklin County, KY",Jan-22,24827,23848,979,3.90000000
CN2107500000000,21,075,"Fulton County, KY",Jan-22,2097,1994,103,4.90000000
CN2107700000000,21,077,"Gallatin County, KY",Jan-22,3997,3837,160,4.00000000
CN2107900000000,21,079,"Garrard County, KY",Jan-22,7667,7333,334,4.40000000
CN2108100000000,21,081,"Grant County, KY",Jan-22,11615,11111,504,4.30000000
CN2108300000000,21,083,"Graves County, KY",Jan-22,16338,15437,901,5.50000000
CN2108500000000,21,085,"Grayson County, KY",Jan-22,10491,9933,558,5.30000000
CN2108700000000,21,087,"Green County, KY",Jan-22,5288,5091,197,3.70000000
CN2108900000000,21,089,"Greenup County, KY",Jan-22,13045,12146,899,6.90000000
CN2109100000000,21,091,"Hancock County, KY",Jan-22,3846,3692,154,4.00000000
CN2109300000000,21,093,"Hardin County, KY",Jan-22,46874,44788,2086,4.50000000
CN2109500000000,21,095,"Harlan County, KY",Jan-22,6560,6074,486,7.40000000
CN2109700000000,21,097,"Harrison County, KY",Jan-22,8854,8543,311,3.50000000
CN2109900000000,21,099,"Hart County, KY",Jan-22,7730,7411,319,4.10000000
CN2110100000000,21,101,"Henderson County, KY",Jan-22,20835,20028,807,3.90000000
CN2110300000000,21,103,"Henry County, KY",Jan-22,8291,7900,391,4.70000000
CN2110500000000,21,105,"Hickman County, KY",Jan-22,1807,1723,84,4.60000000
CN2110700000000,21,107,"Hopkins County, KY",Jan-22,18126,17204,922,5.10000000
CN2110900000000,21,109,"Jackson County, KY",Jan-22,4105,3857,248,6.00000000
CN2111100000000,21,111,"Jefferson County, KY",Jan-22,395156,376628,18528,4.70000000
CN2111300000000,21,113,"Jessamine County, KY",Jan-22,26382,25449,933,3.50000000
CN2111500000000,21,115,"Johnson County, KY",Jan-22,6645,6164,481,7.20000000
CN2111700000000,21,117,"Kenton County, KY",Jan-22,86482,83248,3234,3.70000000
CN2111900000000,21,119,"Knott County, KY",Jan-22,4294,4005,289,6.70000000
CN2112100000000,21,121,"Knox County, KY",Jan-22,10251,9693,558,5.40000000
CN2112300000000,21,123,"Larue County, KY",Jan-22,5821,5554,267,4.60000000
CN2112500000000,21,125,"Laurel County, KY",Jan-22,25849,24788,1061,4.10000000
CN2112700000000,21,127,"Lawrence County, KY",Jan-22,5535,5163,372,6.70000000
CN2112900000000,21,129,"Lee County, KY",Jan-22,2025,1904,121,6.00000000
CN2113100000000,21,131,"Leslie County, KY",Jan-22,2545,2353,192,7.50000000
CN2113300000000,21,133,"Letcher County, KY",Jan-22,6064,5657,407,6.70000000
CN2113500000000,21,135,"Lewis County, KY",Jan-22,4849,4425,424,8.70000000
CN2113700000000,21,137,"Lincoln County, KY",Jan-22,9302,8806,496,5.30000000
CN2113900000000,21,139,"Livingston County, KY",Jan-22,3622,3403,219,6.00000000
CN2114100000000,21,141,"Logan County, KY",Jan-22,12459,12012,447,3.60000000
CN2114300000000,21,143,"Lyon County, KY",Jan-22,3085,2934,151,4.90000000
CN2114500000000,21,145,"McCracken County, KY",Jan-22,29520,28128,1392,4.70000000
CN2114700000000,21,147,"McCreary County, KY",Jan-22,4892,4625,267,5.50000000
CN2114900000000,21,149,"McLean County, KY",Jan-22,4077,3885,192,4.70000000
CN2115100000000,21,151,"Madison County, KY",Jan-22,47231,45451,1780,3.80000000
CN2115300000000,21,153,"Magoffin County, KY",Jan-22,3413,2941,472,13.80000000
CN2115500000000,21,155,"Marion County, KY",Jan-22,9351,8957,394,4.20000000
CN2115700000000,21,157,"Marshall County, KY",Jan-22,14043,13361,682,4.90000000
CN2115900000000,21,159,"Martin County, KY",Jan-22,2289,2087,202,8.80000000
CN2116100000000,21,161,"Mason County, KY",Jan-22,6826,6441,385,5.60000000
CN2116300000000,21,163,"Meade County, KY",Jan-22,11635,11058,577,5.00000000
CN2116500000000,21,165,"Menifee County, KY",Jan-22,2363,2180,183,7.70000000
CN2116700000000,21,167,"Mercer County, KY",Jan-22,9879,9458,421,4.30000000
CN2116900000000,21,169,"Metcalfe County, KY",Jan-22,4020,3813,207,5.10000000
CN2117100000000,21,171,"Monroe County, KY",Jan-22,4708,4533,175,3.70000000
CN2117300000000,21,173,"Montgomery County, KY",Jan-22,11739,11102,637,5.40000000
CN2117500000000,21,175,"Morgan County, KY",Jan-22,4355,4061,294,6.80000000
CN2117700000000,21,177,"Muhlenberg County, KY",Jan-22,9765,9139,626,6.40000000
CN2117900000000,21,179,"Nelson County, KY",Jan-22,23403,22273,1130,4.80000000
CN2118100000000,21,181,"Nicholas County, KY",Jan-22,3375,3229,146,4.30000000
CN2118300000000,21,183,"Ohio County, KY",Jan-22,9010,8506,504,5.60000000
CN2118500000000,21,185,"Oldham County, KY",Jan-22,33500,32081,1419,4.20000000
CN2118700000000,21,187,"Owen County, KY",Jan-22,5040,4843,197,3.90000000
CN2118900000000,21,189,"Owsley County, KY",Jan-22,1066,991,75,7.00000000
CN2119100000000,21,191,"Pendleton County, KY",Jan-22,6907,6624,283,4.10000000
CN2119300000000,21,193,"Perry County, KY",Jan-22,8020,7558,462,5.80000000
CN2119500000000,21,195,"Pike County, KY",Jan-22,19077,17954,1123,5.90000000
CN2119700000000,21,197,"Powell County, KY",Jan-22,5151,4889,262,5.10000000
CN2119900000000,21,199,"Pulaski County, KY",Jan-22,25918,24690,1228,4.70000000
CN2120100000000,21,201,"Robertson County, KY",Jan-22,836,790,46,5.50000000
CN2120300000000,21,203,"Rockcastle County, KY",Jan-22,6552,6236,316,4.80000000
CN2120500000000,21,205,"Rowan County, KY",Jan-22,9767,9260,507,5.20000000
CN2120700000000,21,207,"Russell County, KY",Jan-22,6201,5867,334,5.40000000
CN2120900000000,21,209,"Scott County, KY",Jan-22,30076,29089,987,3.30000000
CN2121100000000,21,211,"Shelby County, KY",Jan-22,26099,25044,1055,4.00000000
CN2121300000000,21,213,"Simpson County, KY",Jan-22,8892,8573,319,3.60000000
CN2121500000000,21,215,"Spencer County, KY",Jan-22,10726,10135,591,5.50000000
CN2121700000000,21,217,"Taylor County, KY",Jan-22,12445,11962,483,3.90000000
CN2121900000000,21,219,"Todd County, KY",Jan-22,5567,5386,181,3.30000000
CN2122100000000,21,221,"Trigg County, KY",Jan-22,6203,5909,294,4.70000000
CN2122300000000,21,223,"Trimble County, KY",Jan-22,3884,3677,207,5.30000000
CN2122500000000,21,225,"Union County, KY",Jan-22,6124,5871,253,4.10000000
CN2122700000000,21,227,"Warren County, KY",Jan-22,63949,61484,2465,3.90000000
CN2122900000000,21,229,"Washington County, KY",Jan-22,6282,6021,261,4.20000000
CN2123100000000,21,231,"Wayne County, KY",Jan-22,7388,7016,372,5.00000000
CN2123300000000,21,233,"Webster County, KY",Jan-22,5322,5114,208,3.90000000
CN2123500000000,21,235,"Whitley County, KY",Jan-22,14302,13666,636,4.40000000
CN2123700000000,21,237,"Wolfe County, KY",Jan-22,2217,2082,135,6.10000000
CN2123900000000,21,239,"Woodford County, KY",Jan-22,15291,14857,434,2.80000000
CN2200100000000,22,001,"Acadia Parish, LA",Jan-22,23514,22625,889,3.80000000
CN2200300000000,22,003,"Allen Parish, LA",Jan-22,8200,7841,359,4.40000000
CN2200500000000,22,005,"Ascension Parish, LA",Jan-22,64966,62930,2036,3.10000000
CN2200700000000,22,007,"Assumption Parish, LA",Jan-22,8608,8097,511,5.90000000
CN2200900000000,22,009,"Avoyelles Parish, LA",Jan-22,14563,13966,597,4.10000000
CN2201100000000,22,011,"Beauregard Parish, LA",Jan-22,14795,14312,483,3.30000000
CN2201300000000,22,013,"Bienville Parish, LA",Jan-22,5246,5008,238,4.50000000
CN2201500000000,22,015,"Bossier Parish, LA",Jan-22,57436,55721,1715,3.00000000
CN2201700000000,22,017,"Caddo Parish, LA",Jan-22,101557,96567,4990,4.90000000
CN2201900000000,22,019,"Calcasieu Parish, LA",Jan-22,96668,92598,4070,4.20000000
CN2202100000000,22,021,"Caldwell Parish, LA",Jan-22,3630,3493,137,3.80000000
CN2202300000000,22,023,"Cameron Parish, LA",Jan-22,3561,3464,97,2.70000000
CN2202500000000,22,025,"Catahoula Parish, LA",Jan-22,3442,3302,140,4.10000000
CN2202700000000,22,027,"Claiborne Parish, LA",Jan-22,5399,5191,208,3.90000000
CN2202900000000,22,029,"Concordia Parish, LA",Jan-22,6798,6465,333,4.90000000
CN2203100000000,22,031,"De Soto Parish, LA",Jan-22,10801,10400,401,3.70000000
CN2203300000000,22,033,"East Baton Rouge Parish, LA",Jan-22,227663,218459,9204,4.00000000
CN2203500000000,22,035,"East Carroll Parish, LA",Jan-22,1682,1532,150,8.90000000
CN2203700000000,22,037,"East Feliciana Parish, LA",Jan-22,7658,7399,259,3.40000000
CN2203900000000,22,039,"Evangeline Parish, LA",Jan-22,11771,11253,518,4.40000000
CN2204100000000,22,041,"Franklin Parish, LA",Jan-22,7389,7037,352,4.80000000
CN2204300000000,22,043,"Grant Parish, LA",Jan-22,8285,8008,277,3.30000000
CN2204500000000,22,045,"Iberia Parish, LA",Jan-22,27412,25937,1475,5.40000000
CN2204700000000,22,047,"Iberville Parish, LA",Jan-22,13696,12914,782,5.70000000
CN2204900000000,22,049,"Jackson Parish, LA",Jan-22,6809,6603,206,3.00000000
CN2205100000000,22,051,"Jefferson Parish, LA",Jan-22,208859,199224,9635,4.60000000
CN2205300000000,22,053,"Jefferson Davis Parish, LA",Jan-22,12763,12315,448,3.50000000
CN2205500000000,22,055,"Lafayette Parish, LA",Jan-22,114370,110529,3841,3.40000000
CN2205700000000,22,057,"Lafourche Parish, LA",Jan-22,39387,37938,1449,3.70000000
CN2205900000000,22,059,"LaSalle Parish, LA",Jan-22,6560,6392,168,2.60000000
CN2206100000000,22,061,"Lincoln Parish, LA",Jan-22,21345,20671,674,3.20000000
CN2206300000000,22,063,"Livingston Parish, LA",Jan-22,69508,67500,2008,2.90000000
CN2206500000000,22,065,"Madison Parish, LA",Jan-22,3430,3240,190,5.50000000
CN2206700000000,22,067,"Morehouse Parish, LA",Jan-22,9977,9326,651,6.50000000
CN2206900000000,22,069,"Natchitoches Parish, LA",Jan-22,16250,15641,609,3.70000000
CN2207100000000,22,071,"Orleans Parish, LA",Jan-22,177028,165436,11592,6.50000000
CN2207300000000,22,073,"Ouachita Parish, LA",Jan-22,68665,65972,2693,3.90000000
CN2207500000000,22,075,"Plaquemines Parish, LA",Jan-22,9643,9331,312,3.20000000
CN2207700000000,22,077,"Pointe Coupee Parish, LA",Jan-22,9578,9146,432,4.50000000
CN2207900000000,22,079,"Rapides Parish, LA",Jan-22,55951,54214,1737,3.10000000
CN2208100000000,22,081,"Red River Parish, LA",Jan-22,3683,3558,125,3.40000000
CN2208300000000,22,083,"Richland Parish, LA",Jan-22,8071,7735,336,4.20000000
CN2208500000000,22,085,"Sabine Parish, LA",Jan-22,9203,8943,260,2.80000000
CN2208700000000,22,087,"St. Bernard Parish, LA",Jan-22,19889,18822,1067,5.40000000
CN2208900000000,22,089,"St. Charles Parish, LA",Jan-22,24470,23544,926,3.80000000
CN2209100000000,22,091,"St. Helena Parish, LA",Jan-22,4234,3925,309,7.30000000
CN2209300000000,22,093,"St. James Parish, LA",Jan-22,8916,8371,545,6.10000000
CN2209500000000,22,095,"St. John the Baptist Parish, LA",Jan-22,19213,17841,1372,7.10000000
CN2209700000000,22,097,"St. Landry Parish, LA",Jan-22,31600,29968,1632,5.20000000
CN2209900000000,22,099,"St. Martin Parish, LA",Jan-22,21848,20916,932,4.30000000
CN2210100000000,22,101,"St. Mary Parish, LA",Jan-22,18964,17933,1031,5.40000000
CN2210300000000,22,103,"St. Tammany Parish, LA",Jan-22,117334,113919,3415,2.90000000
CN2210500000000,22,105,"Tangipahoa Parish, LA",Jan-22,55940,53045,2895,5.20000000
CN2210700000000,22,107,"Tensas Parish, LA",Jan-22,1310,1241,69,5.30000000
CN2210900000000,22,109,"Terrebonne Parish, LA",Jan-22,43661,41588,2073,4.70000000
CN2211100000000,22,111,"Union Parish, LA",Jan-22,8962,8616,346,3.90000000
CN2211300000000,22,113,"Vermilion Parish, LA",Jan-22,23643,22739,904,3.80000000
CN2211500000000,22,115,"Vernon Parish, LA",Jan-22,16059,15477,582,3.60000000
CN2211700000000,22,117,"Washington Parish, LA",Jan-22,16976,16213,763,4.50000000
CN2211900000000,22,119,"Webster Parish, LA",Jan-22,14037,13446,591,4.20000000
CN2212100000000,22,121,"West Baton Rouge Parish, LA",Jan-22,13625,13130,495,3.60000000
CN2212300000000,22,123,"West Carroll Parish, LA",Jan-22,3494,3267,227,6.50000000
CN2212500000000,22,125,"West Feliciana Parish, LA",Jan-22,5288,5141,147,2.80000000
CN2212700000000,22,127,"Winn Parish, LA",Jan-22,4583,4400,183,4.00000000
CN2300100000000,23,001,"Androscoggin County, ME",Jan-22,54034,51784,2250,4.20000000
CN2300300000000,23,003,"Aroostook County, ME",Jan-22,28784,27152,1632,5.70000000
CN2300500000000,23,005,"Cumberland County, ME",Jan-22,158852,153513,5339,3.40000000
CN2300700000000,23,007,"Franklin County, ME",Jan-22,13838,13161,677,4.90000000
CN2300900000000,23,009,"Hancock County, ME",Jan-22,26282,24656,1626,6.20000000
CN2301100000000,23,011,"Kennebec County, ME",Jan-22,60966,58450,2516,4.10000000
CN2301300000000,23,013,"Knox County, ME",Jan-22,19254,18391,863,4.50000000
CN2301500000000,23,015,"Lincoln County, ME",Jan-22,15837,15133,704,4.40000000
CN2301700000000,23,017,"Oxford County, ME",Jan-22,26555,25275,1280,4.80000000
CN2301900000000,23,019,"Penobscot County, ME",Jan-22,75114,71797,3317,4.40000000
CN2302100000000,23,021,"Piscataquis County, ME",Jan-22,7281,6897,384,5.30000000
CN2302300000000,23,023,"Sagadahoc County, ME",Jan-22,18891,18276,615,3.30000000
CN2302500000000,23,025,"Somerset County, ME",Jan-22,21953,20589,1364,6.20000000
CN2302700000000,23,027,"Waldo County, ME",Jan-22,19822,18845,977,4.90000000
CN2302900000000,23,029,"Washington County, ME",Jan-22,13027,12158,869,6.70000000
CN2303100000000,23,031,"York County, ME",Jan-22,110167,105425,4742,4.30000000
CN2400100000000,24,001,"Allegany County, MD",Jan-22 c,30173,28447,1726,5.70000000
CN2400300000000,24,003,"Anne Arundel County, MD",Jan-22 c,313186,302275,10911,3.50000000
CN2400500000000,24,005,"Baltimore County, MD",Jan-22 c,445394,426194,19200,4.30000000
CN2400900000000,24,009,"Calvert County, MD",Jan-22 c,48621,46923,1698,3.50000000
CN2401100000000,24,011,"Caroline County, MD",Jan-22 c,17082,16403,679,4.00000000
CN2401300000000,24,013,"Carroll County, MD",Jan-22 c,93846,90970,2876,3.10000000
CN2401500000000,24,015,"Cecil County, MD",Jan-22 c,51997,49699,2298,4.40000000
CN2401700000000,24,017,"Charles County, MD",Jan-22 c,85878,82154,3724,4.30000000
CN2401900000000,24,019,"Dorchester County, MD",Jan-22 c,15539,14745,794,5.10000000
CN2402100000000,24,021,"Frederick County, MD",Jan-22 c,134923,130207,4716,3.50000000
CN2402300000000,24,023,"Garrett County, MD",Jan-22 c,14956,14174,782,5.20000000
CN2402500000000,24,025,"Harford County, MD",Jan-22 c,139831,134811,5020,3.60000000
CN2402700000000,24,027,"Howard County, MD",Jan-22 c,186862,181151,5711,3.10000000
CN2402900000000,24,029,"Kent County, MD",Jan-22 c,9059,8566,493,5.40000000
CN2403100000000,24,031,"Montgomery County, MD",Jan-22 c,543487,523112,20375,3.70000000
CN2403300000000,24,033,"Prince George's County, MD",Jan-22 c,498398,469776,28622,5.70000000
CN2403500000000,24,035,"Queen Anne's County, MD",Jan-22 c,27657,26697,960,3.50000000
CN2403700000000,24,037,"St. Mary's County, MD",Jan-22 c,57257,55321,1936,3.40000000
CN2403900000000,24,039,"Somerset County, MD",Jan-22 c,8362,7766,596,7.10000000
CN2404100000000,24,041,"Talbot County, MD",Jan-22 c,16916,16120,796,4.70000000
CN2404300000000,24,043,"Washington County, MD",Jan-22 c,72282,69337,2945,4.10000000
CN2404500000000,24,045,"Wicomico County, MD",Jan-22 c,47546,44954,2592,5.50000000
CN2404700000000,24,047,"Worcester County, MD",Jan-22 c,24251,21829,2422,10.00000000
CN2451000000000,24,510,"Baltimore city, MD",Jan-22 c,278340,260702,17638,6.30000000
CN2500100000000,25,001,"Barnstable County, MA",Jan-22,107609,99297,8312,7.70000000
CN2500300000000,25,003,"Berkshire County, MA",Jan-22,61999,58110,3889,6.30000000
CN2500500000000,25,005,"Bristol County, MA",Jan-22,301208,281662,19546,6.50000000
CN2500700000000,25,007,"Dukes County, MA",Jan-22,8674,7889,785,9.10000000
CN2500900000000,25,009,"Essex County, MA",Jan-22,425209,402273,22936,5.40000000
CN2501100000000,25,011,"Franklin County, MA",Jan-22,40703,38820,1883,4.60000000
CN2501300000000,25,013,"Hampden County, MA",Jan-22,225967,210853,15114,6.70000000
CN2501500000000,25,015,"Hampshire County, MA",Jan-22,89451,85567,3884,4.30000000
CN2501700000000,25,017,"Middlesex County, MA",Jan-22,913884,879336,34548,3.80000000
CN2501900000000,25,019,"Nantucket County/town, MA",Jan-22,6427,5457,970,15.10000000
CN2502100000000,25,021,"Norfolk County, MA",Jan-22,393215,376709,16506,4.20000000
CN2502300000000,25,023,"Plymouth County, MA",Jan-22,284874,268920,15954,5.60000000
CN2502500000000,25,025,"Suffolk County, MA",Jan-22,454385,433610,20775,4.60000000
CN2502700000000,25,027,"Worcester County, MA",Jan-22,444544,421666,22878,5.10000000
CN2600100000000,26,001,"Alcona County, MI",Jan-22,3609,3300,309,8.60000000
CN2600300000000,26,003,"Alger County, MI",Jan-22,3012,2739,273,9.10000000
CN2600500000000,26,005,"Allegan County, MI",Jan-22,60207,57697,2510,4.20000000
CN2600700000000,26,007,"Alpena County, MI",Jan-22,13437,12709,728,5.40000000
CN2600900000000,26,009,"Antrim County, MI",Jan-22,9361,8644,717,7.70000000
CN2601100000000,26,011,"Arenac County, MI",Jan-22,5629,5070,559,9.90000000
CN2601300000000,26,013,"Baraga County, MI",Jan-22,3014,2748,266,8.80000000
CN2601500000000,26,015,"Barry County, MI",Jan-22,30784,29478,1306,4.20000000
CN2601700000000,26,017,"Bay County, MI",Jan-22,48173,45264,2909,6.00000000
CN2601900000000,26,019,"Benzie County, MI",Jan-22,8325,7752,573,6.90000000
CN2602100000000,26,021,"Berrien County, MI",Jan-22,69569,65960,3609,5.20000000
CN2602300000000,26,023,"Branch County, MI",Jan-22,18652,17847,805,4.30000000
CN2602500000000,26,025,"Calhoun County, MI",Jan-22,58895,55599,3296,5.60000000
CN2602700000000,26,027,"Cass County, MI",Jan-22,23022,22010,1012,4.40000000
CN2602900000000,26,029,"Charlevoix County, MI",Jan-22,11767,11041,726,6.20000000
CN2603100000000,26,031,"Cheboygan County, MI",Jan-22,9392,8177,1215,12.90000000
CN2603300000000,26,033,"Chippewa County, MI",Jan-22,16132,14892,1240,7.70000000
CN2603500000000,26,035,"Clare County, MI",Jan-22,10986,10048,938,8.50000000
CN2603700000000,26,037,"Clinton County, MI",Jan-22,38045,36520,1525,4.00000000
CN2603900000000,26,039,"Crawford County, MI",Jan-22,5278,4862,416,7.90000000
CN2604100000000,26,041,"Delta County, MI",Jan-22,16063,15016,1047,6.50000000
CN2604300000000,26,043,"Dickinson County, MI",Jan-22,12193,11639,554,4.50000000
CN2604500000000,26,045,"Eaton County, MI",Jan-22,53338,50636,2702,5.10000000
CN2604700000000,26,047,"Emmet County, MI",Jan-22,15565,14361,1204,7.70000000
CN2604900000000,26,049,"Genesee County, MI",Jan-22,174385,162361,12024,6.90000000
CN2605100000000,26,051,"Gladwin County, MI",Jan-22,9311,8628,683,7.30000000
CN2605300000000,26,053,"Gogebic County, MI",Jan-22,5667,5355,312,5.50000000
CN2605500000000,26,055,"Grand Traverse County, MI",Jan-22,46647,44530,2117,4.50000000
CN2605700000000,26,057,"Gratiot County, MI",Jan-22,16889,16046,843,5.00000000
CN2605900000000,26,059,"Hillsdale County, MI",Jan-22,19496,18526,970,5.00000000
CN2606100000000,26,061,"Houghton County, MI",Jan-22,16061,15280,781,4.90000000
CN2606300000000,26,063,"Huron County, MI",Jan-22,14310,13496,814,5.70000000
CN2606500000000,26,065,"Ingham County, MI",Jan-22,139239,132379,6860,4.90000000
CN2606700000000,26,067,"Ionia County, MI",Jan-22,29113,27905,1208,4.10000000
CN2606900000000,26,069,"Iosco County, MI",Jan-22,9723,8909,814,8.40000000
CN2607100000000,26,071,"Iron County, MI",Jan-22,4775,4445,330,6.90000000
CN2607300000000,26,073,"Isabella County, MI",Jan-22,31853,30351,1502,4.70000000
CN2607500000000,26,075,"Jackson County, MI",Jan-22,71970,68263,3707,5.20000000
CN2607700000000,26,077,"Kalamazoo County, MI",Jan-22,129138,123985,5153,4.00000000
CN2607900000000,26,079,"Kalkaska County, MI",Jan-22,7549,6938,611,8.10000000
CN2608100000000,26,081,"Kent County, MI",Jan-22,348776,335735,13041,3.70000000
CN2608300000000,26,083,"Keweenaw County, MI",Jan-22,895,836,59,6.60000000
CN2608500000000,26,085,"Lake County, MI",Jan-22,3822,3499,323,8.50000000
CN2608700000000,26,087,"Lapeer County, MI",Jan-22,40807,38204,2603,6.40000000
CN2608900000000,26,089,"Leelanau County, MI",Jan-22,9720,9212,508,5.20000000
CN2609100000000,26,091,"Lenawee County, MI",Jan-22,44291,42129,2162,4.90000000
CN2609300000000,26,093,"Livingston County, MI",Jan-22,102939,99129,3810,3.70000000
CN2609500000000,26,095,"Luce County, MI",Jan-22,2021,1871,150,7.40000000
CN2609700000000,26,097,"Mackinac County, MI",Jan-22,4032,3346,686,17.00000000
CN2609900000000,26,099,"Macomb County, MI",Jan-22,443937,422204,21733,4.90000000
CN2610100000000,26,101,"Manistee County, MI",Jan-22,9525,8806,719,7.50000000
CN2610300000000,26,103,"Marquette County, MI",Jan-22,31122,29468,1654,5.30000000
CN2610500000000,26,105,"Mason County, MI",Jan-22,12526,11677,849,6.80000000
CN2610700000000,26,107,"Mecosta County, MI",Jan-22,17834,16745,1089,6.10000000
CN2610900000000,26,109,"Menominee County, MI",Jan-22,10316,9892,424,4.10000000
CN2611100000000,26,111,"Midland County, MI",Jan-22,38083,36349,1734,4.60000000
CN2611300000000,26,113,"Missaukee County, MI",Jan-22,6602,6194,408,6.20000000
CN2611500000000,26,115,"Monroe County, MI",Jan-22,72710,69193,3517,4.80000000
CN2611700000000,26,117,"Montcalm County, MI",Jan-22,26992,25645,1347,5.00000000
CN2611900000000,26,119,"Montmorency County, MI",Jan-22,2899,2594,305,10.50000000
CN2612100000000,26,121,"Muskegon County, MI",Jan-22,76009,71083,4926,6.50000000
CN2612300000000,26,123,"Newaygo County, MI",Jan-22,22783,21555,1228,5.40000000
CN2612500000000,26,125,"Oakland County, MI",Jan-22,666306,640605,25701,3.90000000
CN2612700000000,26,127,"Oceana County, MI",Jan-22,11133,10174,959,8.60000000
CN2612900000000,26,129,"Ogemaw County, MI",Jan-22,7597,6881,716,9.40000000
CN2613100000000,26,131,"Ontonagon County, MI",Jan-22,2034,1886,148,7.30000000
CN2613300000000,26,133,"Osceola County, MI",Jan-22,11312,10715,597,5.30000000
CN2613500000000,26,135,"Oscoda County, MI",Jan-22,2422,2183,239,9.90000000
CN2613700000000,26,137,"Otsego County, MI",Jan-22,11221,10504,717,6.40000000
CN2613900000000,26,139,"Ottawa County, MI",Jan-22,156554,151247,5307,3.40000000
CN2614100000000,26,141,"Presque Isle County, MI",Jan-22,4769,4251,518,10.90000000
CN2614300000000,26,143,"Roscommon County, MI",Jan-22,7111,6281,830,11.70000000
CN2614500000000,26,145,"Saginaw County, MI",Jan-22,81448,76092,5356,6.60000000
CN2614700000000,26,147,"St. Clair County, MI",Jan-22,75136,70935,4201,5.60000000
CN2614900000000,26,149,"St. Joseph County, MI",Jan-22,27339,26283,1056,3.90000000
CN2615100000000,26,151,"Sanilac County, MI",Jan-22,18595,17440,1155,6.20000000
CN2615300000000,26,153,"Schoolcraft County, MI",Jan-22,3104,2794,310,10.00000000
CN2615500000000,26,155,"Shiawassee County, MI",Jan-22,31519,29779,1740,5.50000000
CN2615700000000,26,157,"Tuscola County, MI",Jan-22,22580,21167,1413,6.30000000
CN2615900000000,26,159,"Van Buren County, MI",Jan-22,33851,31832,2019,6.00000000
CN2616100000000,26,161,"Washtenaw County, MI",Jan-22,192705,186366,6339,3.30000000
CN2616300000000,26,163,"Wayne County, MI",Jan-22,811421,759258,52163,6.40000000
CN2616500000000,26,165,"Wexford County, MI",Jan-22,14307,13489,818,5.70000000
CN2700100000000,27,001,"Aitkin County, MN",Jan-22,7375,6902,473,6.40000000
CN2700300000000,27,003,"Anoka County, MN",Jan-22,198880,192530,6350,3.20000000
CN2700500000000,27,005,"Becker County, MN",Jan-22,19090,18299,791,4.10000000
CN2700700000000,27,007,"Beltrami County, MN",Jan-22,24221,23153,1068,4.40000000
CN2700900000000,27,009,"Benton County, MN",Jan-22,22210,21125,1085,4.90000000
CN2701100000000,27,011,"Big Stone County, MN",Jan-22,2383,2271,112,4.70000000
CN2701300000000,27,013,"Blue Earth County, MN",Jan-22,40292,39162,1130,2.80000000
CN2701500000000,27,015,"Brown County, MN",Jan-22,13565,13070,495,3.60000000
CN2701700000000,27,017,"Carlton County, MN",Jan-22,17746,16907,839,4.70000000
CN2701900000000,27,019,"Carver County, MN",Jan-22,59335,57796,1539,2.60000000
CN2702100000000,27,021,"Cass County, MN",Jan-22,16792,15865,927,5.50000000
CN2702300000000,27,023,"Chippewa County, MN",Jan-22,6556,6352,204,3.10000000
CN2702500000000,27,025,"Chisago County, MN",Jan-22,30168,28886,1282,4.20000000
CN2702700000000,27,027,"Clay County, MN",Jan-22,37118,36055,1063,2.90000000
CN2702900000000,27,029,"Clearwater County, MN",Jan-22,4593,4120,473,10.30000000
CN2703100000000,27,031,"Cook County, MN",Jan-22,2657,2510,147,5.50000000
CN2703300000000,27,033,"Cottonwood County, MN",Jan-22,6663,6460,203,3.00000000
CN2703500000000,27,035,"Crow Wing County, MN",Jan-22,31555,30016,1539,4.90000000
CN2703700000000,27,037,"Dakota County, MN",Jan-22,242238,235346,6892,2.80000000
CN2703900000000,27,039,"Dodge County, MN",Jan-22,12176,11704,472,3.90000000
CN2704100000000,27,041,"Douglas County, MN",Jan-22,20946,20254,692,3.30000000
CN2704300000000,27,043,"Faribault County, MN",Jan-22,6863,6556,307,4.50000000
CN2704500000000,27,045,"Fillmore County, MN",Jan-22,11670,11254,416,3.60000000
CN2704700000000,27,047,"Freeborn County, MN",Jan-22,15501,14969,532,3.40000000
CN2704900000000,27,049,"Goodhue County, MN",Jan-22,26597,25671,926,3.50000000
CN2705100000000,27,051,"Grant County, MN",Jan-22,3222,3070,152,4.70000000
CN2705300000000,27,053,"Hennepin County, MN",Jan-22,702838,683137,19701,2.80000000
CN2705500000000,27,055,"Houston County, MN",Jan-22,10415,10064,351,3.40000000
CN2705700000000,27,057,"Hubbard County, MN",Jan-22,10023,9436,587,5.90000000
CN2705900000000,27,059,"Isanti County, MN",Jan-22,21974,20913,1061,4.80000000
CN2706100000000,27,061,"Itasca County, MN",Jan-22,22497,21216,1281,5.70000000
CN2706300000000,27,063,"Jackson County, MN",Jan-22,5443,5273,170,3.10000000
CN2706500000000,27,065,"Kanabec County, MN",Jan-22,9263,8547,716,7.70000000
CN2706700000000,27,067,"Kandiyohi County, MN",Jan-22,22930,21964,966,4.20000000
CN2706900000000,27,069,"Kittson County, MN",Jan-22,2259,2177,82,3.60000000
CN2707100000000,27,071,"Koochiching County, MN",Jan-22,5524,5283,241,4.40000000
CN2707300000000,27,073,"Lac qui Parle County, MN",Jan-22,3377,3247,130,3.80000000
CN2707500000000,27,075,"Lake County, MN",Jan-22,5140,4949,191,3.70000000
CN2707700000000,27,077,"Lake of the Woods County, MN",Jan-22,2518,2429,89,3.50000000
CN2707900000000,27,079,"Le Sueur County, MN",Jan-22,16169,15298,871,5.40000000
CN2708100000000,27,081,"Lincoln County, MN",Jan-22,2958,2825,133,4.50000000
CN2708300000000,27,083,"Lyon County, MN",Jan-22,14148,13674,474,3.40000000
CN2708500000000,27,085,"McLeod County, MN",Jan-22,19139,18363,776,4.10000000
CN2708700000000,27,087,"Mahnomen County, MN",Jan-22,2261,2108,153,6.80000000
CN2708900000000,27,089,"Marshall County, MN",Jan-22,5324,4981,343,6.40000000
CN2709100000000,27,091,"Martin County, MN",Jan-22,9548,9228,320,3.40000000
CN2709300000000,27,093,"Meeker County, MN",Jan-22,13264,12685,579,4.40000000
CN2709500000000,27,095,"Mille Lacs County, MN",Jan-22,12977,12059,918,7.10000000
CN2709700000000,27,097,"Morrison County, MN",Jan-22,17728,16521,1207,6.80000000
CN2709900000000,27,099,"Mower County, MN",Jan-22,20691,20034,657,3.20000000
CN2710100000000,27,101,"Murray County, MN",Jan-22,4584,4325,259,5.70000000
CN2710300000000,27,103,"Nicollet County, MN",Jan-22,20656,20132,524,2.50000000
CN2710500000000,27,105,"Nobles County, MN",Jan-22,11363,11051,312,2.70000000
CN2710700000000,27,107,"Norman County, MN",Jan-22,3292,3133,159,4.80000000
CN2710900000000,27,109,"Olmsted County, MN",Jan-22,92204,89701,2503,2.70000000
CN2711100000000,27,111,"Otter Tail County, MN",Jan-22,30581,29201,1380,4.50000000
CN2711300000000,27,113,"Pennington County, MN",Jan-22,8817,8381,436,4.90000000
CN2711500000000,27,115,"Pine County, MN",Jan-22,14368,13410,958,6.70000000
CN2711700000000,27,117,"Pipestone County, MN",Jan-22,4402,4226,176,4.00000000
CN2711900000000,27,119,"Polk County, MN",Jan-22,16288,15652,636,3.90000000
CN2712100000000,27,121,"Pope County, MN",Jan-22,6316,6100,216,3.40000000
CN2712300000000,27,123,"Ramsey County, MN",Jan-22,285184,276303,8881,3.10000000
CN2712500000000,27,125,"Red Lake County, MN",Jan-22,2215,2093,122,5.50000000
CN2712700000000,27,127,"Redwood County, MN",Jan-22,7448,7170,278,3.70000000
CN2712900000000,27,129,"Renville County, MN",Jan-22,8272,7877,395,4.80000000
CN2713100000000,27,131,"Rice County, MN",Jan-22,36999,35709,1290,3.50000000
CN2713300000000,27,133,"Rock County, MN",Jan-22,5987,5848,139,2.30000000
CN2713500000000,27,135,"Roseau County, MN",Jan-22,7993,7726,267,3.30000000
CN2713700000000,27,137,"St. Louis County, MN",Jan-22,100661,96783,3878,3.90000000
CN2713900000000,27,139,"Scott County, MN",Jan-22,84405,82044,2361,2.80000000
CN2714100000000,27,141,"Sherburne County, MN",Jan-22,53536,51407,2129,4.00000000
CN2714300000000,27,143,"Sibley County, MN",Jan-22,8239,7854,385,4.70000000
CN2714500000000,27,145,"Stearns County, MN",Jan-22,91427,88163,3264,3.60000000
CN2714700000000,27,147,"Steele County, MN",Jan-22,19774,19071,703,3.60000000
CN2714900000000,27,149,"Stevens County, MN",Jan-22,5153,4988,165,3.20000000
CN2715100000000,27,151,"Swift County, MN",Jan-22,4685,4477,208,4.40000000
CN2715300000000,27,153,"Todd County, MN",Jan-22,13483,12868,615,4.60000000
CN2715500000000,27,155,"Traverse County, MN",Jan-22,1673,1611,62,3.70000000
CN2715700000000,27,157,"Wabasha County, MN",Jan-22,12412,11970,442,3.60000000
CN2715900000000,27,159,"Wadena County, MN",Jan-22,6002,5636,366,6.10000000
CN2716100000000,27,161,"Waseca County, MN",Jan-22,8654,8266,388,4.50000000
CN2716300000000,27,163,"Washington County, MN",Jan-22,144726,140926,3800,2.60000000
CN2716500000000,27,165,"Watonwan County, MN",Jan-22,6529,6337,192,2.90000000
CN2716700000000,27,167,"Wilkin County, MN",Jan-22,3355,3256,99,3.00000000
CN2716900000000,27,169,"Winona County, MN",Jan-22,27715,26970,745,2.70000000
CN2717100000000,27,171,"Wright County, MN",Jan-22,76933,74275,2658,3.50000000
CN2717300000000,27,173,"Yellow Medicine County, MN",Jan-22,5014,4820,194,3.90000000
CN2800100000000,28,001,"Adams County, MS",Jan-22,10394,9653,741,7.10000000
CN2800300000000,28,003,"Alcorn County, MS",Jan-22,15258,14625,633,4.10000000
CN2800500000000,28,005,"Amite County, MS",Jan-22,4350,4068,282,6.50000000
CN2800700000000,28,007,"Attala County, MS",Jan-22,7021,6665,356,5.10000000
CN2800900000000,28,009,"Benton County, MS",Jan-22,3034,2865,169,5.60000000
CN2801100000000,28,011,"Bolivar County, MS",Jan-22,11174,10500,674,6.00000000
CN2801300000000,28,013,"Calhoun County, MS",Jan-22,5316,5073,243,4.60000000
CN2801500000000,28,015,"Carroll County, MS",Jan-22,3537,3352,185,5.20000000
CN2801700000000,28,017,"Chickasaw County, MS",Jan-22,6800,6452,348,5.10000000
CN2801900000000,28,019,"Choctaw County, MS",Jan-22,3536,3376,160,4.50000000
CN2802100000000,28,021,"Claiborne County, MS",Jan-22,2890,2602,288,10.00000000
CN2802300000000,28,023,"Clarke County, MS",Jan-22,5622,5299,323,5.70000000
CN2802500000000,28,025,"Clay County, MS",Jan-22,8123,7639,484,6.00000000
CN2802700000000,28,027,"Coahoma County, MS",Jan-22,7870,7250,620,7.90000000
CN2802900000000,28,029,"Copiah County, MS",Jan-22,10579,9996,583,5.50000000
CN2803100000000,28,031,"Covington County, MS",Jan-22,8058,7722,336,4.20000000
CN2803300000000,28,033,"DeSoto County, MS",Jan-22,92989,89458,3531,3.80000000
CN2803500000000,28,035,"Forrest County, MS",Jan-22,33042,31484,1558,4.70000000
CN2803700000000,28,037,"Franklin County, MS",Jan-22,2619,2458,161,6.10000000
CN2803900000000,28,039,"George County, MS",Jan-22,8597,8031,566,6.60000000
CN2804100000000,28,041,"Greene County, MS",Jan-22,4163,3872,291,7.00000000
CN2804300000000,28,043,"Grenada County, MS",Jan-22,8992,8596,396,4.40000000
CN2804500000000,28,045,"Hancock County, MS",Jan-22,19015,18058,957,5.00000000
CN2804700000000,28,047,"Harrison County, MS",Jan-22,87257,83128,4129,4.70000000
CN2804900000000,28,049,"Hinds County, MS",Jan-22,100051,94889,5162,5.20000000
CN2805100000000,28,051,"Holmes County, MS",Jan-22,5041,4559,482,9.60000000
CN2805300000000,28,053,"Humphreys County, MS",Jan-22,1971,1747,224,11.40000000
CN2805500000000,28,055,"Issaquena County, MS",Jan-22,318,285,33,10.40000000
CN2805700000000,28,057,"Itawamba County, MS",Jan-22,10265,9869,396,3.90000000
CN2805900000000,28,059,"Jackson County, MS",Jan-22,58534,55386,3148,5.40000000
CN2806100000000,28,061,"Jasper County, MS",Jan-22,5730,5356,374,6.50000000
CN2806300000000,28,063,"Jefferson County, MS",Jan-22,1887,1577,310,16.40000000
CN2806500000000,28,065,"Jefferson Davis County, MS",Jan-22,3841,3569,272,7.10000000
CN2806700000000,28,067,"Jones County, MS",Jan-22,24279,23060,1219,5.00000000
CN2806900000000,28,069,"Kemper County, MS",Jan-22,3236,3022,214,6.60000000
CN2807100000000,28,071,"Lafayette County, MS",Jan-22,27257,26284,973,3.60000000
CN2807300000000,28,073,"Lamar County, MS",Jan-22,31322,30155,1167,3.70000000
CN2807500000000,28,075,"Lauderdale County, MS",Jan-22,28787,27386,1401,4.90000000
CN2807700000000,28,077,"Lawrence County, MS",Jan-22,4571,4284,287,6.30000000
CN2807900000000,28,079,"Leake County, MS",Jan-22,7883,7479,404,5.10000000
CN2808100000000,28,081,"Lee County, MS",Jan-22,40849,39268,1581,3.90000000
CN2808300000000,28,083,"Leflore County, MS",Jan-22,10042,9365,677,6.70000000
CN2808500000000,28,085,"Lincoln County, MS",Jan-22,14821,14172,649,4.40000000
CN2808700000000,28,087,"Lowndes County, MS",Jan-22,24847,23573,1274,5.10000000
CN2808900000000,28,089,"Madison County, MS",Jan-22,52147,50195,1952,3.70000000
CN2809100000000,28,091,"Marion County, MS",Jan-22,10318,9866,452,4.40000000
CN2809300000000,28,093,"Marshall County, MS",Jan-22,14176,13491,685,4.80000000
CN2809500000000,28,095,"Monroe County, MS",Jan-22,15898,15179,719,4.50000000
CN2809700000000,28,097,"Montgomery County, MS",Jan-22,3895,3690,205,5.30000000
CN2809900000000,28,099,"Neshoba County, MS",Jan-22,9908,9410,498,5.00000000
CN2810100000000,28,101,"Newton County, MS",Jan-22,8121,7737,384,4.70000000
CN2810300000000,28,103,"Noxubee County, MS",Jan-22,3535,3250,285,8.10000000
CN2810500000000,28,105,"Oktibbeha County, MS",Jan-22,22349,21319,1030,4.60000000
CN2810700000000,28,107,"Panola County, MS",Jan-22,12512,11745,767,6.10000000
CN2810900000000,28,109,"Pearl River County, MS",Jan-22,23462,22378,1084,4.60000000
CN2811100000000,28,111,"Perry County, MS",Jan-22,4226,3976,250,5.90000000
CN2811300000000,28,113,"Pike County, MS",Jan-22,14213,13355,858,6.00000000
CN2811500000000,28,115,"Pontotoc County, MS",Jan-22,14898,14345,553,3.70000000
CN2811700000000,28,117,"Prentiss County, MS",Jan-22,11285,10840,445,3.90000000
CN2811900000000,28,119,"Quitman County, MS",Jan-22,2298,2132,166,7.20000000
CN2812100000000,28,121,"Rankin County, MS",Jan-22,74697,72132,2565,3.40000000
CN2812300000000,28,123,"Scott County, MS",Jan-22,12130,11637,493,4.10000000
CN2812500000000,28,125,"Sharkey County, MS",Jan-22,1386,1264,122,8.80000000
CN2812700000000,28,127,"Simpson County, MS",Jan-22,10373,9896,477,4.60000000
CN2812900000000,28,129,"Smith County, MS",Jan-22,6625,6338,287,4.30000000
CN2813100000000,28,131,"Stone County, MS",Jan-22,6903,6571,332,4.80000000
CN2813300000000,28,133,"Sunflower County, MS",Jan-22,7363,6800,563,7.60000000
CN2813500000000,28,135,"Tallahatchie County, MS",Jan-22,4691,4426,265,5.60000000
CN2813700000000,28,137,"Tate County, MS",Jan-22,12064,11505,559,4.60000000
CN2813900000000,28,139,"Tippah County, MS",Jan-22,9598,9224,374,3.90000000
CN2814100000000,28,141,"Tishomingo County, MS",Jan-22,8379,8007,372,4.40000000
CN2814300000000,28,143,"Tunica County, MS",Jan-22,4227,3914,313,7.40000000
CN2814500000000,28,145,"Union County, MS",Jan-22,14147,13655,492,3.50000000
CN2814700000000,28,147,"Walthall County, MS",Jan-22,4918,4628,290,5.90000000
CN2814900000000,28,149,"Warren County, MS",Jan-22,19063,17995,1068,5.60000000
CN2815100000000,28,151,"Washington County, MS",Jan-22,15581,14420,1161,7.50000000
CN2815300000000,28,153,"Wayne County, MS",Jan-22,7362,6921,441,6.00000000
CN2815500000000,28,155,"Webster County, MS",Jan-22,3926,3746,180,4.60000000
CN2815700000000,28,157,"Wilkinson County, MS",Jan-22,2592,2374,218,8.40000000
CN2815900000000,28,159,"Winston County, MS",Jan-22,7011,6627,384,5.50000000
CN2816100000000,28,161,"Yalobusha County, MS",Jan-22,4835,4604,231,4.80000000
CN2816300000000,28,163,"Yazoo County, MS",Jan-22,8801,8239,562,6.40000000
CN2900100000000,29,001,"Adair County, MO",Jan-22,9861,9430,431,4.40000000
CN2900300000000,29,003,"Andrew County, MO",Jan-22,9781,9475,306,3.10000000
CN2900500000000,29,005,"Atchison County, MO",Jan-22,2588,2492,96,3.70000000
CN2900700000000,29,007,"Audrain County, MO",Jan-22,10261,9866,395,3.80000000
CN2900900000000,29,009,"Barry County, MO",Jan-22,14964,14305,659,4.40000000
CN2901100000000,29,011,"Barton County, MO",Jan-22,5199,5022,177,3.40000000
CN2901300000000,29,013,"Bates County, MO",Jan-22,7672,7343,329,4.30000000
CN2901500000000,29,015,"Benton County, MO",Jan-22,7305,6876,429,5.90000000
CN2901700000000,29,017,"Bollinger County, MO",Jan-22,5376,5155,221,4.10000000
CN2901900000000,29,019,"Boone County, MO",Jan-22,99292,96313,2979,3.00000000
CN2902100000000,29,021,"Buchanan County, MO",Jan-22,43921,42348,1573,3.60000000
CN2902300000000,29,023,"Butler County, MO",Jan-22,18208,17400,808,4.40000000
CN2902500000000,29,025,"Caldwell County, MO",Jan-22,4238,4078,160,3.80000000
CN2902700000000,29,027,"Callaway County, MO",Jan-22,21508,20779,729,3.40000000
CN2902900000000,29,029,"Camden County, MO",Jan-22,18403,17293,1110,6.00000000
CN2903100000000,29,031,"Cape Girardeau County, MO",Jan-22,40984,39596,1388,3.40000000
CN2903300000000,29,033,"Carroll County, MO",Jan-22,4490,4296,194,4.30000000
CN2903500000000,29,035,"Carter County, MO",Jan-22,2570,2421,149,5.80000000
CN2903700000000,29,037,"Cass County, MO",Jan-22,55089,53082,2007,3.60000000
CN2903900000000,29,039,"Cedar County, MO",Jan-22,5743,5524,219,3.80000000
CN2904100000000,29,041,"Chariton County, MO",Jan-22,3735,3605,130,3.50000000
CN2904300000000,29,043,"Christian County, MO",Jan-22,47506,45952,1554,3.30000000
CN2904500000000,29,045,"Clark County, MO",Jan-22,3081,2946,135,4.40000000
CN2904700000000,29,047,"Clay County, MO",Jan-22,138763,133770,4993,3.60000000
CN2904900000000,29,049,"Clinton County, MO",Jan-22,10599,10181,418,3.90000000
CN2905100000000,29,051,"Cole County, MO",Jan-22,39085,37899,1186,3.00000000
CN2905300000000,29,053,"Cooper County, MO",Jan-22,7018,6747,271,3.90000000
CN2905500000000,29,055,"Crawford County, MO",Jan-22,10940,10456,484,4.40000000
CN2905700000000,29,057,"Dade County, MO",Jan-22,3498,3384,114,3.30000000
CN2905900000000,29,059,"Dallas County, MO",Jan-22,7232,6916,316,4.40000000
CN2906100000000,29,061,"Daviess County, MO",Jan-22,3961,3830,131,3.30000000
CN2906300000000,29,063,"DeKalb County, MO",Jan-22,4171,4013,158,3.80000000
CN2906500000000,29,065,"Dent County, MO",Jan-22,6275,5999,276,4.40000000
CN2906700000000,29,067,"Douglas County, MO",Jan-22,5229,5010,219,4.20000000
CN2906900000000,29,069,"Dunklin County, MO",Jan-22,11091,10422,669,6.00000000
CN2907100000000,29,071,"Franklin County, MO",Jan-22,53253,51221,2032,3.80000000
CN2907300000000,29,073,"Gasconade County, MO",Jan-22,7589,7324,265,3.50000000
CN2907500000000,29,075,"Gentry County, MO",Jan-22,3265,3167,98,3.00000000
CN2907700000000,29,077,"Greene County, MO",Jan-22,154759,149775,4984,3.20000000
CN2907900000000,29,079,"Grundy County, MO",Jan-22,4094,3925,169,4.10000000
CN2908100000000,29,081,"Harrison County, MO",Jan-22,3740,3587,153,4.10000000
CN2908300000000,29,083,"Henry County, MO",Jan-22,10165,9764,401,3.90000000
CN2908500000000,29,085,"Hickory County, MO",Jan-22,3898,3721,177,4.50000000
CN2908700000000,29,087,"Holt County, MO",Jan-22,2396,2329,67,2.80000000
CN2908900000000,29,089,"Howard County, MO",Jan-22,4868,4683,185,3.80000000
CN2909100000000,29,091,"Howell County, MO",Jan-22,16387,15680,707,4.30000000
CN2909300000000,29,093,"Iron County, MO",Jan-22,3501,3295,206,5.90000000
CN2909500000000,29,095,"Jackson County, MO",Jan-22,362595,346306,16289,4.50000000
CN2909700000000,29,097,"Jasper County, MO",Jan-22,58070,56095,1975,3.40000000
CN2909900000000,29,099,"Jefferson County, MO",Jan-22,119009,114451,4558,3.80000000
CN2910100000000,29,101,"Johnson County, MO",Jan-22,23147,22213,934,4.00000000
CN2910300000000,29,103,"Knox County, MO",Jan-22,1706,1643,63,3.70000000
CN2910500000000,29,105,"Laclede County, MO",Jan-22,16599,15912,687,4.10000000
CN2910700000000,29,107,"Lafayette County, MO",Jan-22,16724,16068,656,3.90000000
CN2910900000000,29,109,"Lawrence County, MO",Jan-22,17376,16708,668,3.80000000
CN2911100000000,29,111,"Lewis County, MO",Jan-22,4744,4575,169,3.60000000
CN2911300000000,29,113,"Lincoln County, MO",Jan-22,29853,28219,1634,5.50000000
CN2911500000000,29,115,"Linn County, MO",Jan-22,5041,4787,254,5.00000000
CN2911700000000,29,117,"Livingston County, MO",Jan-22,7213,6977,236,3.30000000
CN2911900000000,29,119,"McDonald County, MO",Jan-22,10853,10465,388,3.60000000
CN2912100000000,29,121,"Macon County, MO",Jan-22,7433,7119,314,4.20000000
CN2912300000000,29,123,"Madison County, MO",Jan-22,5517,5285,232,4.20000000
CN2912500000000,29,125,"Maries County, MO",Jan-22,3928,3781,147,3.70000000
CN2912700000000,29,127,"Marion County, MO",Jan-22,14004,13510,494,3.50000000
CN2912900000000,29,129,"Mercer County, MO",Jan-22,1735,1668,67,3.90000000
CN2913100000000,29,131,"Miller County, MO",Jan-22,12535,11994,541,4.30000000
CN2913300000000,29,133,"Mississippi County, MO",Jan-22,5296,5068,228,4.30000000
CN2913500000000,29,135,"Moniteau County, MO",Jan-22,7042,6776,266,3.80000000
CN2913700000000,29,137,"Monroe County, MO",Jan-22,3725,3560,165,4.40000000
CN2913900000000,29,139,"Montgomery County, MO",Jan-22,5833,5580,253,4.30000000
CN2914100000000,29,141,"Morgan County, MO",Jan-22,8591,8167,424,4.90000000
CN2914300000000,29,143,"New Madrid County, MO",Jan-22,8240,7885,355,4.30000000
CN2914500000000,29,145,"Newton County, MO",Jan-22,27474,26500,974,3.50000000
CN2914700000000,29,147,"Nodaway County, MO",Jan-22,10892,10555,337,3.10000000
CN2914900000000,29,149,"Oregon County, MO",Jan-22,3832,3637,195,5.10000000
CN2915100000000,29,151,"Osage County, MO",Jan-22,7013,6811,202,2.90000000
CN2915300000000,29,153,"Ozark County, MO",Jan-22,3352,3136,216,6.40000000
CN2915500000000,29,155,"Pemiscot County, MO",Jan-22,5905,5533,372,6.30000000
CN2915700000000,29,157,"Perry County, MO",Jan-22,9768,9454,314,3.20000000
CN2915900000000,29,159,"Pettis County, MO",Jan-22,20096,19310,786,3.90000000
CN2916100000000,29,161,"Phelps County, MO",Jan-22,20224,19454,770,3.80000000
CN2916300000000,29,163,"Pike County, MO",Jan-22,7324,7024,300,4.10000000
CN2916500000000,29,165,"Platte County, MO",Jan-22,60006,57980,2026,3.40000000
CN2916700000000,29,167,"Polk County, MO",Jan-22,14784,14254,530,3.60000000
CN2916900000000,29,169,"Pulaski County, MO",Jan-22,14808,14140,668,4.50000000
CN2917100000000,29,171,"Putnam County, MO",Jan-22,2144,2068,76,3.50000000
CN2917300000000,29,173,"Ralls County, MO",Jan-22,5507,5311,196,3.60000000
CN2917500000000,29,175,"Randolph County, MO",Jan-22,10324,9912,412,4.00000000
CN2917700000000,29,177,"Ray County, MO",Jan-22,10871,10411,460,4.20000000
CN2917900000000,29,179,"Reynolds County, MO",Jan-22,2888,2764,124,4.30000000
CN2918100000000,29,181,"Ripley County, MO",Jan-22,5087,4829,258,5.10000000
CN2918300000000,29,183,"St. Charles County, MO",Jan-22,230399,222041,8358,3.60000000
CN2918500000000,29,185,"St. Clair County, MO",Jan-22,3842,3673,169,4.40000000
CN2918600000000,29,186,"Ste. Genevieve County, MO",Jan-22,9207,8877,330,3.60000000
CN2918700000000,29,187,"St. Francois County, MO",Jan-22,26153,24926,1227,4.70000000
CN2918900000000,29,189,"St. Louis County, MO",Jan-22,530913,509314,21599,4.10000000
CN2919500000000,29,195,"Saline County, MO",Jan-22,10583,10205,378,3.60000000
CN2919700000000,29,197,"Schuyler County, MO",Jan-22,1811,1721,90,5.00000000
CN2919900000000,29,199,"Scotland County, MO",Jan-22,2244,2179,65,2.90000000
CN2920100000000,29,201,"Scott County, MO",Jan-22,20260,19532,728,3.60000000
CN2920300000000,29,203,"Shannon County, MO",Jan-22,3271,3075,196,6.00000000
CN2920500000000,29,205,"Shelby County, MO",Jan-22,2957,2838,119,4.00000000
CN2920700000000,29,207,"Stoddard County, MO",Jan-22,13330,12746,584,4.40000000
CN2920900000000,29,209,"Stone County, MO",Jan-22,12931,11839,1092,8.40000000
CN2921100000000,29,211,"Sullivan County, MO",Jan-22,2609,2483,126,4.80000000
CN2921300000000,29,213,"Taney County, MO",Jan-22,25151,22506,2645,10.50000000
CN2921500000000,29,215,"Texas County, MO",Jan-22,9061,8635,426,4.70000000
CN2921700000000,29,217,"Vernon County, MO",Jan-22,9453,9140,313,3.30000000
CN2921900000000,29,219,"Warren County, MO",Jan-22,19012,18127,885,4.70000000
CN2922100000000,29,221,"Washington County, MO",Jan-22,10208,9695,513,5.00000000
CN2922300000000,29,223,"Wayne County, MO",Jan-22,4783,4533,250,5.20000000
CN2922500000000,29,225,"Webster County, MO",Jan-22,17583,16996,587,3.30000000
CN2922700000000,29,227,"Worth County, MO",Jan-22,1167,1136,31,2.70000000
CN2922900000000,29,229,"Wright County, MO",Jan-22,7620,7319,301,4.00000000
CN2951000000000,29,510,"St. Louis city, MO",Jan-22,151038,142858,8180,5.40000000
CN3000100000000,30,001,"Beaverhead County, MT",Jan-22,5170,5003,167,3.20000000
CN3000300000000,30,003,"Big Horn County, MT",Jan-22,4541,4220,321,7.10000000
CN3000500000000,30,005,"Blaine County, MT",Jan-22,2255,2168,87,3.90000000
CN3000700000000,30,007,"Broadwater County, MT",Jan-22,2686,2564,122,4.50000000
CN3000900000000,30,009,"Carbon County, MT",Jan-22,5744,5551,193,3.40000000
CN3001100000000,30,011,"Carter County, MT",Jan-22,665,650,15,2.30000000
CN3001300000000,30,013,"Cascade County, MT",Jan-22,38102,36881,1221,3.20000000
CN3001500000000,30,015,"Chouteau County, MT",Jan-22,2460,2402,58,2.40000000
CN3001700000000,30,017,"Custer County, MT",Jan-22,6233,6021,212,3.40000000
CN3001900000000,30,019,"Daniels County, MT",Jan-22,889,871,18,2.00000000
CN3002100000000,30,021,"Dawson County, MT",Jan-22,4518,4392,126,2.80000000
CN3002300000000,30,023,"Deer Lodge County, MT",Jan-22,5066,4891,175,3.50000000
CN3002500000000,30,025,"Fallon County, MT",Jan-22,1614,1579,35,2.20000000
CN3002700000000,30,027,"Fergus County, MT",Jan-22,5852,5604,248,4.20000000
CN3002900000000,30,029,"Flathead County, MT",Jan-22,51155,48962,2193,4.30000000
CN3003100000000,30,031,"Gallatin County, MT",Jan-22,74483,72817,1666,2.20000000
CN3003300000000,30,033,"Garfield County, MT",Jan-22,762,737,25,3.30000000
CN3003500000000,30,035,"Glacier County, MT",Jan-22,5477,5101,376,6.90000000
CN3003700000000,30,037,"Golden Valley County, MT",Jan-22,379,364,15,4.00000000
CN3003900000000,30,039,"Granite County, MT",Jan-22,1712,1611,101,5.90000000
CN3004100000000,30,041,"Hill County, MT",Jan-22,7486,7278,208,2.80000000
CN3004300000000,30,043,"Jefferson County, MT",Jan-22,5917,5727,190,3.20000000
CN3004500000000,30,045,"Judith Basin County, MT",Jan-22,986,957,29,2.90000000
CN3004700000000,30,047,"Lake County, MT",Jan-22,14062,13506,556,4.00000000
CN3004900000000,30,049,"Lewis and Clark County, MT",Jan-22,37259,36142,1117,3.00000000
CN3005100000000,30,051,"Liberty County, MT",Jan-22,1005,979,26,2.60000000
CN3005300000000,30,053,"Lincoln County, MT",Jan-22,8078,7496,582,7.20000000
CN3005500000000,30,055,"McCone County, MT",Jan-22,989,968,21,2.10000000
CN3005700000000,30,057,"Madison County, MT",Jan-22,5317,5171,146,2.70000000
CN3005900000000,30,059,"Meagher County, MT",Jan-22,1068,1038,30,2.80000000
CN3006100000000,30,061,"Mineral County, MT",Jan-22,1862,1727,135,7.30000000
CN3006300000000,30,063,"Missoula County, MT",Jan-22,65891,63545,2346,3.60000000
CN3006500000000,30,065,"Musselshell County, MT",Jan-22,2386,2280,106,4.40000000
CN3006700000000,30,067,"Park County, MT",Jan-22,8981,8653,328,3.70000000
CN3006900000000,30,069,"Petroleum County, MT",Jan-22,280,271,9,3.20000000
CN3007100000000,30,071,"Phillips County, MT",Jan-22,1843,1762,81,4.40000000
CN3007300000000,30,073,"Pondera County, MT",Jan-22,2642,2561,81,3.10000000
CN3007500000000,30,075,"Powder River County, MT",Jan-22,997,969,28,2.80000000
CN3007700000000,30,077,"Powell County, MT",Jan-22,2919,2837,82,2.80000000
CN3007900000000,30,079,"Prairie County, MT",Jan-22,508,486,22,4.30000000
CN3008100000000,30,081,"Ravalli County, MT",Jan-22,21310,20448,862,4.00000000
CN3008300000000,30,083,"Richland County, MT",Jan-22,5951,5779,172,2.90000000
CN3008500000000,30,085,"Roosevelt County, MT",Jan-22,4306,4126,180,4.20000000
CN3008700000000,30,087,"Rosebud County, MT",Jan-22,3480,3341,139,4.00000000
CN3008900000000,30,089,"Sanders County, MT",Jan-22,5220,4895,325,6.20000000
CN3009100000000,30,091,"Sheridan County, MT",Jan-22,1773,1723,50,2.80000000
CN3009300000000,30,093,"Silver Bow County, MT",Jan-22,17466,16801,665,3.80000000
CN3009500000000,30,095,"Stillwater County, MT",Jan-22,5534,5381,153,2.80000000
CN3009700000000,30,097,"Sweet Grass County, MT",Jan-22,1924,1875,49,2.50000000
CN3009900000000,30,099,"Teton County, MT",Jan-22,2843,2752,91,3.20000000
CN3010100000000,30,101,"Toole County, MT",Jan-22,2036,1987,49,2.40000000
CN3010300000000,30,103,"Treasure County, MT",Jan-22,348,340,8,2.30000000
CN3010500000000,30,105,"Valley County, MT",Jan-22,4028,3883,145,3.60000000
CN3010700000000,30,107,"Wheatland County, MT",Jan-22,762,723,39,5.10000000
CN3010900000000,30,109,"Wibaux County, MT",Jan-22,407,393,14,3.40000000
CN3011100000000,30,111,"Yellowstone County, MT",Jan-22,85274,82731,2543,3.00000000
CN3100100000000,31,001,"Adams County, NE",Jan-22,16930,16502,428,2.50000000
CN3100300000000,31,003,"Antelope County, NE",Jan-22,3843,3766,77,2.00000000
CN3100500000000,31,005,"Arthur County, NE",Jan-22,246,242,4,1.60000000
CN3100700000000,31,007,"Banner County, NE",Jan-22,413,403,10,2.40000000
CN3100900000000,31,009,"Blaine County, NE",Jan-22,269,259,10,3.70000000
CN3101100000000,31,011,"Boone County, NE",Jan-22,3084,3025,59,1.90000000
CN3101300000000,31,013,"Box Butte County, NE",Jan-22,5476,5352,124,2.30000000
CN3101500000000,31,015,"Boyd County, NE",Jan-22,1094,1067,27,2.50000000
CN3101700000000,31,017,"Brown County, NE",Jan-22,1473,1433,40,2.70000000
CN3101900000000,31,019,"Buffalo County, NE",Jan-22,28289,27729,560,2.00000000
CN3102100000000,31,021,"Burt County, NE",Jan-22,3902,3800,102,2.60000000
CN3102300000000,31,023,"Butler County, NE",Jan-22,4780,4697,83,1.70000000
CN3102500000000,31,025,"Cass County, NE",Jan-22,13663,13299,364,2.70000000
CN3102700000000,31,027,"Cedar County, NE",Jan-22,4749,4663,86,1.80000000
CN3102900000000,31,029,"Chase County, NE",Jan-22,2335,2301,34,1.50000000
CN3103100000000,31,031,"Cherry County, NE",Jan-22,3524,3466,58,1.60000000
CN3103300000000,31,033,"Cheyenne County, NE",Jan-22,4292,4180,112,2.60000000
CN3103500000000,31,035,"Clay County, NE",Jan-22,3319,3231,88,2.70000000
CN3103700000000,31,037,"Colfax County, NE",Jan-22,5825,5716,109,1.90000000
CN3103900000000,31,039,"Cuming County, NE",Jan-22,5054,4967,87,1.70000000
CN3104100000000,31,041,"Custer County, NE",Jan-22,6568,6458,110,1.70000000
CN3104300000000,31,043,"Dakota County, NE",Jan-22,10885,10527,358,3.30000000
CN3104500000000,31,045,"Dawes County, NE",Jan-22,5061,4969,92,1.80000000
CN3104700000000,31,047,"Dawson County, NE",Jan-22,13895,13535,360,2.60000000
CN3104900000000,31,049,"Deuel County, NE",Jan-22,1001,977,24,2.40000000
CN3105100000000,31,051,"Dixon County, NE",Jan-22,3061,2995,66,2.20000000
CN3105300000000,31,053,"Dodge County, NE",Jan-22,20478,19993,485,2.40000000
CN3105500000000,31,055,"Douglas County, NE",Jan-22,304067,295318,8749,2.90000000
CN3105700000000,31,057,"Dundy County, NE",Jan-22,1222,1204,18,1.50000000
CN3105900000000,31,059,"Fillmore County, NE",Jan-22,3374,3307,67,2.00000000
CN3106100000000,31,061,"Franklin County, NE",Jan-22,1566,1532,34,2.20000000
CN3106300000000,31,063,"Frontier County, NE",Jan-22,1629,1596,33,2.00000000
CN3106500000000,31,065,"Furnas County, NE",Jan-22,2644,2599,45,1.70000000
CN3106700000000,31,067,"Gage County, NE",Jan-22,11086,10804,282,2.50000000
CN3106900000000,31,069,"Garden County, NE",Jan-22,1175,1150,25,2.10000000
CN3107100000000,31,071,"Garfield County, NE",Jan-22,1169,1145,24,2.10000000
CN3107300000000,31,073,"Gosper County, NE",Jan-22,1194,1175,19,1.60000000
CN3107500000000,31,075,"Grant County, NE",Jan-22,454,448,6,1.30000000
CN3107700000000,31,077,"Greeley County, NE",Jan-22,1284,1257,27,2.10000000
CN3107900000000,31,079,"Hall County, NE",Jan-22,32479,31593,886,2.70000000
CN3108100000000,31,081,"Hamilton County, NE",Jan-22,4931,4827,104,2.10000000
CN3108300000000,31,083,"Harlan County, NE",Jan-22,1804,1770,34,1.90000000
CN3108500000000,31,085,"Hayes County, NE",Jan-22,655,647,8,1.20000000
CN3108700000000,31,087,"Hitchcock County, NE",Jan-22,1349,1314,35,2.60000000
CN3108900000000,31,089,"Holt County, NE",Jan-22,5912,5802,110,1.90000000
CN3109100000000,31,091,"Hooker County, NE",Jan-22,392,381,11,2.80000000
CN3109300000000,31,093,"Howard County, NE",Jan-22,3487,3414,73,2.10000000
CN3109500000000,31,095,"Jefferson County, NE",Jan-22,4339,4261,78,1.80000000
CN3109700000000,31,097,"Johnson County, NE",Jan-22,2030,1968,62,3.10000000
CN3109900000000,31,099,"Kearney County, NE",Jan-22,3897,3834,63,1.60000000
CN3110100000000,31,101,"Keith County, NE",Jan-22,4615,4527,88,1.90000000
CN3110300000000,31,103,"Keya Paha County, NE",Jan-22,638,628,10,1.60000000
CN3110500000000,31,105,"Kimball County, NE",Jan-22,1983,1944,39,2.00000000
CN3110700000000,31,107,"Knox County, NE",Jan-22,4858,4737,121,2.50000000
CN3110900000000,31,109,"Lancaster County, NE",Jan-22,177123,173093,4030,2.30000000
CN3111100000000,31,111,"Lincoln County, NE",Jan-22,18390,17977,413,2.20000000
CN3111300000000,31,113,"Logan County, NE",Jan-22,491,481,10,2.00000000
CN3111500000000,31,115,"Loup County, NE",Jan-22,422,411,11,2.60000000
CN3111700000000,31,117,"McPherson County, NE",Jan-22,444,438,6,1.40000000
CN3111900000000,31,119,"Madison County, NE",Jan-22,20202,19750,452,2.20000000
CN3112100000000,31,121,"Merrick County, NE",Jan-22,4211,4117,94,2.20000000
CN3112300000000,31,123,"Morrill County, NE",Jan-22,2690,2624,66,2.50000000
CN3112500000000,31,125,"Nance County, NE",Jan-22,2037,1995,42,2.10000000
CN3112700000000,31,127,"Nemaha County, NE",Jan-22,3675,3594,81,2.20000000
CN3112900000000,31,129,"Nuckolls County, NE",Jan-22,2605,2546,59,2.30000000
CN3113100000000,31,131,"Otoe County, NE",Jan-22,8655,8443,212,2.40000000
CN3113300000000,31,133,"Pawnee County, NE",Jan-22,1573,1541,32,2.00000000
CN3113500000000,31,135,"Perkins County, NE",Jan-22,1929,1900,29,1.50000000
CN3113700000000,31,137,"Phelps County, NE",Jan-22,5113,5023,90,1.80000000
CN3113900000000,31,139,"Pierce County, NE",Jan-22,4240,4153,87,2.10000000
CN3114100000000,31,141,"Platte County, NE",Jan-22,18701,18321,380,2.00000000
CN3114300000000,31,143,"Polk County, NE",Jan-22,3049,2991,58,1.90000000
CN3114500000000,31,145,"Red Willow County, NE",Jan-22,5887,5773,114,1.90000000
CN3114700000000,31,147,"Richardson County, NE",Jan-22,4333,4237,96,2.20000000
CN3114900000000,31,149,"Rock County, NE",Jan-22,939,924,15,1.60000000
CN3115100000000,31,151,"Saline County, NE",Jan-22,7368,7182,186,2.50000000
CN3115300000000,31,153,"Sarpy County, NE",Jan-22,98977,96581,2396,2.40000000
CN3115500000000,31,155,"Saunders County, NE",Jan-22,11605,11342,263,2.30000000
CN3115700000000,31,157,"Scotts Bluff County, NE",Jan-22,17943,17468,475,2.60000000
CN3115900000000,31,159,"Seward County, NE",Jan-22,8859,8686,173,2.00000000
CN3116100000000,31,161,"Sheridan County, NE",Jan-22,2844,2790,54,1.90000000
CN3116300000000,31,163,"Sherman County, NE",Jan-22,1749,1710,39,2.20000000
CN3116500000000,31,165,"Sioux County, NE",Jan-22,803,788,15,1.90000000
CN3116700000000,31,167,"Stanton County, NE",Jan-22,3671,3598,73,2.00000000
CN3116900000000,31,169,"Thayer County, NE",Jan-22,2783,2730,53,1.90000000
CN3117100000000,31,171,"Thomas County, NE",Jan-22,444,433,11,2.50000000
CN3117300000000,31,173,"Thurston County, NE",Jan-22,3182,3086,96,3.00000000
CN3117500000000,31,175,"Valley County, NE",Jan-22,2160,2116,44,2.00000000
CN3117700000000,31,177,"Washington County, NE",Jan-22,11469,11214,255,2.20000000
CN3117900000000,31,179,"Wayne County, NE",Jan-22,5756,5647,109,1.90000000
CN3118100000000,31,181,"Webster County, NE",Jan-22,1717,1680,37,2.20000000
CN3118300000000,31,183,"Wheeler County, NE",Jan-22,624,614,10,1.60000000
CN3118500000000,31,185,"York County, NE",Jan-22,7390,7252,138,1.90000000
CN3200100000000,32,001,"Churchill County, NV",Jan-22,10998,10686,312,2.80000000
CN3200300000000,32,003,"Clark County, NV",Jan-22,1108419,1043846,64573,5.80000000
CN3200500000000,32,005,"Douglas County, NV",Jan-22,21375,20589,786,3.70000000
CN3200700000000,32,007,"Elko County, NV",Jan-22,24825,24127,698,2.80000000
CN3200900000000,32,009,"Esmeralda County, NV",Jan-22,413,401,12,2.90000000
CN3201100000000,32,011,"Eureka County, NV",Jan-22,1044,1023,21,2.00000000
CN3201300000000,32,013,"Humboldt County, NV",Jan-22,7857,7652,205,2.60000000
CN3201500000000,32,015,"Lander County, NV",Jan-22,3104,3007,97,3.10000000
CN3201700000000,32,017,"Lincoln County, NV",Jan-22,2141,2080,61,2.80000000
CN3201900000000,32,019,"Lyon County, NV",Jan-22,23247,22252,995,4.30000000
CN3202100000000,32,021,"Mineral County, NV",Jan-22,2016,1953,63,3.10000000
CN3202300000000,32,023,"Nye County, NV",Jan-22,16969,16146,823,4.90000000
CN3202700000000,32,027,"Pershing County, NV",Jan-22,2535,2457,78,3.10000000
CN3202900000000,32,029,"Storey County, NV",Jan-22,2028,1954,74,3.60000000
CN3203100000000,32,031,"Washoe County, NV",Jan-22,249579,241628,7951,3.20000000
CN3203300000000,32,033,"White Pine County, NV",Jan-22,4428,4318,110,2.50000000
CN3251000000000,32,510,"Carson City, NV",Jan-22,25281,24382,899,3.60000000
CN3300100000000,33,001,"Belknap County, NH",Jan-22,30337,29207,1130,3.70000000
CN3300300000000,33,003,"Carroll County, NH",Jan-22,22448,21615,833,3.70000000
CN3300500000000,33,005,"Cheshire County, NH",Jan-22,39071,37453,1618,4.10000000
CN3300700000000,33,007,"Coos County, NH",Jan-22,14280,13635,645,4.50000000
CN3300900000000,33,009,"Grafton County, NH",Jan-22,48491,46943,1548,3.20000000
CN3301100000000,33,011,"Hillsborough County, NH",Jan-22,239967,231412,8555,3.60000000
CN3301300000000,33,013,"Merrimack County, NH",Jan-22,81246,78599,2647,3.30000000
CN3301500000000,33,015,"Rockingham County, NH",Jan-22,186904,180186,6718,3.60000000
CN3301700000000,33,017,"Strafford County, NH",Jan-22,72381,70031,2350,3.20000000
CN3301900000000,33,019,"Sullivan County, NH",Jan-22,22801,22043,758,3.30000000
CN3400100000000,34,001,"Atlantic County, NJ",Jan-22,124154,114797,9357,7.50000000
CN3400300000000,34,003,"Bergen County, NJ",Jan-22,490063,468229,21834,4.50000000
CN3400500000000,34,005,"Burlington County, NJ",Jan-22,242190,232448,9742,4.00000000
CN3400700000000,34,007,"Camden County, NJ",Jan-22,266246,252118,14128,5.30000000
CN3400900000000,34,009,"Cape May County, NJ",Jan-22,41523,36930,4593,11.10000000
CN3401100000000,34,011,"Cumberland County, NJ",Jan-22,67724,63022,4702,6.90000000
CN3401300000000,34,013,"Essex County, NJ",Jan-22,380057,356534,23523,6.20000000
CN3401500000000,34,015,"Gloucester County, NJ",Jan-22,158207,150774,7433,4.70000000
CN3401700000000,34,017,"Hudson County, NJ",Jan-22,367851,349262,18589,5.10000000
CN3401900000000,34,019,"Hunterdon County, NJ",Jan-22,65857,63596,2261,3.40000000
CN3402100000000,34,021,"Mercer County, NJ",Jan-22,209444,201404,8040,3.80000000
CN3402300000000,34,023,"Middlesex County, NJ",Jan-22,441972,422909,19063,4.30000000
CN3402500000000,34,025,"Monmouth County, NJ",Jan-22,332729,318527,14202,4.30000000
CN3402700000000,34,027,"Morris County, NJ",Jan-22,260188,250661,9527,3.70000000
CN3402900000000,34,029,"Ocean County, NJ",Jan-22,286132,271998,14134,4.90000000
CN3403100000000,34,031,"Passaic County, NJ",Jan-22,248203,231812,16391,6.60000000
CN3403300000000,34,033,"Salem County, NJ",Jan-22,29716,27873,1843,6.20000000
CN3403500000000,34,035,"Somerset County, NJ",Jan-22,173589,167045,6544,3.80000000
CN3403700000000,34,037,"Sussex County, NJ",Jan-22,75597,71918,3679,4.90000000
CN3403900000000,34,039,"Union County, NJ",Jan-22,282383,267553,14830,5.30000000
CN3404100000000,34,041,"Warren County, NJ",Jan-22,57876,55408,2468,4.30000000
CN3500100000000,35,001,"Bernalillo County, NM",Jan-22,335858,319294,16564,4.90000000
CN3500300000000,35,003,"Catron County, NM",Jan-22,1130,1067,63,5.60000000
CN3500500000000,35,005,"Chaves County, NM",Jan-22,27505,25877,1628,5.90000000
CN3500600000000,35,006,"Cibola County, NM",Jan-22,8976,8322,654,7.30000000
CN3500700000000,35,007,"Colfax County, NM",Jan-22,5552,5282,270,4.90000000
CN3500900000000,35,009,"Curry County, NM",Jan-22,21645,20781,864,4.00000000
CN3501100000000,35,011,"De Baca County, NM",Jan-22,670,641,29,4.30000000
CN3501300000000,35,013,"Dona Ana County, NM",Jan-22,98001,92455,5546,5.70000000
CN3501500000000,35,015,"Eddy County, NM",Jan-22,31976,30442,1534,4.80000000
CN3501700000000,35,017,"Grant County, NM",Jan-22,11502,10827,675,5.90000000
CN3501900000000,35,019,"Guadalupe County, NM",Jan-22,1672,1553,119,7.10000000
CN3502100000000,35,021,"Harding County, NM",Jan-22,270,257,13,4.80000000
CN3502300000000,35,023,"Hidalgo County, NM",Jan-22,1855,1770,85,4.60000000
CN3502500000000,35,025,"Lea County, NM",Jan-22,28520,26463,2057,7.20000000
CN3502700000000,35,027,"Lincoln County, NM",Jan-22,8709,8180,529,6.10000000
CN3502800000000,35,028,"Los Alamos County, NM",Jan-22,9903,9647,256,2.60000000
CN3502900000000,35,029,"Luna County, NM",Jan-22,9502,8036,1466,15.40000000
CN3503100000000,35,031,"McKinley County, NM",Jan-22,23318,21426,1892,8.10000000
CN3503300000000,35,033,"Mora County, NM",Jan-22,1917,1803,114,5.90000000
CN3503500000000,35,035,"Otero County, NM",Jan-22,24986,23677,1309,5.20000000
CN3503700000000,35,037,"Quay County, NM",Jan-22,2987,2804,183,6.10000000
CN3503900000000,35,039,"Rio Arriba County, NM",Jan-22,16627,15630,997,6.00000000
CN3504100000000,35,041,"Roosevelt County, NM",Jan-22,7491,7145,346,4.60000000
CN3504300000000,35,043,"Sandoval County, NM",Jan-22,67884,64340,3544,5.20000000
CN3504500000000,35,045,"San Juan County, NM",Jan-22,49349,46070,3279,6.60000000
CN3504700000000,35,047,"San Miguel County, NM",Jan-22,10325,9681,644,6.20000000
CN3504900000000,35,049,"Santa Fe County, NM",Jan-22,73024,69426,3598,4.90000000
CN3505100000000,35,051,"Sierra County, NM",Jan-22,4093,3773,320,7.80000000
CN3505300000000,35,053,"Socorro County, NM",Jan-22,6087,5757,330,5.40000000
CN3505500000000,35,055,"Taos County, NM",Jan-22,14568,13498,1070,7.30000000
CN3505700000000,35,057,"Torrance County, NM",Jan-22,5330,4955,375,7.00000000
CN3505900000000,35,059,"Union County, NM",Jan-22,1548,1489,59,3.80000000
CN3506100000000,35,061,"Valencia County, NM",Jan-22,30935,29195,1740,5.60000000
CN3600100000000,36,001,"Albany County, NY",Jan-22,156375,151171,5204,3.30000000
CN3600300000000,36,003,"Allegany County, NY",Jan-22,19026,18150,876,4.60000000
CN3600500000000,36,005,"Bronx County, NY",Jan-22,595909,534803,61106,10.30000000
CN3600700000000,36,007,"Broome County, NY",Jan-22,81572,77913,3659,4.50000000
CN3600900000000,36,009,"Cattaraugus County, NY",Jan-22,33346,31779,1567,4.70000000
CN3601100000000,36,011,"Cayuga County, NY",Jan-22,34710,33322,1388,4.00000000
CN3601300000000,36,013,"Chautauqua County, NY",Jan-22,51722,49303,2419,4.70000000
CN3601500000000,36,015,"Chemung County, NY",Jan-22,34553,33132,1421,4.10000000
CN3601700000000,36,017,"Chenango County, NY",Jan-22,22030,21177,853,3.90000000
CN3601900000000,36,019,"Clinton County, NY",Jan-22,34921,33590,1331,3.80000000
CN3602100000000,36,021,"Columbia County, NY",Jan-22,29684,28750,934,3.10000000
CN3602300000000,36,023,"Cortland County, NY",Jan-22,22327,21275,1052,4.70000000
CN3602500000000,36,025,"Delaware County, NY",Jan-22,18488,17723,765,4.10000000
CN3602700000000,36,027,"Dutchess County, NY",Jan-22,141121,136182,4939,3.50000000
CN3602900000000,36,029,"Erie County, NY",Jan-22,435358,416463,18895,4.30000000
CN3603100000000,36,031,"Essex County, NY",Jan-22,16943,16197,746,4.40000000
CN3603300000000,36,033,"Franklin County, NY",Jan-22,19017,18258,759,4.00000000
CN3603500000000,36,035,"Fulton County, NY",Jan-22,22323,21255,1068,4.80000000
CN3603700000000,36,037,"Genesee County, NY",Jan-22,29306,28195,1111,3.80000000
CN3603900000000,36,039,"Greene County, NY",Jan-22,20764,19937,827,4.00000000
CN3604100000000,36,041,"Hamilton County, NY",Jan-22,2132,2021,111,5.20000000
CN3604300000000,36,043,"Herkimer County, NY",Jan-22,27568,26179,1389,5.00000000
CN3604500000000,36,045,"Jefferson County, NY",Jan-22,43470,41434,2036,4.70000000
CN3604700000000,36,047,"Kings County, NY",Jan-22,1181505,1093026,88479,7.50000000
CN3604900000000,36,049,"Lewis County, NY",Jan-22,11747,11157,590,5.00000000
CN3605100000000,36,051,"Livingston County, NY",Jan-22,30163,29019,1144,3.80000000
CN3605300000000,36,053,"Madison County, NY",Jan-22,32353,31050,1303,4.00000000
CN3605500000000,36,055,"Monroe County, NY",Jan-22,360841,346658,14183,3.90000000
CN3605700000000,36,057,"Montgomery County, NY",Jan-22,21913,20838,1075,4.90000000
CN3605900000000,36,059,"Nassau County, NY",Jan-22,706661,683246,23415,3.30000000
CN3606100000000,36,061,"New York County, NY",Jan-22,892189,842401,49788,5.60000000
CN3606300000000,36,063,"Niagara County, NY",Jan-22,96472,91832,4640,4.80000000
CN3606500000000,36,065,"Oneida County, NY",Jan-22,100024,95989,4035,4.00000000
CN3606700000000,36,067,"Onondaga County, NY",Jan-22,218853,210643,8210,3.80000000
CN3606900000000,36,069,"Ontario County, NY",Jan-22,55393,53429,1964,3.50000000
CN3607100000000,36,071,"Orange County, NY",Jan-22,183175,176499,6676,3.60000000
CN3607300000000,36,073,"Orleans County, NY",Jan-22,17136,16407,729,4.30000000
CN3607500000000,36,075,"Oswego County, NY",Jan-22,51893,49386,2507,4.80000000
CN3607700000000,36,077,"Otsego County, NY",Jan-22,26456,25376,1080,4.10000000
CN3607900000000,36,079,"Putnam County, NY",Jan-22,49977,48328,1649,3.30000000
CN3608100000000,36,081,"Queens County, NY",Jan-22,1117071,1038938,78133,7.00000000
CN3608300000000,36,083,"Rensselaer County, NY",Jan-22,80869,77993,2876,3.60000000
CN3608500000000,36,085,"Richmond County, NY",Jan-22,220794,206053,14741,6.70000000
CN3608700000000,36,087,"Rockland County, NY",Jan-22,152980,147956,5024,3.30000000
CN3608900000000,36,089,"St. Lawrence County, NY",Jan-22,42597,40631,1966,4.60000000
CN3609100000000,36,091,"Saratoga County, NY",Jan-22,119462,115918,3544,3.00000000
CN3609300000000,36,093,"Schenectady County, NY",Jan-22,76584,73698,2886,3.80000000
CN3609500000000,36,095,"Schoharie County, NY",Jan-22,14648,14029,619,4.20000000
CN3609700000000,36,097,"Schuyler County, NY",Jan-22,7929,7550,379,4.80000000
CN3609900000000,36,099,"Seneca County, NY",Jan-22,15025,14440,585,3.90000000
CN3610100000000,36,101,"Steuben County, NY",Jan-22,41338,39527,1811,4.40000000
CN3610300000000,36,103,"Suffolk County, NY",Jan-22,776675,748553,28122,3.60000000
CN3610500000000,36,105,"Sullivan County, NY",Jan-22,35832,34390,1442,4.00000000
CN3610700000000,36,107,"Tioga County, NY",Jan-22,22077,21233,844,3.80000000
CN3610900000000,36,109,"Tompkins County, NY",Jan-22,48685,47308,1377,2.80000000
CN3611100000000,36,111,"Ulster County, NY",Jan-22,86636,83469,3167,3.70000000
CN3611300000000,36,113,"Warren County, NY",Jan-22,30951,29597,1354,4.40000000
CN3611500000000,36,115,"Washington County, NY",Jan-22,27398,26293,1105,4.00000000
CN3611700000000,36,117,"Wayne County, NY",Jan-22,43247,41655,1592,3.70000000
CN3611900000000,36,119,"Westchester County, NY",Jan-22,477013,459614,17399,3.60000000
CN3612100000000,36,121,"Wyoming County, NY",Jan-22,18074,17270,804,4.40000000
CN3612300000000,36,123,"Yates County, NY",Jan-22,11709,11315,394,3.40000000
CN3700100000000,37,001,"Alamance County, NC",Jan-22,81504,78484,3020,3.70000000
CN3700300000000,37,003,"Alexander County, NC",Jan-22,17566,17013,553,3.10000000
CN3700500000000,37,005,"Alleghany County, NC",Jan-22,4124,3966,158,3.80000000
CN3700700000000,37,007,"Anson County, NC",Jan-22,10154,9635,519,5.10000000
CN3700900000000,37,009,"Ashe County, NC",Jan-22,12522,12122,400,3.20000000
CN3701100000000,37,011,"Avery County, NC",Jan-22,7125,6891,234,3.30000000
CN3701300000000,37,013,"Beaufort County, NC",Jan-22,19564,18816,748,3.80000000
CN3701500000000,37,015,"Bertie County, NC",Jan-22,7120,6762,358,5.00000000
CN3701700000000,37,017,"Bladen County, NC",Jan-22,14032,13330,702,5.00000000
CN3701900000000,37,019,"Brunswick County, NC",Jan-22,53437,50631,2806,5.30000000
CN3702100000000,37,021,"Buncombe County, NC",Jan-22,137364,133123,4241,3.10000000
CN3702300000000,37,023,"Burke County, NC",Jan-22,39896,38523,1373,3.40000000
CN3702500000000,37,025,"Cabarrus County, NC",Jan-22,111003,107232,3771,3.40000000
CN3702700000000,37,027,"Caldwell County, NC",Jan-22,35581,34272,1309,3.70000000
CN3702900000000,37,029,"Camden County, NC",Jan-22,4501,4359,142,3.20000000
CN3703100000000,37,031,"Carteret County, NC",Jan-22,30814,29721,1093,3.50000000
CN3703300000000,37,033,"Caswell County, NC",Jan-22,9584,9184,400,4.20000000
CN3703500000000,37,035,"Catawba County, NC",Jan-22,77729,75014,2715,3.50000000
CN3703700000000,37,037,"Chatham County, NC",Jan-22,36743,35731,1012,2.80000000
CN3703900000000,37,039,"Cherokee County, NC",Jan-22,10472,10065,407,3.90000000
CN3704100000000,37,041,"Chowan County, NC",Jan-22,5590,5373,217,3.90000000
CN3704300000000,37,043,"Clay County, NC",Jan-22,3976,3826,150,3.80000000
CN3704500000000,37,045,"Cleveland County, NC",Jan-22,47885,45902,1983,4.10000000
CN3704700000000,37,047,"Columbus County, NC",Jan-22,22622,21425,1197,5.30000000
CN3704900000000,37,049,"Craven County, NC",Jan-22,41039,39547,1492,3.60000000
CN3705100000000,37,051,"Cumberland County, NC",Jan-22,126718,119503,7215,5.70000000
CN3705300000000,37,053,"Currituck County, NC",Jan-22,14227,13720,507,3.60000000
CN3705500000000,37,055,"Dare County, NC",Jan-22,17511,16291,1220,7.00000000
CN3705700000000,37,057,"Davidson County, NC",Jan-22,79576,76815,2761,3.50000000
CN3705900000000,37,059,"Davie County, NC",Jan-22,20263,19602,661,3.30000000
CN3706100000000,37,061,"Duplin County, NC",Jan-22,24223,23393,830,3.40000000
CN3706300000000,37,063,"Durham County, NC",Jan-22,176944,171424,5520,3.10000000
CN3706500000000,37,065,"Edgecombe County, NC",Jan-22,20487,18918,1569,7.70000000
CN3706700000000,37,067,"Forsyth County, NC",Jan-22,184674,177672,7002,3.80000000
CN3706900000000,37,069,"Franklin County, NC",Jan-22,32646,31410,1236,3.80000000
CN3707100000000,37,071,"Gaston County, NC",Jan-22,110150,105651,4499,4.10000000
CN3707300000000,37,073,"Gates County, NC",Jan-22,4931,4779,152,3.10000000
CN3707500000000,37,075,"Graham County, NC",Jan-22,2873,2672,201,7.00000000
CN3707700000000,37,077,"Granville County, NC",Jan-22,30166,29237,929,3.10000000
CN3707900000000,37,079,"Greene County, NC",Jan-22,9433,9125,308,3.30000000
CN3708100000000,37,081,"Guilford County, NC",Jan-22,257505,246163,11342,4.40000000
CN3708300000000,37,083,"Halifax County, NC",Jan-22,19081,17894,1187,6.20000000
CN3708500000000,37,085,"Harnett County, NC",Jan-22,53256,51023,2233,4.20000000
CN3708700000000,37,087,"Haywood County, NC",Jan-22,29200,28244,956,3.30000000
CN3708900000000,37,089,"Henderson County, NC",Jan-22,53559,51913,1646,3.10000000
CN3709100000000,37,091,"Hertford County, NC",Jan-22,8453,8018,435,5.10000000
CN3709300000000,37,093,"Hoke County, NC",Jan-22,20031,18988,1043,5.20000000
CN3709500000000,37,095,"Hyde County, NC",Jan-22,1657,1524,133,8.00000000
CN3709700000000,37,097,"Iredell County, NC",Jan-22,90577,87392,3185,3.50000000
CN3709900000000,37,099,"Jackson County, NC",Jan-22,18046,17366,680,3.80000000
CN3710100000000,37,101,"Johnston County, NC",Jan-22,103462,100100,3362,3.20000000
CN3710300000000,37,103,"Jones County, NC",Jan-22,4172,4038,134,3.20000000
CN3710500000000,37,105,"Lee County, NC",Jan-22,25629,24513,1116,4.40000000
CN3710700000000,37,107,"Lenoir County, NC",Jan-22,27200,26135,1065,3.90000000
CN3710900000000,37,109,"Lincoln County, NC",Jan-22,44344,42933,1411,3.20000000
CN3711100000000,37,111,"McDowell County, NC",Jan-22,19700,19041,659,3.30000000
CN3711300000000,37,113,"Macon County, NC",Jan-22,14990,14484,506,3.40000000
CN3711500000000,37,115,"Madison County, NC",Jan-22,9718,9401,317,3.30000000
CN3711700000000,37,117,"Martin County, NC",Jan-22,8643,8270,373,4.30000000
CN3711900000000,37,119,"Mecklenburg County, NC",Jan-22,626136,601950,24186,3.90000000
CN3712100000000,37,121,"Mitchell County, NC",Jan-22,5901,5643,258,4.40000000
CN3712300000000,37,123,"Montgomery County, NC",Jan-22,10907,10512,395,3.60000000
CN3712500000000,37,125,"Moore County, NC",Jan-22,40273,38850,1423,3.50000000
CN3712700000000,37,127,"Nash County, NC",Jan-22,42395,40208,2187,5.20000000
CN3712900000000,37,129,"New Hanover County, NC",Jan-22,124618,120514,4104,3.30000000
CN3713100000000,37,131,"Northampton County, NC",Jan-22,7141,6777,364,5.10000000
CN3713300000000,37,133,"Onslow County, NC",Jan-22,65903,63259,2644,4.00000000
CN3713500000000,37,135,"Orange County, NC",Jan-22,80184,78090,2094,2.60000000
CN3713700000000,37,137,"Pamlico County, NC",Jan-22,5350,5163,187,3.50000000
CN3713900000000,37,139,"Pasquotank County, NC",Jan-22,16202,15496,706,4.40000000
CN3714100000000,37,141,"Pender County, NC",Jan-22,29473,28504,969,3.30000000
CN3714300000000,37,143,"Perquimans County, NC",Jan-22,4796,4579,217,4.50000000
CN3714500000000,37,145,"Person County, NC",Jan-22,18608,17890,718,3.90000000
CN3714700000000,37,147,"Pitt County, NC",Jan-22,88710,85231,3479,3.90000000
CN3714900000000,37,149,"Polk County, NC",Jan-22,9044,8689,355,3.90000000
CN3715100000000,37,151,"Randolph County, NC",Jan-22,64284,62028,2256,3.50000000
CN3715300000000,37,153,"Richmond County, NC",Jan-22,16333,15301,1032,6.30000000
CN3715500000000,37,155,"Robeson County, NC",Jan-22,48371,45287,3084,6.40000000
CN3715700000000,37,157,"Rockingham County, NC",Jan-22,38955,37278,1677,4.30000000
CN3715900000000,37,159,"Rowan County, NC",Jan-22,64873,62394,2479,3.80000000
CN3716100000000,37,161,"Rutherford County, NC",Jan-22,24088,22818,1270,5.30000000
CN3716300000000,37,163,"Sampson County, NC",Jan-22,27698,26700,998,3.60000000
CN3716500000000,37,165,"Scotland County, NC",Jan-22,11179,10281,898,8.00000000
CN3716700000000,37,167,"Stanly County, NC",Jan-22,29707,28716,991,3.30000000
CN3716900000000,37,169,"Stokes County, NC",Jan-22,21123,20440,683,3.20000000
CN3717100000000,37,171,"Surry County, NC",Jan-22,32009,30946,1063,3.30000000
CN3717300000000,37,173,"Swain County, NC",Jan-22,6641,6395,246,3.70000000
CN3717500000000,37,175,"Transylvania County, NC",Jan-22,13948,13494,454,3.30000000
CN3717700000000,37,177,"Tyrrell County, NC",Jan-22,1145,1061,84,7.30000000
CN3717900000000,37,179,"Union County, NC",Jan-22,124361,120614,3747,3.00000000
CN3718100000000,37,181,"Vance County, NC",Jan-22,16822,15716,1106,6.60000000
CN3718300000000,37,183,"Wake County, NC",Jan-22,605270,586857,18413,3.00000000
CN3718500000000,37,185,"Warren County, NC",Jan-22,6398,5962,436,6.80000000
CN3718700000000,37,187,"Washington County, NC",Jan-22,4181,3938,243,5.80000000
CN3718900000000,37,189,"Watauga County, NC",Jan-22,28839,28062,777,2.70000000
CN3719100000000,37,191,"Wayne County, NC",Jan-22,50930,48919,2011,3.90000000
CN3719300000000,37,193,"Wilkes County, NC",Jan-22,27160,26171,989,3.60000000
CN3719500000000,37,195,"Wilson County, NC",Jan-22,33097,31246,1851,5.60000000
CN3719700000000,37,197,"Yadkin County, NC",Jan-22,17188,16632,556,3.20000000
CN3719900000000,37,199,"Yancey County, NC",Jan-22,7980,7703,277,3.50000000
CN3800100000000,38,001,"Adams County, ND",Jan-22,929,902,27,2.90000000
CN3800300000000,38,003,"Barnes County, ND",Jan-22,5246,5069,177,3.40000000
CN3800500000000,38,005,"Benson County, ND",Jan-22,2254,2156,98,4.30000000
CN3800700000000,38,007,"Billings County, ND",Jan-22,368,356,12,3.30000000
CN3800900000000,38,009,"Bottineau County, ND",Jan-22,2911,2755,156,5.40000000
CN3801100000000,38,011,"Bowman County, ND",Jan-22,1546,1513,33,2.10000000
CN3801300000000,38,013,"Burke County, ND",Jan-22,1029,992,37,3.60000000
CN3801500000000,38,015,"Burleigh County, ND",Jan-22,52397,50783,1614,3.10000000
CN3801700000000,38,017,"Cass County, ND",Jan-22,108230,105273,2957,2.70000000
CN3801900000000,38,019,"Cavalier County, ND",Jan-22,1826,1760,66,3.60000000
CN3802100000000,38,021,"Dickey County, ND",Jan-22,2225,2173,52,2.30000000
CN3802300000000,38,023,"Divide County, ND",Jan-22,1361,1331,30,2.20000000
CN3802500000000,38,025,"Dunn County, ND",Jan-22,3146,3070,76,2.40000000
CN3802700000000,38,027,"Eddy County, ND",Jan-22,1173,1109,64,5.50000000
CN3802900000000,38,029,"Emmons County, ND",Jan-22,1482,1378,104,7.00000000
CN3803100000000,38,031,"Foster County, ND",Jan-22,1483,1433,50,3.40000000
CN3803300000000,38,033,"Golden Valley County, ND",Jan-22,821,805,16,1.90000000
CN3803500000000,38,035,"Grand Forks County, ND",Jan-22,37807,36726,1081,2.90000000
CN3803700000000,38,037,"Grant County, ND",Jan-22,1228,1190,38,3.10000000
CN3803900000000,38,039,"Griggs County, ND",Jan-22,1023,986,37,3.60000000
CN3804100000000,38,041,"Hettinger County, ND",Jan-22,1369,1327,42,3.10000000
CN3804300000000,38,043,"Kidder County, ND",Jan-22,1334,1230,104,7.80000000
CN3804500000000,38,045,"LaMoure County, ND",Jan-22,1978,1915,63,3.20000000
CN3804700000000,38,047,"Logan County, ND",Jan-22,858,831,27,3.10000000
CN3804900000000,38,049,"McHenry County, ND",Jan-22,3150,2959,191,6.10000000
CN3805100000000,38,051,"McIntosh County, ND",Jan-22,1054,1020,34,3.20000000
CN3805300000000,38,053,"McKenzie County, ND",Jan-22,8620,8267,353,4.10000000
CN3805500000000,38,055,"McLean County, ND",Jan-22,4582,4364,218,4.80000000
CN3805700000000,38,057,"Mercer County, ND",Jan-22,3465,3267,198,5.70000000
CN3805900000000,38,059,"Morton County, ND",Jan-22,17363,16614,749,4.30000000
CN3806100000000,38,061,"Mountrail County, ND",Jan-22,6374,6203,171,2.70000000
CN3806300000000,38,063,"Nelson County, ND",Jan-22,1368,1309,59,4.30000000
CN3806500000000,38,065,"Oliver County, ND",Jan-22,894,838,56,6.30000000
CN3806700000000,38,067,"Pembina County, ND",Jan-22,3247,3060,187,5.80000000
CN3806900000000,38,069,"Pierce County, ND",Jan-22,1646,1580,66,4.00000000
CN3807100000000,38,071,"Ramsey County, ND",Jan-22,5629,5442,187,3.30000000
CN3807300000000,38,073,"Ransom County, ND",Jan-22,2655,2585,70,2.60000000
CN3807500000000,38,075,"Renville County, ND",Jan-22,1189,1145,44,3.70000000
CN3807700000000,38,077,"Richland County, ND",Jan-22,8546,8309,237,2.80000000
CN3807900000000,38,079,"Rolette County, ND",Jan-22,4856,4373,483,9.90000000
CN3808100000000,38,081,"Sargent County, ND",Jan-22,2307,2241,66,2.90000000
CN3808300000000,38,083,"Sheridan County, ND",Jan-22,635,598,37,5.80000000
CN3808500000000,38,085,"Sioux County, ND",Jan-22,1203,1172,31,2.60000000
CN3808700000000,38,087,"Slope County, ND",Jan-22,345,334,11,3.20000000
CN3808900000000,38,089,"Stark County, ND",Jan-22,17480,16850,630,3.60000000
CN3809100000000,38,091,"Steele County, ND",Jan-22,893,868,25,2.80000000
CN3809300000000,38,093,"Stutsman County, ND",Jan-22,10276,9944,332,3.20000000
CN3809500000000,38,095,"Towner County, ND",Jan-22,1083,1041,42,3.90000000
CN3809700000000,38,097,"Traill County, ND",Jan-22,4410,4284,126,2.90000000
CN3809900000000,38,099,"Walsh County, ND",Jan-22,5199,4925,274,5.30000000
CN3810100000000,38,101,"Ward County, ND",Jan-22,31498,30281,1217,3.90000000
CN3810300000000,38,103,"Wells County, ND",Jan-22,1848,1751,97,5.20000000
CN3810500000000,38,105,"Williams County, ND",Jan-22,20480,19394,1086,5.30000000
CN3900100000000,39,001,"Adams County, OH",Jan-22,10916,10135,781,7.20000000
CN3900300000000,39,003,"Allen County, OH",Jan-22,47178,44919,2259,4.80000000
CN3900500000000,39,005,"Ashland County, OH",Jan-22,25752,24573,1179,4.60000000
CN3900700000000,39,007,"Ashtabula County, OH",Jan-22,42716,40336,2380,5.60000000
CN3900900000000,39,009,"Athens County, OH",Jan-22,23812,22401,1411,5.90000000
CN3901100000000,39,011,"Auglaize County, OH",Jan-22,24191,23382,809,3.30000000
CN3901300000000,39,013,"Belmont County, OH",Jan-22,28187,26424,1763,6.30000000
CN3901500000000,39,015,"Brown County, OH",Jan-22,19459,18362,1097,5.60000000
CN3901700000000,39,017,"Butler County, OH",Jan-22,195241,187519,7722,4.00000000
CN3901900000000,39,019,"Carroll County, OH",Jan-22,12639,11975,664,5.30000000
CN3902100000000,39,021,"Champaign County, OH",Jan-22,19194,18288,906,4.70000000
CN3902300000000,39,023,"Clark County, OH",Jan-22,62793,59507,3286,5.20000000
CN3902500000000,39,025,"Clermont County, OH",Jan-22,107242,102889,4353,4.10000000
CN3902700000000,39,027,"Clinton County, OH",Jan-22,18046,17136,910,5.00000000
CN3902900000000,39,029,"Columbiana County, OH",Jan-22,44876,42491,2385,5.30000000
CN3903100000000,39,031,"Coshocton County, OH",Jan-22,13396,12626,770,5.70000000
CN3903300000000,39,033,"Crawford County, OH",Jan-22,17564,16589,975,5.60000000
CN3903500000000,39,035,"Cuyahoga County, OH",Jan-22,590141,553992,36149,6.10000000
CN3903700000000,39,037,"Darke County, OH",Jan-22,25463,24409,1054,4.10000000
CN3903900000000,39,039,"Defiance County, OH",Jan-22,17296,16570,726,4.20000000
CN3904100000000,39,041,"Delaware County, OH",Jan-22,115185,111619,3566,3.10000000
CN3904300000000,39,043,"Erie County, OH",Jan-22,35720,33185,2535,7.10000000
CN3904500000000,39,045,"Fairfield County, OH",Jan-22,80131,77044,3087,3.90000000
CN3904700000000,39,047,"Fayette County, OH",Jan-22,13579,12965,614,4.50000000
CN3904900000000,39,049,"Franklin County, OH",Jan-22,708584,681562,27022,3.80000000
CN3905100000000,39,051,"Fulton County, OH",Jan-22,21869,20764,1105,5.10000000
CN3905300000000,39,053,"Gallia County, OH",Jan-22,12159,11477,682,5.60000000
CN3905500000000,39,055,"Geauga County, OH",Jan-22,47331,45030,2301,4.90000000
CN3905700000000,39,057,"Greene County, OH",Jan-22,83125,79943,3182,3.80000000
CN3905900000000,39,059,"Guernsey County, OH",Jan-22,17584,16475,1109,6.30000000
CN3906100000000,39,061,"Hamilton County, OH",Jan-22,414236,397406,16830,4.10000000
CN3906300000000,39,063,"Hancock County, OH",Jan-22,40258,38870,1388,3.40000000
CN3906500000000,39,065,"Hardin County, OH",Jan-22,13427,12817,610,4.50000000
CN3906700000000,39,067,"Harrison County, OH",Jan-22,6381,5979,402,6.30000000
CN3906900000000,39,069,"Henry County, OH",Jan-22,12545,11764,781,6.20000000
CN3907100000000,39,071,"Highland County, OH",Jan-22,17324,16282,1042,6.00000000
CN3907300000000,39,073,"Hocking County, OH",Jan-22,13037,12381,656,5.00000000
CN3907500000000,39,075,"Holmes County, OH",Jan-22,20986,20386,600,2.90000000
CN3907700000000,39,077,"Huron County, OH",Jan-22,27140,25138,2002,7.40000000
CN3907900000000,39,079,"Jackson County, OH",Jan-22,12441,11680,761,6.10000000
CN3908100000000,39,081,"Jefferson County, OH",Jan-22,27229,25548,1681,6.20000000
CN3908300000000,39,083,"Knox County, OH",Jan-22,30515,29235,1280,4.20000000
CN3908500000000,39,085,"Lake County, OH",Jan-22,122296,115771,6525,5.30000000
CN3908700000000,39,087,"Lawrence County, OH",Jan-22,23329,22175,1154,4.90000000
CN3908900000000,39,089,"Licking County, OH",Jan-22,91828,88387,3441,3.70000000
CN3909100000000,39,091,"Logan County, OH",Jan-22,22361,21428,933,4.20000000
CN3909300000000,39,093,"Lorain County, OH",Jan-22,152413,141743,10670,7.00000000
CN3909500000000,39,095,"Lucas County, OH",Jan-22,205732,194860,10872,5.30000000
CN3909700000000,39,097,"Madison County, OH",Jan-22,20873,20107,766,3.70000000
CN3909900000000,39,099,"Mahoning County, OH",Jan-22,97872,92225,5647,5.80000000
CN3910100000000,39,101,"Marion County, OH",Jan-22,27761,26582,1179,4.20000000
CN3910300000000,39,103,"Medina County, OH",Jan-22,95397,90902,4495,4.70000000
CN3910500000000,39,105,"Meigs County, OH",Jan-22,8583,7933,650,7.60000000
CN3910700000000,39,107,"Mercer County, OH",Jan-22,22330,21666,664,3.00000000
CN3910900000000,39,109,"Miami County, OH",Jan-22,54115,51946,2169,4.00000000
CN3911100000000,39,111,"Monroe County, OH",Jan-22,5193,4739,454,8.70000000
CN3911300000000,39,113,"Montgomery County, OH",Jan-22,249771,238200,11571,4.60000000
CN3911500000000,39,115,"Morgan County, OH",Jan-22,6727,6180,547,8.10000000
CN3911700000000,39,117,"Morrow County, OH",Jan-22,17034,16272,762,4.50000000
CN3911900000000,39,119,"Muskingum County, OH",Jan-22,40067,37851,2216,5.50000000
CN3912100000000,39,121,"Noble County, OH",Jan-22,4554,4211,343,7.50000000
CN3912300000000,39,123,"Ottawa County, OH",Jan-22,19616,18107,1509,7.70000000
CN3912500000000,39,125,"Paulding County, OH",Jan-22,8458,8143,315,3.70000000
CN3912700000000,39,127,"Perry County, OH",Jan-22,16074,15159,915,5.70000000
CN3912900000000,39,129,"Pickaway County, OH",Jan-22,26820,25642,1178,4.40000000
CN3913100000000,39,131,"Pike County, OH",Jan-22,10790,10066,724,6.70000000
CN3913300000000,39,133,"Portage County, OH",Jan-22,84481,80639,3842,4.50000000
CN3913500000000,39,135,"Preble County, OH",Jan-22,21677,20832,845,3.90000000
CN3913700000000,39,137,"Putnam County, OH",Jan-22,18593,17951,642,3.50000000
CN3913900000000,39,139,"Richland County, OH",Jan-22,51666,48920,2746,5.30000000
CN3914100000000,39,141,"Ross County, OH",Jan-22,34781,33078,1703,4.90000000
CN3914300000000,39,143,"Sandusky County, OH",Jan-22,29956,28497,1459,4.90000000
CN3914500000000,39,145,"Scioto County, OH",Jan-22,29152,27333,1819,6.20000000
CN3914700000000,39,147,"Seneca County, OH",Jan-22,26329,25130,1199,4.60000000
CN3914900000000,39,149,"Shelby County, OH",Jan-22,23560,22603,957,4.10000000
CN3915100000000,39,151,"Stark County, OH",Jan-22,181671,172927,8744,4.80000000
CN3915300000000,39,153,"Summit County, OH",Jan-22,263301,250470,12831,4.90000000
CN3915500000000,39,155,"Trumbull County, OH",Jan-22,82794,77830,4964,6.00000000
CN3915700000000,39,157,"Tuscarawas County, OH",Jan-22,43683,41621,2062,4.70000000
CN3915900000000,39,159,"Union County, OH",Jan-22,30071,29068,1003,3.30000000
CN3916100000000,39,161,"Van Wert County, OH",Jan-22,14525,13984,541,3.70000000
CN3916300000000,39,163,"Vinton County, OH",Jan-22,5431,5069,362,6.70000000
CN3916500000000,39,165,"Warren County, OH",Jan-22,121322,116988,4334,3.60000000
CN3916700000000,39,167,"Washington County, OH",Jan-22,26562,25022,1540,5.80000000
CN3916900000000,39,169,"Wayne County, OH",Jan-22,59122,57033,2089,3.50000000
CN3917100000000,39,171,"Williams County, OH",Jan-22,18277,17534,743,4.10000000
CN3917300000000,39,173,"Wood County, OH",Jan-22,69734,67076,2658,3.80000000
CN3917500000000,39,175,"Wyandot County, OH",Jan-22,12715,12272,443,3.50000000
CN4000100000000,40,001,"Adair County, OK",Jan-22,8465,8185,280,3.30000000
CN4000300000000,40,003,"Alfalfa County, OK",Jan-22,2625,2572,53,2.00000000
CN4000500000000,40,005,"Atoka County, OK",Jan-22,5026,4836,190,3.80000000
CN4000700000000,40,007,"Beaver County, OK",Jan-22,2595,2550,45,1.70000000
CN4000900000000,40,009,"Beckham County, OK",Jan-22,9414,9128,286,3.00000000
CN4001100000000,40,011,"Blaine County, OK",Jan-22,4342,4248,94,2.20000000
CN4001300000000,40,013,"Bryan County, OK",Jan-22,21806,21206,600,2.80000000
CN4001500000000,40,015,"Caddo County, OK",Jan-22,12162,11803,359,3.00000000
CN4001700000000,40,017,"Canadian County, OK",Jan-22,78800,76821,1979,2.50000000
CN4001900000000,40,019,"Carter County, OK",Jan-22,21143,20402,741,3.50000000
CN4002100000000,40,021,"Cherokee County, OK",Jan-22,19778,19096,682,3.40000000
CN4002300000000,40,023,"Choctaw County, OK",Jan-22,6058,5812,246,4.10000000
CN4002500000000,40,025,"Cimarron County, OK",Jan-22,1497,1474,23,1.50000000
CN4002700000000,40,027,"Cleveland County, OK",Jan-22,145437,141796,3641,2.50000000
CN4002900000000,40,029,"Coal County, OK",Jan-22,2318,2246,72,3.10000000
CN4003100000000,40,031,"Comanche County, OK",Jan-22,47052,45443,1609,3.40000000
CN4003300000000,40,033,"Cotton County, OK",Jan-22,2646,2571,75,2.80000000
CN4003500000000,40,035,"Craig County, OK",Jan-22,5601,5424,177,3.20000000
CN4003700000000,40,037,"Creek County, OK",Jan-22,31099,30018,1081,3.50000000
CN4003900000000,40,039,"Custer County, OK",Jan-22,15105,14717,388,2.60000000
CN4004100000000,40,041,"Delaware County, OK",Jan-22,18589,18018,571,3.10000000
CN4004300000000,40,043,"Dewey County, OK",Jan-22,2938,2882,56,1.90000000
CN4004500000000,40,045,"Ellis County, OK",Jan-22,2059,2011,48,2.30000000
CN4004700000000,40,047,"Garfield County, OK",Jan-22,26509,25765,744,2.80000000
CN4004900000000,40,049,"Garvin County, OK",Jan-22,12698,12336,362,2.90000000
CN4005100000000,40,051,"Grady County, OK",Jan-22,26789,26074,715,2.70000000
CN4005300000000,40,053,"Grant County, OK",Jan-22,2617,2561,56,2.10000000
CN4005500000000,40,055,"Greer County, OK",Jan-22,1782,1722,60,3.40000000
CN4005700000000,40,057,"Harmon County, OK",Jan-22,1160,1129,31,2.70000000
CN4005900000000,40,059,"Harper County, OK",Jan-22,1771,1734,37,2.10000000
CN4006100000000,40,061,"Haskell County, OK",Jan-22,4201,4025,176,4.20000000
CN4006300000000,40,063,"Hughes County, OK",Jan-22,5125,4914,211,4.10000000
CN4006500000000,40,065,"Jackson County, OK",Jan-22,10798,10528,270,2.50000000
CN4006700000000,40,067,"Jefferson County, OK",Jan-22,2453,2377,76,3.10000000
CN4006900000000,40,069,"Johnston County, OK",Jan-22,3537,3395,142,4.00000000
CN4007100000000,40,071,"Kay County, OK",Jan-22,18033,17407,626,3.50000000
CN4007300000000,40,073,"Kingfisher County, OK",Jan-22,8690,8510,180,2.10000000
CN4007500000000,40,075,"Kiowa County, OK",Jan-22,3622,3518,104,2.90000000
CN4007700000000,40,077,"Latimer County, OK",Jan-22,3010,2829,181,6.00000000
CN4007900000000,40,079,"Le Flore County, OK",Jan-22,19249,18510,739,3.80000000
CN4008100000000,40,081,"Lincoln County, OK",Jan-22,15906,15447,459,2.90000000
CN4008300000000,40,083,"Logan County, OK",Jan-22,22889,22281,608,2.70000000
CN4008500000000,40,085,"Love County, OK",Jan-22,5925,5790,135,2.30000000
CN4008700000000,40,087,"McClain County, OK",Jan-22,20495,19989,506,2.50000000
CN4008900000000,40,089,"McCurtain County, OK",Jan-22,15838,15220,618,3.90000000
CN4009100000000,40,091,"McIntosh County, OK",Jan-22,7008,6653,355,5.10000000
CN4009300000000,40,093,"Major County, OK",Jan-22,3644,3561,83,2.30000000
CN4009500000000,40,095,"Marshall County, OK",Jan-22,6988,6768,220,3.10000000
CN4009700000000,40,097,"Mayes County, OK",Jan-22,19239,18648,591,3.10000000
CN4009900000000,40,099,"Murray County, OK",Jan-22,5996,5817,179,3.00000000
CN4010100000000,40,101,"Muskogee County, OK",Jan-22,28400,27412,988,3.50000000
CN4010300000000,40,103,"Noble County, OK",Jan-22,5593,5473,120,2.10000000
CN4010500000000,40,105,"Nowata County, OK",Jan-22,4604,4473,131,2.80000000
CN4010700000000,40,107,"Okfuskee County, OK",Jan-22,4388,4218,170,3.90000000
CN4010900000000,40,109,"Oklahoma County, OK",Jan-22,390800,379367,11433,2.90000000
CN4011100000000,40,111,"Okmulgee County, OK",Jan-22,15392,14741,651,4.20000000
CN4011300000000,40,113,"Osage County, OK",Jan-22,20208,19513,695,3.40000000
CN4011500000000,40,115,"Ottawa County, OK",Jan-22,14498,14113,385,2.70000000
CN4011700000000,40,117,"Pawnee County, OK",Jan-22,7283,7023,260,3.60000000
CN4011900000000,40,119,"Payne County, OK",Jan-22,38255,37249,1006,2.60000000
CN4012100000000,40,121,"Pittsburg County, OK",Jan-22,16230,15516,714,4.40000000
CN4012300000000,40,123,"Pontotoc County, OK",Jan-22,19154,18633,521,2.70000000
CN4012500000000,40,125,"Pottawatomie County, OK",Jan-22,32751,31701,1050,3.20000000
CN4012700000000,40,127,"Pushmataha County, OK",Jan-22,4788,4632,156,3.30000000
CN4012900000000,40,129,"Roger Mills County, OK",Jan-22,1760,1719,41,2.30000000
CN4013100000000,40,131,"Rogers County, OK",Jan-22,44815,43554,1261,2.80000000
CN4013300000000,40,133,"Seminole County, OK",Jan-22,9043,8675,368,4.10000000
CN4013500000000,40,135,"Sequoyah County, OK",Jan-22,16585,15987,598,3.60000000
CN4013700000000,40,137,"Stephens County, OK",Jan-22,19146,18503,643,3.40000000
CN4013900000000,40,139,"Texas County, OK",Jan-22,11231,11028,203,1.80000000
CN4014100000000,40,141,"Tillman County, OK",Jan-22,2776,2683,93,3.40000000
CN4014300000000,40,143,"Tulsa County, OK",Jan-22,322865,313116,9749,3.00000000
CN4014500000000,40,145,"Wagoner County, OK",Jan-22,38659,37531,1128,2.90000000
CN4014700000000,40,147,"Washington County, OK",Jan-22,22332,21626,706,3.20000000
CN4014900000000,40,149,"Washita County, OK",Jan-22,4801,4633,168,3.50000000
CN4015100000000,40,151,"Woods County, OK",Jan-22,4646,4564,82,1.80000000
CN4015300000000,40,153,"Woodward County, OK",Jan-22,8471,8203,268,3.20000000
CN4100100000000,41,001,"Baker County, OR",Jan-22,7468,7057,411,5.50000000
CN4100300000000,41,003,"Benton County, OR",Jan-22,48779,47193,1586,3.30000000
CN4100500000000,41,005,"Clackamas County, OR",Jan-22,227262,217910,9352,4.10000000
CN4100700000000,41,007,"Clatsop County, OR",Jan-22,19282,18278,1004,5.20000000
CN4100900000000,41,009,"Columbia County, OR",Jan-22,25173,23872,1301,5.20000000
CN4101100000000,41,011,"Coos County, OR",Jan-22,27204,25627,1577,5.80000000
CN4101300000000,41,013,"Crook County, OR",Jan-22,11179,10426,753,6.70000000
CN4101500000000,41,015,"Curry County, OR",Jan-22,9006,8394,612,6.80000000
CN4101700000000,41,017,"Deschutes County, OR",Jan-22,105342,100384,4958,4.70000000
CN4101900000000,41,019,"Douglas County, OR",Jan-22,48133,45448,2685,5.60000000
CN4102100000000,41,021,"Gilliam County, OR",Jan-22,1014,969,45,4.40000000
CN4102300000000,41,023,"Grant County, OR",Jan-22,3183,2914,269,8.50000000
CN4102500000000,41,025,"Harney County, OR",Jan-22,3656,3434,222,6.10000000
CN4102700000000,41,027,"Hood River County, OR",Jan-22,14168,13610,558,3.90000000
CN4102900000000,41,029,"Jackson County, OR",Jan-22,108128,102790,5338,4.90000000
CN4103100000000,41,031,"Jefferson County, OR",Jan-22,10418,9734,684,6.60000000
CN4103300000000,41,033,"Josephine County, OR",Jan-22,37380,35130,2250,6.00000000
CN4103500000000,41,035,"Klamath County, OR",Jan-22,29712,27513,2199,7.40000000
CN4103700000000,41,037,"Lake County, OR",Jan-22,3598,3360,238,6.60000000
CN4103900000000,41,039,"Lane County, OR",Jan-22,184696,175880,8816,4.80000000
CN4104100000000,41,041,"Lincoln County, OR",Jan-22,21020,19714,1306,6.20000000
CN4104300000000,41,043,"Linn County, OR",Jan-22,61638,58534,3104,5.00000000
CN4104500000000,41,045,"Malheur County, OR",Jan-22,12561,11977,584,4.60000000
CN4104700000000,41,047,"Marion County, OR",Jan-22,167305,159662,7643,4.60000000
CN4104900000000,41,049,"Morrow County, OR",Jan-22,5877,5602,275,4.70000000
CN4105100000000,41,051,"Multnomah County, OR",Jan-22,470963,449219,21744,4.60000000
CN4105300000000,41,053,"Polk County, OR",Jan-22,42134,40321,1813,4.30000000
CN4105500000000,41,055,"Sherman County, OR",Jan-22,921,882,39,4.20000000
CN4105700000000,41,057,"Tillamook County, OR",Jan-22,12230,11624,606,5.00000000
CN4105900000000,41,059,"Umatilla County, OR",Jan-22,37280,35263,2017,5.40000000
CN4106100000000,41,061,"Union County, OR",Jan-22,12239,11569,670,5.50000000
CN4106300000000,41,063,"Wallowa County, OR",Jan-22,3510,3272,238,6.80000000
CN4106500000000,41,065,"Wasco County, OR",Jan-22,12966,12263,703,5.40000000
CN4106700000000,41,067,"Washington County, OR",Jan-22,333362,321187,12175,3.70000000
CN4106900000000,41,069,"Wheeler County, OR",Jan-22,739,708,31,4.20000000
CN4107100000000,41,071,"Yamhill County, OR",Jan-22,56278,53992,2286,4.10000000
CN4200100000000,42,001,"Adams County, PA",Jan-22,54524,52480,2044,3.70000000
CN4200300000000,42,003,"Allegheny County, PA",Jan-22,622394,589423,32971,5.30000000
CN4200500000000,42,005,"Armstrong County, PA",Jan-22,30988,28703,2285,7.40000000
CN4200700000000,42,007,"Beaver County, PA",Jan-22,80963,75485,5478,6.80000000
CN4200900000000,42,009,"Bedford County, PA",Jan-22,23595,22135,1460,6.20000000
CN4201100000000,42,011,"Berks County, PA",Jan-22,208181,196155,12026,5.80000000
CN4201300000000,42,013,"Blair County, PA",Jan-22,59204,56000,3204,5.40000000
CN4201500000000,42,015,"Bradford County, PA",Jan-22,27573,26149,1424,5.20000000
CN4201700000000,42,017,"Bucks County, PA",Jan-22,342491,326679,15812,4.60000000
CN4201900000000,42,019,"Butler County, PA",Jan-22,97096,92060,5036,5.20000000
CN4202100000000,42,021,"Cambria County, PA",Jan-22,55387,51675,3712,6.70000000
CN4202300000000,42,023,"Cameron County, PA",Jan-22,1956,1811,145,7.40000000
CN4202500000000,42,025,"Carbon County, PA",Jan-22,32231,30196,2035,6.30000000
CN4202700000000,42,027,"Centre County, PA",Jan-22,76207,73181,3026,4.00000000
CN4202900000000,42,029,"Chester County, PA",Jan-22,285873,275613,10260,3.60000000
CN4203100000000,42,031,"Clarion County, PA",Jan-22,16231,15167,1064,6.60000000
CN4203300000000,42,033,"Clearfield County, PA",Jan-22,35399,32879,2520,7.10000000
CN4203500000000,42,035,"Clinton County, PA",Jan-22,16965,15772,1193,7.00000000
CN4203700000000,42,037,"Columbia County, PA",Jan-22,33081,31201,1880,5.70000000
CN4203900000000,42,039,"Crawford County, PA",Jan-22,37027,34713,2314,6.20000000
CN4204100000000,42,041,"Cumberland County, PA",Jan-22,132718,127583,5135,3.90000000
CN4204300000000,42,043,"Dauphin County, PA",Jan-22,144782,137378,7404,5.10000000
CN4204500000000,42,045,"Delaware County, PA",Jan-22,294279,278501,15778,5.40000000
CN4204700000000,42,047,"Elk County, PA",Jan-22,14786,13859,927,6.30000000
CN4204900000000,42,049,"Erie County, PA",Jan-22,125987,117429,8558,6.80000000
CN4205100000000,42,051,"Fayette County, PA",Jan-22,55081,50360,4721,8.60000000
CN4205300000000,42,053,"Forest County, PA",Jan-22,1698,1565,133,7.80000000
CN4205500000000,42,055,"Franklin County, PA",Jan-22,76992,73662,3330,4.30000000
CN4205700000000,42,057,"Fulton County, PA",Jan-22,7055,6633,422,6.00000000
CN4205900000000,42,059,"Greene County, PA",Jan-22,15411,14333,1078,7.00000000
CN4206100000000,42,061,"Huntingdon County, PA",Jan-22,18691,17212,1479,7.90000000
CN4206300000000,42,063,"Indiana County, PA",Jan-22,35886,33382,2504,7.00000000
CN4206500000000,42,065,"Jefferson County, PA",Jan-22,19438,18210,1228,6.30000000
CN4206700000000,42,067,"Juniata County, PA",Jan-22,12438,11792,646,5.20000000
CN4206900000000,42,069,"Lackawanna County, PA",Jan-22,103674,97330,6344,6.10000000
CN4207100000000,42,071,"Lancaster County, PA",Jan-22,281667,269809,11858,4.20000000
CN4207300000000,42,073,"Lawrence County, PA",Jan-22,39079,36051,3028,7.70000000
CN4207500000000,42,075,"Lebanon County, PA",Jan-22,72256,68973,3283,4.50000000
CN4207700000000,42,077,"Lehigh County, PA",Jan-22,195792,184423,11369,5.80000000
CN4207900000000,42,079,"Luzerne County, PA",Jan-22,157330,145599,11731,7.50000000
CN4208100000000,42,081,"Lycoming County, PA",Jan-22,54632,51142,3490,6.40000000
CN4208300000000,42,083,"McKean County, PA",Jan-22,16570,15460,1110,6.70000000
CN4208500000000,42,085,"Mercer County, PA",Jan-22,46940,43905,3035,6.50000000
CN4208700000000,42,087,"Mifflin County, PA",Jan-22,20638,19410,1228,6.00000000
CN4208900000000,42,089,"Monroe County, PA",Jan-22,82505,76613,5892,7.10000000
CN4209100000000,42,091,"Montgomery County, PA",Jan-22,455311,436265,19046,4.20000000
CN4209300000000,42,093,"Montour County, PA",Jan-22,8927,8579,348,3.90000000
CN4209500000000,42,095,"Northampton County, PA",Jan-22,162491,153870,8621,5.30000000
CN4209700000000,42,097,"Northumberland County, PA",Jan-22,40985,38239,2746,6.70000000
CN4209900000000,42,099,"Perry County, PA",Jan-22,24253,23194,1059,4.40000000
CN4210100000000,42,101,"Philadelphia County/city, PA",Jan-22,724047,668329,55718,7.70000000
CN4210300000000,42,103,"Pike County, PA",Jan-22,25257,23425,1832,7.30000000
CN4210500000000,42,105,"Potter County, PA",Jan-22,6992,6476,516,7.40000000
CN4210700000000,42,107,"Schuylkill County, PA",Jan-22,64820,60808,4012,6.20000000
CN4210900000000,42,109,"Snyder County, PA",Jan-22,18941,17953,988,5.20000000
CN4211100000000,42,111,"Somerset County, PA",Jan-22,32847,30534,2313,7.00000000
CN4211300000000,42,113,"Sullivan County, PA",Jan-22,2525,2332,193,7.60000000
CN4211500000000,42,115,"Susquehanna County, PA",Jan-22,19988,18899,1089,5.40000000
CN4211700000000,42,117,"Tioga County, PA",Jan-22,18555,17324,1231,6.60000000
CN4211900000000,42,119,"Union County, PA",Jan-22,19043,18204,839,4.40000000
CN4212100000000,42,121,"Venango County, PA",Jan-22,21237,19902,1335,6.30000000
CN4212300000000,42,123,"Warren County, PA",Jan-22,17389,16317,1072,6.20000000
CN4212500000000,42,125,"Washington County, PA",Jan-22,103622,97262,6360,6.10000000
CN4212700000000,42,127,"Wayne County, PA",Jan-22,22012,20477,1535,7.00000000
CN4212900000000,42,129,"Westmoreland County, PA",Jan-22,173418,163243,10175,5.90000000
CN4213100000000,42,131,"Wyoming County, PA",Jan-22,13297,12465,832,6.30000000
CN4213300000000,42,133,"York County, PA",Jan-22,234526,224013,10513,4.50000000
CN4400100000000,44,001,"Bristol County, RI",Jan-22,26304,25363,941,3.60000000
CN4400300000000,44,003,"Kent County, RI",Jan-22,93044,89265,3779,4.10000000
CN4400500000000,44,005,"Newport County, RI",Jan-22,45008,43036,1972,4.40000000
CN4400700000000,44,007,"Providence County, RI",Jan-22,333106,316879,16227,4.90000000
CN4400900000000,44,009,"Washington County, RI",Jan-22,69482,66753,2729,3.90000000
CN4500100000000,45,001,"Abbeville County, SC",Jan-22,9576,9178,398,4.20000000
CN4500300000000,45,003,"Aiken County, SC",Jan-22,74398,72046,2352,3.20000000
CN4500500000000,45,005,"Allendale County, SC",Jan-22,2371,2188,183,7.70000000
CN4500700000000,45,007,"Anderson County, SC",Jan-22,90828,87821,3007,3.30000000
CN4500900000000,45,009,"Bamberg County, SC",Jan-22,4698,4354,344,7.30000000
CN4501100000000,45,011,"Barnwell County, SC",Jan-22,7504,6992,512,6.80000000
CN4501300000000,45,013,"Beaufort County, SC",Jan-22,75865,73350,2515,3.30000000
CN4501500000000,45,015,"Berkeley County, SC",Jan-22,108977,105383,3594,3.30000000
CN4501700000000,45,017,"Calhoun County, SC",Jan-22,6336,6069,267,4.20000000
CN4501900000000,45,019,"Charleston County, SC",Jan-22,214086,207207,6879,3.20000000
CN4502100000000,45,021,"Cherokee County, SC",Jan-22,24806,23645,1161,4.70000000
CN4502300000000,45,023,"Chester County, SC",Jan-22,13436,12635,801,6.00000000
CN4502500000000,45,025,"Chesterfield County, SC",Jan-22,21536,20575,961,4.50000000
CN4502700000000,45,027,"Clarendon County, SC",Jan-22,11997,11438,559,4.70000000
CN4502900000000,45,029,"Colleton County, SC",Jan-22,16063,15409,654,4.10000000
CN4503100000000,45,031,"Darlington County, SC",Jan-22,29772,28513,1259,4.20000000
CN4503300000000,45,033,"Dillon County, SC",Jan-22,13147,12374,773,5.90000000
CN4503500000000,45,035,"Dorchester County, SC",Jan-22,79044,76501,2543,3.20000000
CN4503700000000,45,037,"Edgefield County, SC",Jan-22,10353,10027,326,3.10000000
CN4503900000000,45,039,"Fairfield County, SC",Jan-22,9193,8640,553,6.00000000
CN4504100000000,45,041,"Florence County, SC",Jan-22,66083,63579,2504,3.80000000
CN4504300000000,45,043,"Georgetown County, SC",Jan-22,25442,24214,1228,4.80000000
CN4504500000000,45,045,"Greenville County, SC",Jan-22,258314,250228,8086,3.10000000
CN4504700000000,45,047,"Greenwood County, SC",Jan-22,30113,28867,1246,4.10000000
CN4504900000000,45,049,"Hampton County, SC",Jan-22,7885,7637,248,3.10000000
CN4505100000000,45,051,"Horry County, SC",Jan-22,147390,139385,8005,5.40000000
CN4505300000000,45,053,"Jasper County, SC",Jan-22,13024,12609,415,3.20000000
CN4505500000000,45,055,"Kershaw County, SC",Jan-22,28948,27931,1017,3.50000000
CN4505700000000,45,057,"Lancaster County, SC",Jan-22,43475,41572,1903,4.40000000
CN4505900000000,45,059,"Laurens County, SC",Jan-22,29933,28735,1198,4.00000000
CN4506100000000,45,061,"Lee County, SC",Jan-22,6538,6165,373,5.70000000
CN4506300000000,45,063,"Lexington County, SC",Jan-22,149193,144873,4320,2.90000000
CN4506500000000,45,065,"McCormick County, SC",Jan-22,3278,3142,136,4.10000000
CN4506700000000,45,067,"Marion County, SC",Jan-22,12826,11929,897,7.00000000
CN4506900000000,45,069,"Marlboro County, SC",Jan-22,8833,8080,753,8.50000000
CN4507100000000,45,071,"Newberry County, SC",Jan-22,18978,18399,579,3.10000000
CN4507300000000,45,073,"Oconee County, SC",Jan-22,33826,32695,1131,3.30000000
CN4507500000000,45,075,"Orangeburg County, SC",Jan-22,34108,31673,2435,7.10000000
CN4507700000000,45,077,"Pickens County, SC",Jan-22,57413,55614,1799,3.10000000
CN4507900000000,45,079,"Richland County, SC",Jan-22,195639,188199,7440,3.80000000
CN4508100000000,45,081,"Saluda County, SC",Jan-22,8160,7913,247,3.00000000
CN4508300000000,45,083,"Spartanburg County, SC",Jan-22,157720,152130,5590,3.50000000
CN4508500000000,45,085,"Sumter County, SC",Jan-22,42466,40662,1804,4.20000000
CN4508700000000,45,087,"Union County, SC",Jan-22,11604,10864,740,6.40000000
CN4508900000000,45,089,"Williamsburg County, SC",Jan-22,10870,10217,653,6.00000000
CN4509100000000,45,091,"York County, SC",Jan-22,147648,142134,5514,3.70000000
CN4600300000000,46,003,"Aurora County, SD",Jan-22,1440,1409,31,2.20000000
CN4600500000000,46,005,"Beadle County, SD",Jan-22,9150,8898,252,2.80000000
CN4600700000000,46,007,"Bennett County, SD",Jan-22,1026,985,41,4.00000000
CN4600900000000,46,009,"Bon Homme County, SD",Jan-22,2769,2703,66,2.40000000
CN4601100000000,46,011,"Brookings County, SD",Jan-22,18440,17925,515,2.80000000
CN4601300000000,46,013,"Brown County, SD",Jan-22,20395,19795,600,2.90000000
CN4601500000000,46,015,"Brule County, SD",Jan-22,2532,2481,51,2.00000000
CN4601700000000,46,017,"Buffalo County, SD",Jan-22,687,657,30,4.40000000
CN4601900000000,46,019,"Butte County, SD",Jan-22,4939,4814,125,2.50000000
CN4602100000000,46,021,"Campbell County, SD",Jan-22,752,726,26,3.50000000
CN4602300000000,46,023,"Charles Mix County, SD",Jan-22,3698,3599,99,2.70000000
CN4602500000000,46,025,"Clark County, SD",Jan-22,1839,1773,66,3.60000000
CN4602700000000,46,027,"Clay County, SD",Jan-22,7585,7403,182,2.40000000
CN4602900000000,46,029,"Codington County, SD",Jan-22,15879,15407,472,3.00000000
CN4603100000000,46,031,"Corson County, SD",Jan-22,1291,1252,39,3.00000000
CN4603300000000,46,033,"Custer County, SD",Jan-22,4069,3901,168,4.10000000
CN4603500000000,46,035,"Davison County, SD",Jan-22,10848,10577,271,2.50000000
CN4603700000000,46,037,"Day County, SD",Jan-22,2636,2491,145,5.50000000
CN4603900000000,46,039,"Deuel County, SD",Jan-22,2192,2080,112,5.10000000
CN4604100000000,46,041,"Dewey County, SD",Jan-22,2239,2132,107,4.80000000
CN4604300000000,46,043,"Douglas County, SD",Jan-22,1497,1458,39,2.60000000
CN4604500000000,46,045,"Edmunds County, SD",Jan-22,1981,1935,46,2.30000000
CN4604700000000,46,047,"Fall River County, SD",Jan-22,3001,2909,92,3.10000000
CN4604900000000,46,049,"Faulk County, SD",Jan-22,1031,1008,23,2.20000000
CN4605100000000,46,051,"Grant County, SD",Jan-22,4308,4117,191,4.40000000
CN4605300000000,46,053,"Gregory County, SD",Jan-22,2016,1972,44,2.20000000
CN4605500000000,46,055,"Haakon County, SD",Jan-22,1035,1005,30,2.90000000
CN4605700000000,46,057,"Hamlin County, SD",Jan-22,3422,3320,102,3.00000000
CN4605900000000,46,059,"Hand County, SD",Jan-22,1718,1675,43,2.50000000
CN4606100000000,46,061,"Hanson County, SD",Jan-22,1751,1679,72,4.10000000
CN4606300000000,46,063,"Harding County, SD",Jan-22,705,690,15,2.10000000
CN4606500000000,46,065,"Hughes County, SD",Jan-22,9812,9585,227,2.30000000
CN4606700000000,46,067,"Hutchinson County, SD",Jan-22,3627,3505,122,3.40000000
CN4606900000000,46,069,"Hyde County, SD",Jan-22,632,620,12,1.90000000
CN4607100000000,46,071,"Jackson County, SD",Jan-22,1099,1043,56,5.10000000
CN4607300000000,46,073,"Jerauld County, SD",Jan-22,1324,1306,18,1.40000000
CN4607500000000,46,075,"Jones County, SD",Jan-22,480,465,15,3.10000000
CN4607700000000,46,077,"Kingsbury County, SD",Jan-22,2627,2553,74,2.80000000
CN4607900000000,46,079,"Lake County, SD",Jan-22,6480,6312,168,2.60000000
CN4608100000000,46,081,"Lawrence County, SD",Jan-22,13625,13321,304,2.20000000
CN4608300000000,46,083,"Lincoln County, SD",Jan-22,36964,36183,781,2.10000000
CN4608500000000,46,085,"Lyman County, SD",Jan-22,1611,1558,53,3.30000000
CN4608700000000,46,087,"McCook County, SD",Jan-22,3038,2967,71,2.30000000
CN4608900000000,46,089,"McPherson County, SD",Jan-22,946,911,35,3.70000000
CN4609100000000,46,091,"Marshall County, SD",Jan-22,2381,2277,104,4.40000000
CN4609300000000,46,093,"Meade County, SD",Jan-22,13957,13595,362,2.60000000
CN4609500000000,46,095,"Mellette County, SD",Jan-22,732,702,30,4.10000000
CN4609700000000,46,097,"Miner County, SD",Jan-22,1164,1136,28,2.40000000
CN4609900000000,46,099,"Minnehaha County, SD",Jan-22,115274,112224,3050,2.60000000
CN4610100000000,46,101,"Moody County, SD",Jan-22,3908,3804,104,2.70000000
CN4610200000000,46,102,"Oglala Lakota County, SD",Jan-22,4019,3751,268,6.70000000
CN4610300000000,46,103,"Pennington County, SD",Jan-22,57636,56153,1483,2.60000000
CN4610500000000,46,105,"Perkins County, SD",Jan-22,1359,1324,35,2.60000000
CN4610700000000,46,107,"Potter County, SD",Jan-22,995,967,28,2.80000000
CN4610900000000,46,109,"Roberts County, SD",Jan-22,4698,4419,279,5.90000000
CN4611100000000,46,111,"Sanborn County, SD",Jan-22,1183,1147,36,3.00000000
CN4611500000000,46,115,"Spink County, SD",Jan-22,3005,2900,105,3.50000000
CN4611700000000,46,117,"Stanley County, SD",Jan-22,1917,1843,74,3.90000000
CN4611900000000,46,119,"Sully County, SD",Jan-22,781,766,15,1.90000000
CN4612100000000,46,121,"Todd County, SD",Jan-22,3220,3079,141,4.40000000
CN4612300000000,46,123,"Tripp County, SD",Jan-22,2932,2865,67,2.30000000
CN4612500000000,46,125,"Turner County, SD",Jan-22,4630,4520,110,2.40000000
CN4612700000000,46,127,"Union County, SD",Jan-22,8665,8404,261,3.00000000
CN4612900000000,46,129,"Walworth County, SD",Jan-22,2099,1982,117,5.60000000
CN4613500000000,46,135,"Yankton County, SD",Jan-22,11621,11369,252,2.20000000
CN4613700000000,46,137,"Ziebach County, SD",Jan-22,932,901,31,3.30000000
CN4700100000000,47,001,"Anderson County, TN",Jan-22,35118,33974,1144,3.30000000
CN4700300000000,47,003,"Bedford County, TN",Jan-22,21157,20453,704,3.30000000
CN4700500000000,47,005,"Benton County, TN",Jan-22,6791,6481,310,4.60000000
CN4700700000000,47,007,"Bledsoe County, TN",Jan-22,4242,4034,208,4.90000000
CN4700900000000,47,009,"Blount County, TN",Jan-22,65252,63187,2065,3.20000000
CN4701100000000,47,011,"Bradley County, TN",Jan-22,50938,48899,2039,4.00000000
CN4701300000000,47,013,"Campbell County, TN",Jan-22,14881,14260,621,4.20000000
CN4701500000000,47,015,"Cannon County, TN",Jan-22,6781,6603,178,2.60000000
CN4701700000000,47,017,"Carroll County, TN",Jan-22,11402,10927,475,4.20000000
CN4701900000000,47,019,"Carter County, TN",Jan-22,24136,23259,877,3.60000000
CN4702100000000,47,021,"Cheatham County, TN",Jan-22,22333,21743,590,2.60000000
CN4702300000000,47,023,"Chester County, TN",Jan-22,8488,8245,243,2.90000000
CN4702500000000,47,025,"Claiborne County, TN",Jan-22,12744,12279,465,3.60000000
CN4702700000000,47,027,"Clay County, TN",Jan-22,2775,2631,144,5.20000000
CN4702900000000,47,029,"Cocke County, TN",Jan-22,14633,13588,1045,7.10000000
CN4703100000000,47,031,"Coffee County, TN",Jan-22,25161,24323,838,3.30000000
CN4703300000000,47,033,"Crockett County, TN",Jan-22,6784,6560,224,3.30000000
CN4703500000000,47,035,"Cumberland County, TN",Jan-22,22233,21137,1096,4.90000000
CN4703700000000,47,037,"Davidson County, TN",Jan-22,411993,398532,13461,3.30000000
CN4703900000000,47,039,"Decatur County, TN",Jan-22,4291,4056,235,5.50000000
CN4704100000000,47,041,"DeKalb County, TN",Jan-22,7758,7467,291,3.80000000
CN4704300000000,47,043,"Dickson County, TN",Jan-22,27715,26911,804,2.90000000
CN4704500000000,47,045,"Dyer County, TN",Jan-22,15971,15333,638,4.00000000
CN4704700000000,47,047,"Fayette County, TN",Jan-22,19449,18755,694,3.60000000
CN4704900000000,47,049,"Fentress County, TN",Jan-22,7530,7240,290,3.90000000
CN4705100000000,47,051,"Franklin County, TN",Jan-22,19244,18597,647,3.40000000
CN4705300000000,47,053,"Gibson County, TN",Jan-22,21420,20623,797,3.70000000
CN4705500000000,47,055,"Giles County, TN",Jan-22,14766,14239,527,3.60000000
CN4705700000000,47,057,"Grainger County, TN",Jan-22,9641,9268,373,3.90000000
CN4705900000000,47,059,"Greene County, TN",Jan-22,28865,27638,1227,4.30000000
CN4706100000000,47,061,"Grundy County, TN",Jan-22,5041,4809,232,4.60000000
CN4706300000000,47,063,"Hamblen County, TN",Jan-22,28243,27149,1094,3.90000000
CN4706500000000,47,065,"Hamilton County, TN",Jan-22,185154,177931,7223,3.90000000
CN4706700000000,47,067,"Hancock County, TN",Jan-22,2275,2179,96,4.20000000
CN4706900000000,47,069,"Hardeman County, TN",Jan-22,8848,8385,463,5.20000000
CN4707100000000,47,071,"Hardin County, TN",Jan-22,9981,9556,425,4.30000000
CN4707300000000,47,073,"Hawkins County, TN",Jan-22,23245,22375,870,3.70000000
CN4707500000000,47,075,"Haywood County, TN",Jan-22,7608,7225,383,5.00000000
CN4707700000000,47,077,"Henderson County, TN",Jan-22,11842,11395,447,3.80000000
CN4707900000000,47,079,"Henry County, TN",Jan-22,14077,13506,571,4.10000000
CN4708100000000,47,081,"Hickman County, TN",Jan-22,11613,11269,344,3.00000000
CN4708300000000,47,083,"Houston County, TN",Jan-22,3197,3051,146,4.60000000
CN4708500000000,47,085,"Humphreys County, TN",Jan-22,8640,8343,297,3.40000000
CN4708700000000,47,087,"Jackson County, TN",Jan-22,4768,4589,179,3.80000000
CN4708900000000,47,089,"Jefferson County, TN",Jan-22,25170,24119,1051,4.20000000
CN4709100000000,47,091,"Johnson County, TN",Jan-22,7779,7517,262,3.40000000
CN4709300000000,47,093,"Knox County, TN",Jan-22,249928,242935,6993,2.80000000
CN4709500000000,47,095,"Lake County, TN",Jan-22,1660,1554,106,6.40000000
CN4709700000000,47,097,"Lauderdale County, TN",Jan-22,9600,9115,485,5.10000000
CN4709900000000,47,099,"Lawrence County, TN",Jan-22,19364,18704,660,3.40000000
CN4710100000000,47,101,"Lewis County, TN",Jan-22,5556,5356,200,3.60000000
CN4710300000000,47,103,"Lincoln County, TN",Jan-22,15886,15338,548,3.40000000
CN4710500000000,47,105,"Loudon County, TN",Jan-22,24176,23452,724,3.00000000
CN4710700000000,47,107,"McMinn County, TN",Jan-22,22058,21185,873,4.00000000
CN4710900000000,47,109,"McNairy County, TN",Jan-22,8253,7867,386,4.70000000
CN4711100000000,47,111,"Macon County, TN",Jan-22,11495,11157,338,2.90000000
CN4711300000000,47,113,"Madison County, TN",Jan-22,49094,47233,1861,3.80000000
CN4711500000000,47,115,"Marion County, TN",Jan-22,12356,11852,504,4.10000000
CN4711700000000,47,117,"Marshall County, TN",Jan-22,15461,14954,507,3.30000000
CN4711900000000,47,119,"Maury County, TN",Jan-22,52756,50993,1763,3.30000000
CN4712100000000,47,121,"Meigs County, TN",Jan-22,5128,4901,227,4.40000000
CN4712300000000,47,123,"Monroe County, TN",Jan-22,20802,20108,694,3.30000000
CN4712500000000,47,125,"Montgomery County, TN",Jan-22,89080,85729,3351,3.80000000
CN4712700000000,47,127,"Moore County, TN",Jan-22,3509,3433,76,2.20000000
CN4712900000000,47,129,"Morgan County, TN",Jan-22,7822,7531,291,3.70000000
CN4713100000000,47,131,"Obion County, TN",Jan-22,12282,11763,519,4.20000000
CN4713300000000,47,133,"Overton County, TN",Jan-22,9940,9596,344,3.50000000
CN4713500000000,47,135,"Perry County, TN",Jan-22,2868,2604,264,9.20000000
CN4713700000000,47,137,"Pickett County, TN",Jan-22,2127,2040,87,4.10000000
CN4713900000000,47,139,"Polk County, TN",Jan-22,7100,6835,265,3.70000000
CN4714100000000,47,141,"Putnam County, TN",Jan-22,35407,34275,1132,3.20000000
CN4714300000000,47,143,"Rhea County, TN",Jan-22,13784,13213,571,4.10000000
CN4714500000000,47,145,"Roane County, TN",Jan-22,23646,22817,829,3.50000000
CN4714700000000,47,147,"Robertson County, TN",Jan-22,38880,37813,1067,2.70000000
CN4714900000000,47,149,"Rutherford County, TN",Jan-22,194783,189287,5496,2.80000000
CN4715100000000,47,151,"Scott County, TN",Jan-22,8036,7638,398,5.00000000
CN4715300000000,47,153,"Sequatchie County, TN",Jan-22,6182,5911,271,4.40000000
CN4715500000000,47,155,"Sevier County, TN",Jan-22,54064,51387,2677,5.00000000
CN4715700000000,47,157,"Shelby County, TN",Jan-22,451418,425443,25975,5.80000000
CN4715900000000,47,159,"Smith County, TN",Jan-22,9653,9373,280,2.90000000
CN4716100000000,47,161,"Stewart County, TN",Jan-22,5384,5168,216,4.00000000
CN4716300000000,47,163,"Sullivan County, TN",Jan-22,69069,66650,2419,3.50000000
CN4716500000000,47,165,"Sumner County, TN",Jan-22,107890,104938,2952,2.70000000
CN4716700000000,47,167,"Tipton County, TN",Jan-22,28063,27037,1026,3.70000000
CN4716900000000,47,169,"Trousdale County, TN",Jan-22,5683,5510,173,3.00000000
CN4717100000000,47,171,"Unicoi County, TN",Jan-22,7124,6780,344,4.80000000
CN4717300000000,47,173,"Union County, TN",Jan-22,7771,7487,284,3.70000000
CN4717500000000,47,175,"Van Buren County, TN",Jan-22,1992,1905,87,4.40000000
CN4717700000000,47,177,"Warren County, TN",Jan-22,16540,15807,733,4.40000000
CN4717900000000,47,179,"Washington County, TN",Jan-22,61693,59812,1881,3.00000000
CN4718100000000,47,181,"Wayne County, TN",Jan-22,6303,6000,303,4.80000000
CN4718300000000,47,183,"Weakley County, TN",Jan-22,15397,14881,516,3.40000000
CN4718500000000,47,185,"White County, TN",Jan-22,11607,11206,401,3.50000000
CN4718700000000,47,187,"Williamson County, TN",Jan-22,136477,133523,2954,2.20000000
CN4718900000000,47,189,"Wilson County, TN",Jan-22,81378,79251,2127,2.60000000
CN4800100000000,48,001,"Anderson County, TX",Jan-22,23143,22236,907,3.90000000
CN4800300000000,48,003,"Andrews County, TX",Jan-22,8882,8459,423,4.80000000
CN4800500000000,48,005,"Angelina County, TX",Jan-22,35551,33493,2058,5.80000000
CN4800700000000,48,007,"Aransas County, TX",Jan-22,9198,8571,627,6.80000000
CN4800900000000,48,009,"Archer County, TX",Jan-22,3947,3794,153,3.90000000
CN4801100000000,48,011,"Armstrong County, TX",Jan-22,909,883,26,2.90000000
CN4801300000000,48,013,"Atascosa County, TX",Jan-22,21992,20851,1141,5.20000000
CN4801500000000,48,015,"Austin County, TX",Jan-22,13754,13106,648,4.70000000
CN4801700000000,48,017,"Bailey County, TX",Jan-22,2284,2176,108,4.70000000
CN4801900000000,48,019,"Bandera County, TX",Jan-22,10283,9863,420,4.10000000
CN4802100000000,48,021,"Bastrop County, TX",Jan-22,46034,44266,1768,3.80000000
CN4802300000000,48,023,"Baylor County, TX",Jan-22,1818,1760,58,3.20000000
CN4802500000000,48,025,"Bee County, TX",Jan-22,8990,8269,721,8.00000000
CN4802700000000,48,027,"Bell County, TX",Jan-22,148397,140916,7481,5.00000000
CN4802900000000,48,029,"Bexar County, TX",Jan-22,957275,915133,42142,4.40000000
CN4803100000000,48,031,"Blanco County, TX",Jan-22,6904,6698,206,3.00000000
CN4803300000000,48,033,"Borden County, TX",Jan-22,655,639,16,2.40000000
CN4803500000000,48,035,"Bosque County, TX",Jan-22,8501,8133,368,4.30000000
CN4803700000000,48,037,"Bowie County, TX",Jan-22,39311,37217,2094,5.30000000
CN4803900000000,48,039,"Brazoria County, TX",Jan-22,182480,171363,11117,6.10000000
CN4804100000000,48,041,"Brazos County, TX",Jan-22,122331,117984,4347,3.60000000
CN4804300000000,48,043,"Brewster County, TX",Jan-22,4112,3952,160,3.90000000
CN4804500000000,48,045,"Briscoe County, TX",Jan-22,544,520,24,4.40000000
CN4804700000000,48,047,"Brooks County, TX",Jan-22,2541,2335,206,8.10000000
CN4804900000000,48,049,"Brown County, TX",Jan-22,15020,14348,672,4.50000000
CN4805100000000,48,051,"Burleson County, TX",Jan-22,8415,8051,364,4.30000000
CN4805300000000,48,053,"Burnet County, TX",Jan-22,24683,23867,816,3.30000000
CN4805500000000,48,055,"Caldwell County, TX",Jan-22,20369,19542,827,4.10000000
CN4805700000000,48,057,"Calhoun County, TX",Jan-22,12145,11610,535,4.40000000
CN4805900000000,48,059,"Callahan County, TX",Jan-22,6129,5884,245,4.00000000
CN4806100000000,48,061,"Cameron County, TX",Jan-22,175953,162607,13346,7.60000000
CN4806300000000,48,063,"Camp County, TX",Jan-22,5151,4875,276,5.40000000
CN4806500000000,48,065,"Carson County, TX",Jan-22,2935,2831,104,3.50000000
CN4806700000000,48,067,"Cass County, TX",Jan-22,12311,11579,732,5.90000000
CN4806900000000,48,069,"Castro County, TX",Jan-22,3250,3146,104,3.20000000
CN4807100000000,48,071,"Chambers County, TX",Jan-22,20940,19373,1567,7.50000000
CN4807300000000,48,073,"Cherokee County, TX",Jan-22,20542,19343,1199,5.80000000
CN4807500000000,48,075,"Childress County, TX",Jan-22,2888,2799,89,3.10000000
CN4807700000000,48,077,"Clay County, TX",Jan-22,4782,4569,213,4.50000000
CN4807900000000,48,079,"Cochran County, TX",Jan-22,992,929,63,6.40000000
CN4808100000000,48,081,"Coke County, TX",Jan-22,1334,1276,58,4.30000000
CN4808300000000,48,083,"Coleman County, TX",Jan-22,2868,2717,151,5.30000000
CN4808500000000,48,085,"Collin County, TX",Jan-22,614022,592330,21692,3.50000000
CN4808700000000,48,087,"Collingsworth County, TX",Jan-22,1044,1007,37,3.50000000
CN4808900000000,48,089,"Colorado County, TX",Jan-22,9878,9474,404,4.10000000
CN4809100000000,48,091,"Comal County, TX",Jan-22,79987,76925,3062,3.80000000
CN4809300000000,48,093,"Comanche County, TX",Jan-22,6078,5841,237,3.90000000
CN4809500000000,48,095,"Concho County, TX",Jan-22,1282,1232,50,3.90000000
CN4809700000000,48,097,"Cooke County, TX",Jan-22,19237,18466,771,4.00000000
CN4809900000000,48,099,"Coryell County, TX",Jan-22,24491,23256,1235,5.00000000
CN4810100000000,48,101,"Cottle County, TX",Jan-22,582,556,26,4.50000000
CN4810300000000,48,103,"Crane County, TX",Jan-22,1591,1469,122,7.70000000
CN4810500000000,48,105,"Crockett County, TX",Jan-22,1394,1308,86,6.20000000
CN4810700000000,48,107,"Crosby County, TX",Jan-22,2314,2205,109,4.70000000
CN4810900000000,48,109,"Culberson County, TX",Jan-22,1054,1011,43,4.10000000
CN4811100000000,48,111,"Dallam County, TX",Jan-22,3689,3604,85,2.30000000
CN4811300000000,48,113,"Dallas County, TX",Jan-22,1401272,1337801,63471,4.50000000
CN4811500000000,48,115,"Dawson County, TX",Jan-22,4522,4254,268,5.90000000
CN4811700000000,48,117,"Deaf Smith County, TX",Jan-22,8654,8359,295,3.40000000
CN4811900000000,48,119,"Delta County, TX",Jan-22,2438,2334,104,4.30000000
CN4812100000000,48,121,"Denton County, TX",Jan-22,541779,522442,19337,3.60000000
CN4812300000000,48,123,"DeWitt County, TX",Jan-22,9483,9107,376,4.00000000
CN4812500000000,48,125,"Dickens County, TX",Jan-22,687,657,30,4.40000000
CN4812700000000,48,127,"Dimmit County, TX",Jan-22,5715,5440,275,4.80000000
CN4812900000000,48,129,"Donley County, TX",Jan-22,1423,1371,52,3.70000000
CN4813100000000,48,131,"Duval County, TX",Jan-22,5519,5152,367,6.60000000
CN4813300000000,48,133,"Eastland County, TX",Jan-22,7152,6807,345,4.80000000
CN4813500000000,48,135,"Ector County, TX",Jan-22,81295,76123,5172,6.40000000
CN4813700000000,48,137,"Edwards County, TX",Jan-22,1234,1189,45,3.60000000
CN4813900000000,48,139,"Ellis County, TX",Jan-22,101311,97429,3882,3.80000000
CN4814100000000,48,141,"El Paso County, TX",Jan-22,365338,345735,19603,5.40000000
CN4814300000000,48,143,"Erath County, TX",Jan-22,20238,19435,803,4.00000000
CN4814500000000,48,145,"Falls County, TX",Jan-22,6632,6320,312,4.70000000
CN4814700000000,48,147,"Fannin County, TX",Jan-22,17247,16650,597,3.50000000
CN4814900000000,48,149,"Fayette County, TX",Jan-22,11667,11225,442,3.80000000
CN4815100000000,48,151,"Fisher County, TX",Jan-22,1558,1500,58,3.70000000
CN4815300000000,48,153,"Floyd County, TX",Jan-22,2402,2280,122,5.10000000
CN4815500000000,48,155,"Foard County, TX",Jan-22,598,579,19,3.20000000
CN4815700000000,48,157,"Fort Bend County, TX",Jan-22,411556,391177,20379,5.00000000
CN4815900000000,48,159,"Franklin County, TX",Jan-22,5161,4968,193,3.70000000
CN4816100000000,48,161,"Freestone County, TX",Jan-22,6154,5757,397,6.50000000
CN4816300000000,48,163,"Frio County, TX",Jan-22,9144,8760,384,4.20000000
CN4816500000000,48,165,"Gaines County, TX",Jan-22,9613,9265,348,3.60000000
CN4816700000000,48,167,"Galveston County, TX",Jan-22,166746,157109,9637,5.80000000
CN4816900000000,48,169,"Garza County, TX",Jan-22,1932,1856,76,3.90000000
CN4817100000000,48,171,"Gillespie County, TX",Jan-22,13945,13526,419,3.00000000
CN4817300000000,48,173,"Glasscock County, TX",Jan-22,788,766,22,2.80000000
CN4817500000000,48,175,"Goliad County, TX",Jan-22,3126,2949,177,5.70000000
CN4817700000000,48,177,"Gonzales County, TX",Jan-22,9473,9129,344,3.60000000
CN4817900000000,48,179,"Gray County, TX",Jan-22,7559,7132,427,5.60000000
CN4818100000000,48,181,"Grayson County, TX",Jan-22,66122,63500,2622,4.00000000
CN4818300000000,48,183,"Gregg County, TX",Jan-22,56616,53527,3089,5.50000000
CN4818500000000,48,185,"Grimes County, TX",Jan-22,11049,10384,665,6.00000000
CN4818700000000,48,187,"Guadalupe County, TX",Jan-22,83486,80326,3160,3.80000000
CN4818900000000,48,189,"Hale County, TX",Jan-22,11716,11080,636,5.40000000
CN4819100000000,48,191,"Hall County, TX",Jan-22,1052,1003,49,4.70000000
CN4819300000000,48,193,"Hamilton County, TX",Jan-22,3749,3614,135,3.60000000
CN4819500000000,48,195,"Hansford County, TX",Jan-22,2497,2426,71,2.80000000
CN4819700000000,48,197,"Hardeman County, TX",Jan-22,1676,1607,69,4.10000000
CN4819900000000,48,199,"Hardin County, TX",Jan-22,25015,23205,1810,7.20000000
CN4820100000000,48,201,"Harris County, TX",Jan-22,2304549,2177878,126671,5.50000000
CN4820300000000,48,203,"Harrison County, TX",Jan-22,28231,26601,1630,5.80000000
CN4820500000000,48,205,"Hartley County, TX",Jan-22,2686,2631,55,2.00000000
CN4820700000000,48,207,"Haskell County, TX",Jan-22,2707,2613,94,3.50000000
CN4820900000000,48,209,"Hays County, TX",Jan-22,132713,128052,4661,3.50000000
CN4821100000000,48,211,"Hemphill County, TX",Jan-22,1529,1461,68,4.40000000
CN4821300000000,48,213,"Henderson County, TX",Jan-22,38343,36669,1674,4.40000000
CN4821500000000,48,215,"Hidalgo County, TX",Jan-22,369704,336478,33226,9.00000000
CN4821700000000,48,217,"Hill County, TX",Jan-22,16857,16122,735,4.40000000
CN4821900000000,48,219,"Hockley County, TX",Jan-22,10629,10118,511,4.80000000
CN4822100000000,48,221,"Hood County, TX",Jan-22,29055,27799,1256,4.30000000
CN4822300000000,48,223,"Hopkins County, TX",Jan-22,17845,17174,671,3.80000000
CN4822500000000,48,225,"Houston County, TX",Jan-22,10463,10008,455,4.30000000
CN4822700000000,48,227,"Howard County, TX",Jan-22,13437,12528,909,6.80000000
CN4822900000000,48,229,"Hudspeth County, TX",Jan-22,1808,1722,86,4.80000000
CN4823100000000,48,231,"Hunt County, TX",Jan-22,45920,43900,2020,4.40000000
CN4823300000000,48,233,"Hutchinson County, TX",Jan-22,8275,7804,471,5.70000000
CN4823500000000,48,235,"Irion County, TX",Jan-22,753,721,32,4.20000000
CN4823700000000,48,237,"Jack County, TX",Jan-22,3396,3249,147,4.30000000
CN4823900000000,48,239,"Jackson County, TX",Jan-22,6962,6667,295,4.20000000
CN4824100000000,48,241,"Jasper County, TX",Jan-22,12867,11713,1154,9.00000000
CN4824300000000,48,243,"Jeff Davis County, TX",Jan-22,969,930,39,4.00000000
CN4824500000000,48,245,"Jefferson County, TX",Jan-22,102226,93113,9113,8.90000000
CN4824700000000,48,247,"Jim Hogg County, TX",Jan-22,1806,1661,145,8.00000000
CN4824900000000,48,249,"Jim Wells County, TX",Jan-22,15495,14191,1304,8.40000000
CN4825100000000,48,251,"Johnson County, TX",Jan-22,86806,83315,3491,4.00000000
CN4825300000000,48,253,"Jones County, TX",Jan-22,5694,5395,299,5.30000000
CN4825500000000,48,255,"Karnes County, TX",Jan-22,6912,6629,283,4.10000000
CN4825700000000,48,257,"Kaufman County, TX",Jan-22,73780,70737,3043,4.10000000
CN4825900000000,48,259,"Kendall County, TX",Jan-22,22910,22142,768,3.40000000
CN4826100000000,48,261,"Kenedy County, TX",Jan-22,188,176,12,6.40000000
CN4826300000000,48,263,"Kent County, TX",Jan-22,428,415,13,3.00000000
CN4826500000000,48,265,"Kerr County, TX",Jan-22,21757,20881,876,4.00000000
CN4826700000000,48,267,"Kimble County, TX",Jan-22,1849,1781,68,3.70000000
CN4826900000000,48,269,"King County, TX",Jan-22,575,571,4,0.70000000
CN4827100000000,48,271,"Kinney County, TX",Jan-22,1154,1088,66,5.70000000
CN4827300000000,48,273,"Kleberg County, TX",Jan-22,13082,12249,833,6.40000000
CN4827500000000,48,275,"Knox County, TX",Jan-22,1394,1334,60,4.30000000
CN4827700000000,48,277,"Lamar County, TX",Jan-22,24304,23078,1226,5.00000000
CN4827900000000,48,279,"Lamb County, TX",Jan-22,5054,4828,226,4.50000000
CN4828100000000,48,281,"Lampasas County, TX",Jan-22,9290,8906,384,4.10000000
CN4828300000000,48,283,"La Salle County, TX",Jan-22,3898,3761,137,3.50000000
CN4828500000000,48,285,"Lavaca County, TX",Jan-22,8595,8255,340,4.00000000
CN4828700000000,48,287,"Lee County, TX",Jan-22,8817,8480,337,3.80000000
CN4828900000000,48,289,"Leon County, TX",Jan-22,6041,5645,396,6.60000000
CN4829100000000,48,291,"Liberty County, TX",Jan-22,35099,32230,2869,8.20000000
CN4829300000000,48,293,"Limestone County, TX",Jan-22,8481,8016,465,5.50000000
CN4829500000000,48,295,"Lipscomb County, TX",Jan-22,1468,1416,52,3.50000000
CN4829700000000,48,297,"Live Oak County, TX",Jan-22,4855,4572,283,5.80000000
CN4829900000000,48,299,"Llano County, TX",Jan-22,8732,8355,377,4.30000000
CN4830100000000,48,301,"Loving County, TX",Jan-22,447,443,4,0.90000000
CN4830300000000,48,303,"Lubbock County, TX",Jan-22,161791,155755,6036,3.70000000
CN4830500000000,48,305,"Lynn County, TX",Jan-22,2753,2649,104,3.80000000
CN4830700000000,48,307,"McCulloch County, TX",Jan-22,3043,2872,171,5.60000000
CN4830900000000,48,309,"McLennan County, TX",Jan-22,124071,118937,5134,4.10000000
CN4831100000000,48,311,"McMullen County, TX",Jan-22,763,747,16,2.10000000
CN4831300000000,48,313,"Madison County, TX",Jan-22,4692,4439,253,5.40000000
CN4831500000000,48,315,"Marion County, TX",Jan-22,4258,3996,262,6.20000000
CN4831700000000,48,317,"Martin County, TX",Jan-22,2610,2499,111,4.30000000
CN4831900000000,48,319,"Mason County, TX",Jan-22,1746,1677,69,4.00000000
CN4832100000000,48,321,"Matagorda County, TX",Jan-22,16350,15033,1317,8.10000000
CN4832300000000,48,323,"Maverick County, TX",Jan-22,23880,21018,2862,12.00000000
CN4832500000000,48,325,"Medina County, TX",Jan-22,22007,21060,947,4.30000000
CN4832700000000,48,327,"Menard County, TX",Jan-22,789,756,33,4.20000000
CN4832900000000,48,329,"Midland County, TX",Jan-22,100678,96204,4474,4.40000000
CN4833100000000,48,331,"Milam County, TX",Jan-22,10246,9735,511,5.00000000
CN4833300000000,48,333,"Mills County, TX",Jan-22,1846,1755,91,4.90000000
CN4833500000000,48,335,"Mitchell County, TX",Jan-22,2332,2185,147,6.30000000
CN4833700000000,48,337,"Montague County, TX",Jan-22,9257,8863,394,4.30000000
CN4833900000000,48,339,"Montgomery County, TX",Jan-22,296322,281689,14633,4.90000000
CN4834100000000,48,341,"Moore County, TX",Jan-22,11009,10685,324,2.90000000
CN4834300000000,48,343,"Morris County, TX",Jan-22,4487,4070,417,9.30000000
CN4834500000000,48,345,"Motley County, TX",Jan-22,434,412,22,5.10000000
CN4834700000000,48,347,"Nacogdoches County, TX",Jan-22,28190,26837,1353,4.80000000
CN4834900000000,48,349,"Navarro County, TX",Jan-22,23389,22323,1066,4.60000000
CN4835100000000,48,351,"Newton County, TX",Jan-22,4921,4455,466,9.50000000
CN4835300000000,48,353,"Nolan County, TX",Jan-22,7062,6766,296,4.20000000
CN4835500000000,48,355,"Nueces County, TX",Jan-22,163522,153313,10209,6.20000000
CN4835700000000,48,357,"Ochiltree County, TX",Jan-22,3876,3729,147,3.80000000
CN4835900000000,48,359,"Oldham County, TX",Jan-22,906,879,27,3.00000000
CN4836100000000,48,361,"Orange County, TX",Jan-22,35069,32282,2787,7.90000000
CN4836300000000,48,363,"Palo Pinto County, TX",Jan-22,12572,11959,613,4.90000000
CN4836500000000,48,365,"Panola County, TX",Jan-22,9851,9274,577,5.90000000
CN4836700000000,48,367,"Parker County, TX",Jan-22,72552,69848,2704,3.70000000
CN4836900000000,48,369,"Parmer County, TX",Jan-22,4864,4739,125,2.60000000
CN4837100000000,48,371,"Pecos County, TX",Jan-22,5878,5500,378,6.40000000
CN4837300000000,48,373,"Polk County, TX",Jan-22,18538,17171,1367,7.40000000
CN4837500000000,48,375,"Potter County, TX",Jan-22,54494,52461,2033,3.70000000
CN4837700000000,48,377,"Presidio County, TX",Jan-22,3081,2822,259,8.40000000
CN4837900000000,48,379,"Rains County, TX",Jan-22,6529,6305,224,3.40000000
CN4838100000000,48,381,"Randall County, TX",Jan-22,75111,72800,2311,3.10000000
CN4838300000000,48,383,"Reagan County, TX",Jan-22,1589,1495,94,5.90000000
CN4838500000000,48,385,"Real County, TX",Jan-22,1047,988,59,5.60000000
CN4838700000000,48,387,"Red River County, TX",Jan-22,5345,5041,304,5.70000000
CN4838900000000,48,389,"Reeves County, TX",Jan-22,8979,8563,416,4.60000000
CN4839100000000,48,391,"Refugio County, TX",Jan-22,3010,2823,187,6.20000000
CN4839300000000,48,393,"Roberts County, TX",Jan-22,382,366,16,4.20000000
CN4839500000000,48,395,"Robertson County, TX",Jan-22,7546,7208,338,4.50000000
CN4839700000000,48,397,"Rockwall County, TX",Jan-22,58074,55970,2104,3.60000000
CN4839900000000,48,399,"Runnels County, TX",Jan-22,4539,4372,167,3.70000000
CN4840100000000,48,401,"Rusk County, TX",Jan-22,22168,21011,1157,5.20000000
CN4840300000000,48,403,"Sabine County, TX",Jan-22,3997,3627,370,9.30000000
CN4840500000000,48,405,"San Augustine County, TX",Jan-22,2959,2732,227,7.70000000
CN4840700000000,48,407,"San Jacinto County, TX",Jan-22,11830,11073,757,6.40000000
CN4840900000000,48,409,"San Patricio County, TX",Jan-22,29472,26954,2518,8.50000000
CN4841100000000,48,411,"San Saba County, TX",Jan-22,2189,2101,88,4.00000000
CN4841300000000,48,413,"Schleicher County, TX",Jan-22,1168,1113,55,4.70000000
CN4841500000000,48,415,"Scurry County, TX",Jan-22,5890,5548,342,5.80000000
CN4841700000000,48,417,"Shackelford County, TX",Jan-22,1804,1739,65,3.60000000
CN4841900000000,48,419,"Shelby County, TX",Jan-22,11412,10848,564,4.90000000
CN4842100000000,48,421,"Sherman County, TX",Jan-22,1373,1333,40,2.90000000
CN4842300000000,48,423,"Smith County, TX",Jan-22,110106,105311,4795,4.40000000
CN4842500000000,48,425,"Somervell County, TX",Jan-22,4450,4260,190,4.30000000
CN4842700000000,48,427,"Starr County, TX",Jan-22,25541,21308,4233,16.60000000
CN4842900000000,48,429,"Stephens County, TX",Jan-22,4306,4133,173,4.00000000
CN4843100000000,48,431,"Sterling County, TX",Jan-22,536,512,24,4.50000000
CN4843300000000,48,433,"Stonewall County, TX",Jan-22,563,543,20,3.60000000
CN4843500000000,48,435,"Sutton County, TX",Jan-22,1085,1006,79,7.30000000
CN4843700000000,48,437,"Swisher County, TX",Jan-22,2518,2414,104,4.10000000
CN4843900000000,48,439,"Tarrant County, TX",Jan-22,1115230,1067295,47935,4.30000000
CN4844100000000,48,441,"Taylor County, TX",Jan-22,67624,65103,2521,3.70000000
CN4844300000000,48,443,"Terrell County, TX",Jan-22,432,413,19,4.40000000
CN4844500000000,48,445,"Terry County, TX",Jan-22,4615,4365,250,5.40000000
CN4844700000000,48,447,"Throckmorton County, TX",Jan-22,1135,1109,26,2.30000000
CN4844900000000,48,449,"Titus County, TX",Jan-22,13591,12929,662,4.90000000
CN4845100000000,48,451,"Tom Green County, TX",Jan-22,54068,51825,2243,4.10000000
CN4845300000000,48,453,"Travis County, TX",Jan-22,787439,761765,25674,3.30000000
CN4845500000000,48,455,"Trinity County, TX",Jan-22,5199,4844,355,6.80000000
CN4845700000000,48,457,"Tyler County, TX",Jan-22,7458,6861,597,8.00000000
CN4845900000000,48,459,"Upshur County, TX",Jan-22,17651,16687,964,5.50000000
CN4846100000000,48,461,"Upton County, TX",Jan-22,1763,1684,79,4.50000000
CN4846300000000,48,463,"Uvalde County, TX",Jan-22,10949,10415,534,4.90000000
CN4846500000000,48,465,"Val Verde County, TX",Jan-22,21992,20780,1212,5.50000000
CN4846700000000,48,467,"Van Zandt County, TX",Jan-22,26832,25771,1061,4.00000000
CN4846900000000,48,469,"Victoria County, TX",Jan-22,40740,38471,2269,5.60000000
CN4847100000000,48,471,"Walker County, TX",Jan-22,23731,22417,1314,5.50000000
CN4847300000000,48,473,"Waller County, TX",Jan-22,24911,23584,1327,5.30000000
CN4847500000000,48,475,"Ward County, TX",Jan-22,5938,5600,338,5.70000000
CN4847700000000,48,477,"Washington County, TX",Jan-22,14769,14094,675,4.60000000
CN4847900000000,48,479,"Webb County, TX",Jan-22,117769,111384,6385,5.40000000
CN4848100000000,48,481,"Wharton County, TX",Jan-22,20675,19663,1012,4.90000000
CN4848300000000,48,483,"Wheeler County, TX",Jan-22,1892,1790,102,5.40000000
CN4848500000000,48,485,"Wichita County, TX",Jan-22,55151,52640,2511,4.60000000
CN4848700000000,48,487,"Wilbarger County, TX",Jan-22,4806,4525,281,5.80000000
CN4848900000000,48,489,"Willacy County, TX",Jan-22,7164,6463,701,9.80000000
CN4849100000000,48,491,"Williamson County, TX",Jan-22,349104,337572,11532,3.30000000
CN4849300000000,48,493,"Wilson County, TX",Jan-22,25302,24339,963,3.80000000
CN4849500000000,48,495,"Winkler County, TX",Jan-22,3765,3512,253,6.70000000
CN4849700000000,48,497,"Wise County, TX",Jan-22,33355,31984,1371,4.10000000
CN4849900000000,48,499,"Wood County, TX",Jan-22,17681,16763,918,5.20000000
CN4850100000000,48,501,"Yoakum County, TX",Jan-22,3159,2963,196,6.20000000
CN4850300000000,48,503,"Young County, TX",Jan-22,7940,7625,315,4.00000000
CN4850500000000,48,505,"Zapata County, TX",Jan-22,4489,3997,492,11.00000000
CN4850700000000,48,507,"Zavala County, TX",Jan-22,3288,2911,377,11.50000000
CN4900100000000,49,001,"Beaver County, UT",Jan-22,2703,2621,82,3.00000000
CN4900300000000,49,003,"Box Elder County, UT",Jan-22,26819,26214,605,2.30000000
CN4900500000000,49,005,"Cache County, UT",Jan-22,69318,68022,1296,1.90000000
CN4900700000000,49,007,"Carbon County, UT",Jan-22,8374,8065,309,3.70000000
CN4900900000000,49,009,"Daggett County, UT",Jan-22,332,311,21,6.30000000
CN4901100000000,49,011,"Davis County, UT",Jan-22,179798,176080,3718,2.10000000
CN4901300000000,49,013,"Duchesne County, UT",Jan-22,7685,7370,315,4.10000000
CN4901500000000,49,015,"Emery County, UT",Jan-22,4319,4163,156,3.60000000
CN4901700000000,49,017,"Garfield County, UT",Jan-22,2285,2003,282,12.30000000
CN4901900000000,49,019,"Grand County, UT",Jan-22,5655,5205,450,8.00000000
CN4902100000000,49,021,"Iron County, UT",Jan-22,26422,25728,694,2.60000000
CN4902300000000,49,023,"Juab County, UT",Jan-22,6305,6178,127,2.00000000
CN4902500000000,49,025,"Kane County, UT",Jan-22,3716,3590,126,3.40000000
CN4902700000000,49,027,"Millard County, UT",Jan-22,5695,5558,137,2.40000000
CN4902900000000,49,029,"Morgan County, UT",Jan-22,5795,5685,110,1.90000000
CN4903100000000,49,031,"Piute County, UT",Jan-22,459,434,25,5.40000000
CN4903300000000,49,033,"Rich County, UT",Jan-22,975,943,32,3.30000000
CN4903500000000,49,035,"Salt Lake County, UT",Jan-22,657525,641755,15770,2.40000000
CN4903700000000,49,037,"San Juan County, UT",Jan-22,5155,4803,352,6.80000000
CN4903900000000,49,039,"Sanpete County, UT",Jan-22,13039,12691,348,2.70000000
CN4904100000000,49,041,"Sevier County, UT",Jan-22,9780,9455,325,3.30000000
CN4904300000000,49,043,"Summit County, UT",Jan-22,27171,26623,548,2.00000000
CN4904500000000,49,045,"Tooele County, UT",Jan-22,36997,36071,926,2.50000000
CN4904700000000,49,047,"Uintah County, UT",Jan-22,13513,12911,602,4.50000000
CN4904900000000,49,049,"Utah County, UT",Jan-22,338902,332093,6809,2.00000000
CN4905100000000,49,051,"Wasatch County, UT",Jan-22,17074,16661,413,2.40000000
CN4905300000000,49,053,"Washington County, UT",Jan-22,83897,81600,2297,2.70000000
CN4905500000000,49,055,"Wayne County, UT",Jan-22,1345,1250,95,7.10000000
CN4905700000000,49,057,"Weber County, UT",Jan-22,132107,128661,3446,2.60000000
CN5000100000000,50,001,"Addison County, VT",Jan-22,19968,19288,680,3.40000000
CN5000300000000,50,003,"Bennington County, VT",Jan-22,17086,16361,725,4.20000000
CN5000500000000,50,005,"Caledonia County, VT",Jan-22,13842,13239,603,4.40000000
CN5000700000000,50,007,"Chittenden County, VT",Jan-22,93150,90802,2348,2.50000000
CN5000900000000,50,009,"Essex County, VT",Jan-22,2594,2462,132,5.10000000
CN5001100000000,50,011,"Franklin County, VT",Jan-22,26938,26007,931,3.50000000
CN5001300000000,50,013,"Grand Isle County, VT",Jan-22,4032,3810,222,5.50000000
CN5001500000000,50,015,"Lamoille County, VT",Jan-22,13571,12891,680,5.00000000
CN5001700000000,50,017,"Orange County, VT",Jan-22,15258,14644,614,4.00000000
CN5001900000000,50,019,"Orleans County, VT",Jan-22,13239,12348,891,6.70000000
CN5002100000000,50,021,"Rutland County, VT",Jan-22,29416,28162,1254,4.30000000
CN5002300000000,50,023,"Washington County, VT",Jan-22,32558,31524,1034,3.20000000
CN5002500000000,50,025,"Windham County, VT",Jan-22,20479,19728,751,3.70000000
CN5002700000000,50,027,"Windsor County, VT",Jan-22,28856,28107,749,2.60000000
CN5100100000000,51,001,"Accomack County, VA",Jan-22,15149,14518,631,4.20000000
CN5100300000000,51,003,"Albemarle County, VA",Jan-22,56339,54688,1651,2.90000000
CN5100500000000,51,005,"Alleghany County, VA",Jan-22,6658,6389,269,4.00000000
CN5100700000000,51,007,"Amelia County, VA",Jan-22,5992,5790,202,3.40000000
CN5100900000000,51,009,"Amherst County, VA",Jan-22,14447,13940,507,3.50000000
CN5101100000000,51,011,"Appomattox County, VA",Jan-22,6947,6710,237,3.40000000
CN5101300000000,51,013,"Arlington County, VA",Jan-22,151963,148077,3886,2.60000000
CN5101500000000,51,015,"Augusta County, VA",Jan-22,36955,35895,1060,2.90000000
CN5101700000000,51,017,"Bath County, VA",Jan-22,2275,2193,82,3.60000000
CN5101900000000,51,019,"Bedford County, VA",Jan-22,37565,36354,1211,3.20000000
CN5102100000000,51,021,"Bland County, VA",Jan-22,2753,2662,91,3.30000000
CN5102300000000,51,023,"Botetourt County, VA",Jan-22,17059,16577,482,2.80000000
CN5102500000000,51,025,"Brunswick County, VA",Jan-22,5939,5564,375,6.30000000
CN5102700000000,51,027,"Buchanan County, VA",Jan-22,6439,6045,394,6.10000000
CN5102900000000,51,029,"Buckingham County, VA",Jan-22,6307,5993,314,5.00000000
CN5103100000000,51,031,"Campbell County, VA",Jan-22,25168,24268,900,3.60000000
CN5103300000000,51,033,"Caroline County, VA",Jan-22,14597,14033,564,3.90000000
CN5103500000000,51,035,"Carroll County, VA",Jan-22,13209,12697,512,3.90000000
CN5103600000000,51,036,"Charles City County, VA",Jan-22,3429,3295,134,3.90000000
CN5103700000000,51,037,"Charlotte County, VA",Jan-22,5534,5356,178,3.20000000
CN5104100000000,51,041,"Chesterfield County, VA",Jan-22,183318,177421,5897,3.20000000
CN5104300000000,51,043,"Clarke County, VA",Jan-22,7473,7261,212,2.80000000
CN5104500000000,51,045,"Craig County, VA",Jan-22,2237,2167,70,3.10000000
CN5104700000000,51,047,"Culpeper County, VA",Jan-22,24880,24115,765,3.10000000
CN5104900000000,51,049,"Cumberland County, VA",Jan-22,4651,4459,192,4.10000000
CN5105100000000,51,051,"Dickenson County, VA",Jan-22,4891,4661,230,4.70000000
CN5105300000000,51,053,"Dinwiddie County, VA",Jan-22,13206,12663,543,4.10000000
CN5105700000000,51,057,"Essex County, VA",Jan-22,5284,5048,236,4.50000000
CN5105900000000,51,059,"Fairfax County, VA",Jan-22,619830,601640,18190,2.90000000
CN5106100000000,51,061,"Fauquier County, VA",Jan-22,36653,35631,1022,2.80000000
CN5106300000000,51,063,"Floyd County, VA",Jan-22,8192,7959,233,2.80000000
CN5106500000000,51,065,"Fluvanna County, VA",Jan-22,13789,13383,406,2.90000000
CN5106700000000,51,067,"Franklin County, VA",Jan-22,25689,24835,854,3.30000000
CN5106900000000,51,069,"Frederick County, VA",Jan-22,49587,48246,1341,2.70000000
CN5107100000000,51,071,"Giles County, VA",Jan-22,7773,7512,261,3.40000000
CN5107300000000,51,073,"Gloucester County, VA",Jan-22,18823,18243,580,3.10000000
CN5107500000000,51,075,"Goochland County, VA",Jan-22,11283,10933,350,3.10000000
CN5107700000000,51,077,"Grayson County, VA",Jan-22,8282,8048,234,2.80000000
CN5107900000000,51,079,"Greene County, VA",Jan-22,10334,10057,277,2.70000000
CN5108100000000,51,081,"Greensville County, VA",Jan-22,4391,4185,206,4.70000000
CN5108300000000,51,083,"Halifax County, VA",Jan-22,15310,14643,667,4.40000000
CN5108500000000,51,085,"Hanover County, VA",Jan-22,56819,55273,1546,2.70000000
CN5108700000000,51,087,"Henrico County, VA",Jan-22,175692,169647,6045,3.40000000
CN5108900000000,51,089,"Henry County, VA",Jan-22,24632,23647,985,4.00000000
CN5109100000000,51,091,"Highland County, VA",Jan-22,1237,1198,39,3.20000000
CN5109300000000,51,093,"Isle of Wight County, VA",Jan-22,19044,18416,628,3.30000000
CN5109500000000,51,095,"James City County, VA",Jan-22,35767,34497,1270,3.60000000
CN5109700000000,51,097,"King and Queen County, VA",Jan-22,3893,3782,111,2.90000000
CN5109900000000,51,099,"King George County, VA",Jan-22,14216,13825,391,2.80000000
CN5110100000000,51,101,"King William County, VA",Jan-22,9125,8846,279,3.10000000
CN5110300000000,51,103,"Lancaster County, VA",Jan-22,5287,5002,285,5.40000000
CN5110500000000,51,105,"Lee County, VA",Jan-22,8308,7988,320,3.90000000
CN5110700000000,51,107,"Loudoun County, VA",Jan-22,224530,218477,6053,2.70000000
CN5110900000000,51,109,"Louisa County, VA",Jan-22,20490,19841,649,3.20000000
CN5111100000000,51,111,"Lunenburg County, VA",Jan-22,5201,5015,186,3.60000000
CN5111300000000,51,113,"Madison County, VA",Jan-22,7492,7318,174,2.30000000
CN5111500000000,51,115,"Mathews County, VA",Jan-22,3951,3822,129,3.30000000
CN5111700000000,51,117,"Mecklenburg County, VA",Jan-22,13013,12473,540,4.10000000
CN5111900000000,51,119,"Middlesex County, VA",Jan-22,5166,5005,161,3.10000000
CN5112100000000,51,121,"Montgomery County, VA",Jan-22,49421,48019,1402,2.80000000
CN5112500000000,51,125,"Nelson County, VA",Jan-22,7243,7014,229,3.20000000
CN5112700000000,51,127,"New Kent County, VA",Jan-22,12541,12209,332,2.60000000
CN5113100000000,51,131,"Northampton County, VA",Jan-22,5390,5123,267,5.00000000
CN5113300000000,51,133,"Northumberland County, VA",Jan-22,5589,5300,289,5.20000000
CN5113500000000,51,135,"Nottoway County, VA",Jan-22,7220,6975,245,3.40000000
CN5113700000000,51,137,"Orange County, VA",Jan-22,17367,16789,578,3.30000000
CN5113900000000,51,139,"Page County, VA",Jan-22,12088,11545,543,4.50000000
CN5114100000000,51,141,"Patrick County, VA",Jan-22,7223,6912,311,4.30000000
CN5114300000000,51,143,"Pittsylvania County, VA",Jan-22,30566,29462,1104,3.60000000
CN5114500000000,51,145,"Powhatan County, VA",Jan-22,13923,13528,395,2.80000000
CN5114700000000,51,147,"Prince Edward County, VA",Jan-22,10420,9995,425,4.10000000
CN5114900000000,51,149,"Prince George County, VA",Jan-22,14613,14005,608,4.20000000
CN5115300000000,51,153,"Prince William County, VA",Jan-22,243149,235156,7993,3.30000000
CN5115500000000,51,155,"Pulaski County, VA",Jan-22,15916,15361,555,3.50000000
CN5115700000000,51,157,"Rappahannock County, VA",Jan-22,3651,3548,103,2.80000000
CN5115900000000,51,159,"Richmond County, VA",Jan-22,3991,3854,137,3.40000000
CN5116100000000,51,161,"Roanoke County, VA",Jan-22,48094,46718,1376,2.90000000
CN5116300000000,51,163,"Rockbridge County, VA",Jan-22,10849,10502,347,3.20000000
CN5116500000000,51,165,"Rockingham County, VA",Jan-22,41698,40559,1139,2.70000000
CN5116700000000,51,167,"Russell County, VA",Jan-22,11027,10582,445,4.00000000
CN5116900000000,51,169,"Scott County, VA",Jan-22,8927,8616,311,3.50000000
CN5117100000000,51,171,"Shenandoah County, VA",Jan-22,22244,21579,665,3.00000000
CN5117300000000,51,173,"Smyth County, VA",Jan-22,14418,13913,505,3.50000000
CN5117500000000,51,175,"Southampton County, VA",Jan-22,8873,8593,280,3.20000000
CN5117700000000,51,177,"Spotsylvania County, VA",Jan-22,67216,64982,2234,3.30000000
CN5117900000000,51,179,"Stafford County, VA",Jan-22,73015,70690,2325,3.20000000
CN5118100000000,51,181,"Surry County, VA",Jan-22,3502,3371,131,3.70000000
CN5118300000000,51,183,"Sussex County, VA",Jan-22,3566,3368,198,5.60000000
CN5118500000000,51,185,"Tazewell County, VA",Jan-22,15651,14897,754,4.80000000
CN5118700000000,51,187,"Warren County, VA",Jan-22,20141,19506,635,3.20000000
CN5119100000000,51,191,"Washington County, VA",Jan-22,25585,24737,848,3.30000000
CN5119300000000,51,193,"Westmoreland County, VA",Jan-22,9719,9346,373,3.80000000
CN5119500000000,51,195,"Wise County, VA",Jan-22,13427,12832,595,4.40000000
CN5119700000000,51,197,"Wythe County, VA",Jan-22,14019,13553,466,3.30000000
CN5119900000000,51,199,"York County, VA",Jan-22,31900,30911,989,3.10000000
CN5151000000000,51,510,"Alexandria city, VA",Jan-22,97886,94901,2985,3.00000000
CN5152000000000,51,520,"Bristol city, VA",Jan-22,7389,7092,297,4.00000000
CN5153000000000,51,530,"Buena Vista city, VA",Jan-22,2976,2874,102,3.40000000
CN5154000000000,51,540,"Charlottesville city, VA",Jan-22,24923,24131,792,3.20000000
CN5155000000000,51,550,"Chesapeake city, VA",Jan-22,119213,115164,4049,3.40000000
CN5157000000000,51,570,"Colonial Heights city, VA",Jan-22,8119,7785,334,4.10000000
CN5158000000000,51,580,"Covington city, VA",Jan-22,2326,2205,121,5.20000000
CN5159000000000,51,590,"Danville city, VA",Jan-22,19058,17961,1097,5.80000000
CN5159500000000,51,595,"Emporia city, VA",Jan-22,2420,2244,176,7.30000000
CN5160000000000,51,600,"Fairfax city, VA",Jan-22,12546,12171,375,3.00000000
CN5161000000000,51,610,"Falls Church city, VA",Jan-22,8283,8089,194,2.30000000
CN5162000000000,51,620,"Franklin city, VA",Jan-22,3481,3287,194,5.60000000
CN5163000000000,51,630,"Fredericksburg city, VA",Jan-22,13906,13366,540,3.90000000
CN5164000000000,51,640,"Galax city, VA",Jan-22,2924,2824,100,3.40000000
CN5165000000000,51,650,"Hampton city, VA",Jan-22,62457,59295,3162,5.10000000
CN5166000000000,51,660,"Harrisonburg city, VA",Jan-22,24072,23228,844,3.50000000
CN5167000000000,51,670,"Hopewell city, VA",Jan-22,9250,8659,591,6.40000000
CN5167800000000,51,678,"Lexington city, VA",Jan-22,2155,2064,91,4.20000000
CN5168000000000,51,680,"Lynchburg city, VA",Jan-22,34713,33215,1498,4.30000000
CN5168300000000,51,683,"Manassas city, VA",Jan-22,21139,20426,713,3.40000000
CN5168500000000,51,685,"Manassas Park city, VA",Jan-22,9534,9233,301,3.20000000
CN5169000000000,51,690,"Martinsville city, VA",Jan-22,5736,5366,370,6.50000000
CN5170000000000,51,700,"Newport News city, VA",Jan-22,85637,81529,4108,4.80000000
CN5171000000000,51,710,"Norfolk city, VA",Jan-22,106869,101698,5171,4.80000000
CN5172000000000,51,720,"Norton city, VA",Jan-22,1693,1622,71,4.20000000
CN5173000000000,51,730,"Petersburg city, VA",Jan-22,12326,11214,1112,9.00000000
CN5173500000000,51,735,"Poquoson city, VA",Jan-22,6142,5972,170,2.80000000
CN5174000000000,51,740,"Portsmouth city, VA",Jan-22,43004,40588,2416,5.60000000
CN5175000000000,51,750,"Radford city, VA",Jan-22,8503,8212,291,3.40000000
CN5176000000000,51,760,"Richmond city, VA",Jan-22,115396,110031,5365,4.60000000
CN5177000000000,51,770,"Roanoke city, VA",Jan-22,47608,45672,1936,4.10000000
CN5177500000000,51,775,"Salem city, VA",Jan-22,12417,12023,394,3.20000000
CN5179000000000,51,790,"Staunton city, VA",Jan-22,12010,11616,394,3.30000000
CN5180000000000,51,800,"Suffolk city, VA",Jan-22,43938,42282,1656,3.80000000
CN5181000000000,51,810,"Virginia Beach city, VA",Jan-22,223341,216119,7222,3.20000000
CN5182000000000,51,820,"Waynesboro city, VA",Jan-22,10420,10060,360,3.50000000
CN5183000000000,51,830,"Williamsburg city, VA",Jan-22,6554,6267,287,4.40000000
CN5184000000000,51,840,"Winchester city, VA",Jan-22,14559,14124,435,3.00000000
CN5300100000000,53,001,"Adams County, WA",Jan-22,9238,8561,677,7.30000000
CN5300300000000,53,003,"Asotin County, WA",Jan-22,10834,10396,438,4.00000000
CN5300500000000,53,005,"Benton County, WA",Jan-22,105244,98829,6415,6.10000000
CN5300700000000,53,007,"Chelan County, WA",Jan-22,43199,40434,2765,6.40000000
CN5300900000000,53,009,"Clallam County, WA",Jan-22,30855,28804,2051,6.60000000
CN5301100000000,53,011,"Clark County, WA",Jan-22,252609,239894,12715,5.00000000
CN5301300000000,53,013,"Columbia County, WA",Jan-22,1830,1721,109,6.00000000
CN5301500000000,53,015,"Cowlitz County, WA",Jan-22,49532,46484,3048,6.20000000
CN5301700000000,53,017,"Douglas County, WA",Jan-22,21163,19725,1438,6.80000000
CN5301900000000,53,019,"Ferry County, WA",Jan-22,2444,2185,259,10.60000000
CN5302100000000,53,021,"Franklin County, WA",Jan-22,42718,39367,3351,7.80000000
CN5302300000000,53,023,"Garfield County, WA",Jan-22,846,782,64,7.60000000
CN5302500000000,53,025,"Grant County, WA",Jan-22,46666,42680,3986,8.50000000
CN5302700000000,53,027,"Grays Harbor County, WA",Jan-22,29921,27595,2326,7.80000000
CN5302900000000,53,029,"Island County, WA",Jan-22,37237,35282,1955,5.30000000
CN5303100000000,53,031,"Jefferson County, WA",Jan-22,13043,12248,795,6.10000000
CN5303300000000,53,033,"King County, WA",Jan-22,1314162,1266016,48146,3.70000000
CN5303500000000,53,035,"Kitsap County, WA",Jan-22,131105,124898,6207,4.70000000
CN5303700000000,53,037,"Kittitas County, WA",Jan-22,22946,21386,1560,6.80000000
CN5303900000000,53,039,"Klickitat County, WA",Jan-22,10178,9493,685,6.70000000
CN5304100000000,53,041,"Lewis County, WA",Jan-22,35681,33333,2348,6.60000000
CN5304300000000,53,043,"Lincoln County, WA",Jan-22,4840,4529,311,6.40000000
CN5304500000000,53,045,"Mason County, WA",Jan-22,25962,24113,1849,7.10000000
CN5304700000000,53,047,"Okanogan County, WA",Jan-22,19039,17405,1634,8.60000000
CN5304900000000,53,049,"Pacific County, WA",Jan-22,8839,8156,683,7.70000000
CN5305100000000,53,051,"Pend Oreille County, WA",Jan-22,5357,4914,443,8.30000000
CN5305300000000,53,053,"Pierce County, WA",Jan-22,456794,429909,26885,5.90000000
CN5305500000000,53,055,"San Juan County, WA",Jan-22,8762,8346,416,4.70000000
CN5305700000000,53,057,"Skagit County, WA",Jan-22,63069,59111,3958,6.30000000
CN5305900000000,53,059,"Skamania County, WA",Jan-22,5668,5312,356,6.30000000
CN5306100000000,53,061,"Snohomish County, WA",Jan-22,449614,429609,20005,4.40000000
CN5306300000000,53,063,"Spokane County, WA",Jan-22,270140,255492,14648,5.40000000
CN5306500000000,53,065,"Stevens County, WA",Jan-22,19899,18325,1574,7.90000000
CN5306700000000,53,067,"Thurston County, WA",Jan-22,149825,142336,7489,5.00000000
CN5306900000000,53,069,"Wahkiakum County, WA",Jan-22,1397,1301,96,6.90000000
CN5307100000000,53,071,"Walla Walla County, WA",Jan-22,31096,29461,1635,5.30000000
CN5307300000000,53,073,"Whatcom County, WA",Jan-22,117738,111208,6530,5.50000000
CN5307500000000,53,075,"Whitman County, WA",Jan-22,23406,22425,981,4.20000000
CN5307700000000,53,077,"Yakima County, WA",Jan-22,127658,116336,11322,8.90000000
CN5400100000000,54,001,"Barbour County, WV",Jan-22,7275,6930,345,4.70000000
CN5400300000000,54,003,"Berkeley County, WV",Jan-22,60279,58602,1677,2.80000000
CN5400500000000,54,005,"Boone County, WV",Jan-22,7173,6809,364,5.10000000
CN5400700000000,54,007,"Braxton County, WV",Jan-22,5091,4723,368,7.20000000
CN5400900000000,54,009,"Brooke County, WV",Jan-22,9864,9344,520,5.30000000
CN5401100000000,54,011,"Cabell County, WV",Jan-22,41218,39685,1533,3.70000000
CN5401300000000,54,013,"Calhoun County, WV",Jan-22,2614,2324,290,11.10000000
CN5401500000000,54,015,"Clay County, WV",Jan-22,3040,2807,233,7.70000000
CN5401700000000,54,017,"Doddridge County, WV",Jan-22,3785,3653,132,3.50000000
CN5401900000000,54,019,"Fayette County, WV",Jan-22,15917,15031,886,5.60000000
CN5402100000000,54,021,"Gilmer County, WV",Jan-22,2279,2117,162,7.10000000
CN5402300000000,54,023,"Grant County, WV",Jan-22,6015,5735,280,4.70000000
CN5402500000000,54,025,"Greenbrier County, WV",Jan-22,15362,14718,644,4.20000000
CN5402700000000,54,027,"Hampshire County, WV",Jan-22,11080,10775,305,2.80000000
CN5402900000000,54,029,"Hancock County, WV",Jan-22,12994,12298,696,5.40000000
CN5403100000000,54,031,"Hardy County, WV",Jan-22,5758,5498,260,4.50000000
CN5403300000000,54,033,"Harrison County, WV",Jan-22,33860,32419,1441,4.30000000
CN5403500000000,54,035,"Jackson County, WV",Jan-22,12106,11483,623,5.10000000
CN5403700000000,54,037,"Jefferson County, WV",Jan-22,30275,29546,729,2.40000000
CN5403900000000,54,039,"Kanawha County, WV",Jan-22,80965,77448,3517,4.30000000
CN5404100000000,54,041,"Lewis County, WV",Jan-22,6079,5694,385,6.30000000
CN5404300000000,54,043,"Lincoln County, WV",Jan-22,7088,6648,440,6.20000000
CN5404500000000,54,045,"Logan County, WV",Jan-22,11185,10600,585,5.20000000
CN5404700000000,54,047,"McDowell County, WV",Jan-22,4264,3969,295,6.90000000
CN5404900000000,54,049,"Marion County, WV",Jan-22,25252,24048,1204,4.80000000
CN5405100000000,54,051,"Marshall County, WV",Jan-22,13457,12623,834,6.20000000
CN5405300000000,54,053,"Mason County, WV",Jan-22,10162,9634,528,5.20000000
CN5405500000000,54,055,"Mercer County, WV",Jan-22,20527,19495,1032,5.00000000
CN5405700000000,54,057,"Mineral County, WV",Jan-22,12173,11632,541,4.40000000
CN5405900000000,54,059,"Mingo County, WV",Jan-22,6092,5639,453,7.40000000
CN5406100000000,54,061,"Monongalia County, WV",Jan-22,55253,53332,1921,3.50000000
CN5406300000000,54,063,"Monroe County, WV",Jan-22,6053,5873,180,3.00000000
CN5406500000000,54,065,"Morgan County, WV",Jan-22,8547,8309,238,2.80000000
CN5406700000000,54,067,"Nicholas County, WV",Jan-22,9109,8628,481,5.30000000
CN5406900000000,54,069,"Ohio County, WV",Jan-22,20316,19435,881,4.30000000
CN5407100000000,54,071,"Pendleton County, WV",Jan-22,3753,3646,107,2.90000000
CN5407300000000,54,073,"Pleasants County, WV",Jan-22,2704,2524,180,6.70000000
CN5407500000000,54,075,"Pocahontas County, WV",Jan-22,4245,4076,169,4.00000000
CN5407700000000,54,077,"Preston County, WV",Jan-22,15505,14814,691,4.50000000
CN5407900000000,54,079,"Putnam County, WV",Jan-22,26879,25898,981,3.60000000
CN5408100000000,54,081,"Raleigh County, WV",Jan-22,29905,28623,1282,4.30000000
CN5408300000000,54,083,"Randolph County, WV",Jan-22,12036,11369,667,5.50000000
CN5408500000000,54,085,"Ritchie County, WV",Jan-22,4312,4100,212,4.90000000
CN5408700000000,54,087,"Roane County, WV",Jan-22,5106,4668,438,8.60000000
CN5408900000000,54,089,"Summers County, WV",Jan-22,4477,4299,178,4.00000000
CN5409100000000,54,091,"Taylor County, WV",Jan-22,7869,7530,339,4.30000000
CN5409300000000,54,093,"Tucker County, WV",Jan-22,3404,3226,178,5.20000000
CN5409500000000,54,095,"Tyler County, WV",Jan-22,3025,2808,217,7.20000000
CN5409700000000,54,097,"Upshur County, WV",Jan-22,9817,9279,538,5.50000000
CN5409900000000,54,099,"Wayne County, WV",Jan-22,15553,14852,701,4.50000000
CN5410100000000,54,101,"Webster County, WV",Jan-22,3240,3055,185,5.70000000
CN5410300000000,54,103,"Wetzel County, WV",Jan-22,7038,6569,469,6.70000000
CN5410500000000,54,105,"Wirt County, WV",Jan-22,2297,2114,183,8.00000000
CN5410700000000,54,107,"Wood County, WV",Jan-22,36632,34850,1782,4.90000000
CN5410900000000,54,109,"Wyoming County, WV",Jan-22,7341,6996,345,4.70000000
CN5500100000000,55,001,"Adams County, WI",Jan-22,7855,7357,498,6.30000000
CN5500300000000,55,003,"Ashland County, WI",Jan-22,7383,7044,339,4.60000000
CN5500500000000,55,005,"Barron County, WI",Jan-22,24456,23494,962,3.90000000
CN5500700000000,55,007,"Bayfield County, WI",Jan-22,7348,6925,423,5.80000000
CN5500900000000,55,009,"Brown County, WI",Jan-22,142461,138560,3901,2.70000000
CN5501100000000,55,011,"Buffalo County, WI",Jan-22,6449,6159,290,4.50000000
CN5501300000000,55,013,"Burnett County, WI",Jan-22,7321,6889,432,5.90000000
CN5501500000000,55,015,"Calumet County, WI",Jan-22,28017,27371,646,2.30000000
CN5501700000000,55,017,"Chippewa County, WI",Jan-22,33940,32568,1372,4.00000000
CN5501900000000,55,019,"Clark County, WI",Jan-22,18232,17674,558,3.10000000
CN5502100000000,55,021,"Columbia County, WI",Jan-22,32020,31045,975,3.00000000
CN5502300000000,55,023,"Crawford County, WI",Jan-22,7543,7188,355,4.70000000
CN5502500000000,55,025,"Dane County, WI",Jan-22,329110,321896,7214,2.20000000
CN5502700000000,55,027,"Dodge County, WI",Jan-22,48373,46997,1376,2.80000000
CN5502900000000,55,029,"Door County, WI",Jan-22,14150,13501,649,4.60000000
CN5503100000000,55,031,"Douglas County, WI",Jan-22,23361,22341,1020,4.40000000
CN5503300000000,55,033,"Dunn County, WI",Jan-22,24277,23460,817,3.40000000
CN5503500000000,55,035,"Eau Claire County, WI",Jan-22,59549,57929,1620,2.70000000
CN5503700000000,55,037,"Florence County, WI",Jan-22,2250,2158,92,4.10000000
CN5503900000000,55,039,"Fond du Lac County, WI",Jan-22,57876,56296,1580,2.70000000
CN5504100000000,55,041,"Forest County, WI",Jan-22,4014,3776,238,5.90000000
CN5504300000000,55,043,"Grant County, WI",Jan-22,27582,26807,775,2.80000000
CN5504500000000,55,045,"Green County, WI",Jan-22,21120,20517,603,2.90000000
CN5504700000000,55,047,"Green Lake County, WI",Jan-22,9196,8823,373,4.10000000
CN5504900000000,55,049,"Iowa County, WI",Jan-22,13889,13477,412,3.00000000
CN5505100000000,55,051,"Iron County, WI",Jan-22,2597,2449,148,5.70000000
CN5505300000000,55,053,"Jackson County, WI",Jan-22,9557,9060,497,5.20000000
CN5505500000000,55,055,"Jefferson County, WI",Jan-22,46401,45016,1385,3.00000000
CN5505700000000,55,057,"Juneau County, WI",Jan-22,13341,12820,521,3.90000000
CN5505900000000,55,059,"Kenosha County, WI",Jan-22,90938,87734,3204,3.50000000
CN5506100000000,55,061,"Kewaunee County, WI",Jan-22,11122,10820,302,2.70000000
CN5506300000000,55,063,"La Crosse County, WI",Jan-22,67109,65356,1753,2.60000000
CN5506500000000,55,065,"Lafayette County, WI",Jan-22,10544,10288,256,2.40000000
CN5506700000000,55,067,"Langlade County, WI",Jan-22,9536,9170,366,3.80000000
CN5506900000000,55,069,"Lincoln County, WI",Jan-22,14829,14295,534,3.60000000
CN5507100000000,55,071,"Manitowoc County, WI",Jan-22,41211,39939,1272,3.10000000
CN5507300000000,55,073,"Marathon County, WI",Jan-22,75293,73368,1925,2.60000000
CN5507500000000,55,075,"Marinette County, WI",Jan-22,19305,18524,781,4.00000000
CN5507700000000,55,077,"Marquette County, WI",Jan-22,7817,7446,371,4.70000000
CN5507800000000,55,078,"Menominee County, WI",Jan-22,1558,1470,88,5.60000000
CN5507900000000,55,079,"Milwaukee County, WI",Jan-22,459379,440341,19038,4.10000000
CN5508100000000,55,081,"Monroe County, WI",Jan-22,23766,23076,690,2.90000000
CN5508300000000,55,083,"Oconto County, WI",Jan-22,21055,20302,753,3.60000000
CN5508500000000,55,085,"Oneida County, WI",Jan-22,17434,16675,759,4.40000000
CN5508700000000,55,087,"Outagamie County, WI",Jan-22,105326,102606,2720,2.60000000
CN5508900000000,55,089,"Ozaukee County, WI",Jan-22,48811,47630,1181,2.40000000
CN5509100000000,55,091,"Pepin County, WI",Jan-22,4090,3931,159,3.90000000
CN5509300000000,55,093,"Pierce County, WI",Jan-22,25298,24419,879,3.50000000
CN5509500000000,55,095,"Polk County, WI",Jan-22,25135,23948,1187,4.70000000
CN5509700000000,55,097,"Portage County, WI",Jan-22,37992,36786,1206,3.20000000
CN5509900000000,55,099,"Price County, WI",Jan-22,6280,6049,231,3.70000000
CN5510100000000,55,101,"Racine County, WI",Jan-22,98281,94361,3920,4.00000000
CN5510300000000,55,103,"Richland County, WI",Jan-22,9119,8823,296,3.20000000
CN5510500000000,55,105,"Rock County, WI",Jan-22,86855,83605,3250,3.70000000
CN5510700000000,55,107,"Rusk County, WI",Jan-22,6800,6494,306,4.50000000
CN5510900000000,55,109,"St. Croix County, WI",Jan-22,51146,49479,1667,3.30000000
CN5511100000000,55,111,"Sauk County, WI",Jan-22,34432,33299,1133,3.30000000
CN5511300000000,55,113,"Sawyer County, WI",Jan-22,7841,7461,380,4.80000000
CN5511500000000,55,115,"Shawano County, WI",Jan-22,21188,20519,669,3.20000000
CN5511700000000,55,117,"Sheboygan County, WI",Jan-22,62595,61042,1553,2.50000000
CN5511900000000,55,119,"Taylor County, WI",Jan-22,11377,10911,466,4.10000000
CN5512100000000,55,121,"Trempealeau County, WI",Jan-22,15697,15119,578,3.70000000
CN5512300000000,55,123,"Vernon County, WI",Jan-22,15746,15257,489,3.10000000
CN5512500000000,55,125,"Vilas County, WI",Jan-22,9947,9496,451,4.50000000
CN5512700000000,55,127,"Walworth County, WI",Jan-22,57256,55405,1851,3.20000000
CN5512900000000,55,129,"Washburn County, WI",Jan-22,7819,7451,368,4.70000000
CN5513100000000,55,131,"Washington County, WI",Jan-22,76344,74404,1940,2.50000000
CN5513300000000,55,133,"Waukesha County, WI",Jan-22,222451,216878,5573,2.50000000
CN5513500000000,55,135,"Waupaca County, WI",Jan-22,26125,25296,829,3.20000000
CN5513700000000,55,137,"Waushara County, WI",Jan-22,11530,11045,485,4.20000000
CN5513900000000,55,139,"Winnebago County, WI",Jan-22,92686,90336,2350,2.50000000
CN5514100000000,55,141,"Wood County, WI",Jan-22,34403,33073,1330,3.90000000
CN5600100000000,56,001,"Albany County, WY",Jan-22,20877,20233,644,3.10000000
CN5600300000000,56,003,"Big Horn County, WY",Jan-22,5064,4820,244,4.80000000
CN5600500000000,56,005,"Campbell County, WY",Jan-22,22043,21083,960,4.40000000
CN5600700000000,56,007,"Carbon County, WY",Jan-22,7664,7353,311,4.10000000
CN5600900000000,56,009,"Converse County, WY",Jan-22,7549,7258,291,3.90000000
CN5601100000000,56,011,"Crook County, WY",Jan-22,3703,3583,120,3.20000000
CN5601300000000,56,013,"Fremont County, WY",Jan-22,18750,17916,834,4.40000000
CN5601500000000,56,015,"Goshen County, WY",Jan-22,6389,6194,195,3.10000000
CN5601700000000,56,017,"Hot Springs County, WY",Jan-22,2189,2114,75,3.40000000
CN5601900000000,56,019,"Johnson County, WY",Jan-22,4058,3890,168,4.10000000
CN5602100000000,56,021,"Laramie County, WY",Jan-22,50508,48657,1851,3.70000000
CN5602300000000,56,023,"Lincoln County, WY",Jan-22,9454,9125,329,3.50000000
CN5602500000000,56,025,"Natrona County, WY",Jan-22,39316,37297,2019,5.10000000
CN5602700000000,56,027,"Niobrara County, WY",Jan-22,1210,1170,40,3.30000000
CN5602900000000,56,029,"Park County, WY",Jan-22,14596,13976,620,4.20000000
CN5603100000000,56,031,"Platte County, WY",Jan-22,4401,4242,159,3.60000000
CN5603300000000,56,033,"Sheridan County, WY",Jan-22,15844,15243,601,3.80000000
CN5603500000000,56,035,"Sublette County, WY",Jan-22,3815,3629,186,4.90000000
CN5603700000000,56,037,"Sweetwater County, WY",Jan-22,19318,18337,981,5.10000000
CN5603900000000,56,039,"Teton County, WY",Jan-22,15811,15423,388,2.50000000
CN5604100000000,56,041,"Uinta County, WY",Jan-22,8567,8184,383,4.50000000
CN5604300000000,56,043,"Washakie County, WY",Jan-22,3971,3804,167,4.20000000
CN5604500000000,56,045,"Weston County, WY",Jan-22,3740,3631,109,2.90000000
CN7200100000000,72,001,"Adjuntas Municipio, PR",Jan-22,4584,4129,455,9.90000000
CN7200300000000,72,003,"Aguada Municipio, PR",Jan-22,13450,12373,1077,8.00000000
CN7200500000000,72,005,"Aguadilla Municipio, PR",Jan-22,16115,14877,1238,7.70000000
CN7200700000000,72,007,"Aguas Buenas Municipio, PR",Jan-22,7246,6710,536,7.40000000
CN7200900000000,72,009,"Aibonito Municipio, PR",Jan-22,6973,6454,519,7.40000000
CN7201100000000,72,011,"Anasco Municipio, PR",Jan-22,10059,9376,683,6.80000000
CN7201300000000,72,013,"Arecibo Municipio, PR",Jan-22,26438,24609,1829,6.90000000
CN7201500000000,72,015,"Arroyo Municipio, PR",Jan-22,5077,4705,372,7.30000000
CN7201700000000,72,017,"Barceloneta Municipio, PR",Jan-22,6564,5981,583,8.90000000
CN7201900000000,72,019,"Barranquitas Municipio, PR",Jan-22,7974,7415,559,7.00000000
CN7202100000000,72,021,"Bayamon Municipio, PR",Jan-22,71907,67885,4022,5.60000000
CN7202300000000,72,023,"Cabo Rojo Municipio, PR",Jan-22,15545,14438,1107,7.10000000
CN7202500000000,72,025,"Caguas Municipio, PR",Jan-22,52747,50040,2707,5.10000000
CN7202700000000,72,027,"Camuy Municipio, PR",Jan-22,10533,9912,621,5.90000000
CN7202900000000,72,029,"Canovanas Municipio, PR",Jan-22,18052,17100,952,5.30000000
CN7203100000000,72,031,"Carolina Municipio, PR",Jan-22,68030,64348,3682,5.40000000
CN7203300000000,72,033,"Catano Municipio, PR",Jan-22,8666,8101,565,6.50000000
CN7203500000000,72,035,"Cayey Municipio, PR",Jan-22,17804,16945,859,4.80000000
CN7203700000000,72,037,"Ceiba Municipio, PR",Jan-22,3968,3680,288,7.30000000
CN7203900000000,72,039,"Ciales Municipio, PR",Jan-22,4046,3658,388,9.60000000
CN7204100000000,72,041,"Cidra Municipio, PR",Jan-22,16980,16221,759,4.50000000
CN7204300000000,72,043,"Coamo Municipio, PR",Jan-22,11270,10399,871,7.70000000
CN7204500000000,72,045,"Comerio Municipio, PR",Jan-22,5421,5009,412,7.60000000
CN7204700000000,72,047,"Corozal Municipio, PR",Jan-22,9804,9006,798,8.10000000
CN7204900000000,72,049,"Culebra Municipio, PR",Jan-22,1014,973,41,4.00000000
CN7205100000000,72,051,"Dorado Municipio, PR",Jan-22,14940,14238,702,4.70000000
CN7205300000000,72,053,"Fajardo Municipio, PR",Jan-22,11703,10834,869,7.40000000
CN7205400000000,72,054,"Florida Municipio, PR",Jan-22,3614,3309,305,8.40000000
CN7205500000000,72,055,"Guanica Municipio, PR",Jan-22,4350,3829,521,12.00000000
CN7205700000000,72,057,"Guayama Municipio, PR",Jan-22,11995,11247,748,6.20000000
CN7205900000000,72,059,"Guayanilla Municipio, PR",Jan-22,5332,4760,572,10.70000000
CN7206100000000,72,061,"Guaynabo Municipio, PR",Jan-22,42019,40633,1386,3.30000000
CN7206300000000,72,063,"Gurabo Municipio, PR",Jan-22,20682,19875,807,3.90000000
CN7206500000000,72,065,"Hatillo Municipio, PR",Jan-22,14936,13817,1119,7.50000000
CN7206700000000,72,067,"Hormigueros Municipio, PR",Jan-22,6182,5692,490,7.90000000
CN7206900000000,72,069,"Humacao Municipio, PR",Jan-22,19149,17870,1279,6.70000000
CN7207100000000,72,071,"Isabela Municipio, PR",Jan-22,13205,12341,864,6.50000000
CN7207300000000,72,073,"Jayuya Municipio, PR",Jan-22,4606,4120,486,10.60000000
CN7207500000000,72,075,"Juana Diaz Municipio, PR",Jan-22,17183,16138,1045,6.10000000
CN7207700000000,72,077,"Juncos Municipio, PR",Jan-22,13758,12841,917,6.70000000
CN7207900000000,72,079,"Lajas Municipio, PR",Jan-22,5865,5212,653,11.10000000
CN7208100000000,72,081,"Lares Municipio, PR",Jan-22,7616,6788,828,10.90000000
CN7208300000000,72,083,"Las Marias Municipio, PR",Jan-22,2849,2561,288,10.10000000
CN7208500000000,72,085,"Las Piedras Municipio, PR",Jan-22,12678,11899,779,6.10000000
CN7208700000000,72,087,"Loiza Municipio, PR",Jan-22,9262,8603,659,7.10000000
CN7208900000000,72,089,"Luquillo Municipio, PR",Jan-22,6796,6332,464,6.80000000
CN7209100000000,72,091,"Manati Municipio, PR",Jan-22,12394,11635,759,6.10000000
CN7209300000000,72,093,"Maricao Municipio, PR",Jan-22,2094,1860,234,11.20000000
CN7209500000000,72,095,"Maunabo Municipio, PR",Jan-22,3116,2785,331,10.60000000
CN7209700000000,72,097,"Mayaguez Municipio, PR",Jan-22,24317,22479,1838,7.60000000
CN7209900000000,72,099,"Moca Municipio, PR",Jan-22,11691,10751,940,8.00000000
CN7210100000000,72,101,"Morovis Municipio, PR",Jan-22,8932,8248,684,7.70000000
CN7210300000000,72,103,"Naguabo Municipio, PR",Jan-22,9179,8555,624,6.80000000
CN7210500000000,72,105,"Naranjito Municipio, PR",Jan-22,7894,7235,659,8.30000000
CN7210700000000,72,107,"Orocovis Municipio, PR",Jan-22,5354,4889,465,8.70000000
CN7210900000000,72,109,"Patillas Municipio, PR",Jan-22,4629,4150,479,10.30000000
CN7211100000000,72,111,"Penuelas Municipio, PR",Jan-22,6322,5691,631,10.00000000
CN7211300000000,72,113,"Ponce Municipio, PR",Jan-22,50125,46284,3841,7.70000000
CN7211500000000,72,115,"Quebradillas Municipio, PR",Jan-22,6700,6174,526,7.90000000
CN7211700000000,72,117,"Rincon Municipio, PR",Jan-22,5233,4773,460,8.80000000
CN7211900000000,72,119,"Rio Grande Municipio, PR",Jan-22,18929,17684,1245,6.60000000
CN7212100000000,72,121,"Sabana Grande Municipio, PR",Jan-22,6654,6071,583,8.80000000
CN7212300000000,72,123,"Salinas Municipio, PR",Jan-22,7672,6989,683,8.90000000
CN7212500000000,72,125,"San German Municipio, PR",Jan-22,10753,9858,895,8.30000000
CN7212700000000,72,127,"San Juan Municipio, PR",Jan-22,148133,140937,7196,4.90000000
CN7212900000000,72,129,"San Lorenzo Municipio, PR",Jan-22,12726,11959,767,6.00000000
CN7213100000000,72,131,"San Sebastian Municipio, PR",Jan-22,11228,10092,1136,10.10000000
CN7213300000000,72,133,"Santa Isabel Municipio, PR",Jan-22,10799,10009,790,7.30000000
CN7213500000000,72,135,"Toa Alta Municipio, PR",Jan-22,30894,29370,1524,4.90000000
CN7213700000000,72,137,"Toa Baja Municipio, PR",Jan-22,32132,30482,1650,5.10000000
CN7213900000000,72,139,"Trujillo Alto Municipio, PR",Jan-22,30042,28833,1209,4.00000000
CN7214100000000,72,141,"Utuado Municipio, PR",Jan-22,7342,6706,636,8.70000000
CN7214300000000,72,143,"Vega Alta Municipio, PR",Jan-22,10914,10081,833,7.60000000
CN7214500000000,72,145,"Vega Baja Municipio, PR",Jan-22,14634,13412,1222,8.40000000
CN7214700000000,72,147,"Vieques Municipio, PR",Jan-22,2893,2588,305,10.50000000
CN7214900000000,72,149,"Villalba Municipio, PR",Jan-22,7910,7129,781,9.90000000
CN7215100000000,72,151,"Yabucoa Municipio, PR",Jan-22,9484,8620,864,9.10000000
CN7215300000000,72,153,"Yauco Municipio, PR",Jan-22,10595,9474,1121,10.60000000
CN0100100000000,01,001,"Autauga County, AL",Feb-22,26726,26054,672,2.50000000
CN0100300000000,01,003,"Baldwin County, AL",Feb-22,100917,98161,2756,2.70000000
CN0100500000000,01,005,"Barbour County, AL",Feb-22,8028,7637,391,4.90000000
CN0100700000000,01,007,"Bibb County, AL",Feb-22,8717,8461,256,2.90000000
CN0100900000000,01,009,"Blount County, AL",Feb-22,25632,25013,619,2.40000000
CN0101100000000,01,011,"Bullock County, AL",Feb-22,4476,4321,155,3.50000000
CN0101300000000,01,013,"Butler County, AL",Feb-22,8642,8241,401,4.60000000
CN0101500000000,01,015,"Calhoun County, AL",Feb-22,46885,45167,1718,3.70000000
CN0101700000000,01,017,"Chambers County, AL",Feb-22,16009,15533,476,3.00000000
CN0101900000000,01,019,"Cherokee County, AL",Feb-22,11810,11510,300,2.50000000
CN0102100000000,01,021,"Chilton County, AL",Feb-22,20150,19641,509,2.50000000
CN0102300000000,01,023,"Choctaw County, AL",Feb-22,4478,4298,180,4.00000000
CN0102500000000,01,025,"Clarke County, AL",Feb-22,7793,7356,437,5.60000000
CN0102700000000,01,027,"Clay County, AL",Feb-22,6135,5987,148,2.40000000
CN0102900000000,01,029,"Cleburne County, AL",Feb-22,6006,5847,159,2.60000000
CN0103100000000,01,031,"Coffee County, AL",Feb-22,21935,21327,608,2.80000000
CN0103300000000,01,033,"Colbert County, AL",Feb-22,23915,23061,854,3.60000000
CN0103500000000,01,035,"Conecuh County, AL",Feb-22,4303,4112,191,4.40000000
CN0103700000000,01,037,"Coosa County, AL",Feb-22,4331,4214,117,2.70000000
CN0103900000000,01,039,"Covington County, AL",Feb-22,15087,14663,424,2.80000000
CN0104100000000,01,041,"Crenshaw County, AL",Feb-22,5986,5812,174,2.90000000
CN0104300000000,01,043,"Cullman County, AL",Feb-22,39348,38463,885,2.20000000
CN0104500000000,01,045,"Dale County, AL",Feb-22,21184,20564,620,2.90000000
CN0104700000000,01,047,"Dallas County, AL",Feb-22,13781,12841,940,6.80000000
CN0104900000000,01,049,"DeKalb County, AL",Feb-22,31131,30347,784,2.50000000
CN0105100000000,01,051,"Elmore County, AL",Feb-22,38189,37255,934,2.40000000
CN0105300000000,01,053,"Escambia County, AL",Feb-22,13797,13305,492,3.60000000
CN0105500000000,01,055,"Etowah County, AL",Feb-22,39762,38312,1450,3.60000000
CN0105700000000,01,057,"Fayette County, AL",Feb-22,6729,6539,190,2.80000000
CN0105900000000,01,059,"Franklin County, AL",Feb-22,14483,14118,365,2.50000000
CN0106100000000,01,061,"Geneva County, AL",Feb-22,11103,10804,299,2.70000000
CN0106300000000,01,063,"Greene County, AL",Feb-22,2838,2660,178,6.30000000
CN0106500000000,01,065,"Hale County, AL",Feb-22,5920,5623,297,5.00000000
CN0106700000000,01,067,"Henry County, AL",Feb-22,6993,6777,216,3.10000000
CN0106900000000,01,069,"Houston County, AL",Feb-22,47840,46411,1429,3.00000000
CN0107100000000,01,071,"Jackson County, AL",Feb-22,23120,22481,639,2.80000000
CN0107300000000,01,073,"Jefferson County, AL",Feb-22,324030,313791,10239,3.20000000
CN0107500000000,01,075,"Lamar County, AL",Feb-22,5713,5551,162,2.80000000
CN0107700000000,01,077,"Lauderdale County, AL",Feb-22,42925,41649,1276,3.00000000
CN0107900000000,01,079,"Lawrence County, AL",Feb-22,14572,14178,394,2.70000000
CN0108100000000,01,081,"Lee County, AL",Feb-22,78884,76814,2070,2.60000000
CN0108300000000,01,083,"Limestone County, AL",Feb-22,47659,46548,1111,2.30000000
CN0108500000000,01,085,"Lowndes County, AL",Feb-22,3580,3299,281,7.80000000
CN0108700000000,01,087,"Macon County, AL",Feb-22,7997,7588,409,5.10000000
CN0108900000000,01,089,"Madison County, AL",Feb-22,196887,192091,4796,2.40000000
CN0109100000000,01,091,"Marengo County, AL",Feb-22,7658,7363,295,3.90000000
CN0109300000000,01,093,"Marion County, AL",Feb-22,13418,13061,357,2.70000000
CN0109500000000,01,095,"Marshall County, AL",Feb-22,44854,43828,1026,2.30000000
CN0109700000000,01,097,"Mobile County, AL",Feb-22,194174,186276,7898,4.10000000
CN0109900000000,01,099,"Monroe County, AL",Feb-22,7439,7062,377,5.10000000
CN0110100000000,01,101,"Montgomery County, AL",Feb-22,107905,103605,4300,4.00000000
CN0110300000000,01,103,"Morgan County, AL",Feb-22,60316,58885,1431,2.40000000
CN0110500000000,01,105,"Perry County, AL",Feb-22,3117,2876,241,7.70000000
CN0110700000000,01,107,"Pickens County, AL",Feb-22,7619,7349,270,3.50000000
CN0110900000000,01,109,"Pike County, AL",Feb-22,16294,15820,474,2.90000000
CN0111100000000,01,111,"Randolph County, AL",Feb-22,9429,9178,251,2.70000000
CN0111300000000,01,113,"Russell County, AL",Feb-22,23919,23275,644,2.70000000
CN0111500000000,01,115,"St. Clair County, AL",Feb-22,42129,41081,1048,2.50000000
CN0111700000000,01,117,"Shelby County, AL",Feb-22,121131,118659,2472,2.00000000
CN0111900000000,01,119,"Sumter County, AL",Feb-22,4446,4275,171,3.80000000
CN0112100000000,01,121,"Talladega County, AL",Feb-22,36182,34787,1395,3.90000000
CN0112300000000,01,123,"Tallapoosa County, AL",Feb-22,17525,16913,612,3.50000000
CN0112500000000,01,125,"Tuscaloosa County, AL",Feb-22,103529,100405,3124,3.00000000
CN0112700000000,01,127,"Walker County, AL",Feb-22,25529,24716,813,3.20000000
CN0112900000000,01,129,"Washington County, AL",Feb-22,6541,6242,299,4.60000000
CN0113100000000,01,131,"Wilcox County, AL",Feb-22,2608,2331,277,10.60000000
CN0113300000000,01,133,"Winston County, AL",Feb-22,10096,9833,263,2.60000000
CN0201300000000,02,013,"Aleutians East Borough, AK",Feb-22,2432,2383,49,2.00000000
CN0201600000000,02,016,"Aleutians West Census Area, AK",Feb-22,4808,4707,101,2.10000000
CN0202000000000,02,020,"Anchorage Borough/municipality, AK",Feb-22,153452,146732,6720,4.40000000
CN0205000000000,02,050,"Bethel Census Area, AK",Feb-22,7125,6287,838,11.80000000
CN0206000000000,02,060,"Bristol Bay Borough, AK",Feb-22,243,215,28,11.50000000
CN0206300000000,02,063,"Chugach Census Area, AK",Feb-22,2902,2716,186,6.40000000
CN0206600000000,02,066,"Copper River Census Area, AK",Feb-22,1262,1060,202,16.00000000
CN0206800000000,02,068,"Denali Borough, AK",Feb-22,613,515,98,16.00000000
CN0207000000000,02,070,"Dillingham Census Area, AK",Feb-22,1606,1484,122,7.60000000
CN0209000000000,02,090,"Fairbanks North Star Borough, AK",Feb-22,45864,43730,2134,4.70000000
CN0210000000000,02,100,"Haines Borough, AK",Feb-22,951,839,112,11.80000000
CN0210500000000,02,105,"Hoonah-Angoon Census Area, AK",Feb-22,1020,901,119,11.70000000
CN0211000000000,02,110,"Juneau Borough/city, AK",Feb-22,16917,16278,639,3.80000000
CN0212200000000,02,122,"Kenai Peninsula Borough, AK",Feb-22,26790,24910,1880,7.00000000
CN0213000000000,02,130,"Ketchikan Gateway Borough, AK",Feb-22,6384,5989,395,6.20000000
CN0215000000000,02,150,"Kodiak Island Borough, AK",Feb-22,6122,5751,371,6.10000000
CN0215800000000,02,158,"Kusilvak Census Area, AK",Feb-22,2337,1920,417,17.80000000
CN0216400000000,02,164,"Lake and Peninsula Borough, AK",Feb-22,561,509,52,9.30000000
CN0217000000000,02,170,"Matanuska-Susitna Borough, AK",Feb-22,51038,47804,3234,6.30000000
CN0218000000000,02,180,"Nome Census Area, AK",Feb-22,4201,3812,389,9.30000000
CN0218500000000,02,185,"North Slope Borough, AK",Feb-22,3019,2835,184,6.10000000
CN0218800000000,02,188,"Northwest Arctic Borough, AK",Feb-22,2970,2653,317,10.70000000
CN0219500000000,02,195,"Petersburg Borough, AK",Feb-22,1648,1535,113,6.90000000
CN0219800000000,02,198,"Prince of Wales-Hyder Census Area, AK",Feb-22,2881,2662,219,7.60000000
CN0222000000000,02,220,"Sitka Borough/city, AK",Feb-22,4117,3951,166,4.00000000
CN0223000000000,02,230,"Skagway Municipality, AK",Feb-22,609,502,107,17.60000000
CN0224000000000,02,240,"Southeast Fairbanks Census Area, AK",Feb-22,3276,3028,248,7.60000000
CN0227500000000,02,275,"Wrangell Borough/city, AK",Feb-22,990,922,68,6.90000000
CN0228200000000,02,282,"Yakutat Borough/city, AK",Feb-22,286,266,20,7.00000000
CN0229000000000,02,290,"Yukon-Koyukuk Census Area, AK",Feb-22,2489,2197,292,11.70000000
CN0400100000000,04,001,"Apache County, AZ",Feb-22,18729,17233,1496,8.00000000
CN0400300000000,04,003,"Cochise County, AZ",Feb-22,49781,47895,1886,3.80000000
CN0400500000000,04,005,"Coconino County, AZ",Feb-22,74610,71093,3517,4.70000000
CN0400700000000,04,007,"Gila County, AZ",Feb-22,20343,19570,773,3.80000000
CN0400900000000,04,009,"Graham County, AZ",Feb-22,16150,15672,478,3.00000000
CN0401100000000,04,011,"Greenlee County, AZ",Feb-22,4419,4297,122,2.80000000
CN0401200000000,04,012,"La Paz County, AZ",Feb-22,9361,8999,362,3.90000000
CN0401300000000,04,013,"Maricopa County, AZ",Feb-22,2342268,2269709,72559,3.10000000
CN0401500000000,04,015,"Mohave County, AZ",Feb-22,89513,85576,3937,4.40000000
CN0401700000000,04,017,"Navajo County, AZ",Feb-22,38949,36852,2097,5.40000000
CN0401900000000,04,019,"Pima County, AZ",Feb-22,488609,471210,17399,3.60000000
CN0402100000000,04,021,"Pinal County, AZ",Feb-22,197023,190230,6793,3.40000000
CN0402300000000,04,023,"Santa Cruz County, AZ",Feb-22,19606,18220,1386,7.10000000
CN0402500000000,04,025,"Yavapai County, AZ",Feb-22,107008,103839,3169,3.00000000
CN0402700000000,04,027,"Yuma County, AZ",Feb-22,99333,87487,11846,11.90000000
CN0500100000000,05,001,"Arkansas County, AR",Feb-22,9458,9082,376,4.00000000
CN0500300000000,05,003,"Ashley County, AR",Feb-22,6660,6174,486,7.30000000
CN0500500000000,05,005,"Baxter County, AR",Feb-22,16253,15627,626,3.90000000
CN0500700000000,05,007,"Benton County, AR",Feb-22,147571,143748,3823,2.60000000
CN0500900000000,05,009,"Boone County, AR",Feb-22,15847,15381,466,2.90000000
CN0501100000000,05,011,"Bradley County, AR",Feb-22,4003,3816,187,4.70000000
CN0501300000000,05,013,"Calhoun County, AR",Feb-22,2405,2329,76,3.20000000
CN0501500000000,05,015,"Carroll County, AR",Feb-22,12373,11917,456,3.70000000
CN0501700000000,05,017,"Chicot County, AR",Feb-22,3008,2759,249,8.30000000
CN0501900000000,05,019,"Clark County, AR",Feb-22,8795,8404,391,4.40000000
CN0502100000000,05,021,"Clay County, AR",Feb-22,5318,5078,240,4.50000000
CN0502300000000,05,023,"Cleburne County, AR",Feb-22,8884,8452,432,4.90000000
CN0502500000000,05,025,"Cleveland County, AR",Feb-22,3115,2992,123,3.90000000
CN0502700000000,05,027,"Columbia County, AR",Feb-22,8870,8449,421,4.70000000
CN0502900000000,05,029,"Conway County, AR",Feb-22,8284,7922,362,4.40000000
CN0503100000000,05,031,"Craighead County, AR",Feb-22,56489,54819,1670,3.00000000
CN0503300000000,05,033,"Crawford County, AR",Feb-22,26213,25273,940,3.60000000
CN0503500000000,05,035,"Crittenden County, AR",Feb-22,20651,19754,897,4.30000000
CN0503700000000,05,037,"Cross County, AR",Feb-22,6909,6606,303,4.40000000
CN0503900000000,05,039,"Dallas County, AR",Feb-22,2763,2640,123,4.50000000
CN0504100000000,05,041,"Desha County, AR",Feb-22,4950,4631,319,6.40000000
CN0504300000000,05,043,"Drew County, AR",Feb-22,7581,7203,378,5.00000000
CN0504500000000,05,045,"Faulkner County, AR",Feb-22,61785,59800,1985,3.20000000
CN0504700000000,05,047,"Franklin County, AR",Feb-22,7256,6981,275,3.80000000
CN0504900000000,05,049,"Fulton County, AR",Feb-22,4856,4688,168,3.50000000
CN0505100000000,05,051,"Garland County, AR",Feb-22,40444,38580,1864,4.60000000
CN0505300000000,05,053,"Grant County, AR",Feb-22,8292,8019,273,3.30000000
CN0505500000000,05,055,"Greene County, AR",Feb-22,19488,18829,659,3.40000000
CN0505700000000,05,057,"Hempstead County, AR",Feb-22,9083,8749,334,3.70000000
CN0505900000000,05,059,"Hot Spring County, AR",Feb-22,13933,13408,525,3.80000000
CN0506100000000,05,061,"Howard County, AR",Feb-22,5436,5258,178,3.30000000
CN0506300000000,05,063,"Independence County, AR",Feb-22,16422,15803,619,3.80000000
CN0506500000000,05,065,"Izard County, AR",Feb-22,4305,4056,249,5.80000000
CN0506700000000,05,067,"Jackson County, AR",Feb-22,5659,5356,303,5.40000000
CN0506900000000,05,069,"Jefferson County, AR",Feb-22,26257,24562,1695,6.50000000
CN0507100000000,05,071,"Johnson County, AR",Feb-22,9912,9460,452,4.60000000
CN0507300000000,05,073,"Lafayette County, AR",Feb-22,2304,2179,125,5.40000000
CN0507500000000,05,075,"Lawrence County, AR",Feb-22,6745,6470,275,4.10000000
CN0507700000000,05,077,"Lee County, AR",Feb-22,2519,2371,148,5.90000000
CN0507900000000,05,079,"Lincoln County, AR",Feb-22,3754,3563,191,5.10000000
CN0508100000000,05,081,"Little River County, AR",Feb-22,5371,5141,230,4.30000000
CN0508300000000,05,083,"Logan County, AR",Feb-22,8394,8051,343,4.10000000
CN0508500000000,05,085,"Lonoke County, AR",Feb-22,33604,32518,1086,3.20000000
CN0508700000000,05,087,"Madison County, AR",Feb-22,7608,7389,219,2.90000000
CN0508900000000,05,089,"Marion County, AR",Feb-22,6056,5791,265,4.40000000
CN0509100000000,05,091,"Miller County, AR",Feb-22,19326,18473,853,4.40000000
CN0509300000000,05,093,"Mississippi County, AR",Feb-22,16179,15034,1145,7.10000000
CN0509500000000,05,095,"Monroe County, AR",Feb-22,2613,2477,136,5.20000000
CN0509700000000,05,097,"Montgomery County, AR",Feb-22,2804,2653,151,5.40000000
CN0509900000000,05,099,"Nevada County, AR",Feb-22,3337,3194,143,4.30000000
CN0510100000000,05,101,"Newton County, AR",Feb-22,3198,3088,110,3.40000000
CN0510300000000,05,103,"Ouachita County, AR",Feb-22,9828,9421,407,4.10000000
CN0510500000000,05,105,"Perry County, AR",Feb-22,4159,3971,188,4.50000000
CN0510700000000,05,107,"Phillips County, AR",Feb-22,5782,5330,452,7.80000000
CN0510900000000,05,109,"Pike County, AR",Feb-22,4128,3937,191,4.60000000
CN0511100000000,05,111,"Poinsett County, AR",Feb-22,9824,9449,375,3.80000000
CN0511300000000,05,113,"Polk County, AR",Feb-22,7743,7410,333,4.30000000
CN0511500000000,05,115,"Pope County, AR",Feb-22,27368,26255,1113,4.10000000
CN0511700000000,05,117,"Prairie County, AR",Feb-22,3486,3366,120,3.40000000
CN0511900000000,05,119,"Pulaski County, AR",Feb-22,186760,178617,8143,4.40000000
CN0512100000000,05,121,"Randolph County, AR",Feb-22,7303,7029,274,3.80000000
CN0512300000000,05,123,"St. Francis County, AR",Feb-22,7622,7170,452,5.90000000
CN0512500000000,05,125,"Saline County, AR",Feb-22,58731,56961,1770,3.00000000
CN0512700000000,05,127,"Scott County, AR",Feb-22,4234,4102,132,3.10000000
CN0512900000000,05,129,"Searcy County, AR",Feb-22,2881,2734,147,5.10000000
CN0513100000000,05,131,"Sebastian County, AR",Feb-22,55069,53165,1904,3.50000000
CN0513300000000,05,133,"Sevier County, AR",Feb-22,5334,5107,227,4.30000000
CN0513500000000,05,135,"Sharp County, AR",Feb-22,5622,5346,276,4.90000000
CN0513700000000,05,137,"Stone County, AR",Feb-22,4380,4165,215,4.90000000
CN0513900000000,05,139,"Union County, AR",Feb-22,14963,14084,879,5.90000000
CN0514100000000,05,141,"Van Buren County, AR",Feb-22,5785,5503,282,4.90000000
CN0514300000000,05,143,"Washington County, AR",Feb-22,130453,127056,3397,2.60000000
CN0514500000000,05,145,"White County, AR",Feb-22,34091,32749,1342,3.90000000
CN0514700000000,05,147,"Woodruff County, AR",Feb-22,2809,2684,125,4.40000000
CN0514900000000,05,149,"Yell County, AR",Feb-22,7863,7531,332,4.20000000
CN0600100000000,06,001,"Alameda County, CA",Feb-22,828009,796571,31438,3.80000000
CN0600300000000,06,003,"Alpine County, CA",Feb-22,576,543,33,5.70000000
CN0600500000000,06,005,"Amador County, CA",Feb-22,14408,13660,748,5.20000000
CN0600700000000,06,007,"Butte County, CA",Feb-22,92277,87519,4758,5.20000000
CN0600900000000,06,009,"Calaveras County, CA",Feb-22,21570,20690,880,4.10000000
CN0601100000000,06,011,"Colusa County, CA",Feb-22,10845,9258,1587,14.60000000
CN0601300000000,06,013,"Contra Costa County, CA",Feb-22,553950,531185,22765,4.10000000
CN0601500000000,06,015,"Del Norte County, CA",Feb-22,9301,8760,541,5.80000000
CN0601700000000,06,017,"El Dorado County, CA",Feb-22,93235,89614,3621,3.90000000
CN0601900000000,06,019,"Fresno County, CA",Feb-22,455657,420698,34959,7.70000000
CN0602100000000,06,021,"Glenn County, CA",Feb-22,12715,11976,739,5.80000000
CN0602300000000,06,023,"Humboldt County, CA",Feb-22,59604,57037,2567,4.30000000
CN0602500000000,06,025,"Imperial County, CA",Feb-22,70655,60714,9941,14.10000000
CN0602700000000,06,027,"Inyo County, CA",Feb-22,8263,7910,353,4.30000000
CN0602900000000,06,029,"Kern County, CA",Feb-22,389093,356564,32529,8.40000000
CN0603100000000,06,031,"Kings County, CA",Feb-22,57355,52456,4899,8.50000000
CN0603300000000,06,033,"Lake County, CA",Feb-22,28524,26845,1679,5.90000000
CN0603500000000,06,035,"Lassen County, CA",Feb-22,8856,8395,461,5.20000000
CN0603700000000,06,037,"Los Angeles County, CA",Feb-22,5065387,4772698,292689,5.80000000
CN0603900000000,06,039,"Madera County, CA",Feb-22,64601,59952,4649,7.20000000
CN0604100000000,06,041,"Marin County, CA",Feb-22,130751,127102,3649,2.80000000
CN0604300000000,06,043,"Mariposa County, CA",Feb-22,6367,5951,416,6.50000000
CN0604500000000,06,045,"Mendocino County, CA",Feb-22,37449,35721,1728,4.60000000
CN0604700000000,06,047,"Merced County, CA",Feb-22,116793,105857,10936,9.40000000
CN0604900000000,06,049,"Modoc County, CA",Feb-22,3135,2911,224,7.10000000
CN0605100000000,06,051,"Mono County, CA",Feb-22,9522,9129,393,4.10000000
CN0605300000000,06,053,"Monterey County, CA",Feb-22,206821,188409,18412,8.90000000
CN0605500000000,06,055,"Napa County, CA",Feb-22,69763,67061,2702,3.90000000
CN0605700000000,06,057,"Nevada County, CA",Feb-22,47953,46070,1883,3.90000000
CN0605900000000,06,059,"Orange County, CA",Feb-22,1589722,1531419,58303,3.70000000
CN0606100000000,06,061,"Placer County, CA",Feb-22,192774,186520,6254,3.20000000
CN0606300000000,06,063,"Plumas County, CA",Feb-22,6850,6170,680,9.90000000
CN0606500000000,06,065,"Riverside County, CA",Feb-22,1162542,1104968,57574,5.00000000
CN0606700000000,06,067,"Sacramento County, CA",Feb-22,727749,693498,34251,4.70000000
CN0606900000000,06,069,"San Benito County, CA",Feb-22,32583,30564,2019,6.20000000
CN0607100000000,06,071,"San Bernardino County, CA",Feb-22,1017769,966449,51320,5.00000000
CN0607300000000,06,073,"San Diego County, CA",Feb-22,1589258,1524946,64312,4.00000000
CN0607500000000,06,075,"San Francisco County/city, CA",Feb-22,567859,550814,17045,3.00000000
CN0607700000000,06,077,"San Joaquin County, CA",Feb-22,338496,316262,22234,6.60000000
CN0607900000000,06,079,"San Luis Obispo County, CA",Feb-22,138192,133644,4548,3.30000000
CN0608100000000,06,081,"San Mateo County, CA",Feb-22,449035,436859,12176,2.70000000
CN0608300000000,06,083,"Santa Barbara County, CA",Feb-22,218925,209497,9428,4.30000000
CN0608500000000,06,085,"Santa Clara County, CA",Feb-22,1040930,1010930,30000,2.90000000
CN0608700000000,06,087,"Santa Cruz County, CA",Feb-22,133951,125815,8136,6.10000000
CN0608900000000,06,089,"Shasta County, CA",Feb-22,73681,69769,3912,5.30000000
CN0609100000000,06,091,"Sierra County, CA",Feb-22,1299,1224,75,5.80000000
CN0609300000000,06,093,"Siskiyou County, CA",Feb-22,16081,14842,1239,7.70000000
CN0609500000000,06,095,"Solano County, CA",Feb-22,202218,191427,10791,5.30000000
CN0609700000000,06,097,"Sonoma County, CA",Feb-22,248423,239754,8669,3.50000000
CN0609900000000,06,099,"Stanislaus County, CA",Feb-22,241333,225671,15662,6.50000000
CN0610100000000,06,101,"Sutter County, CA",Feb-22,45700,42009,3691,8.10000000
CN0610300000000,06,103,"Tehama County, CA",Feb-22,25275,23871,1404,5.60000000
CN0610500000000,06,105,"Trinity County, CA",Feb-22,4264,4019,245,5.70000000
CN0610700000000,06,107,"Tulare County, CA",Feb-22,206909,187753,19156,9.30000000
CN0610900000000,06,109,"Tuolumne County, CA",Feb-22,19996,18904,1092,5.50000000
CN0611100000000,06,111,"Ventura County, CA",Feb-22,412989,395960,17029,4.10000000
CN0611300000000,06,113,"Yolo County, CA",Feb-22,108770,103865,4905,4.50000000
CN0611500000000,06,115,"Yuba County, CA",Feb-22,31450,29361,2089,6.60000000
CN0800100000000,08,001,"Adams County, CO",Feb-22,282211,268885,13326,4.70000000
CN0800300000000,08,003,"Alamosa County, CO",Feb-22,8672,8300,372,4.30000000
CN0800500000000,08,005,"Arapahoe County, CO",Feb-22,374826,358928,15898,4.20000000
CN0800700000000,08,007,"Archuleta County, CO",Feb-22,7155,6858,297,4.20000000
CN0800900000000,08,009,"Baca County, CO",Feb-22,2119,2077,42,2.00000000
CN0801100000000,08,011,"Bent County, CO",Feb-22,1889,1803,86,4.60000000
CN0801300000000,08,013,"Boulder County, CO",Feb-22,200705,194268,6437,3.20000000
CN0801400000000,08,014,"Broomfield County/city, CO",Feb-22,42216,40833,1383,3.30000000
CN0801500000000,08,015,"Chaffee County, CO",Feb-22,10288,9947,341,3.30000000
CN0801700000000,08,017,"Cheyenne County, CO",Feb-22,1130,1109,21,1.90000000
CN0801900000000,08,019,"Clear Creek County, CO",Feb-22,6146,5898,248,4.00000000
CN0802100000000,08,021,"Conejos County, CO",Feb-22,4170,4011,159,3.80000000
CN0802300000000,08,023,"Costilla County, CO",Feb-22,1902,1803,99,5.20000000
CN0802500000000,08,025,"Crowley County, CO",Feb-22,1465,1403,62,4.20000000
CN0802700000000,08,027,"Custer County, CO",Feb-22,2331,2252,79,3.40000000
CN0802900000000,08,029,"Delta County, CO",Feb-22,14218,13583,635,4.50000000
CN0803100000000,08,031,"Denver County/city, CO",Feb-22,436143,417240,18903,4.30000000
CN0803300000000,08,033,"Dolores County, CO",Feb-22,1152,1107,45,3.90000000
CN0803500000000,08,035,"Douglas County, CO",Feb-22,206117,199839,6278,3.00000000
CN0803700000000,08,037,"Eagle County, CO",Feb-22,40398,39221,1177,2.90000000
CN0803900000000,08,039,"Elbert County, CO",Feb-22,15863,15390,473,3.00000000
CN0804100000000,08,041,"El Paso County, CO",Feb-22,356511,341362,15149,4.20000000
CN0804300000000,08,043,"Fremont County, CO",Feb-22,15701,14768,933,5.90000000
CN0804500000000,08,045,"Garfield County, CO",Feb-22,33653,32416,1237,3.70000000
CN0804700000000,08,047,"Gilpin County, CO",Feb-22,3935,3772,163,4.10000000
CN0804900000000,08,049,"Grand County, CO",Feb-22,10711,10387,324,3.00000000
CN0805100000000,08,051,"Gunnison County, CO",Feb-22,12476,12141,335,2.70000000
CN0805300000000,08,053,"Hinsdale County, CO",Feb-22,405,393,12,3.00000000
CN0805500000000,08,055,"Huerfano County, CO",Feb-22,2606,2410,196,7.50000000
CN0805700000000,08,057,"Jackson County, CO",Feb-22,956,929,27,2.80000000
CN0805900000000,08,059,"Jefferson County, CO",Feb-22,341659,329072,12587,3.70000000
CN0806100000000,08,061,"Kiowa County, CO",Feb-22,916,894,22,2.40000000
CN0806300000000,08,063,"Kit Carson County, CO",Feb-22,4251,4146,105,2.50000000
CN0806500000000,08,065,"Lake County, CO",Feb-22,5415,5252,163,3.00000000
CN0806700000000,08,067,"La Plata County, CO",Feb-22,31471,30196,1275,4.10000000
CN0806900000000,08,069,"Larimer County, CO",Feb-22,211132,203740,7392,3.50000000
CN0807100000000,08,071,"Las Animas County, CO",Feb-22,6473,6110,363,5.60000000
CN0807300000000,08,073,"Lincoln County, CO",Feb-22,2354,2278,76,3.20000000
CN0807500000000,08,075,"Logan County, CO",Feb-22,11025,10665,360,3.30000000
CN0807700000000,08,077,"Mesa County, CO",Feb-22,79025,75460,3565,4.50000000
CN0807900000000,08,079,"Mineral County, CO",Feb-22,519,504,15,2.90000000
CN0808100000000,08,081,"Moffat County, CO",Feb-22,7266,6972,294,4.00000000
CN0808300000000,08,083,"Montezuma County, CO",Feb-22,13017,12366,651,5.00000000
CN0808500000000,08,085,"Montrose County, CO",Feb-22,22981,22026,955,4.20000000
CN0808700000000,08,087,"Morgan County, CO",Feb-22,16442,15802,640,3.90000000
CN0808900000000,08,089,"Otero County, CO",Feb-22,8337,7923,414,5.00000000
CN0809100000000,08,091,"Ouray County, CO",Feb-22,2750,2650,100,3.60000000
CN0809300000000,08,093,"Park County, CO",Feb-22,11542,11168,374,3.20000000
CN0809500000000,08,095,"Phillips County, CO",Feb-22,2495,2428,67,2.70000000
CN0809700000000,08,097,"Pitkin County, CO",Feb-22,11465,11065,400,3.50000000
CN0809900000000,08,099,"Prowers County, CO",Feb-22,6412,6187,225,3.50000000
CN0810100000000,08,101,"Pueblo County, CO",Feb-22,79084,74155,4929,6.20000000
CN0810300000000,08,103,"Rio Blanco County, CO",Feb-22,2865,2725,140,4.90000000
CN0810500000000,08,105,"Rio Grande County, CO",Feb-22,5555,5234,321,5.80000000
CN0810700000000,08,107,"Routt County, CO",Feb-22,16845,16341,504,3.00000000
CN0810900000000,08,109,"Saguache County, CO",Feb-22,3531,3373,158,4.50000000
CN0811100000000,08,111,"San Juan County, CO",Feb-22,597,581,16,2.70000000
CN0811300000000,08,113,"San Miguel County, CO",Feb-22,7004,6813,191,2.70000000
CN0811500000000,08,115,"Sedgwick County, CO",Feb-22,1187,1152,35,2.90000000
CN0811700000000,08,117,"Summit County, CO",Feb-22,26156,25511,645,2.50000000
CN0811900000000,08,119,"Teller County, CO",Feb-22,13312,12795,517,3.90000000
CN0812100000000,08,121,"Washington County, CO",Feb-22,2754,2675,79,2.90000000
CN0812300000000,08,123,"Weld County, CO",Feb-22,168790,161485,7305,4.30000000
CN0812500000000,08,125,"Yuma County, CO",Feb-22,5699,5565,134,2.40000000
CN0900100000000,09,001,"Fairfield County, CT",Feb-22,469622,446044,23578,5.00000000
CN0900300000000,09,003,"Hartford County, CT",Feb-22,473617,449821,23796,5.00000000
CN0900500000000,09,005,"Litchfield County, CT",Feb-22,102021,97079,4942,4.80000000
CN0900700000000,09,007,"Middlesex County, CT",Feb-22,92443,88461,3982,4.30000000
CN0900900000000,09,009,"New Haven County, CT",Feb-22,459770,436103,23667,5.10000000
CN0901100000000,09,011,"New London County, CT",Feb-22,129390,122232,7158,5.50000000
CN0901300000000,09,013,"Tolland County, CT",Feb-22,85782,81658,4124,4.80000000
CN0901500000000,09,015,"Windham County, CT",Feb-22,62733,59457,3276,5.20000000
CN1000100000000,10,001,"Kent County, DE",Feb-22,82018,77779,4239,5.20000000
CN1000300000000,10,003,"New Castle County, DE",Feb-22,306804,292989,13815,4.50000000
CN1000500000000,10,005,"Sussex County, DE",Feb-22,109304,104141,5163,4.70000000
CN1100100000000,11,001,District of Columbia,Feb-22,387107,365514,21593,5.60000000
CN1200100000000,12,001,"Alachua County, FL",Feb-22,140989,137188,3801,2.70000000
CN1200300000000,12,003,"Baker County, FL",Feb-22,12347,12009,338,2.70000000
CN1200500000000,12,005,"Bay County, FL",Feb-22,85858,83376,2482,2.90000000
CN1200700000000,12,007,"Bradford County, FL",Feb-22,10927,10583,344,3.10000000
CN1200900000000,12,009,"Brevard County, FL",Feb-22,291832,283342,8490,2.90000000
CN1201100000000,12,011,"Broward County, FL",Feb-22,1042055,1008570,33485,3.20000000
CN1201300000000,12,013,"Calhoun County, FL",Feb-22,4859,4698,161,3.30000000
CN1201500000000,12,015,"Charlotte County, FL",Feb-22,75495,73035,2460,3.30000000
CN1201700000000,12,017,"Citrus County, FL",Feb-22,47415,45361,2054,4.30000000
CN1201900000000,12,019,"Clay County, FL",Feb-22,110329,107435,2894,2.60000000
CN1202100000000,12,021,"Collier County, FL",Feb-22,187369,182575,4794,2.60000000
CN1202300000000,12,023,"Columbia County, FL",Feb-22,29049,28058,991,3.40000000
CN1202700000000,12,027,"DeSoto County, FL",Feb-22,15055,14641,414,2.70000000
CN1202900000000,12,029,"Dixie County, FL",Feb-22,5889,5693,196,3.30000000
CN1203100000000,12,031,"Duval County, FL",Feb-22,501452,485890,15562,3.10000000
CN1203300000000,12,033,"Escambia County, FL",Feb-22,146502,141817,4685,3.20000000
CN1203500000000,12,035,"Flagler County, FL",Feb-22,48818,47135,1683,3.40000000
CN1203700000000,12,037,"Franklin County, FL",Feb-22,4628,4477,151,3.30000000
CN1203900000000,12,039,"Gadsden County, FL",Feb-22,20059,19288,771,3.80000000
CN1204100000000,12,041,"Gilchrist County, FL",Feb-22,7354,7132,222,3.00000000
CN1204300000000,12,043,"Glades County, FL",Feb-22,5338,5179,159,3.00000000
CN1204500000000,12,045,"Gulf County, FL",Feb-22,5281,5129,152,2.90000000
CN1204700000000,12,047,"Hamilton County, FL",Feb-22,4057,3876,181,4.50000000
CN1204900000000,12,049,"Hardee County, FL",Feb-22,9131,8837,294,3.20000000
CN1205100000000,12,051,"Hendry County, FL",Feb-22,16442,15773,669,4.10000000
CN1205300000000,12,053,"Hernando County, FL",Feb-22,74789,71968,2821,3.80000000
CN1205500000000,12,055,"Highlands County, FL",Feb-22,34627,33117,1510,4.40000000
CN1205700000000,12,057,"Hillsborough County, FL",Feb-22,785688,762891,22797,2.90000000
CN1205900000000,12,059,"Holmes County, FL",Feb-22,6951,6736,215,3.10000000
CN1206100000000,12,061,"Indian River County, FL",Feb-22,66333,64056,2277,3.40000000
CN1206300000000,12,063,"Jackson County, FL",Feb-22,17046,16497,549,3.20000000
CN1206500000000,12,065,"Jefferson County, FL",Feb-22,5700,5525,175,3.10000000
CN1206700000000,12,067,"Lafayette County, FL",Feb-22,2792,2702,90,3.20000000
CN1206900000000,12,069,"Lake County, FL",Feb-22,164340,158958,5382,3.30000000
CN1207100000000,12,071,"Lee County, FL",Feb-22,365623,354858,10765,2.90000000
CN1207300000000,12,073,"Leon County, FL",Feb-22,157118,152389,4729,3.00000000
CN1207500000000,12,075,"Levy County, FL",Feb-22,16929,16328,601,3.60000000
CN1207700000000,12,077,"Liberty County, FL",Feb-22,2584,2498,86,3.30000000
CN1207900000000,12,079,"Madison County, FL",Feb-22,7810,7536,274,3.50000000
CN1208100000000,12,081,"Manatee County, FL",Feb-22,190396,185132,5264,2.80000000
CN1208300000000,12,083,"Marion County, FL",Feb-22,142263,137144,5119,3.60000000
CN1208500000000,12,085,"Martin County, FL",Feb-22,74559,72589,1970,2.60000000
CN1208600000000,12,086,"Miami-Dade County, FL",Feb-22,1372977,1333320,39657,2.90000000
CN1208700000000,12,087,"Monroe County, FL",Feb-22,48743,47770,973,2.00000000
CN1208900000000,12,089,"Nassau County, FL",Feb-22,43683,42589,1094,2.50000000
CN1209100000000,12,091,"Okaloosa County, FL",Feb-22,99047,96597,2450,2.50000000
CN1209300000000,12,093,"Okeechobee County, FL",Feb-22,17845,17294,551,3.10000000
CN1209500000000,12,095,"Orange County, FL",Feb-22,761363,735635,25728,3.40000000
CN1209700000000,12,097,"Osceola County, FL",Feb-22,190158,182326,7832,4.10000000
CN1209900000000,12,099,"Palm Beach County, FL",Feb-22,747906,725540,22366,3.00000000
CN1210100000000,12,101,"Pasco County, FL",Feb-22,251029,243104,7925,3.20000000
CN1210300000000,12,103,"Pinellas County, FL",Feb-22,495728,481884,13844,2.80000000
CN1210500000000,12,105,"Polk County, FL",Feb-22,334283,321971,12312,3.70000000
CN1210700000000,12,107,"Putnam County, FL",Feb-22,27323,26114,1209,4.40000000
CN1210900000000,12,109,"St. Johns County, FL",Feb-22,145517,142213,3304,2.30000000
CN1211100000000,12,111,"St. Lucie County, FL",Feb-22,152074,146714,5360,3.50000000
CN1211300000000,12,113,"Santa Rosa County, FL",Feb-22,85674,83413,2261,2.60000000
CN1211500000000,12,115,"Sarasota County, FL",Feb-22,199000,193529,5471,2.70000000
CN1211700000000,12,117,"Seminole County, FL",Feb-22,252481,245342,7139,2.80000000
CN1211900000000,12,119,"Sumter County, FL",Feb-22,35511,34027,1484,4.20000000
CN1212100000000,12,121,"Suwannee County, FL",Feb-22,17294,16743,551,3.20000000
CN1212300000000,12,123,"Taylor County, FL",Feb-22,7837,7555,282,3.60000000
CN1212500000000,12,125,"Union County, FL",Feb-22,4584,4471,113,2.50000000
CN1212700000000,12,127,"Volusia County, FL",Feb-22,257530,248923,8607,3.30000000
CN1212900000000,12,129,"Wakulla County, FL",Feb-22,15809,15419,390,2.50000000
CN1213100000000,12,131,"Walton County, FL",Feb-22,33613,32724,889,2.60000000
CN1213300000000,12,133,"Washington County, FL",Feb-22,9477,9162,315,3.30000000
CN1300100000000,13,001,"Appling County, GA",Feb-22,9145,8839,306,3.30000000
CN1300300000000,13,003,"Atkinson County, GA",Feb-22,4516,4384,132,2.90000000
CN1300500000000,13,005,"Bacon County, GA",Feb-22,4758,4607,151,3.20000000
CN1300700000000,13,007,"Baker County, GA",Feb-22,1124,1074,50,4.40000000
CN1300900000000,13,009,"Baldwin County, GA",Feb-22,17876,17146,730,4.10000000
CN1301100000000,13,011,"Banks County, GA",Feb-22,10235,9990,245,2.40000000
CN1301300000000,13,013,"Barrow County, GA",Feb-22,43530,42394,1136,2.60000000
CN1301500000000,13,015,"Bartow County, GA",Feb-22,52825,51249,1576,3.00000000
CN1301700000000,13,017,"Ben Hill County, GA",Feb-22,5482,5239,243,4.40000000
CN1301900000000,13,019,"Berrien County, GA",Feb-22,7642,7391,251,3.30000000
CN1302100000000,13,021,"Bibb County, GA",Feb-22,68642,65913,2729,4.00000000
CN1302300000000,13,023,"Bleckley County, GA",Feb-22,4682,4489,193,4.10000000
CN1302500000000,13,025,"Brantley County, GA",Feb-22,7283,7019,264,3.60000000
CN1302700000000,13,027,"Brooks County, GA",Feb-22,6752,6532,220,3.30000000
CN1302900000000,13,029,"Bryan County, GA",Feb-22,20507,19958,549,2.70000000
CN1303100000000,13,031,"Bulloch County, GA",Feb-22,38382,37014,1368,3.60000000
CN1303300000000,13,033,"Burke County, GA",Feb-22,9167,8663,504,5.50000000
CN1303500000000,13,035,"Butts County, GA",Feb-22,11451,11121,330,2.90000000
CN1303700000000,13,037,"Calhoun County, GA",Feb-22,2215,2138,77,3.50000000
CN1303900000000,13,039,"Camden County, GA",Feb-22,21927,21259,668,3.00000000
CN1304300000000,13,043,"Candler County, GA",Feb-22,6047,5884,163,2.70000000
CN1304500000000,13,045,"Carroll County, GA",Feb-22,57747,55913,1834,3.20000000
CN1304700000000,13,047,"Catoosa County, GA",Feb-22,33806,32837,969,2.90000000
CN1304900000000,13,049,"Charlton County, GA",Feb-22,4990,4822,168,3.40000000
CN1305100000000,13,051,"Chatham County, GA",Feb-22,147492,142424,5068,3.40000000
CN1305300000000,13,053,"Chattahoochee County, GA",Feb-22,1942,1855,87,4.50000000
CN1305500000000,13,055,"Chattooga County, GA",Feb-22,9473,9094,379,4.00000000
CN1305700000000,13,057,"Cherokee County, GA",Feb-22,143935,140509,3426,2.40000000
CN1305900000000,13,059,"Clarke County, GA",Feb-22,61310,59332,1978,3.20000000
CN1306100000000,13,061,"Clay County, GA",Feb-22,850,769,81,9.50000000
CN1306300000000,13,063,"Clayton County, GA",Feb-22,143417,136078,7339,5.10000000
CN1306500000000,13,065,"Clinch County, GA",Feb-22,3061,2980,81,2.60000000
CN1306700000000,13,067,"Cobb County, GA",Feb-22,435850,423927,11923,2.70000000
CN1306900000000,13,069,"Coffee County, GA",Feb-22,18651,17957,694,3.70000000
CN1307100000000,13,071,"Colquitt County, GA",Feb-22,22005,21358,647,2.90000000
CN1307300000000,13,073,"Columbia County, GA",Feb-22,76848,74772,2076,2.70000000
CN1307500000000,13,075,"Cook County, GA",Feb-22,8220,7965,255,3.10000000
CN1307700000000,13,077,"Coweta County, GA",Feb-22,78570,76363,2207,2.80000000
CN1307900000000,13,079,"Crawford County, GA",Feb-22,5594,5420,174,3.10000000
CN1308100000000,13,081,"Crisp County, GA",Feb-22,9603,9100,503,5.20000000
CN1308300000000,13,083,"Dade County, GA",Feb-22,8036,7825,211,2.60000000
CN1308500000000,13,085,"Dawson County, GA",Feb-22,13475,13146,329,2.40000000
CN1308700000000,13,087,"Decatur County, GA",Feb-22,11434,11048,386,3.40000000
CN1308900000000,13,089,"DeKalb County, GA",Feb-22,411134,396209,14925,3.60000000
CN1309100000000,13,091,"Dodge County, GA",Feb-22,7007,6729,278,4.00000000
CN1309300000000,13,093,"Dooly County, GA",Feb-22,4732,4506,226,4.80000000
CN1309500000000,13,095,"Dougherty County, GA",Feb-22,37405,35570,1835,4.90000000
CN1309700000000,13,097,"Douglas County, GA",Feb-22,76054,73348,2706,3.60000000
CN1309900000000,13,099,"Early County, GA",Feb-22,4326,4151,175,4.00000000
CN1310100000000,13,101,"Echols County, GA",Feb-22,1888,1837,51,2.70000000
CN1310300000000,13,103,"Effingham County, GA",Feb-22,34359,33452,907,2.60000000
CN1310500000000,13,105,"Elbert County, GA",Feb-22,7780,7464,316,4.10000000
CN1310700000000,13,107,"Emanuel County, GA",Feb-22,8610,8237,373,4.30000000
CN1310900000000,13,109,"Evans County, GA",Feb-22,5207,5058,149,2.90000000
CN1311100000000,13,111,"Fannin County, GA",Feb-22,11944,11617,327,2.70000000
CN1311300000000,13,113,"Fayette County, GA",Feb-22,60167,58584,1583,2.60000000
CN1311500000000,13,115,"Floyd County, GA",Feb-22,44383,42984,1399,3.20000000
CN1311700000000,13,117,"Forsyth County, GA",Feb-22,131376,128308,3068,2.30000000
CN1311900000000,13,119,"Franklin County, GA",Feb-22,10154,9827,327,3.20000000
CN1312100000000,13,121,"Fulton County, GA",Feb-22,583724,562400,21324,3.70000000
CN1312300000000,13,123,"Gilmer County, GA",Feb-22,12334,11943,391,3.20000000
CN1312500000000,13,125,"Glascock County, GA",Feb-22,1265,1230,35,2.80000000
CN1312700000000,13,127,"Glynn County, GA",Feb-22,39401,38145,1256,3.20000000
CN1312900000000,13,129,"Gordon County, GA",Feb-22,29466,28649,817,2.80000000
CN1313100000000,13,131,"Grady County, GA",Feb-22,11105,10767,338,3.00000000
CN1313300000000,13,133,"Greene County, GA",Feb-22,7210,6971,239,3.30000000
CN1313500000000,13,135,"Gwinnett County, GA",Feb-22,506281,491591,14690,2.90000000
CN1313700000000,13,137,"Habersham County, GA",Feb-22,18683,18089,594,3.20000000
CN1313900000000,13,139,"Hall County, GA",Feb-22,106711,104142,2569,2.40000000
CN1314100000000,13,141,"Hancock County, GA",Feb-22,2524,2386,138,5.50000000
CN1314300000000,13,143,"Haralson County, GA",Feb-22,13107,12716,391,3.00000000
CN1314500000000,13,145,"Harris County, GA",Feb-22,17093,16627,466,2.70000000
CN1314700000000,13,147,"Hart County, GA",Feb-22,11824,11415,409,3.50000000
CN1314900000000,13,149,"Heard County, GA",Feb-22,5386,5204,182,3.40000000
CN1315100000000,13,151,"Henry County, GA",Feb-22,122390,118193,4197,3.40000000
CN1315300000000,13,153,"Houston County, GA",Feb-22,72296,70099,2197,3.00000000
CN1315500000000,13,155,"Irwin County, GA",Feb-22,3555,3409,146,4.10000000
CN1315700000000,13,157,"Jackson County, GA",Feb-22,44551,43571,980,2.20000000
CN1315900000000,13,159,"Jasper County, GA",Feb-22,7252,7054,198,2.70000000
CN1316100000000,13,161,"Jeff Davis County, GA",Feb-22,6220,5997,223,3.60000000
CN1316300000000,13,163,"Jefferson County, GA",Feb-22,7002,6726,276,3.90000000
CN1316500000000,13,165,"Jenkins County, GA",Feb-22,3159,3029,130,4.10000000
CN1316700000000,13,167,"Johnson County, GA",Feb-22,4142,4011,131,3.20000000
CN1316900000000,13,169,"Jones County, GA",Feb-22,13878,13484,394,2.80000000
CN1317100000000,13,171,"Lamar County, GA",Feb-22,8464,8165,299,3.50000000
CN1317300000000,13,173,"Lanier County, GA",Feb-22,3852,3720,132,3.40000000
CN1317500000000,13,175,"Laurens County, GA",Feb-22,19800,19040,760,3.80000000
CN1317700000000,13,177,"Lee County, GA",Feb-22,15334,14888,446,2.90000000
CN1317900000000,13,179,"Liberty County, GA",Feb-22,26536,25647,889,3.40000000
CN1318100000000,13,181,"Lincoln County, GA",Feb-22,3553,3417,136,3.80000000
CN1318300000000,13,183,"Long County, GA",Feb-22,8536,8269,267,3.10000000
CN1318500000000,13,185,"Lowndes County, GA",Feb-22,51851,50107,1744,3.40000000
CN1318700000000,13,187,"Lumpkin County, GA",Feb-22,17748,17300,448,2.50000000
CN1318900000000,13,189,"McDuffie County, GA",Feb-22,8552,8160,392,4.60000000
CN1319100000000,13,191,"McIntosh County, GA",Feb-22,6146,5944,202,3.30000000
CN1319300000000,13,193,"Macon County, GA",Feb-22,4593,4394,199,4.30000000
CN1319500000000,13,195,"Madison County, GA",Feb-22,14070,13678,392,2.80000000
CN1319700000000,13,197,"Marion County, GA",Feb-22,3289,3174,115,3.50000000
CN1319900000000,13,199,"Meriwether County, GA",Feb-22,9071,8687,384,4.20000000
CN1320100000000,13,201,"Miller County, GA",Feb-22,2778,2695,83,3.00000000
CN1320500000000,13,205,"Mitchell County, GA",Feb-22,8127,7775,352,4.30000000
CN1320700000000,13,207,"Monroe County, GA",Feb-22,13298,12936,362,2.70000000
CN1320900000000,13,209,"Montgomery County, GA",Feb-22,3794,3651,143,3.80000000
CN1321100000000,13,211,"Morgan County, GA",Feb-22,9732,9447,285,2.90000000
CN1321300000000,13,213,"Murray County, GA",Feb-22,15770,15154,616,3.90000000
CN1321500000000,13,215,"Muscogee County, GA",Feb-22,77254,73754,3500,4.50000000
CN1321700000000,13,217,"Newton County, GA",Feb-22,54942,52922,2020,3.70000000
CN1321900000000,13,219,"Oconee County, GA",Feb-22,21036,20590,446,2.10000000
CN1322100000000,13,221,"Oglethorpe County, GA",Feb-22,7265,7077,188,2.60000000
CN1322300000000,13,223,"Paulding County, GA",Feb-22,92348,89906,2442,2.60000000
CN1322500000000,13,225,"Peach County, GA",Feb-22,12032,11584,448,3.70000000
CN1322700000000,13,227,"Pickens County, GA",Feb-22,16078,15652,426,2.60000000
CN1322900000000,13,229,"Pierce County, GA",Feb-22,8561,8314,247,2.90000000
CN1323100000000,13,231,"Pike County, GA",Feb-22,9261,9007,254,2.70000000
CN1323300000000,13,233,"Polk County, GA",Feb-22,18612,18025,587,3.20000000
CN1323500000000,13,235,"Pulaski County, GA",Feb-22,4059,3925,134,3.30000000
CN1323700000000,13,237,"Putnam County, GA",Feb-22,8794,8477,317,3.60000000
CN1323900000000,13,239,"Quitman County, GA",Feb-22,740,707,33,4.50000000
CN1324100000000,13,241,"Rabun County, GA",Feb-22,7417,7170,247,3.30000000
CN1324300000000,13,243,"Randolph County, GA",Feb-22,2377,2265,112,4.70000000
CN1324500000000,13,245,"Richmond County, GA",Feb-22,84425,80518,3907,4.60000000
CN1324700000000,13,247,"Rockdale County, GA",Feb-22,45837,44075,1762,3.80000000
CN1324900000000,13,249,"Schley County, GA",Feb-22,2118,2034,84,4.00000000
CN1325100000000,13,251,"Screven County, GA",Feb-22,5062,4814,248,4.90000000
CN1325300000000,13,253,"Seminole County, GA",Feb-22,3005,2890,115,3.80000000
CN1325500000000,13,255,"Spalding County, GA",Feb-22,29711,28618,1093,3.70000000
CN1325700000000,13,257,"Stephens County, GA",Feb-22,10524,10143,381,3.60000000
CN1325900000000,13,259,"Stewart County, GA",Feb-22,2624,2538,86,3.30000000
CN1326100000000,13,261,"Sumter County, GA",Feb-22,12086,11525,561,4.60000000
CN1326300000000,13,263,"Talbot County, GA",Feb-22,2821,2707,114,4.00000000
CN1326500000000,13,265,"Taliaferro County, GA",Feb-22,532,508,24,4.50000000
CN1326700000000,13,267,"Tattnall County, GA",Feb-22,9665,9363,302,3.10000000
CN1326900000000,13,269,"Taylor County, GA",Feb-22,2896,2758,138,4.80000000
CN1327100000000,13,271,"Telfair County, GA",Feb-22,3697,3464,233,6.30000000
CN1327300000000,13,273,"Terrell County, GA",Feb-22,3574,3382,192,5.40000000
CN1327500000000,13,275,"Thomas County, GA",Feb-22,17643,17008,635,3.60000000
CN1327700000000,13,277,"Tift County, GA",Feb-22,21442,20848,594,2.80000000
CN1327900000000,13,279,"Toombs County, GA",Feb-22,11927,11453,474,4.00000000
CN1328100000000,13,281,"Towns County, GA",Feb-22,4043,3881,162,4.00000000
CN1328300000000,13,283,"Treutlen County, GA",Feb-22,2630,2530,100,3.80000000
CN1328500000000,13,285,"Troup County, GA",Feb-22,37864,36620,1244,3.30000000
CN1328700000000,13,287,"Turner County, GA",Feb-22,3250,3090,160,4.90000000
CN1328900000000,13,289,"Twiggs County, GA",Feb-22,2861,2732,129,4.50000000
CN1329100000000,13,291,"Union County, GA",Feb-22,11158,10853,305,2.70000000
CN1329300000000,13,293,"Upson County, GA",Feb-22,11873,11498,375,3.20000000
CN1329500000000,13,295,"Walker County, GA",Feb-22,31536,30577,959,3.00000000
CN1329700000000,13,297,"Walton County, GA",Feb-22,48504,47129,1375,2.80000000
CN1329900000000,13,299,"Ware County, GA",Feb-22,15250,14799,451,3.00000000
CN1330100000000,13,301,"Warren County, GA",Feb-22,2686,2575,111,4.10000000
CN1330300000000,13,303,"Washington County, GA",Feb-22,6725,6423,302,4.50000000
CN1330500000000,13,305,"Wayne County, GA",Feb-22,11903,11519,384,3.20000000
CN1330700000000,13,307,"Webster County, GA",Feb-22,983,948,35,3.60000000
CN1330900000000,13,309,"Wheeler County, GA",Feb-22,1620,1535,85,5.20000000
CN1331100000000,13,311,"White County, GA",Feb-22,16705,16298,407,2.40000000
CN1331300000000,13,313,"Whitfield County, GA",Feb-22,44211,42695,1516,3.40000000
CN1331500000000,13,315,"Wilcox County, GA",Feb-22,2714,2617,97,3.60000000
CN1331700000000,13,317,"Wilkes County, GA",Feb-22,3633,3478,155,4.30000000
CN1331900000000,13,319,"Wilkinson County, GA",Feb-22,3622,3502,120,3.30000000
CN1332100000000,13,321,"Worth County, GA",Feb-22,8913,8617,296,3.30000000
CN1500100000000,15,001,"Hawaii County, HI",Feb-22,93481,90021,3460,3.70000000
CN1500300000000,15,003,"Honolulu County/city, HI",Feb-22,454682,438545,16137,3.50000000
CN1500700000000,15,007,"Kauai County, HI",Feb-22,36531,34717,1814,5.00000000
CN1500900000000,15,009,"Maui County, HI",Feb-22,87395,83296,4099,4.70000000
CN1600100000000,16,001,"Ada County, ID",Feb-22,275493,268086,7407,2.70000000
CN1600300000000,16,003,"Adams County, ID",Feb-22,1725,1600,125,7.20000000
CN1600500000000,16,005,"Bannock County, ID",Feb-22,44732,43310,1422,3.20000000
CN1600700000000,16,007,"Bear Lake County, ID",Feb-22,3139,3031,108,3.40000000
CN1600900000000,16,009,"Benewah County, ID",Feb-22,3911,3703,208,5.30000000
CN1601100000000,16,011,"Bingham County, ID",Feb-22,24030,23273,757,3.20000000
CN1601300000000,16,013,"Blaine County, ID",Feb-22,12743,12308,435,3.40000000
CN1601500000000,16,015,"Boise County, ID",Feb-22,3847,3654,193,5.00000000
CN1601700000000,16,017,"Bonner County, ID",Feb-22,21266,20284,982,4.60000000
CN1601900000000,16,019,"Bonneville County, ID",Feb-22,62689,60894,1795,2.90000000
CN1602100000000,16,021,"Boundary County, ID",Feb-22,5345,5075,270,5.10000000
CN1602300000000,16,023,"Butte County, ID",Feb-22,1472,1413,59,4.00000000
CN1602500000000,16,025,"Camas County, ID",Feb-22,693,663,30,4.30000000
CN1602700000000,16,027,"Canyon County, ID",Feb-22,112897,109027,3870,3.40000000
CN1602900000000,16,029,"Caribou County, ID",Feb-22,4026,3871,155,3.80000000
CN1603100000000,16,031,"Cassia County, ID",Feb-22,12268,11925,343,2.80000000
CN1603300000000,16,033,"Clark County, ID",Feb-22,360,344,16,4.40000000
CN1603500000000,16,035,"Clearwater County, ID",Feb-22,2892,2698,194,6.70000000
CN1603700000000,16,037,"Custer County, ID",Feb-22,2013,1916,97,4.80000000
CN1603900000000,16,039,"Elmore County, ID",Feb-22,11752,11315,437,3.70000000
CN1604100000000,16,041,"Franklin County, ID",Feb-22,7621,7402,219,2.90000000
CN1604300000000,16,043,"Fremont County, ID",Feb-22,8133,7869,264,3.20000000
CN1604500000000,16,045,"Gem County, ID",Feb-22,8932,8598,334,3.70000000
CN1604700000000,16,047,"Gooding County, ID",Feb-22,8320,8024,296,3.60000000
CN1604900000000,16,049,"Idaho County, ID",Feb-22,6533,6208,325,5.00000000
CN1605100000000,16,051,"Jefferson County, ID",Feb-22,15035,14601,434,2.90000000
CN1605300000000,16,053,"Jerome County, ID",Feb-22,12713,12278,435,3.40000000
CN1605500000000,16,055,"Kootenai County, ID",Feb-22,85066,81631,3435,4.00000000
CN1605700000000,16,057,"Latah County, ID",Feb-22,20552,19959,593,2.90000000
CN1605900000000,16,059,"Lemhi County, ID",Feb-22,3466,3262,204,5.90000000
CN1606100000000,16,061,"Lewis County, ID",Feb-22,1552,1467,85,5.50000000
CN1606300000000,16,063,"Lincoln County, ID",Feb-22,2676,2522,154,5.80000000
CN1606500000000,16,065,"Madison County, ID",Feb-22,23546,23037,509,2.20000000
CN1606700000000,16,067,"Minidoka County, ID",Feb-22,11484,11142,342,3.00000000
CN1606900000000,16,069,"Nez Perce County, ID",Feb-22,21377,20732,645,3.00000000
CN1607100000000,16,071,"Oneida County, ID",Feb-22,2652,2575,77,2.90000000
CN1607300000000,16,073,"Owyhee County, ID",Feb-22,5579,5349,230,4.10000000
CN1607500000000,16,075,"Payette County, ID",Feb-22,12034,11594,440,3.70000000
CN1607700000000,16,077,"Power County, ID",Feb-22,3936,3766,170,4.30000000
CN1607900000000,16,079,"Shoshone County, ID",Feb-22,5470,5128,342,6.30000000
CN1608100000000,16,081,"Teton County, ID",Feb-22,6739,6569,170,2.50000000
CN1608300000000,16,083,"Twin Falls County, ID",Feb-22,43362,41998,1364,3.10000000
CN1608500000000,16,085,"Valley County, ID",Feb-22,5660,5370,290,5.10000000
CN1608700000000,16,087,"Washington County, ID",Feb-22,4759,4555,204,4.30000000
CN1700100000000,17,001,"Adams County, IL",Feb-22,30148,29081,1067,3.50000000
CN1700300000000,17,003,"Alexander County, IL",Feb-22,1831,1696,135,7.40000000
CN1700500000000,17,005,"Bond County, IL",Feb-22,7353,7030,323,4.40000000
CN1700700000000,17,007,"Boone County, IL",Feb-22,25424,23215,2209,8.70000000
CN1700900000000,17,009,"Brown County, IL",Feb-22,3061,2994,67,2.20000000
CN1701100000000,17,011,"Bureau County, IL",Feb-22,15767,14921,846,5.40000000
CN1701300000000,17,013,"Calhoun County, IL",Feb-22,2145,2045,100,4.70000000
CN1701500000000,17,015,"Carroll County, IL",Feb-22,7248,6923,325,4.50000000
CN1701700000000,17,017,"Cass County, IL",Feb-22,5540,5264,276,5.00000000
CN1701900000000,17,019,"Champaign County, IL",Feb-22,109921,105553,4368,4.00000000
CN1702100000000,17,021,"Christian County, IL",Feb-22,13167,12488,679,5.20000000
CN1702300000000,17,023,"Clark County, IL",Feb-22,6971,6617,354,5.10000000
CN1702500000000,17,025,"Clay County, IL",Feb-22,5684,5375,309,5.40000000
CN1702700000000,17,027,"Clinton County, IL",Feb-22,19650,18992,658,3.30000000
CN1702900000000,17,029,"Coles County, IL",Feb-22,22786,21773,1013,4.40000000
CN1703100000000,17,031,"Cook County, IL",Feb-22,2669174,2526604,142570,5.30000000
CN1703300000000,17,033,"Crawford County, IL",Feb-22,8616,8216,400,4.60000000
CN1703500000000,17,035,"Cumberland County, IL",Feb-22,5973,5714,259,4.30000000
CN1703700000000,17,037,"DeKalb County, IL",Feb-22,53543,50809,2734,5.10000000
CN1703900000000,17,039,"De Witt County, IL",Feb-22,7235,6899,336,4.60000000
CN1704100000000,17,041,"Douglas County, IL",Feb-22,10032,9678,354,3.50000000
CN1704300000000,17,043,"DuPage County, IL",Feb-22,516430,499894,16536,3.20000000
CN1704500000000,17,045,"Edgar County, IL",Feb-22,8853,8523,330,3.70000000
CN1704700000000,17,047,"Edwards County, IL",Feb-22,2474,2370,104,4.20000000
CN1704900000000,17,049,"Effingham County, IL",Feb-22,19691,18938,753,3.80000000
CN1705100000000,17,051,"Fayette County, IL",Feb-22,9615,9100,515,5.40000000
CN1705300000000,17,053,"Ford County, IL",Feb-22,6220,5935,285,4.60000000
CN1705500000000,17,055,"Franklin County, IL",Feb-22,15591,14681,910,5.80000000
CN1705700000000,17,057,"Fulton County, IL",Feb-22,14225,13378,847,6.00000000
CN1705900000000,17,059,"Gallatin County, IL",Feb-22,1947,1844,103,5.30000000
CN1706100000000,17,061,"Greene County, IL",Feb-22,5714,5456,258,4.50000000
CN1706300000000,17,063,"Grundy County, IL",Feb-22,26164,24877,1287,4.90000000
CN1706500000000,17,065,"Hamilton County, IL",Feb-22,4170,4003,167,4.00000000
CN1706700000000,17,067,"Hancock County, IL",Feb-22,7898,7549,349,4.40000000
CN1706900000000,17,069,"Hardin County, IL",Feb-22,1305,1223,82,6.30000000
CN1707100000000,17,071,"Henderson County, IL",Feb-22,3475,3296,179,5.20000000
CN1707300000000,17,073,"Henry County, IL",Feb-22,23632,22485,1147,4.90000000
CN1707500000000,17,075,"Iroquois County, IL",Feb-22,12482,11794,688,5.50000000
CN1707700000000,17,077,"Jackson County, IL",Feb-22,27522,26299,1223,4.40000000
CN1707900000000,17,079,"Jasper County, IL",Feb-22,4667,4451,216,4.60000000
CN1708100000000,17,081,"Jefferson County, IL",Feb-22,16341,15451,890,5.40000000
CN1708300000000,17,083,"Jersey County, IL",Feb-22,10500,10077,423,4.00000000
CN1708500000000,17,085,"Jo Daviess County, IL",Feb-22,10131,9658,473,4.70000000
CN1708700000000,17,087,"Johnson County, IL",Feb-22,4158,3913,245,5.90000000
CN1708900000000,17,089,"Kane County, IL",Feb-22,264212,249161,15051,5.70000000
CN1709100000000,17,091,"Kankakee County, IL",Feb-22,52370,48982,3388,6.50000000
CN1709300000000,17,093,"Kendall County, IL",Feb-22,72083,69475,2608,3.60000000
CN1709500000000,17,095,"Knox County, IL",Feb-22,19893,18609,1284,6.50000000
CN1709700000000,17,097,"Lake County, IL",Feb-22,366409,347362,19047,5.20000000
CN1709900000000,17,099,"LaSalle County, IL",Feb-22,51947,48793,3154,6.10000000
CN1710100000000,17,101,"Lawrence County, IL",Feb-22,5556,5234,322,5.80000000
CN1710300000000,17,103,"Lee County, IL",Feb-22,16438,15704,734,4.50000000
CN1710500000000,17,105,"Livingston County, IL",Feb-22,15111,14410,701,4.60000000
CN1710700000000,17,107,"Logan County, IL",Feb-22,11679,11167,512,4.40000000
CN1710900000000,17,109,"McDonough County, IL",Feb-22,12702,12169,533,4.20000000
CN1711100000000,17,111,"McHenry County, IL",Feb-22,168903,162592,6311,3.70000000
CN1711300000000,17,113,"McLean County, IL",Feb-22,87847,84513,3334,3.80000000
CN1711500000000,17,115,"Macon County, IL",Feb-22,46579,43296,3283,7.00000000
CN1711700000000,17,117,"Macoupin County, IL",Feb-22,21842,20911,931,4.30000000
CN1711900000000,17,119,"Madison County, IL",Feb-22,130132,124823,5309,4.10000000
CN1712100000000,17,121,"Marion County, IL",Feb-22,16382,15531,851,5.20000000
CN1712300000000,17,123,"Marshall County, IL",Feb-22,5015,4731,284,5.70000000
CN1712500000000,17,125,"Mason County, IL",Feb-22,5695,5380,315,5.50000000
CN1712700000000,17,127,"Massac County, IL",Feb-22,5267,5022,245,4.70000000
CN1712900000000,17,129,"Menard County, IL",Feb-22,6236,5968,268,4.30000000
CN1713100000000,17,131,"Mercer County, IL",Feb-22,7571,7145,426,5.60000000
CN1713300000000,17,133,"Monroe County, IL",Feb-22,18439,17921,518,2.80000000
CN1713500000000,17,135,"Montgomery County, IL",Feb-22,11010,10429,581,5.30000000
CN1713700000000,17,137,"Morgan County, IL",Feb-22,15481,14766,715,4.60000000
CN1713900000000,17,139,"Moultrie County, IL",Feb-22,7320,7086,234,3.20000000
CN1714100000000,17,141,"Ogle County, IL",Feb-22,23586,22178,1408,6.00000000
CN1714300000000,17,143,"Peoria County, IL",Feb-22,82088,76622,5466,6.70000000
CN1714500000000,17,145,"Perry County, IL",Feb-22,7899,7498,401,5.10000000
CN1714700000000,17,147,"Piatt County, IL",Feb-22,8587,8249,338,3.90000000
CN1714900000000,17,149,"Pike County, IL",Feb-22,6512,6189,323,5.00000000
CN1715100000000,17,151,"Pope County, IL",Feb-22,1670,1590,80,4.80000000
CN1715300000000,17,153,"Pulaski County, IL",Feb-22,1679,1534,145,8.60000000
CN1715500000000,17,155,"Putnam County, IL",Feb-22,2872,2703,169,5.90000000
CN1715700000000,17,157,"Randolph County, IL",Feb-22,13519,13008,511,3.80000000
CN1715900000000,17,159,"Richland County, IL",Feb-22,7011,6747,264,3.80000000
CN1716100000000,17,161,"Rock Island County, IL",Feb-22,67912,64391,3521,5.20000000
CN1716300000000,17,163,"St. Clair County, IL",Feb-22,122932,116643,6289,5.10000000
CN1716500000000,17,165,"Saline County, IL",Feb-22,9118,8599,519,5.70000000
CN1716700000000,17,167,"Sangamon County, IL",Feb-22,98984,94166,4818,4.90000000
CN1716900000000,17,169,"Schuyler County, IL",Feb-22,3098,2956,142,4.60000000
CN1717100000000,17,171,"Scott County, IL",Feb-22,2263,2115,148,6.50000000
CN1717300000000,17,173,"Shelby County, IL",Feb-22,10168,9715,453,4.50000000
CN1717500000000,17,175,"Stark County, IL",Feb-22,2334,2183,151,6.50000000
CN1717700000000,17,177,"Stephenson County, IL",Feb-22,20113,19011,1102,5.50000000
CN1717900000000,17,179,"Tazewell County, IL",Feb-22,60962,58068,2894,4.70000000
CN1718100000000,17,181,"Union County, IL",Feb-22,7219,6793,426,5.90000000
CN1718300000000,17,183,"Vermilion County, IL",Feb-22,31530,29648,1882,6.00000000
CN1718500000000,17,185,"Wabash County, IL",Feb-22,5376,5171,205,3.80000000
CN1718700000000,17,187,"Warren County, IL",Feb-22,7477,7158,319,4.30000000
CN1718900000000,17,189,"Washington County, IL",Feb-22,9446,9217,229,2.40000000
CN1719100000000,17,191,"Wayne County, IL",Feb-22,6683,6396,287,4.30000000
CN1719300000000,17,193,"White County, IL",Feb-22,5867,5608,259,4.40000000
CN1719500000000,17,195,"Whiteside County, IL",Feb-22,27020,25804,1216,4.50000000
CN1719700000000,17,197,"Will County, IL",Feb-22,367655,350653,17002,4.60000000
CN1719900000000,17,199,"Williamson County, IL",Feb-22,31651,30128,1523,4.80000000
CN1720100000000,17,201,"Winnebago County, IL",Feb-22,134834,124445,10389,7.70000000
CN1720300000000,17,203,"Woodford County, IL",Feb-22,17866,17170,696,3.90000000
CN1800100000000,18,001,"Adams County, IN",Feb-22,16802,16496,306,1.80000000
CN1800300000000,18,003,"Allen County, IN",Feb-22,186119,181469,4650,2.50000000
CN1800500000000,18,005,"Bartholomew County, IN",Feb-22,43247,42315,932,2.20000000
CN1800700000000,18,007,"Benton County, IN",Feb-22,4395,4301,94,2.10000000
CN1800900000000,18,009,"Blackford County, IN",Feb-22,4630,4491,139,3.00000000
CN1801100000000,18,011,"Boone County, IN",Feb-22,37550,36913,637,1.70000000
CN1801300000000,18,013,"Brown County, IN",Feb-22,7726,7527,199,2.60000000
CN1801500000000,18,015,"Carroll County, IN",Feb-22,9900,9655,245,2.50000000
CN1801700000000,18,017,"Cass County, IN",Feb-22,17061,16555,506,3.00000000
CN1801900000000,18,019,"Clark County, IN",Feb-22,61761,60298,1463,2.40000000
CN1802100000000,18,021,"Clay County, IN",Feb-22,11635,11326,309,2.70000000
CN1802300000000,18,023,"Clinton County, IN",Feb-22,16817,16454,363,2.20000000
CN1802500000000,18,025,"Crawford County, IN",Feb-22,4747,4580,167,3.50000000
CN1802700000000,18,027,"Daviess County, IN",Feb-22,16422,16103,319,1.90000000
CN1802900000000,18,029,"Dearborn County, IN",Feb-22,25144,24526,618,2.50000000
CN1803100000000,18,031,"Decatur County, IN",Feb-22,14868,14522,346,2.30000000
CN1803300000000,18,033,"DeKalb County, IN",Feb-22,22096,21652,444,2.00000000
CN1803500000000,18,035,"Delaware County, IN",Feb-22,52690,51121,1569,3.00000000
CN1803700000000,18,037,"Dubois County, IN",Feb-22,21817,21416,401,1.80000000
CN1803900000000,18,039,"Elkhart County, IN",Feb-22,119475,117409,2066,1.70000000
CN1804100000000,18,041,"Fayette County, IN",Feb-22,8292,7996,296,3.60000000
CN1804300000000,18,043,"Floyd County, IN",Feb-22,41601,40719,882,2.10000000
CN1804500000000,18,045,"Fountain County, IN",Feb-22,7649,7464,185,2.40000000
CN1804700000000,18,047,"Franklin County, IN",Feb-22,11060,10784,276,2.50000000
CN1804900000000,18,049,"Fulton County, IN",Feb-22,9321,9056,265,2.80000000
CN1805100000000,18,051,"Gibson County, IN",Feb-22,19072,18691,381,2.00000000
CN1805300000000,18,053,"Grant County, IN",Feb-22,31217,30336,881,2.80000000
CN1805500000000,18,055,"Greene County, IN",Feb-22,13673,13276,397,2.90000000
CN1805700000000,18,057,"Hamilton County, IN",Feb-22,191283,187995,3288,1.70000000
CN1805900000000,18,059,"Hancock County, IN",Feb-22,41936,41039,897,2.10000000
CN1806100000000,18,061,"Harrison County, IN",Feb-22,20180,19736,444,2.20000000
CN1806300000000,18,063,"Hendricks County, IN",Feb-22,93121,91304,1817,2.00000000
CN1806500000000,18,065,"Henry County, IN",Feb-22,21671,21080,591,2.70000000
CN1806700000000,18,067,"Howard County, IN",Feb-22,33678,32249,1429,4.20000000
CN1806900000000,18,069,"Huntington County, IN",Feb-22,17884,17475,409,2.30000000
CN1807100000000,18,071,"Jackson County, IN",Feb-22,23293,22786,507,2.20000000
CN1807300000000,18,073,"Jasper County, IN",Feb-22,15659,15148,511,3.30000000
CN1807500000000,18,075,"Jay County, IN",Feb-22,8735,8527,208,2.40000000
CN1807700000000,18,077,"Jefferson County, IN",Feb-22,15018,14667,351,2.30000000
CN1807900000000,18,079,"Jennings County, IN",Feb-22,13310,12914,396,3.00000000
CN1808100000000,18,081,"Johnson County, IN",Feb-22,85147,83490,1657,1.90000000
CN1808300000000,18,083,"Knox County, IN",Feb-22,18202,17805,397,2.20000000
CN1808500000000,18,085,"Kosciusko County, IN",Feb-22,40170,39341,829,2.10000000
CN1808700000000,18,087,"LaGrange County, IN",Feb-22,20838,20514,324,1.60000000
CN1808900000000,18,089,"Lake County, IN",Feb-22,223965,212665,11300,5.00000000
CN1809100000000,18,091,"LaPorte County, IN",Feb-22,46398,44648,1750,3.80000000
CN1809300000000,18,093,"Lawrence County, IN",Feb-22,20860,20281,579,2.80000000
CN1809500000000,18,095,"Madison County, IN",Feb-22,59132,57350,1782,3.00000000
CN1809700000000,18,097,"Marion County, IN",Feb-22,498175,483460,14715,3.00000000
CN1809900000000,18,099,"Marshall County, IN",Feb-22,22362,21888,474,2.10000000
CN1810100000000,18,101,"Martin County, IN",Feb-22,5413,5305,108,2.00000000
CN1810300000000,18,103,"Miami County, IN",Feb-22,14431,13950,481,3.30000000
CN1810500000000,18,105,"Monroe County, IN",Feb-22,72133,70491,1642,2.30000000
CN1810700000000,18,107,"Montgomery County, IN",Feb-22,18313,17909,404,2.20000000
CN1810900000000,18,109,"Morgan County, IN",Feb-22,36722,35825,897,2.40000000
CN1811100000000,18,111,"Newton County, IN",Feb-22,6652,6427,225,3.40000000
CN1811300000000,18,113,"Noble County, IN",Feb-22,21849,21316,533,2.40000000
CN1811500000000,18,115,"Ohio County, IN",Feb-22,3106,3041,65,2.10000000
CN1811700000000,18,117,"Orange County, IN",Feb-22,8332,8075,257,3.10000000
CN1811900000000,18,119,"Owen County, IN",Feb-22,9566,9282,284,3.00000000
CN1812100000000,18,121,"Parke County, IN",Feb-22,6888,6709,179,2.60000000
CN1812300000000,18,123,"Perry County, IN",Feb-22,8649,8414,235,2.70000000
CN1812500000000,18,125,"Pike County, IN",Feb-22,5661,5510,151,2.70000000
CN1812700000000,18,127,"Porter County, IN",Feb-22,83927,81276,2651,3.20000000
CN1812900000000,18,129,"Posey County, IN",Feb-22,12990,12718,272,2.10000000
CN1813100000000,18,131,"Pulaski County, IN",Feb-22,6336,6179,157,2.50000000
CN1813300000000,18,133,"Putnam County, IN",Feb-22,16578,16183,395,2.40000000
CN1813500000000,18,135,"Randolph County, IN",Feb-22,12405,12110,295,2.40000000
CN1813700000000,18,137,"Ripley County, IN",Feb-22,13292,12949,343,2.60000000
CN1813900000000,18,139,"Rush County, IN",Feb-22,8873,8684,189,2.10000000
CN1814100000000,18,141,"St. Joseph County, IN",Feb-22,131107,127314,3793,2.90000000
CN1814300000000,18,143,"Scott County, IN",Feb-22,10385,10086,299,2.90000000
CN1814500000000,18,145,"Shelby County, IN",Feb-22,23323,22780,543,2.30000000
CN1814700000000,18,147,"Spencer County, IN",Feb-22,10048,9804,244,2.40000000
CN1814900000000,18,149,"Starke County, IN",Feb-22,9346,9012,334,3.60000000
CN1815100000000,18,151,"Steuben County, IN",Feb-22,19827,19460,367,1.90000000
CN1815300000000,18,153,"Sullivan County, IN",Feb-22,8013,7738,275,3.40000000
CN1815500000000,18,155,"Switzerland County, IN",Feb-22,4612,4491,121,2.60000000
CN1815700000000,18,157,"Tippecanoe County, IN",Feb-22,96145,93871,2274,2.40000000
CN1815900000000,18,159,"Tipton County, IN",Feb-22,8910,8697,213,2.40000000
CN1816100000000,18,161,"Union County, IN",Feb-22,3478,3406,72,2.10000000
CN1816300000000,18,163,"Vanderburgh County, IN",Feb-22,91818,89403,2415,2.60000000
CN1816500000000,18,165,"Vermillion County, IN",Feb-22,6609,6383,226,3.40000000
CN1816700000000,18,167,"Vigo County, IN",Feb-22,46009,44466,1543,3.40000000
CN1816900000000,18,169,"Wabash County, IN",Feb-22,14464,14117,347,2.40000000
CN1817100000000,18,171,"Warren County, IN",Feb-22,4046,3958,88,2.20000000
CN1817300000000,18,173,"Warrick County, IN",Feb-22,32201,31492,709,2.20000000
CN1817500000000,18,175,"Washington County, IN",Feb-22,13682,13339,343,2.50000000
CN1817700000000,18,177,"Wayne County, IN",Feb-22,29232,28435,797,2.70000000
CN1817900000000,18,179,"Wells County, IN",Feb-22,14164,13870,294,2.10000000
CN1818100000000,18,181,"White County, IN",Feb-22,13090,12805,285,2.20000000
CN1818300000000,18,183,"Whitley County, IN",Feb-22,17577,17218,359,2.00000000
CN1900100000000,19,001,"Adair County, IA",Feb-22,4454,4320,134,3.00000000
CN1900300000000,19,003,"Adams County, IA",Feb-22,2052,2007,45,2.20000000
CN1900500000000,19,005,"Allamakee County, IA",Feb-22,7306,6840,466,6.40000000
CN1900700000000,19,007,"Appanoose County, IA",Feb-22,6147,5921,226,3.70000000
CN1900900000000,19,009,"Audubon County, IA",Feb-22,3145,3048,97,3.10000000
CN1901100000000,19,011,"Benton County, IA",Feb-22,13102,12580,522,4.00000000
CN1901300000000,19,013,"Black Hawk County, IA",Feb-22,68423,65972,2451,3.60000000
CN1901500000000,19,015,"Boone County, IA",Feb-22,14814,14387,427,2.90000000
CN1901700000000,19,017,"Bremer County, IA",Feb-22,14198,13791,407,2.90000000
CN1901900000000,19,019,"Buchanan County, IA",Feb-22,11359,10937,422,3.70000000
CN1902100000000,19,021,"Buena Vista County, IA",Feb-22,12239,11961,278,2.30000000
CN1902300000000,19,023,"Butler County, IA",Feb-22,8129,7780,349,4.30000000
CN1902500000000,19,025,"Calhoun County, IA",Feb-22,4096,3967,129,3.10000000
CN1902700000000,19,027,"Carroll County, IA",Feb-22,10833,10577,256,2.40000000
CN1902900000000,19,029,"Cass County, IA",Feb-22,6893,6660,233,3.40000000
CN1903100000000,19,031,"Cedar County, IA",Feb-22,10666,10283,383,3.60000000
CN1903300000000,19,033,"Cerro Gordo County, IA",Feb-22,22381,21613,768,3.40000000
CN1903500000000,19,035,"Cherokee County, IA",Feb-22,6243,6047,196,3.10000000
CN1903700000000,19,037,"Chickasaw County, IA",Feb-22,6548,6314,234,3.60000000
CN1903900000000,19,039,"Clarke County, IA",Feb-22,4979,4771,208,4.20000000
CN1904100000000,19,041,"Clay County, IA",Feb-22,8634,8344,290,3.40000000
CN1904300000000,19,043,"Clayton County, IA",Feb-22,9810,9102,708,7.20000000
CN1904500000000,19,045,"Clinton County, IA",Feb-22,22166,21166,1000,4.50000000
CN1904700000000,19,047,"Crawford County, IA",Feb-22,8195,7697,498,6.10000000
CN1904900000000,19,049,"Dallas County, IA",Feb-22,53155,51960,1195,2.20000000
CN1905100000000,19,051,"Davis County, IA",Feb-22,4315,4194,121,2.80000000
CN1905300000000,19,053,"Decatur County, IA",Feb-22,4514,4385,129,2.90000000
CN1905500000000,19,055,"Delaware County, IA",Feb-22,10795,10450,345,3.20000000
CN1905700000000,19,057,"Des Moines County, IA",Feb-22,18255,17250,1005,5.50000000
CN1905900000000,19,059,"Dickinson County, IA",Feb-22,10026,9582,444,4.40000000
CN1906100000000,19,061,"Dubuque County, IA",Feb-22,55493,53320,2173,3.90000000
CN1906300000000,19,063,"Emmet County, IA",Feb-22,4978,4789,189,3.80000000
CN1906500000000,19,065,"Fayette County, IA",Feb-22,10537,10014,523,5.00000000
CN1906700000000,19,067,"Floyd County, IA",Feb-22,8396,8067,329,3.90000000
CN1906900000000,19,069,"Franklin County, IA",Feb-22,5699,5494,205,3.60000000
CN1907100000000,19,071,"Fremont County, IA",Feb-22,3752,3658,94,2.50000000
CN1907300000000,19,073,"Greene County, IA",Feb-22,5446,5304,142,2.60000000
CN1907500000000,19,075,"Grundy County, IA",Feb-22,6581,6354,227,3.40000000
CN1907700000000,19,077,"Guthrie County, IA",Feb-22,5729,5492,237,4.10000000
CN1907900000000,19,079,"Hamilton County, IA",Feb-22,7031,6791,240,3.40000000
CN1908100000000,19,081,"Hancock County, IA",Feb-22,5778,5623,155,2.70000000
CN1908300000000,19,083,"Hardin County, IA",Feb-22,8041,7719,322,4.00000000
CN1908500000000,19,085,"Harrison County, IA",Feb-22,7234,6994,240,3.30000000
CN1908700000000,19,087,"Henry County, IA",Feb-22,9792,9480,312,3.20000000
CN1908900000000,19,089,"Howard County, IA",Feb-22,5374,5118,256,4.80000000
CN1909100000000,19,091,"Humboldt County, IA",Feb-22,4996,4837,159,3.20000000
CN1909300000000,19,093,"Ida County, IA",Feb-22,4046,3921,125,3.10000000
CN1909500000000,19,095,"Iowa County, IA",Feb-22,10170,9807,363,3.60000000
CN1909700000000,19,097,"Jackson County, IA",Feb-22,10827,10308,519,4.80000000
CN1909900000000,19,099,"Jasper County, IA",Feb-22,18847,18021,826,4.40000000
CN1910100000000,19,101,"Jefferson County, IA",Feb-22,10156,9848,308,3.00000000
CN1910300000000,19,103,"Johnson County, IA",Feb-22,86511,84289,2222,2.60000000
CN1910500000000,19,105,"Jones County, IA",Feb-22,10531,10013,518,4.90000000
CN1910700000000,19,107,"Keokuk County, IA",Feb-22,5243,5023,220,4.20000000
CN1910900000000,19,109,"Kossuth County, IA",Feb-22,8296,8055,241,2.90000000
CN1911100000000,19,111,"Lee County, IA",Feb-22,15376,14613,763,5.00000000
CN1911300000000,19,113,"Linn County, IA",Feb-22,119615,114926,4689,3.90000000
CN1911500000000,19,115,"Louisa County, IA",Feb-22,5983,5719,264,4.40000000
CN1911700000000,19,117,"Lucas County, IA",Feb-22,4743,4624,119,2.50000000
CN1911900000000,19,119,"Lyon County, IA",Feb-22,7100,6956,144,2.00000000
CN1912100000000,19,121,"Madison County, IA",Feb-22,8830,8395,435,4.90000000
CN1912300000000,19,123,"Mahaska County, IA",Feb-22,12145,11803,342,2.80000000
CN1912500000000,19,125,"Marion County, IA",Feb-22,18947,18444,503,2.70000000
CN1912700000000,19,127,"Marshall County, IA",Feb-22,17927,16310,1617,9.00000000
CN1912900000000,19,129,"Mills County, IA",Feb-22,7147,6962,185,2.60000000
CN1913100000000,19,131,"Mitchell County, IA",Feb-22,5787,5625,162,2.80000000
CN1913300000000,19,133,"Monona County, IA",Feb-22,4527,4337,190,4.20000000
CN1913500000000,19,135,"Monroe County, IA",Feb-22,3967,3834,133,3.40000000
CN1913700000000,19,137,"Montgomery County, IA",Feb-22,5009,4862,147,2.90000000
CN1913900000000,19,139,"Muscatine County, IA",Feb-22,20815,19989,826,4.00000000
CN1914100000000,19,141,"O'Brien County, IA",Feb-22,8235,8039,196,2.40000000
CN1914300000000,19,143,"Osceola County, IA",Feb-22,3657,3584,73,2.00000000
CN1914500000000,19,145,"Page County, IA",Feb-22,6375,6192,183,2.90000000
CN1914700000000,19,147,"Palo Alto County, IA",Feb-22,4556,4408,148,3.20000000
CN1914900000000,19,149,"Plymouth County, IA",Feb-22,14831,14494,337,2.30000000
CN1915100000000,19,151,"Pocahontas County, IA",Feb-22,4371,4266,105,2.40000000
CN1915300000000,19,153,"Polk County, IA",Feb-22,273330,263539,9791,3.60000000
CN1915500000000,19,155,"Pottawattamie County, IA",Feb-22,47899,46253,1646,3.40000000
CN1915700000000,19,157,"Poweshiek County, IA",Feb-22,10564,10176,388,3.70000000
CN1915900000000,19,159,"Ringgold County, IA",Feb-22,2447,2385,62,2.50000000
CN1916100000000,19,161,"Sac County, IA",Feb-22,5358,5185,173,3.20000000
CN1916300000000,19,163,"Scott County, IA",Feb-22,88355,84797,3558,4.00000000
CN1916500000000,19,165,"Shelby County, IA",Feb-22,6367,6197,170,2.70000000
CN1916700000000,19,167,"Sioux County, IA",Feb-22,22925,22357,568,2.50000000
CN1916900000000,19,169,"Story County, IA",Feb-22,59893,58656,1237,2.10000000
CN1917100000000,19,171,"Tama County, IA",Feb-22,9445,8956,489,5.20000000
CN1917300000000,19,173,"Taylor County, IA",Feb-22,3191,3127,64,2.00000000
CN1917500000000,19,175,"Union County, IA",Feb-22,6279,6049,230,3.70000000
CN1917700000000,19,177,"Van Buren County, IA",Feb-22,3699,3578,121,3.30000000
CN1917900000000,19,179,"Wapello County, IA",Feb-22,17023,16389,634,3.70000000
CN1918100000000,19,181,"Warren County, IA",Feb-22,29031,28093,938,3.20000000
CN1918300000000,19,183,"Washington County, IA",Feb-22,11980,11535,445,3.70000000
CN1918500000000,19,185,"Wayne County, IA",Feb-22,2934,2838,96,3.30000000
CN1918700000000,19,187,"Webster County, IA",Feb-22,18480,17771,709,3.80000000
CN1918900000000,19,189,"Winnebago County, IA",Feb-22,4920,4769,151,3.10000000
CN1919100000000,19,191,"Winneshiek County, IA",Feb-22,12011,11425,586,4.90000000
CN1919300000000,19,193,"Woodbury County, IA",Feb-22,55623,53758,1865,3.40000000
CN1919500000000,19,195,"Worth County, IA",Feb-22,4084,3921,163,4.00000000
CN1919700000000,19,197,"Wright County, IA",Feb-22,6777,6535,242,3.60000000
CN2000100000000,20,001,"Allen County, KS",Feb-22,6635,6469,166,2.50000000
CN2000300000000,20,003,"Anderson County, KS",Feb-22,4737,4640,97,2.00000000
CN2000500000000,20,005,"Atchison County, KS",Feb-22,6734,6500,234,3.50000000
CN2000700000000,20,007,"Barber County, KS",Feb-22,2239,2199,40,1.80000000
CN2000900000000,20,009,"Barton County, KS",Feb-22,13287,12960,327,2.50000000
CN2001100000000,20,011,"Bourbon County, KS",Feb-22,6384,6171,213,3.30000000
CN2001300000000,20,013,"Brown County, KS",Feb-22,5049,4935,114,2.30000000
CN2001500000000,20,015,"Butler County, KS",Feb-22,32739,31833,906,2.80000000
CN2001700000000,20,017,"Chase County, KS",Feb-22,1348,1323,25,1.90000000
CN2001900000000,20,019,"Chautauqua County, KS",Feb-22,1392,1353,39,2.80000000
CN2002100000000,20,021,"Cherokee County, KS",Feb-22,9845,9614,231,2.30000000
CN2002300000000,20,023,"Cheyenne County, KS",Feb-22,1277,1252,25,2.00000000
CN2002500000000,20,025,"Clark County, KS",Feb-22,1125,1108,17,1.50000000
CN2002700000000,20,027,"Clay County, KS",Feb-22,3747,3655,92,2.50000000
CN2002900000000,20,029,"Cloud County, KS",Feb-22,3891,3802,89,2.30000000
CN2003100000000,20,031,"Coffey County, KS",Feb-22,3775,3650,125,3.30000000
CN2003300000000,20,033,"Comanche County, KS",Feb-22,867,852,15,1.70000000
CN2003500000000,20,035,"Cowley County, KS",Feb-22,16640,16189,451,2.70000000
CN2003700000000,20,037,"Crawford County, KS",Feb-22,18926,18416,510,2.70000000
CN2003900000000,20,039,"Decatur County, KS",Feb-22,1149,1121,28,2.40000000
CN2004100000000,20,041,"Dickinson County, KS",Feb-22,9024,8791,233,2.60000000
CN2004300000000,20,043,"Doniphan County, KS",Feb-22,4164,4070,94,2.30000000
CN2004500000000,20,045,"Douglas County, KS",Feb-22,67313,65718,1595,2.40000000
CN2004700000000,20,047,"Edwards County, KS",Feb-22,1439,1414,25,1.70000000
CN2004900000000,20,049,"Elk County, KS",Feb-22,1173,1146,27,2.30000000
CN2005100000000,20,051,"Ellis County, KS",Feb-22,17087,16816,271,1.60000000
CN2005300000000,20,053,"Ellsworth County, KS",Feb-22,2693,2637,56,2.10000000
CN2005500000000,20,055,"Finney County, KS",Feb-22,20263,19902,361,1.80000000
CN2005700000000,20,057,"Ford County, KS",Feb-22,17682,17383,299,1.70000000
CN2005900000000,20,059,"Franklin County, KS",Feb-22,14714,14346,368,2.50000000
CN2006100000000,20,061,"Geary County, KS",Feb-22,11494,11109,385,3.30000000
CN2006300000000,20,063,"Gove County, KS",Feb-22,1454,1433,21,1.40000000
CN2006500000000,20,065,"Graham County, KS",Feb-22,1116,1093,23,2.10000000
CN2006700000000,20,067,"Grant County, KS",Feb-22,2841,2769,72,2.50000000
CN2006900000000,20,069,"Gray County, KS",Feb-22,3190,3146,44,1.40000000
CN2007100000000,20,071,"Greeley County, KS",Feb-22,805,797,8,1.00000000
CN2007300000000,20,073,"Greenwood County, KS",Feb-22,2923,2847,76,2.60000000
CN2007500000000,20,075,"Hamilton County, KS",Feb-22,1589,1570,19,1.20000000
CN2007700000000,20,077,"Harper County, KS",Feb-22,2816,2764,52,1.80000000
CN2007900000000,20,079,"Harvey County, KS",Feb-22,17095,16680,415,2.40000000
CN2008100000000,20,081,"Haskell County, KS",Feb-22,2204,2172,32,1.50000000
CN2008300000000,20,083,"Hodgeman County, KS",Feb-22,1013,998,15,1.50000000
CN2008500000000,20,085,"Jackson County, KS",Feb-22,7224,7033,191,2.60000000
CN2008700000000,20,087,"Jefferson County, KS",Feb-22,10290,9994,296,2.90000000
CN2008900000000,20,089,"Jewell County, KS",Feb-22,1194,1170,24,2.00000000
CN2009100000000,20,091,"Johnson County, KS",Feb-22,346378,338938,7440,2.10000000
CN2009300000000,20,093,"Kearny County, KS",Feb-22,2062,2031,31,1.50000000
CN2009500000000,20,095,"Kingman County, KS",Feb-22,3277,3204,73,2.20000000
CN2009700000000,20,097,"Kiowa County, KS",Feb-22,1186,1163,23,1.90000000
CN2009900000000,20,099,"Labette County, KS",Feb-22,9270,9003,267,2.90000000
CN2010100000000,20,101,"Lane County, KS",Feb-22,716,697,19,2.70000000
CN2010300000000,20,103,"Leavenworth County, KS",Feb-22,37182,36087,1095,2.90000000
CN2010500000000,20,105,"Lincoln County, KS",Feb-22,1645,1608,37,2.20000000
CN2010700000000,20,107,"Linn County, KS",Feb-22,4372,4182,190,4.30000000
CN2010900000000,20,109,"Logan County, KS",Feb-22,1595,1572,23,1.40000000
CN2011100000000,20,111,"Lyon County, KS",Feb-22,17180,16772,408,2.40000000
CN2011300000000,20,113,"McPherson County, KS",Feb-22,17201,16921,280,1.60000000
CN2011500000000,20,115,"Marion County, KS",Feb-22,5979,5854,125,2.10000000
CN2011700000000,20,117,"Marshall County, KS",Feb-22,5339,5257,82,1.50000000
CN2011900000000,20,119,"Meade County, KS",Feb-22,2126,2094,32,1.50000000
CN2012100000000,20,121,"Miami County, KS",Feb-22,17900,17447,453,2.50000000
CN2012300000000,20,123,"Mitchell County, KS",Feb-22,3399,3348,51,1.50000000
CN2012500000000,20,125,"Montgomery County, KS",Feb-22,14600,14155,445,3.00000000
CN2012700000000,20,127,"Morris County, KS",Feb-22,3007,2942,65,2.20000000
CN2012900000000,20,129,"Morton County, KS",Feb-22,1111,1083,28,2.50000000
CN2013100000000,20,131,"Nemaha County, KS",Feb-22,5504,5423,81,1.50000000
CN2013300000000,20,133,"Neosho County, KS",Feb-22,6015,5813,202,3.40000000
CN2013500000000,20,135,"Ness County, KS",Feb-22,1308,1285,23,1.80000000
CN2013700000000,20,137,"Norton County, KS",Feb-22,2642,2599,43,1.60000000
CN2013900000000,20,139,"Osage County, KS",Feb-22,7951,7733,218,2.70000000
CN2014100000000,20,141,"Osborne County, KS",Feb-22,1935,1900,35,1.80000000
CN2014300000000,20,143,"Ottawa County, KS",Feb-22,2925,2861,64,2.20000000
CN2014500000000,20,145,"Pawnee County, KS",Feb-22,2765,2704,61,2.20000000
CN2014700000000,20,147,"Phillips County, KS",Feb-22,2626,2573,53,2.00000000
CN2014900000000,20,149,"Pottawatomie County, KS",Feb-22,12606,12338,268,2.10000000
CN2015100000000,20,151,"Pratt County, KS",Feb-22,4931,4847,84,1.70000000
CN2015300000000,20,153,"Rawlins County, KS",Feb-22,1638,1614,24,1.50000000
CN2015500000000,20,155,"Reno County, KS",Feb-22,29574,28822,752,2.50000000
CN2015700000000,20,157,"Republic County, KS",Feb-22,2302,2257,45,2.00000000
CN2015900000000,20,159,"Rice County, KS",Feb-22,5395,5282,113,2.10000000
CN2016100000000,20,161,"Riley County, KS",Feb-22,34766,34003,763,2.20000000
CN2016300000000,20,163,"Rooks County, KS",Feb-22,2375,2324,51,2.10000000
CN2016500000000,20,165,"Rush County, KS",Feb-22,1585,1553,32,2.00000000
CN2016700000000,20,167,"Russell County, KS",Feb-22,3328,3272,56,1.70000000
CN2016900000000,20,169,"Saline County, KS",Feb-22,28996,28296,700,2.40000000
CN2017100000000,20,171,"Scott County, KS",Feb-22,2792,2755,37,1.30000000
CN2017300000000,20,173,"Sedgwick County, KS",Feb-22,256266,247545,8721,3.40000000
CN2017500000000,20,175,"Seward County, KS",Feb-22,9854,9625,229,2.30000000
CN2017700000000,20,177,"Shawnee County, KS",Feb-22,90773,88261,2512,2.80000000
CN2017900000000,20,179,"Sheridan County, KS",Feb-22,1447,1426,21,1.50000000
CN2018100000000,20,181,"Sherman County, KS",Feb-22,2842,2784,58,2.00000000
CN2018300000000,20,183,"Smith County, KS",Feb-22,1989,1960,29,1.50000000
CN2018500000000,20,185,"Stafford County, KS",Feb-22,2003,1963,40,2.00000000
CN2018700000000,20,187,"Stanton County, KS",Feb-22,1145,1129,16,1.40000000
CN2018900000000,20,189,"Stevens County, KS",Feb-22,2940,2888,52,1.80000000
CN2019100000000,20,191,"Sumner County, KS",Feb-22,10784,10454,330,3.10000000
CN2019300000000,20,193,"Thomas County, KS",Feb-22,4265,4211,54,1.30000000
CN2019500000000,20,195,"Trego County, KS",Feb-22,1403,1378,25,1.80000000
CN2019700000000,20,197,"Wabaunsee County, KS",Feb-22,3694,3609,85,2.30000000
CN2019900000000,20,199,"Wallace County, KS",Feb-22,880,865,15,1.70000000
CN2020100000000,20,201,"Washington County, KS",Feb-22,2998,2945,53,1.80000000
CN2020300000000,20,203,"Wichita County, KS",Feb-22,1166,1147,19,1.60000000
CN2020500000000,20,205,"Wilson County, KS",Feb-22,3782,3656,126,3.30000000
CN2020700000000,20,207,"Woodson County, KS",Feb-22,1511,1462,49,3.20000000
CN2020900000000,20,209,"Wyandotte County, KS",Feb-22,77940,74895,3045,3.90000000
CN2100100000000,21,001,"Adair County, KY",Feb-22,7328,7013,315,4.30000000
CN2100300000000,21,003,"Allen County, KY",Feb-22,8921,8589,332,3.70000000
CN2100500000000,21,005,"Anderson County, KY",Feb-22,11937,11541,396,3.30000000
CN2100700000000,21,007,"Ballard County, KY",Feb-22,3448,3278,170,4.90000000
CN2100900000000,21,009,"Barren County, KY",Feb-22,17977,17170,807,4.50000000
CN2101100000000,21,011,"Bath County, KY",Feb-22,4719,4401,318,6.70000000
CN2101300000000,21,013,"Bell County, KY",Feb-22,8220,7801,419,5.10000000
CN2101500000000,21,015,"Boone County, KY",Feb-22,71427,69099,2328,3.30000000
CN2101700000000,21,017,"Bourbon County, KY",Feb-22,9463,9130,333,3.50000000
CN2101900000000,21,019,"Boyd County, KY",Feb-22,17542,16544,998,5.70000000
CN2102100000000,21,021,"Boyle County, KY",Feb-22,12654,12151,503,4.00000000
CN2102300000000,21,023,"Bracken County, KY",Feb-22,3820,3599,221,5.80000000
CN2102500000000,21,025,"Breathitt County, KY",Feb-22,3318,3013,305,9.20000000
CN2102700000000,21,027,"Breckinridge County, KY",Feb-22,7921,7537,384,4.80000000
CN2102900000000,21,029,"Bullitt County, KY",Feb-22,43431,41522,1909,4.40000000
CN2103100000000,21,031,"Butler County, KY",Feb-22,5042,4828,214,4.20000000
CN2103300000000,21,033,"Caldwell County, KY",Feb-22,6007,5796,211,3.50000000
CN2103500000000,21,035,"Calloway County, KY",Feb-22,17315,16604,711,4.10000000
CN2103700000000,21,037,"Campbell County, KY",Feb-22,50310,48533,1777,3.50000000
CN2103900000000,21,039,"Carlisle County, KY",Feb-22,2202,2115,87,4.00000000
CN2104100000000,21,041,"Carroll County, KY",Feb-22,5394,5211,183,3.40000000
CN2104300000000,21,043,"Carter County, KY",Feb-22,9932,9039,893,9.00000000
CN2104500000000,21,045,"Casey County, KY",Feb-22,6680,6428,252,3.80000000
CN2104700000000,21,047,"Christian County, KY",Feb-22,25166,23972,1194,4.70000000
CN2104900000000,21,049,"Clark County, KY",Feb-22,17178,16541,637,3.70000000
CN2105100000000,21,051,"Clay County, KY",Feb-22,5191,4902,289,5.60000000
CN2105300000000,21,053,"Clinton County, KY",Feb-22,3929,3757,172,4.40000000
CN2105500000000,21,055,"Crittenden County, KY",Feb-22,3818,3663,155,4.10000000
CN2105700000000,21,057,"Cumberland County, KY",Feb-22,3293,3171,122,3.70000000
CN2105900000000,21,059,"Daviess County, KY",Feb-22,46572,44881,1691,3.60000000
CN2106100000000,21,061,"Edmonson County, KY",Feb-22,4737,4509,228,4.80000000
CN2106300000000,21,063,"Elliott County, KY",Feb-22,1915,1707,208,10.90000000
CN2106500000000,21,065,"Estill County, KY",Feb-22,5188,4939,249,4.80000000
CN2106700000000,21,067,"Fayette County, KY",Feb-22,174116,168818,5298,3.00000000
CN2106900000000,21,069,"Fleming County, KY",Feb-22,6006,5712,294,4.90000000
CN2107100000000,21,071,"Floyd County, KY",Feb-22,11013,10272,741,6.70000000
CN2107300000000,21,073,"Franklin County, KY",Feb-22,25054,24163,891,3.60000000
CN2107500000000,21,075,"Fulton County, KY",Feb-22,2062,1968,94,4.60000000
CN2107700000000,21,077,"Gallatin County, KY",Feb-22,3973,3818,155,3.90000000
CN2107900000000,21,079,"Garrard County, KY",Feb-22,7697,7379,318,4.10000000
CN2108100000000,21,081,"Grant County, KY",Feb-22,11645,11147,498,4.30000000
CN2108300000000,21,083,"Graves County, KY",Feb-22,16019,15235,784,4.90000000
CN2108500000000,21,085,"Grayson County, KY",Feb-22,10501,9955,546,5.20000000
CN2108700000000,21,087,"Green County, KY",Feb-22,5254,5077,177,3.40000000
CN2108900000000,21,089,"Greenup County, KY",Feb-22,13225,12351,874,6.60000000
CN2109100000000,21,091,"Hancock County, KY",Feb-22,3863,3724,139,3.60000000
CN2109300000000,21,093,"Hardin County, KY",Feb-22,47029,45081,1948,4.10000000
CN2109500000000,21,095,"Harlan County, KY",Feb-22,6621,6157,464,7.00000000
CN2109700000000,21,097,"Harrison County, KY",Feb-22,8834,8544,290,3.30000000
CN2109900000000,21,099,"Hart County, KY",Feb-22,7610,7316,294,3.90000000
CN2110100000000,21,101,"Henderson County, KY",Feb-22,20927,20176,751,3.60000000
CN2110300000000,21,103,"Henry County, KY",Feb-22,8163,7884,279,3.40000000
CN2110500000000,21,105,"Hickman County, KY",Feb-22,1689,1610,79,4.70000000
CN2110700000000,21,107,"Hopkins County, KY",Feb-22,18120,17239,881,4.90000000
CN2110900000000,21,109,"Jackson County, KY",Feb-22,4122,3884,238,5.80000000
CN2111100000000,21,111,"Jefferson County, KY",Feb-22,397944,382347,15597,3.90000000
CN2111300000000,21,113,"Jessamine County, KY",Feb-22,26442,25591,851,3.20000000
CN2111500000000,21,115,"Johnson County, KY",Feb-22,6664,6210,454,6.80000000
CN2111700000000,21,117,"Kenton County, KY",Feb-22,86966,83909,3057,3.50000000
CN2111900000000,21,119,"Knott County, KY",Feb-22,4301,4029,272,6.30000000
CN2112100000000,21,121,"Knox County, KY",Feb-22,10263,9735,528,5.10000000
CN2112300000000,21,123,"Larue County, KY",Feb-22,5788,5541,247,4.30000000
CN2112500000000,21,125,"Laurel County, KY",Feb-22,25899,24911,988,3.80000000
CN2112700000000,21,127,"Lawrence County, KY",Feb-22,5560,5190,370,6.70000000
CN2112900000000,21,129,"Lee County, KY",Feb-22,2018,1906,112,5.60000000
CN2113100000000,21,131,"Leslie County, KY",Feb-22,2548,2367,181,7.10000000
CN2113300000000,21,133,"Letcher County, KY",Feb-22,6081,5706,375,6.20000000
CN2113500000000,21,135,"Lewis County, KY",Feb-22,4760,4354,406,8.50000000
CN2113700000000,21,137,"Lincoln County, KY",Feb-22,9293,8831,462,5.00000000
CN2113900000000,21,139,"Livingston County, KY",Feb-22,3637,3419,218,6.00000000
CN2114100000000,21,141,"Logan County, KY",Feb-22,12432,12028,404,3.20000000
CN2114300000000,21,143,"Lyon County, KY",Feb-22,3121,2969,152,4.90000000
CN2114500000000,21,145,"McCracken County, KY",Feb-22,29623,28359,1264,4.30000000
CN2114700000000,21,147,"McCreary County, KY",Feb-22,4840,4597,243,5.00000000
CN2114900000000,21,149,"McLean County, KY",Feb-22,4037,3854,183,4.50000000
CN2115100000000,21,151,"Madison County, KY",Feb-22,47559,45932,1627,3.40000000
CN2115300000000,21,153,"Magoffin County, KY",Feb-22,3441,2963,478,13.90000000
CN2115500000000,21,155,"Marion County, KY",Feb-22,9226,8891,335,3.60000000
CN2115700000000,21,157,"Marshall County, KY",Feb-22,14075,13437,638,4.50000000
CN2115900000000,21,159,"Martin County, KY",Feb-22,2310,2119,191,8.30000000
CN2116100000000,21,161,"Mason County, KY",Feb-22,6746,6393,353,5.20000000
CN2116300000000,21,163,"Meade County, KY",Feb-22,11623,11084,539,4.60000000
CN2116500000000,21,165,"Menifee County, KY",Feb-22,2371,2190,181,7.60000000
CN2116700000000,21,167,"Mercer County, KY",Feb-22,9878,9487,391,4.00000000
CN2116900000000,21,169,"Metcalfe County, KY",Feb-22,3941,3753,188,4.80000000
CN2117100000000,21,171,"Monroe County, KY",Feb-22,4618,4456,162,3.50000000
CN2117300000000,21,173,"Montgomery County, KY",Feb-22,11755,11145,610,5.20000000
CN2117500000000,21,175,"Morgan County, KY",Feb-22,4367,4093,274,6.30000000
CN2117700000000,21,177,"Muhlenberg County, KY",Feb-22,9729,9138,591,6.10000000
CN2117900000000,21,179,"Nelson County, KY",Feb-22,23325,22399,926,4.00000000
CN2118100000000,21,181,"Nicholas County, KY",Feb-22,3329,3197,132,4.00000000
CN2118300000000,21,183,"Ohio County, KY",Feb-22,8940,8483,457,5.10000000
CN2118500000000,21,185,"Oldham County, KY",Feb-22,33458,32448,1010,3.00000000
CN2118700000000,21,187,"Owen County, KY",Feb-22,4983,4802,181,3.60000000
CN2118900000000,21,189,"Owsley County, KY",Feb-22,1038,969,69,6.60000000
CN2119100000000,21,191,"Pendleton County, KY",Feb-22,6911,6640,271,3.90000000
CN2119300000000,21,193,"Perry County, KY",Feb-22,8070,7644,426,5.30000000
CN2119500000000,21,195,"Pike County, KY",Feb-22,19215,18159,1056,5.50000000
CN2119700000000,21,197,"Powell County, KY",Feb-22,5133,4890,243,4.70000000
CN2119900000000,21,199,"Pulaski County, KY",Feb-22,25884,24716,1168,4.50000000
CN2120100000000,21,201,"Robertson County, KY",Feb-22,814,768,46,5.70000000
CN2120300000000,21,203,"Rockcastle County, KY",Feb-22,6591,6294,297,4.50000000
CN2120500000000,21,205,"Rowan County, KY",Feb-22,9973,9513,460,4.60000000
CN2120700000000,21,207,"Russell County, KY",Feb-22,6161,5856,305,5.00000000
CN2120900000000,21,209,"Scott County, KY",Feb-22,30067,29174,893,3.00000000
CN2121100000000,21,211,"Shelby County, KY",Feb-22,25957,25129,828,3.20000000
CN2121300000000,21,213,"Simpson County, KY",Feb-22,8876,8587,289,3.30000000
CN2121500000000,21,215,"Spencer County, KY",Feb-22,10677,10261,416,3.90000000
CN2121700000000,21,217,"Taylor County, KY",Feb-22,12642,12203,439,3.50000000
CN2121900000000,21,219,"Todd County, KY",Feb-22,5479,5312,167,3.00000000
CN2122100000000,21,221,"Trigg County, KY",Feb-22,6126,5849,277,4.50000000
CN2122300000000,21,223,"Trimble County, KY",Feb-22,3844,3686,158,4.10000000
CN2122500000000,21,225,"Union County, KY",Feb-22,5973,5747,226,3.80000000
CN2122700000000,21,227,"Warren County, KY",Feb-22,65415,63173,2242,3.40000000
CN2122900000000,21,229,"Washington County, KY",Feb-22,6109,5903,206,3.40000000
CN2123100000000,21,231,"Wayne County, KY",Feb-22,7211,6860,351,4.90000000
CN2123300000000,21,233,"Webster County, KY",Feb-22,5273,5067,206,3.90000000
CN2123500000000,21,235,"Whitley County, KY",Feb-22,14327,13743,584,4.10000000
CN2123700000000,21,237,"Wolfe County, KY",Feb-22,2232,2107,125,5.60000000
CN2123900000000,21,239,"Woodford County, KY",Feb-22,14784,14385,399,2.70000000
CN2200100000000,22,001,"Acadia Parish, LA",Feb-22,23697,22904,793,3.30000000
CN2200300000000,22,003,"Allen Parish, LA",Feb-22,8232,7913,319,3.90000000
CN2200500000000,22,005,"Ascension Parish, LA",Feb-22,65731,63897,1834,2.80000000
CN2200700000000,22,007,"Assumption Parish, LA",Feb-22,8650,8177,473,5.50000000
CN2200900000000,22,009,"Avoyelles Parish, LA",Feb-22,14603,14070,533,3.60000000
CN2201100000000,22,011,"Beauregard Parish, LA",Feb-22,14974,14536,438,2.90000000
CN2201300000000,22,013,"Bienville Parish, LA",Feb-22,5243,5028,215,4.10000000
CN2201500000000,22,015,"Bossier Parish, LA",Feb-22,57956,56425,1531,2.60000000
CN2201700000000,22,017,"Caddo Parish, LA",Feb-22,102356,97793,4563,4.50000000
CN2201900000000,22,019,"Calcasieu Parish, LA",Feb-22,97956,94265,3691,3.80000000
CN2202100000000,22,021,"Caldwell Parish, LA",Feb-22,3649,3521,128,3.50000000
CN2202300000000,22,023,"Cameron Parish, LA",Feb-22,3618,3527,91,2.50000000
CN2202500000000,22,025,"Catahoula Parish, LA",Feb-22,3429,3300,129,3.80000000
CN2202700000000,22,027,"Claiborne Parish, LA",Feb-22,5416,5226,190,3.50000000
CN2202900000000,22,029,"Concordia Parish, LA",Feb-22,6774,6469,305,4.50000000
CN2203100000000,22,031,"De Soto Parish, LA",Feb-22,10906,10531,375,3.40000000
CN2203300000000,22,033,"East Baton Rouge Parish, LA",Feb-22,230094,221815,8279,3.60000000
CN2203500000000,22,035,"East Carroll Parish, LA",Feb-22,1669,1530,139,8.30000000
CN2203700000000,22,037,"East Feliciana Parish, LA",Feb-22,7755,7511,244,3.10000000
CN2203900000000,22,039,"Evangeline Parish, LA",Feb-22,11831,11358,473,4.00000000
CN2204100000000,22,041,"Franklin Parish, LA",Feb-22,7417,7089,328,4.40000000
CN2204300000000,22,043,"Grant Parish, LA",Feb-22,8344,8108,236,2.80000000
CN2204500000000,22,045,"Iberia Parish, LA",Feb-22,27629,26261,1368,5.00000000
CN2204700000000,22,047,"Iberville Parish, LA",Feb-22,13841,13108,733,5.30000000
CN2204900000000,22,049,"Jackson Parish, LA",Feb-22,6844,6649,195,2.80000000
CN2205100000000,22,051,"Jefferson Parish, LA",Feb-22,210598,201862,8736,4.10000000
CN2205300000000,22,053,"Jefferson Davis Parish, LA",Feb-22,12803,12397,406,3.20000000
CN2205500000000,22,055,"Lafayette Parish, LA",Feb-22,115372,111931,3441,3.00000000
CN2205700000000,22,057,"Lafourche Parish, LA",Feb-22,40174,38876,1298,3.20000000
CN2205900000000,22,059,"LaSalle Parish, LA",Feb-22,6569,6421,148,2.30000000
CN2206100000000,22,061,"Lincoln Parish, LA",Feb-22,21475,20871,604,2.80000000
CN2206300000000,22,063,"Livingston Parish, LA",Feb-22,70348,68533,1815,2.60000000
CN2206500000000,22,065,"Madison Parish, LA",Feb-22,3436,3266,170,4.90000000
CN2206700000000,22,067,"Morehouse Parish, LA",Feb-22,10054,9436,618,6.10000000
CN2206900000000,22,069,"Natchitoches Parish, LA",Feb-22,16525,15984,541,3.30000000
CN2207100000000,22,071,"Orleans Parish, LA",Feb-22,178334,167630,10704,6.00000000
CN2207300000000,22,073,"Ouachita Parish, LA",Feb-22,69583,67159,2424,3.50000000
CN2207500000000,22,075,"Plaquemines Parish, LA",Feb-22,9735,9451,284,2.90000000
CN2207700000000,22,077,"Pointe Coupee Parish, LA",Feb-22,9676,9283,393,4.10000000
CN2207900000000,22,079,"Rapides Parish, LA",Feb-22,56454,54890,1564,2.80000000
CN2208100000000,22,081,"Red River Parish, LA",Feb-22,3694,3579,115,3.10000000
CN2208300000000,22,083,"Richland Parish, LA",Feb-22,8117,7805,312,3.80000000
CN2208500000000,22,085,"Sabine Parish, LA",Feb-22,9224,8989,235,2.50000000
CN2208700000000,22,087,"St. Bernard Parish, LA",Feb-22,20051,19070,981,4.90000000
CN2208900000000,22,089,"St. Charles Parish, LA",Feb-22,24689,23855,834,3.40000000
CN2209100000000,22,091,"St. Helena Parish, LA",Feb-22,4276,3985,291,6.80000000
CN2209300000000,22,093,"St. James Parish, LA",Feb-22,8971,8479,492,5.50000000
CN2209500000000,22,095,"St. John the Baptist Parish, LA",Feb-22,19345,18077,1268,6.60000000
CN2209700000000,22,097,"St. Landry Parish, LA",Feb-22,31751,30272,1479,4.70000000
CN2209900000000,22,099,"St. Martin Parish, LA",Feb-22,22029,21177,852,3.90000000
CN2210100000000,22,101,"St. Mary Parish, LA",Feb-22,18947,17990,957,5.10000000
CN2210300000000,22,103,"St. Tammany Parish, LA",Feb-22,118501,115430,3071,2.60000000
CN2210500000000,22,105,"Tangipahoa Parish, LA",Feb-22,56380,53749,2631,4.70000000
CN2210700000000,22,107,"Tensas Parish, LA",Feb-22,1304,1247,57,4.40000000
CN2210900000000,22,109,"Terrebonne Parish, LA",Feb-22,44478,42617,1861,4.20000000
CN2211100000000,22,111,"Union Parish, LA",Feb-22,9086,8767,319,3.50000000
CN2211300000000,22,113,"Vermilion Parish, LA",Feb-22,23856,23026,830,3.50000000
CN2211500000000,22,115,"Vernon Parish, LA",Feb-22,16147,15592,555,3.40000000
CN2211700000000,22,117,"Washington Parish, LA",Feb-22,17012,16319,693,4.10000000
CN2211900000000,22,119,"Webster Parish, LA",Feb-22,14156,13617,539,3.80000000
CN2212100000000,22,121,"West Baton Rouge Parish, LA",Feb-22,13788,13333,455,3.30000000
CN2212300000000,22,123,"West Carroll Parish, LA",Feb-22,3478,3274,204,5.90000000
CN2212500000000,22,125,"West Feliciana Parish, LA",Feb-22,5348,5219,129,2.40000000
CN2212700000000,22,127,"Winn Parish, LA",Feb-22,4564,4412,152,3.30000000
CN2300100000000,23,001,"Androscoggin County, ME",Feb-22,54128,52022,2106,3.90000000
CN2300300000000,23,003,"Aroostook County, ME",Feb-22,28467,26882,1585,5.60000000
CN2300500000000,23,005,"Cumberland County, ME",Feb-22,160122,155330,4792,3.00000000
CN2300700000000,23,007,"Franklin County, ME",Feb-22,13818,13170,648,4.70000000
CN2300900000000,23,009,"Hancock County, ME",Feb-22,27224,25448,1776,6.50000000
CN2301100000000,23,011,"Kennebec County, ME",Feb-22,61379,59047,2332,3.80000000
CN2301300000000,23,013,"Knox County, ME",Feb-22,19140,18254,886,4.60000000
CN2301500000000,23,015,"Lincoln County, ME",Feb-22,15933,15204,729,4.60000000
CN2301700000000,23,017,"Oxford County, ME",Feb-22,26148,24906,1242,4.70000000
CN2301900000000,23,019,"Penobscot County, ME",Feb-22,76287,73173,3114,4.10000000
CN2302100000000,23,021,"Piscataquis County, ME",Feb-22,7351,6948,403,5.50000000
CN2302300000000,23,023,"Sagadahoc County, ME",Feb-22,18962,18367,595,3.10000000
CN2302500000000,23,025,"Somerset County, ME",Feb-22,22233,20849,1384,6.20000000
CN2302700000000,23,027,"Waldo County, ME",Feb-22,20078,19113,965,4.80000000
CN2302900000000,23,029,"Washington County, ME",Feb-22,13009,12048,961,7.40000000
CN2303100000000,23,031,"York County, ME",Feb-22,111473,106724,4749,4.30000000
CN2400100000000,24,001,"Allegany County, MD",Feb-22 c,30419,28741,1678,5.50000000
CN2400300000000,24,003,"Anne Arundel County, MD",Feb-22 c,314687,303194,11493,3.70000000
CN2400500000000,24,005,"Baltimore County, MD",Feb-22 c,446917,427421,19496,4.40000000
CN2400900000000,24,009,"Calvert County, MD",Feb-22 c,48936,47158,1778,3.60000000
CN2401100000000,24,011,"Caroline County, MD",Feb-22 c,17301,16594,707,4.10000000
CN2401300000000,24,013,"Carroll County, MD",Feb-22 c,94595,91432,3163,3.30000000
CN2401500000000,24,015,"Cecil County, MD",Feb-22 c,52282,49944,2338,4.50000000
CN2401700000000,24,017,"Charles County, MD",Feb-22 c,86183,82489,3694,4.30000000
CN2401900000000,24,019,"Dorchester County, MD",Feb-22 c,15695,14900,795,5.10000000
CN2402100000000,24,021,"Frederick County, MD",Feb-22 c,135756,130633,5123,3.80000000
CN2402300000000,24,023,"Garrett County, MD",Feb-22 c,15164,14395,769,5.10000000
CN2402500000000,24,025,"Harford County, MD",Feb-22 c,140558,135181,5377,3.80000000
CN2402700000000,24,027,"Howard County, MD",Feb-22 c,187858,181688,6170,3.30000000
CN2402900000000,24,029,"Kent County, MD",Feb-22 c,9367,8866,501,5.30000000
CN2403100000000,24,031,"Montgomery County, MD",Feb-22 c,546190,525055,21135,3.90000000
CN2403300000000,24,033,"Prince George's County, MD",Feb-22 c,498758,471964,26794,5.40000000
CN2403500000000,24,035,"Queen Anne's County, MD",Feb-22 c,27941,26923,1018,3.60000000
CN2403700000000,24,037,"St. Mary's County, MD",Feb-22 c,57334,55206,2128,3.70000000
CN2403900000000,24,039,"Somerset County, MD",Feb-22 c,8502,7913,589,6.90000000
CN2404100000000,24,041,"Talbot County, MD",Feb-22 c,17145,16322,823,4.80000000
CN2404300000000,24,043,"Washington County, MD",Feb-22 c,72309,69159,3150,4.40000000
CN2404500000000,24,045,"Wicomico County, MD",Feb-22 c,48029,45465,2564,5.30000000
CN2404700000000,24,047,"Worcester County, MD",Feb-22 c,24336,22124,2212,9.10000000
CN2451000000000,24,510,"Baltimore city, MD",Feb-22 c,278101,261269,16832,6.10000000
CN2500100000000,25,001,"Barnstable County, MA",Feb-22,107506,99904,7602,7.10000000
CN2500300000000,25,003,"Berkshire County, MA",Feb-22,61670,58304,3366,5.50000000
CN2500500000000,25,005,"Bristol County, MA",Feb-22,300632,283287,17345,5.80000000
CN2500700000000,25,007,"Dukes County, MA",Feb-22,8668,7929,739,8.50000000
CN2500900000000,25,009,"Essex County, MA",Feb-22,423900,404196,19704,4.60000000
CN2501100000000,25,011,"Franklin County, MA",Feb-22,40994,39407,1587,3.90000000
CN2501300000000,25,013,"Hampden County, MA",Feb-22,228467,215401,13066,5.70000000
CN2501500000000,25,015,"Hampshire County, MA",Feb-22,90680,87426,3254,3.60000000
CN2501700000000,25,017,"Middlesex County, MA",Feb-22,913839,885669,28170,3.10000000
CN2501900000000,25,019,"Nantucket County/town, MA",Feb-22,6467,5522,945,14.60000000
CN2502100000000,25,021,"Norfolk County, MA",Feb-22,393693,379901,13792,3.50000000
CN2502300000000,25,023,"Plymouth County, MA",Feb-22,285254,271061,14193,5.00000000
CN2502500000000,25,025,"Suffolk County, MA",Feb-22,454123,437301,16822,3.70000000
CN2502700000000,25,027,"Worcester County, MA",Feb-22,443384,423775,19609,4.40000000
CN2600100000000,26,001,"Alcona County, MI",Feb-22,3611,3282,329,9.10000000
CN2600300000000,26,003,"Alger County, MI",Feb-22,3025,2754,271,9.00000000
CN2600500000000,26,005,"Allegan County, MI",Feb-22,60298,57729,2569,4.30000000
CN2600700000000,26,007,"Alpena County, MI",Feb-22,13471,12710,761,5.60000000
CN2600900000000,26,009,"Antrim County, MI",Feb-22,9414,8671,743,7.90000000
CN2601100000000,26,011,"Arenac County, MI",Feb-22,5647,5062,585,10.40000000
CN2601300000000,26,013,"Baraga County, MI",Feb-22,3025,2744,281,9.30000000
CN2601500000000,26,015,"Barry County, MI",Feb-22,30972,29658,1314,4.20000000
CN2601700000000,26,017,"Bay County, MI",Feb-22,48354,45370,2984,6.20000000
CN2601900000000,26,019,"Benzie County, MI",Feb-22,8347,7755,592,7.10000000
CN2602100000000,26,021,"Berrien County, MI",Feb-22,69985,66329,3656,5.20000000
CN2602300000000,26,023,"Branch County, MI",Feb-22,18675,17856,819,4.40000000
CN2602500000000,26,025,"Calhoun County, MI",Feb-22,59379,56029,3350,5.60000000
CN2602700000000,26,027,"Cass County, MI",Feb-22,23173,22144,1029,4.40000000
CN2602900000000,26,029,"Charlevoix County, MI",Feb-22,11824,11076,748,6.30000000
CN2603100000000,26,031,"Cheboygan County, MI",Feb-22,9425,8150,1275,13.50000000
CN2603300000000,26,033,"Chippewa County, MI",Feb-22,16203,14898,1305,8.10000000
CN2603500000000,26,035,"Clare County, MI",Feb-22,11042,10054,988,8.90000000
CN2603700000000,26,037,"Clinton County, MI",Feb-22,39139,37657,1482,3.80000000
CN2603900000000,26,039,"Crawford County, MI",Feb-22,5280,4847,433,8.20000000
CN2604100000000,26,041,"Delta County, MI",Feb-22,16024,14899,1125,7.00000000
CN2604300000000,26,043,"Dickinson County, MI",Feb-22,12158,11577,581,4.80000000
CN2604500000000,26,045,"Eaton County, MI",Feb-22,54580,52155,2425,4.40000000
CN2604700000000,26,047,"Emmet County, MI",Feb-22,15728,14483,1245,7.90000000
CN2604900000000,26,049,"Genesee County, MI",Feb-22,174735,162767,11968,6.80000000
CN2605100000000,26,051,"Gladwin County, MI",Feb-22,9379,8649,730,7.80000000
CN2605300000000,26,053,"Gogebic County, MI",Feb-22,5639,5329,310,5.50000000
CN2605500000000,26,055,"Grand Traverse County, MI",Feb-22,46682,44512,2170,4.60000000
CN2605700000000,26,057,"Gratiot County, MI",Feb-22,16955,16097,858,5.10000000
CN2605900000000,26,059,"Hillsdale County, MI",Feb-22,19540,18572,968,5.00000000
CN2606100000000,26,061,"Houghton County, MI",Feb-22,16204,15385,819,5.10000000
CN2606300000000,26,063,"Huron County, MI",Feb-22,14355,13544,811,5.60000000
CN2606500000000,26,065,"Ingham County, MI",Feb-22,142741,136282,6459,4.50000000
CN2606700000000,26,067,"Ionia County, MI",Feb-22,29274,27993,1281,4.40000000
CN2606900000000,26,069,"Iosco County, MI",Feb-22,9724,8875,849,8.70000000
CN2607100000000,26,071,"Iron County, MI",Feb-22,4776,4452,324,6.80000000
CN2607300000000,26,073,"Isabella County, MI",Feb-22,31970,30374,1596,5.00000000
CN2607500000000,26,075,"Jackson County, MI",Feb-22,72384,68565,3819,5.30000000
CN2607700000000,26,077,"Kalamazoo County, MI",Feb-22,129715,124423,5292,4.10000000
CN2607900000000,26,079,"Kalkaska County, MI",Feb-22,7541,6923,618,8.20000000
CN2608100000000,26,081,"Kent County, MI",Feb-22,349966,336810,13156,3.80000000
CN2608300000000,26,083,"Keweenaw County, MI",Feb-22,906,845,61,6.70000000
CN2608500000000,26,085,"Lake County, MI",Feb-22,3833,3498,335,8.70000000
CN2608700000000,26,087,"Lapeer County, MI",Feb-22,40977,38410,2567,6.30000000
CN2608900000000,26,089,"Leelanau County, MI",Feb-22,9780,9249,531,5.40000000
CN2609100000000,26,091,"Lenawee County, MI",Feb-22,44412,41992,2420,5.40000000
CN2609300000000,26,093,"Livingston County, MI",Feb-22,103588,99670,3918,3.80000000
CN2609500000000,26,095,"Luce County, MI",Feb-22,2016,1868,148,7.30000000
CN2609700000000,26,097,"Mackinac County, MI",Feb-22,4136,3387,749,18.10000000
CN2609900000000,26,099,"Macomb County, MI",Feb-22,445844,423576,22268,5.00000000
CN2610100000000,26,101,"Manistee County, MI",Feb-22,9563,8845,718,7.50000000
CN2610300000000,26,103,"Marquette County, MI",Feb-22,31369,29570,1799,5.70000000
CN2610500000000,26,105,"Mason County, MI",Feb-22,12475,11594,881,7.10000000
CN2610700000000,26,107,"Mecosta County, MI",Feb-22,17946,16828,1118,6.20000000
CN2610900000000,26,109,"Menominee County, MI",Feb-22,10266,9818,448,4.40000000
CN2611100000000,26,111,"Midland County, MI",Feb-22,38191,36347,1844,4.80000000
CN2611300000000,26,113,"Missaukee County, MI",Feb-22,6645,6228,417,6.30000000
CN2611500000000,26,115,"Monroe County, MI",Feb-22,73791,69165,4626,6.30000000
CN2611700000000,26,117,"Montcalm County, MI",Feb-22,27166,25743,1423,5.20000000
CN2611900000000,26,119,"Montmorency County, MI",Feb-22,2937,2619,318,10.80000000
CN2612100000000,26,121,"Muskegon County, MI",Feb-22,75774,70944,4830,6.40000000
CN2612300000000,26,123,"Newaygo County, MI",Feb-22,22797,21515,1282,5.60000000
CN2612500000000,26,125,"Oakland County, MI",Feb-22,669265,643710,25555,3.80000000
CN2612700000000,26,127,"Oceana County, MI",Feb-22,11197,10229,968,8.60000000
CN2612900000000,26,129,"Ogemaw County, MI",Feb-22,7681,6949,732,9.50000000
CN2613100000000,26,131,"Ontonagon County, MI",Feb-22,2049,1895,154,7.50000000
CN2613300000000,26,133,"Osceola County, MI",Feb-22,11332,10688,644,5.70000000
CN2613500000000,26,135,"Oscoda County, MI",Feb-22,2470,2207,263,10.60000000
CN2613700000000,26,137,"Otsego County, MI",Feb-22,11167,10392,775,6.90000000
CN2613900000000,26,139,"Ottawa County, MI",Feb-22,157137,151772,5365,3.40000000
CN2614100000000,26,141,"Presque Isle County, MI",Feb-22,4798,4235,563,11.70000000
CN2614300000000,26,143,"Roscommon County, MI",Feb-22,7143,6303,840,11.80000000
CN2614500000000,26,145,"Saginaw County, MI",Feb-22,81333,75846,5487,6.70000000
CN2614700000000,26,147,"St. Clair County, MI",Feb-22,75446,71316,4130,5.50000000
CN2614900000000,26,149,"St. Joseph County, MI",Feb-22,27395,26325,1070,3.90000000
CN2615100000000,26,151,"Sanilac County, MI",Feb-22,18637,17485,1152,6.20000000
CN2615300000000,26,153,"Schoolcraft County, MI",Feb-22,3068,2750,318,10.40000000
CN2615500000000,26,155,"Shiawassee County, MI",Feb-22,31922,30199,1723,5.40000000
CN2615700000000,26,157,"Tuscola County, MI",Feb-22,22529,21081,1448,6.40000000
CN2615900000000,26,159,"Van Buren County, MI",Feb-22,34081,31985,2096,6.20000000
CN2616100000000,26,161,"Washtenaw County, MI",Feb-22,196080,188803,7277,3.70000000
CN2616300000000,26,163,"Wayne County, MI",Feb-22,814101,756362,57739,7.10000000
CN2616500000000,26,165,"Wexford County, MI",Feb-22,14346,13522,824,5.70000000
CN2700100000000,27,001,"Aitkin County, MN",Feb-22,7359,6984,375,5.10000000
CN2700300000000,27,003,"Anoka County, MN",Feb-22,199338,194337,5001,2.50000000
CN2700500000000,27,005,"Becker County, MN",Feb-22,19065,18415,650,3.40000000
CN2700700000000,27,007,"Beltrami County, MN",Feb-22,24225,23374,851,3.50000000
CN2700900000000,27,009,"Benton County, MN",Feb-22,22109,21266,843,3.80000000
CN2701100000000,27,011,"Big Stone County, MN",Feb-22,2367,2278,89,3.80000000
CN2701300000000,27,013,"Blue Earth County, MN",Feb-22,40719,39831,888,2.20000000
CN2701500000000,27,015,"Brown County, MN",Feb-22,13558,13145,413,3.00000000
CN2701700000000,27,017,"Carlton County, MN",Feb-22,17771,17104,667,3.80000000
CN2701900000000,27,019,"Carver County, MN",Feb-22,59543,58339,1204,2.00000000
CN2702100000000,27,021,"Cass County, MN",Feb-22,16941,16234,707,4.20000000
CN2702300000000,27,023,"Chippewa County, MN",Feb-22,6502,6343,159,2.40000000
CN2702500000000,27,025,"Chisago County, MN",Feb-22,30180,29166,1014,3.40000000
CN2702700000000,27,027,"Clay County, MN",Feb-22,37294,36454,840,2.30000000
CN2702900000000,27,029,"Clearwater County, MN",Feb-22,4574,4189,385,8.40000000
CN2703100000000,27,031,"Cook County, MN",Feb-22,2648,2532,116,4.40000000
CN2703300000000,27,033,"Cottonwood County, MN",Feb-22,6635,6493,142,2.10000000
CN2703500000000,27,035,"Crow Wing County, MN",Feb-22,31424,30217,1207,3.80000000
CN2703700000000,27,037,"Dakota County, MN",Feb-22,242868,237545,5323,2.20000000
CN2703900000000,27,039,"Dodge County, MN",Feb-22,12141,11771,370,3.00000000
CN2704100000000,27,041,"Douglas County, MN",Feb-22,20940,20416,524,2.50000000
CN2704300000000,27,043,"Faribault County, MN",Feb-22,6808,6575,233,3.40000000
CN2704500000000,27,045,"Fillmore County, MN",Feb-22,11655,11319,336,2.90000000
CN2704700000000,27,047,"Freeborn County, MN",Feb-22,15504,15095,409,2.60000000
CN2704900000000,27,049,"Goodhue County, MN",Feb-22,26467,25759,708,2.70000000
CN2705100000000,27,051,"Grant County, MN",Feb-22,3204,3090,114,3.60000000
CN2705300000000,27,053,"Hennepin County, MN",Feb-22,705069,689757,15312,2.20000000
CN2705500000000,27,055,"Houston County, MN",Feb-22,10545,10263,282,2.70000000
CN2705700000000,27,057,"Hubbard County, MN",Feb-22,10011,9539,472,4.70000000
CN2705900000000,27,059,"Isanti County, MN",Feb-22,21945,21110,835,3.80000000
CN2706100000000,27,061,"Itasca County, MN",Feb-22,21074,20035,1039,4.90000000
CN2706300000000,27,063,"Jackson County, MN",Feb-22,5440,5310,130,2.40000000
CN2706500000000,27,065,"Kanabec County, MN",Feb-22,9187,8616,571,6.20000000
CN2706700000000,27,067,"Kandiyohi County, MN",Feb-22,22768,21995,773,3.40000000
CN2706900000000,27,069,"Kittson County, MN",Feb-22,2246,2184,62,2.80000000
CN2707100000000,27,071,"Koochiching County, MN",Feb-22,5516,5320,196,3.60000000
CN2707300000000,27,073,"Lac qui Parle County, MN",Feb-22,3379,3279,100,3.00000000
CN2707500000000,27,075,"Lake County, MN",Feb-22,5171,5024,147,2.80000000
CN2707700000000,27,077,"Lake of the Woods County, MN",Feb-22,2500,2440,60,2.40000000
CN2707900000000,27,079,"Le Sueur County, MN",Feb-22,16150,15440,710,4.40000000
CN2708100000000,27,081,"Lincoln County, MN",Feb-22,2952,2842,110,3.70000000
CN2708300000000,27,083,"Lyon County, MN",Feb-22,14201,13807,394,2.80000000
CN2708500000000,27,085,"McLeod County, MN",Feb-22,19009,18420,589,3.10000000
CN2708700000000,27,087,"Mahnomen County, MN",Feb-22,2249,2124,125,5.60000000
CN2708900000000,27,089,"Marshall County, MN",Feb-22,5293,5017,276,5.20000000
CN2709100000000,27,091,"Martin County, MN",Feb-22,9462,9215,247,2.60000000
CN2709300000000,27,093,"Meeker County, MN",Feb-22,13231,12758,473,3.60000000
CN2709500000000,27,095,"Mille Lacs County, MN",Feb-22,12885,12173,712,5.50000000
CN2709700000000,27,097,"Morrison County, MN",Feb-22,17615,16649,966,5.50000000
CN2709900000000,27,099,"Mower County, MN",Feb-22,20646,20123,523,2.50000000
CN2710100000000,27,101,"Murray County, MN",Feb-22,4547,4332,215,4.70000000
CN2710300000000,27,103,"Nicollet County, MN",Feb-22,20905,20476,429,2.10000000
CN2710500000000,27,105,"Nobles County, MN",Feb-22,11300,11063,237,2.10000000
CN2710700000000,27,107,"Norman County, MN",Feb-22,3280,3148,132,4.00000000
CN2710900000000,27,109,"Olmsted County, MN",Feb-22,92172,90257,1915,2.10000000
CN2711100000000,27,111,"Otter Tail County, MN",Feb-22,30567,29438,1129,3.70000000
CN2711300000000,27,113,"Pennington County, MN",Feb-22,8782,8422,360,4.10000000
CN2711500000000,27,115,"Pine County, MN",Feb-22,14292,13515,777,5.40000000
CN2711700000000,27,117,"Pipestone County, MN",Feb-22,4368,4225,143,3.30000000
CN2711900000000,27,119,"Polk County, MN",Feb-22,16371,15855,516,3.20000000
CN2712100000000,27,121,"Pope County, MN",Feb-22,6317,6146,171,2.70000000
CN2712300000000,27,123,"Ramsey County, MN",Feb-22,285834,278946,6888,2.40000000
CN2712500000000,27,125,"Red Lake County, MN",Feb-22,2200,2107,93,4.20000000
CN2712700000000,27,127,"Redwood County, MN",Feb-22,7422,7216,206,2.80000000
CN2712900000000,27,129,"Renville County, MN",Feb-22,8233,7895,338,4.10000000
CN2713100000000,27,131,"Rice County, MN",Feb-22,37002,36012,990,2.70000000
CN2713300000000,27,133,"Rock County, MN",Feb-22,5962,5854,108,1.80000000
CN2713500000000,27,135,"Roseau County, MN",Feb-22,7967,7774,193,2.40000000
CN2713700000000,27,137,"St. Louis County, MN",Feb-22,100999,97897,3102,3.10000000
CN2713900000000,27,139,"Scott County, MN",Feb-22,84608,82816,1792,2.10000000
CN2714100000000,27,141,"Sherburne County, MN",Feb-22,53527,51884,1643,3.10000000
CN2714300000000,27,143,"Sibley County, MN",Feb-22,8225,7918,307,3.70000000
CN2714500000000,27,145,"Stearns County, MN",Feb-22,91259,88731,2528,2.80000000
CN2714700000000,27,147,"Steele County, MN",Feb-22,19608,19082,526,2.70000000
CN2714900000000,27,149,"Stevens County, MN",Feb-22,5200,5074,126,2.40000000
CN2715100000000,27,151,"Swift County, MN",Feb-22,4676,4513,163,3.50000000
CN2715300000000,27,153,"Todd County, MN",Feb-22,13460,12977,483,3.60000000
CN2715500000000,27,155,"Traverse County, MN",Feb-22,1656,1605,51,3.10000000
CN2715700000000,27,157,"Wabasha County, MN",Feb-22,12390,12041,349,2.80000000
CN2715900000000,27,159,"Wadena County, MN",Feb-22,6010,5712,298,5.00000000
CN2716100000000,27,161,"Waseca County, MN",Feb-22,8626,8312,314,3.60000000
CN2716300000000,27,163,"Washington County, MN",Feb-22,145170,142232,2938,2.00000000
CN2716500000000,27,165,"Watonwan County, MN",Feb-22,6480,6319,161,2.50000000
CN2716700000000,27,167,"Wilkin County, MN",Feb-22,3363,3284,79,2.30000000
CN2716900000000,27,169,"Winona County, MN",Feb-22,27859,27296,563,2.00000000
CN2717100000000,27,171,"Wright County, MN",Feb-22,77063,74983,2080,2.70000000
CN2717300000000,27,173,"Yellow Medicine County, MN",Feb-22,5004,4846,158,3.20000000
CN2800100000000,28,001,"Adams County, MS",Feb-22,10395,9713,682,6.60000000
CN2800300000000,28,003,"Alcorn County, MS",Feb-22,15494,14880,614,4.00000000
CN2800500000000,28,005,"Amite County, MS",Feb-22,4396,4135,261,5.90000000
CN2800700000000,28,007,"Attala County, MS",Feb-22,7103,6766,337,4.70000000
CN2800900000000,28,009,"Benton County, MS",Feb-22,3084,2920,164,5.30000000
CN2801100000000,28,011,"Bolivar County, MS",Feb-22,11370,10760,610,5.40000000
CN2801300000000,28,013,"Calhoun County, MS",Feb-22,5388,5151,237,4.40000000
CN2801500000000,28,015,"Carroll County, MS",Feb-22,3556,3383,173,4.90000000
CN2801700000000,28,017,"Chickasaw County, MS",Feb-22,6937,6615,322,4.60000000
CN2801900000000,28,019,"Choctaw County, MS",Feb-22,3588,3437,151,4.20000000
CN2802100000000,28,021,"Claiborne County, MS",Feb-22,2930,2669,261,8.90000000
CN2802300000000,28,023,"Clarke County, MS",Feb-22,5695,5388,307,5.40000000
CN2802500000000,28,025,"Clay County, MS",Feb-22,8320,7883,437,5.30000000
CN2802700000000,28,027,"Coahoma County, MS",Feb-22,7913,7387,526,6.60000000
CN2802900000000,28,029,"Copiah County, MS",Feb-22,10710,10163,547,5.10000000
CN2803100000000,28,031,"Covington County, MS",Feb-22,8170,7842,328,4.00000000
CN2803300000000,28,033,"DeSoto County, MS",Feb-22,94497,91161,3336,3.50000000
CN2803500000000,28,035,"Forrest County, MS",Feb-22,33562,32101,1461,4.40000000
CN2803700000000,28,037,"Franklin County, MS",Feb-22,2626,2480,146,5.60000000
CN2803900000000,28,039,"George County, MS",Feb-22,8680,8165,515,5.90000000
CN2804100000000,28,041,"Greene County, MS",Feb-22,4199,3937,262,6.20000000
CN2804300000000,28,043,"Grenada County, MS",Feb-22,9227,8858,369,4.00000000
CN2804500000000,28,045,"Hancock County, MS",Feb-22,19301,18403,898,4.70000000
CN2804700000000,28,047,"Harrison County, MS",Feb-22,88797,84946,3851,4.30000000
CN2804900000000,28,049,"Hinds County, MS",Feb-22,101261,96511,4750,4.70000000
CN2805100000000,28,051,"Holmes County, MS",Feb-22,5072,4644,428,8.40000000
CN2805300000000,28,053,"Humphreys County, MS",Feb-22,1962,1760,202,10.30000000
CN2805500000000,28,055,"Issaquena County, MS",Feb-22,318,291,27,8.50000000
CN2805700000000,28,057,"Itawamba County, MS",Feb-22,10429,10053,376,3.60000000
CN2805900000000,28,059,"Jackson County, MS",Feb-22,59576,56658,2918,4.90000000
CN2806100000000,28,061,"Jasper County, MS",Feb-22,5791,5445,346,6.00000000
CN2806300000000,28,063,"Jefferson County, MS",Feb-22,1893,1621,272,14.40000000
CN2806500000000,28,065,"Jefferson Davis County, MS",Feb-22,3894,3651,243,6.20000000
CN2806700000000,28,067,"Jones County, MS",Feb-22,24588,23436,1152,4.70000000
CN2806900000000,28,069,"Kemper County, MS",Feb-22,3278,3078,200,6.10000000
CN2807100000000,28,071,"Lafayette County, MS",Feb-22,28539,27587,952,3.30000000
CN2807300000000,28,073,"Lamar County, MS",Feb-22,31858,30754,1104,3.50000000
CN2807500000000,28,075,"Lauderdale County, MS",Feb-22,29203,27914,1289,4.40000000
CN2807700000000,28,077,"Lawrence County, MS",Feb-22,4598,4339,259,5.60000000
CN2807900000000,28,079,"Leake County, MS",Feb-22,8024,7651,373,4.60000000
CN2808100000000,28,081,"Lee County, MS",Feb-22,41495,40018,1477,3.60000000
CN2808300000000,28,083,"Leflore County, MS",Feb-22,10071,9465,606,6.00000000
CN2808500000000,28,085,"Lincoln County, MS",Feb-22,14934,14335,599,4.00000000
CN2808700000000,28,087,"Lowndes County, MS",Feb-22,25938,24767,1171,4.50000000
CN2808900000000,28,089,"Madison County, MS",Feb-22,52886,51027,1859,3.50000000
CN2809100000000,28,091,"Marion County, MS",Feb-22,10496,10068,428,4.10000000
CN2809300000000,28,093,"Marshall County, MS",Feb-22,14377,13734,643,4.50000000
CN2809500000000,28,095,"Monroe County, MS",Feb-22,16104,15436,668,4.10000000
CN2809700000000,28,097,"Montgomery County, MS",Feb-22,3953,3762,191,4.80000000
CN2809900000000,28,099,"Neshoba County, MS",Feb-22,10034,9540,494,4.90000000
CN2810100000000,28,101,"Newton County, MS",Feb-22,8250,7872,378,4.60000000
CN2810300000000,28,103,"Noxubee County, MS",Feb-22,3566,3315,251,7.00000000
CN2810500000000,28,105,"Oktibbeha County, MS",Feb-22,23059,22074,985,4.30000000
CN2810700000000,28,107,"Panola County, MS",Feb-22,12612,11901,711,5.60000000
CN2810900000000,28,109,"Pearl River County, MS",Feb-22,23883,22845,1038,4.30000000
CN2811100000000,28,111,"Perry County, MS",Feb-22,4285,4051,234,5.50000000
CN2811300000000,28,113,"Pike County, MS",Feb-22,14394,13579,815,5.70000000
CN2811500000000,28,115,"Pontotoc County, MS",Feb-22,15120,14591,529,3.50000000
CN2811700000000,28,117,"Prentiss County, MS",Feb-22,11454,11041,413,3.60000000
CN2811900000000,28,119,"Quitman County, MS",Feb-22,2321,2173,148,6.40000000
CN2812100000000,28,121,"Rankin County, MS",Feb-22,75832,73369,2463,3.20000000
CN2812300000000,28,123,"Scott County, MS",Feb-22,12414,11939,475,3.80000000
CN2812500000000,28,125,"Sharkey County, MS",Feb-22,1444,1338,106,7.30000000
CN2812700000000,28,127,"Simpson County, MS",Feb-22,10508,10058,450,4.30000000
CN2812900000000,28,129,"Smith County, MS",Feb-22,6672,6406,266,4.00000000
CN2813100000000,28,131,"Stone County, MS",Feb-22,7047,6730,317,4.50000000
CN2813300000000,28,133,"Sunflower County, MS",Feb-22,7426,6913,513,6.90000000
CN2813500000000,28,135,"Tallahatchie County, MS",Feb-22,4728,4487,241,5.10000000
CN2813700000000,28,137,"Tate County, MS",Feb-22,12241,11716,525,4.30000000
CN2813900000000,28,139,"Tippah County, MS",Feb-22,9844,9484,360,3.70000000
CN2814100000000,28,141,"Tishomingo County, MS",Feb-22,8423,8082,341,4.00000000
CN2814300000000,28,143,"Tunica County, MS",Feb-22,4254,3992,262,6.20000000
CN2814500000000,28,145,"Union County, MS",Feb-22,14386,13925,461,3.20000000
CN2814700000000,28,147,"Walthall County, MS",Feb-22,4954,4687,267,5.40000000
CN2814900000000,28,149,"Warren County, MS",Feb-22,19423,18484,939,4.80000000
CN2815100000000,28,151,"Washington County, MS",Feb-22,15612,14574,1038,6.60000000
CN2815300000000,28,153,"Wayne County, MS",Feb-22,7451,7051,400,5.40000000
CN2815500000000,28,155,"Webster County, MS",Feb-22,4004,3836,168,4.20000000
CN2815700000000,28,157,"Wilkinson County, MS",Feb-22,2635,2422,213,8.10000000
CN2815900000000,28,159,"Winston County, MS",Feb-22,7125,6775,350,4.90000000
CN2816100000000,28,161,"Yalobusha County, MS",Feb-22,4956,4738,218,4.40000000
CN2816300000000,28,163,"Yazoo County, MS",Feb-22,8875,8361,514,5.80000000
CN2900100000000,29,001,"Adair County, MO",Feb-22,9863,9508,355,3.60000000
CN2900300000000,29,003,"Andrew County, MO",Feb-22,9802,9538,264,2.70000000
CN2900500000000,29,005,"Atchison County, MO",Feb-22,2634,2557,77,2.90000000
CN2900700000000,29,007,"Audrain County, MO",Feb-22,10224,9886,338,3.30000000
CN2900900000000,29,009,"Barry County, MO",Feb-22,14968,14398,570,3.80000000
CN2901100000000,29,011,"Barton County, MO",Feb-22,5173,5020,153,3.00000000
CN2901300000000,29,013,"Bates County, MO",Feb-22,7689,7376,313,4.10000000
CN2901500000000,29,015,"Benton County, MO",Feb-22,7295,6889,406,5.60000000
CN2901700000000,29,017,"Bollinger County, MO",Feb-22,5391,5205,186,3.50000000
CN2901900000000,29,019,"Boone County, MO",Feb-22,100773,98421,2352,2.30000000
CN2902100000000,29,021,"Buchanan County, MO",Feb-22,43989,42591,1398,3.20000000
CN2902300000000,29,023,"Butler County, MO",Feb-22,18210,17502,708,3.90000000
CN2902500000000,29,025,"Caldwell County, MO",Feb-22,4327,4100,227,5.20000000
CN2902700000000,29,027,"Callaway County, MO",Feb-22,21391,20759,632,3.00000000
CN2902900000000,29,029,"Camden County, MO",Feb-22,18296,17298,998,5.50000000
CN2903100000000,29,031,"Cape Girardeau County, MO",Feb-22,40998,39875,1123,2.70000000
CN2903300000000,29,033,"Carroll County, MO",Feb-22,4506,4307,199,4.40000000
CN2903500000000,29,035,"Carter County, MO",Feb-22,2529,2387,142,5.60000000
CN2903700000000,29,037,"Cass County, MO",Feb-22,54941,53082,1859,3.40000000
CN2903900000000,29,039,"Cedar County, MO",Feb-22,5729,5554,175,3.10000000
CN2904100000000,29,041,"Chariton County, MO",Feb-22,3719,3608,111,3.00000000
CN2904300000000,29,043,"Christian County, MO",Feb-22,47822,46502,1320,2.80000000
CN2904500000000,29,045,"Clark County, MO",Feb-22,3074,2956,118,3.80000000
CN2904700000000,29,047,"Clay County, MO",Feb-22,140436,133715,6721,4.80000000
CN2904900000000,29,049,"Clinton County, MO",Feb-22,10808,10206,602,5.60000000
CN2905100000000,29,051,"Cole County, MO",Feb-22,38776,37819,957,2.50000000
CN2905300000000,29,053,"Cooper County, MO",Feb-22,7024,6800,224,3.20000000
CN2905500000000,29,055,"Crawford County, MO",Feb-22,10901,10465,436,4.00000000
CN2905700000000,29,057,"Dade County, MO",Feb-22,3523,3425,98,2.80000000
CN2905900000000,29,059,"Dallas County, MO",Feb-22,7288,7024,264,3.60000000
CN2906100000000,29,061,"Daviess County, MO",Feb-22,4028,3886,142,3.50000000
CN2906300000000,29,063,"DeKalb County, MO",Feb-22,4210,4055,155,3.70000000
CN2906500000000,29,065,"Dent County, MO",Feb-22,6205,5966,239,3.90000000
CN2906700000000,29,067,"Douglas County, MO",Feb-22,5192,5017,175,3.40000000
CN2906900000000,29,069,"Dunklin County, MO",Feb-22,11154,10486,668,6.00000000
CN2907100000000,29,071,"Franklin County, MO",Feb-22,53176,51410,1766,3.30000000
CN2907300000000,29,073,"Gasconade County, MO",Feb-22,7574,7345,229,3.00000000
CN2907500000000,29,075,"Gentry County, MO",Feb-22,3278,3194,84,2.60000000
CN2907700000000,29,077,"Greene County, MO",Feb-22,155703,151697,4006,2.60000000
CN2907900000000,29,079,"Grundy County, MO",Feb-22,4125,3983,142,3.40000000
CN2908100000000,29,081,"Harrison County, MO",Feb-22,3755,3613,142,3.80000000
CN2908300000000,29,083,"Henry County, MO",Feb-22,10134,9796,338,3.30000000
CN2908500000000,29,085,"Hickory County, MO",Feb-22,3883,3733,150,3.90000000
CN2908700000000,29,087,"Holt County, MO",Feb-22,2416,2359,57,2.40000000
CN2908900000000,29,089,"Howard County, MO",Feb-22,4870,4733,137,2.80000000
CN2909100000000,29,091,"Howell County, MO",Feb-22,16216,15613,603,3.70000000
CN2909300000000,29,093,"Iron County, MO",Feb-22,3479,3293,186,5.30000000
CN2909500000000,29,095,"Jackson County, MO",Feb-22,363063,345968,17095,4.70000000
CN2909700000000,29,097,"Jasper County, MO",Feb-22,57673,56022,1651,2.90000000
CN2909900000000,29,099,"Jefferson County, MO",Feb-22,118812,114738,4074,3.40000000
CN2910100000000,29,101,"Johnson County, MO",Feb-22,23082,22294,788,3.40000000
CN2910300000000,29,103,"Knox County, MO",Feb-22,1690,1638,52,3.10000000
CN2910500000000,29,105,"Laclede County, MO",Feb-22,16578,15986,592,3.60000000
CN2910700000000,29,107,"Lafayette County, MO",Feb-22,16828,16122,706,4.20000000
CN2910900000000,29,109,"Lawrence County, MO",Feb-22,17331,16780,551,3.20000000
CN2911100000000,29,111,"Lewis County, MO",Feb-22,4744,4600,144,3.00000000
CN2911300000000,29,113,"Lincoln County, MO",Feb-22,29478,28345,1133,3.80000000
CN2911500000000,29,115,"Linn County, MO",Feb-22,5020,4791,229,4.60000000
CN2911700000000,29,117,"Livingston County, MO",Feb-22,7231,7023,208,2.90000000
CN2911900000000,29,119,"McDonald County, MO",Feb-22,11007,10666,341,3.10000000
CN2912100000000,29,121,"Macon County, MO",Feb-22,7367,7117,250,3.40000000
CN2912300000000,29,123,"Madison County, MO",Feb-22,5470,5269,201,3.70000000
CN2912500000000,29,125,"Maries County, MO",Feb-22,3918,3790,128,3.30000000
CN2912700000000,29,127,"Marion County, MO",Feb-22,13894,13469,425,3.10000000
CN2912900000000,29,129,"Mercer County, MO",Feb-22,1759,1701,58,3.30000000
CN2913100000000,29,131,"Miller County, MO",Feb-22,12497,11993,504,4.00000000
CN2913300000000,29,133,"Mississippi County, MO",Feb-22,5307,5089,218,4.10000000
CN2913500000000,29,135,"Moniteau County, MO",Feb-22,7052,6806,246,3.50000000
CN2913700000000,29,137,"Monroe County, MO",Feb-22,3741,3585,156,4.20000000
CN2913900000000,29,139,"Montgomery County, MO",Feb-22,5785,5589,196,3.40000000
CN2914100000000,29,141,"Morgan County, MO",Feb-22,8533,8167,366,4.30000000
CN2914300000000,29,143,"New Madrid County, MO",Feb-22,8257,7925,332,4.00000000
CN2914500000000,29,145,"Newton County, MO",Feb-22,27313,26507,806,3.00000000
CN2914700000000,29,147,"Nodaway County, MO",Feb-22,10998,10737,261,2.40000000
CN2914900000000,29,149,"Oregon County, MO",Feb-22,3812,3654,158,4.10000000
CN2915100000000,29,151,"Osage County, MO",Feb-22,6982,6824,158,2.30000000
CN2915300000000,29,153,"Ozark County, MO",Feb-22,3374,3166,208,6.20000000
CN2915500000000,29,155,"Pemiscot County, MO",Feb-22,5914,5546,368,6.20000000
CN2915700000000,29,157,"Perry County, MO",Feb-22,9681,9406,275,2.80000000
CN2915900000000,29,159,"Pettis County, MO",Feb-22,20064,19382,682,3.40000000
CN2916100000000,29,161,"Phelps County, MO",Feb-22,20125,19522,603,3.00000000
CN2916300000000,29,163,"Pike County, MO",Feb-22,7383,7121,262,3.50000000
CN2916500000000,29,165,"Platte County, MO",Feb-22,59953,57968,1985,3.30000000
CN2916700000000,29,167,"Polk County, MO",Feb-22,14862,14439,423,2.80000000
CN2916900000000,29,169,"Pulaski County, MO",Feb-22,14789,14249,540,3.70000000
CN2917100000000,29,171,"Putnam County, MO",Feb-22,2163,2103,60,2.80000000
CN2917300000000,29,173,"Ralls County, MO",Feb-22,5486,5306,180,3.30000000
CN2917500000000,29,175,"Randolph County, MO",Feb-22,10470,10102,368,3.50000000
CN2917700000000,29,177,"Ray County, MO",Feb-22,11293,10418,875,7.70000000
CN2917900000000,29,179,"Reynolds County, MO",Feb-22,2868,2767,101,3.50000000
CN2918100000000,29,181,"Ripley County, MO",Feb-22,5060,4831,229,4.50000000
CN2918300000000,29,183,"St. Charles County, MO",Feb-22,229269,222875,6394,2.80000000
CN2918500000000,29,185,"St. Clair County, MO",Feb-22,3835,3671,164,4.30000000
CN2918600000000,29,186,"Ste. Genevieve County, MO",Feb-22,9155,8879,276,3.00000000
CN2918700000000,29,187,"St. Francois County, MO",Feb-22,25900,24843,1057,4.10000000
CN2918900000000,29,189,"St. Louis County, MO",Feb-22,529126,510807,18319,3.50000000
CN2919500000000,29,195,"Saline County, MO",Feb-22,10599,10286,313,3.00000000
CN2919700000000,29,197,"Schuyler County, MO",Feb-22,1832,1747,85,4.60000000
CN2919900000000,29,199,"Scotland County, MO",Feb-22,2244,2184,60,2.70000000
CN2920100000000,29,201,"Scott County, MO",Feb-22,20217,19596,621,3.10000000
CN2920300000000,29,203,"Shannon County, MO",Feb-22,3265,3091,174,5.30000000
CN2920500000000,29,205,"Shelby County, MO",Feb-22,2970,2859,111,3.70000000
CN2920700000000,29,207,"Stoddard County, MO",Feb-22,13296,12789,507,3.80000000
CN2920900000000,29,209,"Stone County, MO",Feb-22,12571,11438,1133,9.00000000
CN2921100000000,29,211,"Sullivan County, MO",Feb-22,2632,2510,122,4.60000000
CN2921300000000,29,213,"Taney County, MO",Feb-22,24492,21718,2774,11.30000000
CN2921500000000,29,215,"Texas County, MO",Feb-22,9021,8640,381,4.20000000
CN2921700000000,29,217,"Vernon County, MO",Feb-22,9458,9197,261,2.80000000
CN2921900000000,29,219,"Warren County, MO",Feb-22,18865,18203,662,3.50000000
CN2922100000000,29,221,"Washington County, MO",Feb-22,10147,9668,479,4.70000000
CN2922300000000,29,223,"Wayne County, MO",Feb-22,4719,4493,226,4.80000000
CN2922500000000,29,225,"Webster County, MO",Feb-22,17733,17245,488,2.80000000
CN2922700000000,29,227,"Worth County, MO",Feb-22,1174,1149,25,2.10000000
CN2922900000000,29,229,"Wright County, MO",Feb-22,7656,7394,262,3.40000000
CN2951000000000,29,510,"St. Louis city, MO",Feb-22,150771,143294,7477,5.00000000
CN3000100000000,30,001,"Beaverhead County, MT",Feb-22,5208,5058,150,2.90000000
CN3000300000000,30,003,"Big Horn County, MT",Feb-22,4540,4261,279,6.10000000
CN3000500000000,30,005,"Blaine County, MT",Feb-22,2268,2190,78,3.40000000
CN3000700000000,30,007,"Broadwater County, MT",Feb-22,2702,2592,110,4.10000000
CN3000900000000,30,009,"Carbon County, MT",Feb-22,5775,5607,168,2.90000000
CN3001100000000,30,011,"Carter County, MT",Feb-22,653,638,15,2.30000000
CN3001300000000,30,013,"Cascade County, MT",Feb-22,38337,37254,1083,2.80000000
CN3001500000000,30,015,"Chouteau County, MT",Feb-22,2473,2416,57,2.30000000
CN3001700000000,30,017,"Custer County, MT",Feb-22,6307,6123,184,2.90000000
CN3001900000000,30,019,"Daniels County, MT",Feb-22,881,865,16,1.80000000
CN3002100000000,30,021,"Dawson County, MT",Feb-22,4544,4437,107,2.40000000
CN3002300000000,30,023,"Deer Lodge County, MT",Feb-22,5106,4954,152,3.00000000
CN3002500000000,30,025,"Fallon County, MT",Feb-22,1620,1589,31,1.90000000
CN3002700000000,30,027,"Fergus County, MT",Feb-22,5877,5668,209,3.60000000
CN3002900000000,30,029,"Flathead County, MT",Feb-22,51683,49722,1961,3.80000000
CN3003100000000,30,031,"Gallatin County, MT",Feb-22,75753,74270,1483,2.00000000
CN3003300000000,30,033,"Garfield County, MT",Feb-22,750,725,25,3.30000000
CN3003500000000,30,035,"Glacier County, MT",Feb-22,5476,5126,350,6.40000000
CN3003700000000,30,037,"Golden Valley County, MT",Feb-22,379,365,14,3.70000000
CN3003900000000,30,039,"Granite County, MT",Feb-22,1716,1632,84,4.90000000
CN3004100000000,30,041,"Hill County, MT",Feb-22,7594,7399,195,2.60000000
CN3004300000000,30,043,"Jefferson County, MT",Feb-22,5985,5813,172,2.90000000
CN3004500000000,30,045,"Judith Basin County, MT",Feb-22,975,949,26,2.70000000
CN3004700000000,30,047,"Lake County, MT",Feb-22,14228,13716,512,3.60000000
CN3004900000000,30,049,"Lewis and Clark County, MT",Feb-22,37757,36757,1000,2.60000000
CN3005100000000,30,051,"Liberty County, MT",Feb-22,993,970,23,2.30000000
CN3005300000000,30,053,"Lincoln County, MT",Feb-22,8091,7575,516,6.40000000
CN3005500000000,30,055,"McCone County, MT",Feb-22,983,964,19,1.90000000
CN3005700000000,30,057,"Madison County, MT",Feb-22,5289,5156,133,2.50000000
CN3005900000000,30,059,"Meagher County, MT",Feb-22,1076,1046,30,2.80000000
CN3006100000000,30,061,"Mineral County, MT",Feb-22,1869,1752,117,6.30000000
CN3006300000000,30,063,"Missoula County, MT",Feb-22,66668,64609,2059,3.10000000
CN3006500000000,30,065,"Musselshell County, MT",Feb-22,2385,2305,80,3.40000000
CN3006700000000,30,067,"Park County, MT",Feb-22,9087,8793,294,3.20000000
CN3006900000000,30,069,"Petroleum County, MT",Feb-22,279,270,9,3.20000000
CN3007100000000,30,071,"Phillips County, MT",Feb-22,1833,1761,72,3.90000000
CN3007300000000,30,073,"Pondera County, MT",Feb-22,2662,2591,71,2.70000000
CN3007500000000,30,075,"Powder River County, MT",Feb-22,987,961,26,2.60000000
CN3007700000000,30,077,"Powell County, MT",Feb-22,2961,2875,86,2.90000000
CN3007900000000,30,079,"Prairie County, MT",Feb-22,511,490,21,4.10000000
CN3008100000000,30,081,"Ravalli County, MT",Feb-22,21553,20783,770,3.60000000
CN3008300000000,30,083,"Richland County, MT",Feb-22,5979,5819,160,2.70000000
CN3008500000000,30,085,"Roosevelt County, MT",Feb-22,4335,4168,167,3.90000000
CN3008700000000,30,087,"Rosebud County, MT",Feb-22,3506,3374,132,3.80000000
CN3008900000000,30,089,"Sanders County, MT",Feb-22,5271,4977,294,5.60000000
CN3009100000000,30,091,"Sheridan County, MT",Feb-22,1788,1742,46,2.60000000
CN3009300000000,30,093,"Silver Bow County, MT",Feb-22,17679,17097,582,3.30000000
CN3009500000000,30,095,"Stillwater County, MT",Feb-22,5599,5454,145,2.60000000
CN3009700000000,30,097,"Sweet Grass County, MT",Feb-22,1937,1896,41,2.10000000
CN3009900000000,30,099,"Teton County, MT",Feb-22,2851,2771,80,2.80000000
CN3010100000000,30,101,"Toole County, MT",Feb-22,2031,1986,45,2.20000000
CN3010300000000,30,103,"Treasure County, MT",Feb-22,347,340,7,2.00000000
CN3010500000000,30,105,"Valley County, MT",Feb-22,4055,3921,134,3.30000000
CN3010700000000,30,107,"Wheatland County, MT",Feb-22,752,719,33,4.40000000
CN3010900000000,30,109,"Wibaux County, MT",Feb-22,407,394,13,3.20000000
CN3011100000000,30,111,"Yellowstone County, MT",Feb-22,86233,83959,2274,2.60000000
CN3100100000000,31,001,"Adams County, NE",Feb-22,16888,16480,408,2.40000000
CN3100300000000,31,003,"Antelope County, NE",Feb-22,3789,3712,77,2.00000000
CN3100500000000,31,005,"Arthur County, NE",Feb-22,245,239,6,2.40000000
CN3100700000000,31,007,"Banner County, NE",Feb-22,409,399,10,2.40000000
CN3100900000000,31,009,"Blaine County, NE",Feb-22,263,254,9,3.40000000
CN3101100000000,31,011,"Boone County, NE",Feb-22,3043,2988,55,1.80000000
CN3101300000000,31,013,"Box Butte County, NE",Feb-22,5454,5337,117,2.10000000
CN3101500000000,31,015,"Boyd County, NE",Feb-22,1082,1059,23,2.10000000
CN3101700000000,31,017,"Brown County, NE",Feb-22,1465,1423,42,2.90000000
CN3101900000000,31,019,"Buffalo County, NE",Feb-22,28349,27851,498,1.80000000
CN3102100000000,31,021,"Burt County, NE",Feb-22,3889,3789,100,2.60000000
CN3102300000000,31,023,"Butler County, NE",Feb-22,4738,4652,86,1.80000000
CN3102500000000,31,025,"Cass County, NE",Feb-22,13684,13338,346,2.50000000
CN3102700000000,31,027,"Cedar County, NE",Feb-22,4700,4622,78,1.70000000
CN3102900000000,31,029,"Chase County, NE",Feb-22,2317,2285,32,1.40000000
CN3103100000000,31,031,"Cherry County, NE",Feb-22,3481,3427,54,1.60000000
CN3103300000000,31,033,"Cheyenne County, NE",Feb-22,4257,4153,104,2.40000000
CN3103500000000,31,035,"Clay County, NE",Feb-22,3296,3213,83,2.50000000
CN3103700000000,31,037,"Colfax County, NE",Feb-22,5826,5695,131,2.20000000
CN3103900000000,31,039,"Cuming County, NE",Feb-22,5015,4928,87,1.70000000
CN3104100000000,31,041,"Custer County, NE",Feb-22,6508,6402,106,1.60000000
CN3104300000000,31,043,"Dakota County, NE",Feb-22,10909,10582,327,3.00000000
CN3104500000000,31,045,"Dawes County, NE",Feb-22,5102,5016,86,1.70000000
CN3104700000000,31,047,"Dawson County, NE",Feb-22,13826,13488,338,2.40000000
CN3104900000000,31,049,"Deuel County, NE",Feb-22,995,971,24,2.40000000
CN3105100000000,31,051,"Dixon County, NE",Feb-22,3061,2994,67,2.20000000
CN3105300000000,31,053,"Dodge County, NE",Feb-22,20440,19974,466,2.30000000
CN3105500000000,31,055,"Douglas County, NE",Feb-22,304746,296448,8298,2.70000000
CN3105700000000,31,057,"Dundy County, NE",Feb-22,1206,1188,18,1.50000000
CN3105900000000,31,059,"Fillmore County, NE",Feb-22,3326,3267,59,1.80000000
CN3106100000000,31,061,"Franklin County, NE",Feb-22,1545,1514,31,2.00000000
CN3106300000000,31,063,"Frontier County, NE",Feb-22,1620,1588,32,2.00000000
CN3106500000000,31,065,"Furnas County, NE",Feb-22,2612,2567,45,1.70000000
CN3106700000000,31,067,"Gage County, NE",Feb-22,11051,10787,264,2.40000000
CN3106900000000,31,069,"Garden County, NE",Feb-22,1159,1136,23,2.00000000
CN3107100000000,31,071,"Garfield County, NE",Feb-22,1162,1139,23,2.00000000
CN3107300000000,31,073,"Gosper County, NE",Feb-22,1198,1176,22,1.80000000
CN3107500000000,31,075,"Grant County, NE",Feb-22,447,441,6,1.30000000
CN3107700000000,31,077,"Greeley County, NE",Feb-22,1271,1247,24,1.90000000
CN3107900000000,31,079,"Hall County, NE",Feb-22,32630,31782,848,2.60000000
CN3108100000000,31,081,"Hamilton County, NE",Feb-22,4937,4837,100,2.00000000
CN3108300000000,31,083,"Harlan County, NE",Feb-22,1797,1761,36,2.00000000
CN3108500000000,31,085,"Hayes County, NE",Feb-22,648,640,8,1.20000000
CN3108700000000,31,087,"Hitchcock County, NE",Feb-22,1340,1308,32,2.40000000
CN3108900000000,31,089,"Holt County, NE",Feb-22,5856,5756,100,1.70000000
CN3109100000000,31,091,"Hooker County, NE",Feb-22,393,383,10,2.50000000
CN3109300000000,31,093,"Howard County, NE",Feb-22,3492,3422,70,2.00000000
CN3109500000000,31,095,"Jefferson County, NE",Feb-22,4304,4230,74,1.70000000
CN3109700000000,31,097,"Johnson County, NE",Feb-22,2038,1971,67,3.30000000
CN3109900000000,31,099,"Kearney County, NE",Feb-22,3880,3820,60,1.50000000
CN3110100000000,31,101,"Keith County, NE",Feb-22,4591,4503,88,1.90000000
CN3110300000000,31,103,"Keya Paha County, NE",Feb-22,636,626,10,1.60000000
CN3110500000000,31,105,"Kimball County, NE",Feb-22,1978,1945,33,1.70000000
CN3110700000000,31,107,"Knox County, NE",Feb-22,4826,4704,122,2.50000000
CN3110900000000,31,109,"Lancaster County, NE",Feb-22,179817,176066,3751,2.10000000
CN3111100000000,31,111,"Lincoln County, NE",Feb-22,18290,17910,380,2.10000000
CN3111300000000,31,113,"Logan County, NE",Feb-22,485,477,8,1.60000000
CN3111500000000,31,115,"Loup County, NE",Feb-22,419,409,10,2.40000000
CN3111700000000,31,117,"McPherson County, NE",Feb-22,437,431,6,1.40000000
CN3111900000000,31,119,"Madison County, NE",Feb-22,20228,19788,440,2.20000000
CN3112100000000,31,121,"Merrick County, NE",Feb-22,4210,4124,86,2.00000000
CN3112300000000,31,123,"Morrill County, NE",Feb-22,2662,2602,60,2.30000000
CN3112500000000,31,125,"Nance County, NE",Feb-22,2013,1973,40,2.00000000
CN3112700000000,31,127,"Nemaha County, NE",Feb-22,3717,3644,73,2.00000000
CN3112900000000,31,129,"Nuckolls County, NE",Feb-22,2582,2528,54,2.10000000
CN3113100000000,31,131,"Otoe County, NE",Feb-22,8617,8420,197,2.30000000
CN3113300000000,31,133,"Pawnee County, NE",Feb-22,1570,1534,36,2.30000000
CN3113500000000,31,135,"Perkins County, NE",Feb-22,1912,1884,28,1.50000000
CN3113700000000,31,137,"Phelps County, NE",Feb-22,5068,4982,86,1.70000000
CN3113900000000,31,139,"Pierce County, NE",Feb-22,4212,4125,87,2.10000000
CN3114100000000,31,141,"Platte County, NE",Feb-22,18757,18261,496,2.60000000
CN3114300000000,31,143,"Polk County, NE",Feb-22,3018,2962,56,1.90000000
CN3114500000000,31,145,"Red Willow County, NE",Feb-22,5906,5798,108,1.80000000
CN3114700000000,31,147,"Richardson County, NE",Feb-22,4329,4247,82,1.90000000
CN3114900000000,31,149,"Rock County, NE",Feb-22,931,916,15,1.60000000
CN3115100000000,31,151,"Saline County, NE",Feb-22,7399,7204,195,2.60000000
CN3115300000000,31,153,"Sarpy County, NE",Feb-22,99157,96933,2224,2.20000000
CN3115500000000,31,155,"Saunders County, NE",Feb-22,11610,11377,233,2.00000000
CN3115700000000,31,157,"Scotts Bluff County, NE",Feb-22,17888,17431,457,2.60000000
CN3115900000000,31,159,"Seward County, NE",Feb-22,8962,8801,161,1.80000000
CN3116100000000,31,161,"Sheridan County, NE",Feb-22,2815,2768,47,1.70000000
CN3116300000000,31,163,"Sherman County, NE",Feb-22,1732,1699,33,1.90000000
CN3116500000000,31,165,"Sioux County, NE",Feb-22,792,779,13,1.60000000
CN3116700000000,31,167,"Stanton County, NE",Feb-22,3670,3597,73,2.00000000
CN3116900000000,31,169,"Thayer County, NE",Feb-22,2750,2700,50,1.80000000
CN3117100000000,31,171,"Thomas County, NE",Feb-22,446,432,14,3.10000000
CN3117300000000,31,173,"Thurston County, NE",Feb-22,3169,3079,90,2.80000000
CN3117500000000,31,175,"Valley County, NE",Feb-22,2141,2100,41,1.90000000
CN3117700000000,31,177,"Washington County, NE",Feb-22,11491,11236,255,2.20000000
CN3117900000000,31,179,"Wayne County, NE",Feb-22,5859,5757,102,1.70000000
CN3118100000000,31,181,"Webster County, NE",Feb-22,1706,1670,36,2.10000000
CN3118300000000,31,183,"Wheeler County, NE",Feb-22,611,602,9,1.50000000
CN3118500000000,31,185,"York County, NE",Feb-22,7338,7205,133,1.80000000
CN3200100000000,32,001,"Churchill County, NV",Feb-22,11248,10972,276,2.50000000
CN3200300000000,32,003,"Clark County, NV",Feb-22,1107254,1048417,58837,5.30000000
CN3200500000000,32,005,"Douglas County, NV",Feb-22,21432,20738,694,3.20000000
CN3200700000000,32,007,"Elko County, NV",Feb-22,25045,24402,643,2.60000000
CN3200900000000,32,009,"Esmeralda County, NV",Feb-22,441,430,11,2.50000000
CN3201100000000,32,011,"Eureka County, NV",Feb-22,1153,1133,20,1.70000000
CN3201300000000,32,013,"Humboldt County, NV",Feb-22,8104,7914,190,2.30000000
CN3201500000000,32,015,"Lander County, NV",Feb-22,3156,3065,91,2.90000000
CN3201700000000,32,017,"Lincoln County, NV",Feb-22,2223,2168,55,2.50000000
CN3201900000000,32,019,"Lyon County, NV",Feb-22,23425,22531,894,3.80000000
CN3202100000000,32,021,"Mineral County, NV",Feb-22,2010,1956,54,2.70000000
CN3202300000000,32,023,"Nye County, NV",Feb-22,17027,16285,742,4.40000000
CN3202700000000,32,027,"Pershing County, NV",Feb-22,2660,2584,76,2.90000000
CN3202900000000,32,029,"Storey County, NV",Feb-22,2030,1964,66,3.30000000
CN3203100000000,32,031,"Washoe County, NV",Feb-22,250307,243300,7007,2.80000000
CN3203300000000,32,033,"White Pine County, NV",Feb-22,4456,4350,106,2.40000000
CN3251000000000,32,510,"Carson City, NV",Feb-22,25307,24507,800,3.20000000
CN3300100000000,33,001,"Belknap County, NH",Feb-22,30456,29710,746,2.40000000
CN3300300000000,33,003,"Carroll County, NH",Feb-22,22438,21874,564,2.50000000
CN3300500000000,33,005,"Cheshire County, NH",Feb-22,39593,38487,1106,2.80000000
CN3300700000000,33,007,"Coos County, NH",Feb-22,14260,13806,454,3.20000000
CN3300900000000,33,009,"Grafton County, NH",Feb-22,49500,48456,1044,2.10000000
CN3301100000000,33,011,"Hillsborough County, NH",Feb-22,241041,234930,6111,2.50000000
CN3301300000000,33,013,"Merrimack County, NH",Feb-22,81618,79865,1753,2.10000000
CN3301500000000,33,015,"Rockingham County, NH",Feb-22,186749,181816,4933,2.60000000
CN3301700000000,33,017,"Strafford County, NH",Feb-22,73264,71716,1548,2.10000000
CN3301900000000,33,019,"Sullivan County, NH",Feb-22,22841,22360,481,2.10000000
CN3400100000000,34,001,"Atlantic County, NJ",Feb-22,124160,115769,8391,6.80000000
CN3400300000000,34,003,"Bergen County, NJ",Feb-22,490083,469956,20127,4.10000000
CN3400500000000,34,005,"Burlington County, NJ",Feb-22,243060,234155,8905,3.70000000
CN3400700000000,34,007,"Camden County, NJ",Feb-22,266926,254243,12683,4.80000000
CN3400900000000,34,009,"Cape May County, NJ",Feb-22,41308,37023,4285,10.40000000
CN3401100000000,34,011,"Cumberland County, NJ",Feb-22,67278,63005,4273,6.40000000
CN3401300000000,34,013,"Essex County, NJ",Feb-22,381380,360009,21371,5.60000000
CN3401500000000,34,015,"Gloucester County, NJ",Feb-22,158734,151990,6744,4.20000000
CN3401700000000,34,017,"Hudson County, NJ",Feb-22,367480,350695,16785,4.60000000
CN3401900000000,34,019,"Hunterdon County, NJ",Feb-22,66126,63987,2139,3.20000000
CN3402100000000,34,021,"Mercer County, NJ",Feb-22,209150,201770,7380,3.50000000
CN3402300000000,34,023,"Middlesex County, NJ",Feb-22,443506,426164,17342,3.90000000
CN3402500000000,34,025,"Monmouth County, NJ",Feb-22,333651,320571,13080,3.90000000
CN3402700000000,34,027,"Morris County, NJ",Feb-22,261867,253022,8845,3.40000000
CN3402900000000,34,029,"Ocean County, NJ",Feb-22,286907,273854,13053,4.50000000
CN3403100000000,34,031,"Passaic County, NJ",Feb-22,247628,232679,14949,6.00000000
CN3403300000000,34,033,"Salem County, NJ",Feb-22,29425,27775,1650,5.60000000
CN3403500000000,34,035,"Somerset County, NJ",Feb-22,174664,168614,6050,3.50000000
CN3403700000000,34,037,"Sussex County, NJ",Feb-22,75907,72454,3453,4.50000000
CN3403900000000,34,039,"Union County, NJ",Feb-22,283734,270234,13500,4.80000000
CN3404100000000,34,041,"Warren County, NJ",Feb-22,57878,55573,2305,4.00000000
CN3500100000000,35,001,"Bernalillo County, NM",Feb-22,338459,323882,14577,4.30000000
CN3500300000000,35,003,"Catron County, NM",Feb-22,1104,1049,55,5.00000000
CN3500500000000,35,005,"Chaves County, NM",Feb-22,27308,25894,1414,5.20000000
CN3500600000000,35,006,"Cibola County, NM",Feb-22,8985,8387,598,6.70000000
CN3500700000000,35,007,"Colfax County, NM",Feb-22,5428,5184,244,4.50000000
CN3500900000000,35,009,"Curry County, NM",Feb-22,21376,20614,762,3.60000000
CN3501100000000,35,011,"De Baca County, NM",Feb-22,671,646,25,3.70000000
CN3501300000000,35,013,"Dona Ana County, NM",Feb-22,99252,94229,5023,5.10000000
CN3501500000000,35,015,"Eddy County, NM",Feb-22,31976,30611,1365,4.30000000
CN3501700000000,35,017,"Grant County, NM",Feb-22,11401,10798,603,5.30000000
CN3501900000000,35,019,"Guadalupe County, NM",Feb-22,1664,1559,105,6.30000000
CN3502100000000,35,021,"Harding County, NM",Feb-22,273,262,11,4.00000000
CN3502300000000,35,023,"Hidalgo County, NM",Feb-22,1846,1774,72,3.90000000
CN3502500000000,35,025,"Lea County, NM",Feb-22,28525,26698,1827,6.40000000
CN3502700000000,35,027,"Lincoln County, NM",Feb-22,8790,8314,476,5.40000000
CN3502800000000,35,028,"Los Alamos County, NM",Feb-22,9929,9705,224,2.30000000
CN3502900000000,35,029,"Luna County, NM",Feb-22,9541,8156,1385,14.50000000
CN3503100000000,35,031,"McKinley County, NM",Feb-22,23501,21809,1692,7.20000000
CN3503300000000,35,033,"Mora County, NM",Feb-22,1912,1810,102,5.30000000
CN3503500000000,35,035,"Otero County, NM",Feb-22,24806,23653,1153,4.60000000
CN3503700000000,35,037,"Quay County, NM",Feb-22,2940,2775,165,5.60000000
CN3503900000000,35,039,"Rio Arriba County, NM",Feb-22,16584,15692,892,5.40000000
CN3504100000000,35,041,"Roosevelt County, NM",Feb-22,7752,7455,297,3.80000000
CN3504300000000,35,043,"Sandoval County, NM",Feb-22,68432,65289,3143,4.60000000
CN3504500000000,35,045,"San Juan County, NM",Feb-22,49722,46826,2896,5.80000000
CN3504700000000,35,047,"San Miguel County, NM",Feb-22,10325,9756,569,5.50000000
CN3504900000000,35,049,"Santa Fe County, NM",Feb-22,74167,70987,3180,4.30000000
CN3505100000000,35,051,"Sierra County, NM",Feb-22,4044,3747,297,7.30000000
CN3505300000000,35,053,"Socorro County, NM",Feb-22,6143,5854,289,4.70000000
CN3505500000000,35,055,"Taos County, NM",Feb-22,14504,13540,964,6.60000000
CN3505700000000,35,057,"Torrance County, NM",Feb-22,5383,5039,344,6.40000000
CN3505900000000,35,059,"Union County, NM",Feb-22,1545,1496,49,3.20000000
CN3506100000000,35,061,"Valencia County, NM",Feb-22,31184,29643,1541,4.90000000
CN3600100000000,36,001,"Albany County, NY",Feb-22,156279,150803,5476,3.50000000
CN3600300000000,36,003,"Allegany County, NY",Feb-22,19836,18898,938,4.70000000
CN3600500000000,36,005,"Bronx County, NY",Feb-22,593000,538013,54987,9.30000000
CN3600700000000,36,007,"Broome County, NY",Feb-22,81887,78131,3756,4.60000000
CN3600900000000,36,009,"Cattaraugus County, NY",Feb-22,33619,31980,1639,4.90000000
CN3601100000000,36,011,"Cayuga County, NY",Feb-22,34774,33284,1490,4.30000000
CN3601300000000,36,013,"Chautauqua County, NY",Feb-22,52195,49640,2555,4.90000000
CN3601500000000,36,015,"Chemung County, NY",Feb-22,34437,32913,1524,4.40000000
CN3601700000000,36,017,"Chenango County, NY",Feb-22,21866,20959,907,4.10000000
CN3601900000000,36,019,"Clinton County, NY",Feb-22,34958,33596,1362,3.90000000
CN3602100000000,36,021,"Columbia County, NY",Feb-22,29522,28531,991,3.40000000
CN3602300000000,36,023,"Cortland County, NY",Feb-22,22898,21826,1072,4.70000000
CN3602500000000,36,025,"Delaware County, NY",Feb-22,18592,17786,806,4.30000000
CN3602700000000,36,027,"Dutchess County, NY",Feb-22,141949,136792,5157,3.60000000
CN3602900000000,36,029,"Erie County, NY",Feb-22,436389,416569,19820,4.50000000
CN3603100000000,36,031,"Essex County, NY",Feb-22,16833,16037,796,4.70000000
CN3603300000000,36,033,"Franklin County, NY",Feb-22,19117,18300,817,4.30000000
CN3603500000000,36,035,"Fulton County, NY",Feb-22,22262,21106,1156,5.20000000
CN3603700000000,36,037,"Genesee County, NY",Feb-22,29209,28033,1176,4.00000000
CN3603900000000,36,039,"Greene County, NY",Feb-22,20624,19734,890,4.30000000
CN3604100000000,36,041,"Hamilton County, NY",Feb-22,2118,2004,114,5.40000000
CN3604300000000,36,043,"Herkimer County, NY",Feb-22,27584,26120,1464,5.30000000
CN3604500000000,36,045,"Jefferson County, NY",Feb-22,43425,41216,2209,5.10000000
CN3604700000000,36,047,"Kings County, NY",Feb-22,1179188,1099860,79328,6.70000000
CN3604900000000,36,049,"Lewis County, NY",Feb-22,11686,11046,640,5.50000000
CN3605100000000,36,051,"Livingston County, NY",Feb-22,30169,28977,1192,4.00000000
CN3605300000000,36,053,"Madison County, NY",Feb-22,32332,30973,1359,4.20000000
CN3605500000000,36,055,"Monroe County, NY",Feb-22,361984,347031,14953,4.10000000
CN3605700000000,36,057,"Montgomery County, NY",Feb-22,21776,20632,1144,5.30000000
CN3605900000000,36,059,"Nassau County, NY",Feb-22,707107,682628,24479,3.50000000
CN3606100000000,36,061,"New York County, NY",Feb-22,892805,847713,45092,5.10000000
CN3606300000000,36,063,"Niagara County, NY",Feb-22,96670,91812,4858,5.00000000
CN3606500000000,36,065,"Oneida County, NY",Feb-22,100064,95842,4222,4.20000000
CN3606700000000,36,067,"Onondaga County, NY",Feb-22,219232,210529,8703,4.00000000
CN3606900000000,36,069,"Ontario County, NY",Feb-22,55521,53430,2091,3.80000000
CN3607100000000,36,071,"Orange County, NY",Feb-22,183474,176422,7052,3.80000000
CN3607300000000,36,073,"Orleans County, NY",Feb-22,17157,16361,796,4.60000000
CN3607500000000,36,075,"Oswego County, NY",Feb-22,51989,49336,2653,5.10000000
CN3607700000000,36,077,"Otsego County, NY",Feb-22,26905,25754,1151,4.30000000
CN3607900000000,36,079,"Putnam County, NY",Feb-22,50307,48571,1736,3.50000000
CN3608100000000,36,081,"Queens County, NY",Feb-22,1115252,1045341,69911,6.30000000
CN3608300000000,36,083,"Rensselaer County, NY",Feb-22,80796,77799,2997,3.70000000
CN3608500000000,36,085,"Richmond County, NY",Feb-22,220484,207289,13195,6.00000000
CN3608700000000,36,087,"Rockland County, NY",Feb-22,153271,148046,5225,3.40000000
CN3608900000000,36,089,"St. Lawrence County, NY",Feb-22,43390,41370,2020,4.70000000
CN3609100000000,36,091,"Saratoga County, NY",Feb-22,119413,115626,3787,3.20000000
CN3609300000000,36,093,"Schenectady County, NY",Feb-22,76584,73520,3064,4.00000000
CN3609500000000,36,095,"Schoharie County, NY",Feb-22,14635,13964,671,4.60000000
CN3609700000000,36,097,"Schuyler County, NY",Feb-22,7934,7524,410,5.20000000
CN3609900000000,36,099,"Seneca County, NY",Feb-22,14943,14332,611,4.10000000
CN3610100000000,36,101,"Steuben County, NY",Feb-22,41270,39360,1910,4.60000000
CN3610300000000,36,103,"Suffolk County, NY",Feb-22,777433,747653,29780,3.80000000
CN3610500000000,36,105,"Sullivan County, NY",Feb-22,35743,34224,1519,4.20000000
CN3610700000000,36,107,"Tioga County, NY",Feb-22,22191,21276,915,4.10000000
CN3610900000000,36,109,"Tompkins County, NY",Feb-22,49123,47672,1451,3.00000000
CN3611100000000,36,111,"Ulster County, NY",Feb-22,86774,83419,3355,3.90000000
CN3611300000000,36,113,"Warren County, NY",Feb-22,30757,29378,1379,4.50000000
CN3611500000000,36,115,"Washington County, NY",Feb-22,27216,26040,1176,4.30000000
CN3611700000000,36,117,"Wayne County, NY",Feb-22,43287,41590,1697,3.90000000
CN3611900000000,36,119,"Westchester County, NY",Feb-22,478239,459982,18257,3.80000000
CN3612100000000,36,121,"Wyoming County, NY",Feb-22,17943,17098,845,4.70000000
CN3612300000000,36,123,"Yates County, NY",Feb-22,11669,11259,410,3.50000000
CN3700100000000,37,001,"Alamance County, NC",Feb-22,82299,79360,2939,3.60000000
CN3700300000000,37,003,"Alexander County, NC",Feb-22,17628,17081,547,3.10000000
CN3700500000000,37,005,"Alleghany County, NC",Feb-22,4108,3951,157,3.80000000
CN3700700000000,37,007,"Anson County, NC",Feb-22,10126,9616,510,5.00000000
CN3700900000000,37,009,"Ashe County, NC",Feb-22,12516,12112,404,3.20000000
CN3701100000000,37,011,"Avery County, NC",Feb-22,7165,6930,235,3.30000000
CN3701300000000,37,013,"Beaufort County, NC",Feb-22,19539,18819,720,3.70000000
CN3701500000000,37,015,"Bertie County, NC",Feb-22,7068,6710,358,5.10000000
CN3701700000000,37,017,"Bladen County, NC",Feb-22,13871,13192,679,4.90000000
CN3701900000000,37,019,"Brunswick County, NC",Feb-22,54135,51386,2749,5.10000000
CN3702100000000,37,021,"Buncombe County, NC",Feb-22,138750,134570,4180,3.00000000
CN3702300000000,37,023,"Burke County, NC",Feb-22,40103,38763,1340,3.30000000
CN3702500000000,37,025,"Cabarrus County, NC",Feb-22,111858,108110,3748,3.40000000
CN3702700000000,37,027,"Caldwell County, NC",Feb-22,35779,34506,1273,3.60000000
CN3702900000000,37,029,"Camden County, NC",Feb-22,4483,4341,142,3.20000000
CN3703100000000,37,031,"Carteret County, NC",Feb-22,30988,29926,1062,3.40000000
CN3703300000000,37,033,"Caswell County, NC",Feb-22,9583,9200,383,4.00000000
CN3703500000000,37,035,"Catawba County, NC",Feb-22,78169,75533,2636,3.40000000
CN3703700000000,37,037,"Chatham County, NC",Feb-22,37141,36112,1029,2.80000000
CN3703900000000,37,039,"Cherokee County, NC",Feb-22,10568,10153,415,3.90000000
CN3704100000000,37,041,"Chowan County, NC",Feb-22,5567,5360,207,3.70000000
CN3704300000000,37,043,"Clay County, NC",Feb-22,4000,3849,151,3.80000000
CN3704500000000,37,045,"Cleveland County, NC",Feb-22,48439,46515,1924,4.00000000
CN3704700000000,37,047,"Columbus County, NC",Feb-22,22615,21457,1158,5.10000000
CN3704900000000,37,049,"Craven County, NC",Feb-22,40876,39446,1430,3.50000000
CN3705100000000,37,051,"Cumberland County, NC",Feb-22,127588,120587,7001,5.50000000
CN3705300000000,37,053,"Currituck County, NC",Feb-22,14295,13780,515,3.60000000
CN3705500000000,37,055,"Dare County, NC",Feb-22,17702,16462,1240,7.00000000
CN3705700000000,37,057,"Davidson County, NC",Feb-22,79947,77256,2691,3.40000000
CN3705900000000,37,059,"Davie County, NC",Feb-22,20347,19683,664,3.30000000
CN3706100000000,37,061,"Duplin County, NC",Feb-22,24021,23206,815,3.40000000
CN3706300000000,37,063,"Durham County, NC",Feb-22,178822,173430,5392,3.00000000
CN3706500000000,37,065,"Edgecombe County, NC",Feb-22,20024,18420,1604,8.00000000
CN3706700000000,37,067,"Forsyth County, NC",Feb-22,185559,178755,6804,3.70000000
CN3706900000000,37,069,"Franklin County, NC",Feb-22,32857,31646,1211,3.70000000
CN3707100000000,37,071,"Gaston County, NC",Feb-22,110951,106581,4370,3.90000000
CN3707300000000,37,073,"Gates County, NC",Feb-22,4933,4776,157,3.20000000
CN3707500000000,37,075,"Graham County, NC",Feb-22,2858,2661,197,6.90000000
CN3707700000000,37,077,"Granville County, NC",Feb-22,30127,29240,887,2.90000000
CN3707900000000,37,079,"Greene County, NC",Feb-22,9317,9012,305,3.30000000
CN3708100000000,37,081,"Guilford County, NC",Feb-22,259131,248088,11043,4.30000000
CN3708300000000,37,083,"Halifax County, NC",Feb-22,19093,17916,1177,6.20000000
CN3708500000000,37,085,"Harnett County, NC",Feb-22,53889,51698,2191,4.10000000
CN3708700000000,37,087,"Haywood County, NC",Feb-22,29476,28530,946,3.20000000
CN3708900000000,37,089,"Henderson County, NC",Feb-22,54027,52389,1638,3.00000000
CN3709100000000,37,091,"Hertford County, NC",Feb-22,8456,8014,442,5.20000000
CN3709300000000,37,093,"Hoke County, NC",Feb-22,20147,19134,1013,5.00000000
CN3709500000000,37,095,"Hyde County, NC",Feb-22,1612,1469,143,8.90000000
CN3709700000000,37,097,"Iredell County, NC",Feb-22,91188,88102,3086,3.40000000
CN3709900000000,37,099,"Jackson County, NC",Feb-22,19210,18518,692,3.60000000
CN3710100000000,37,101,"Johnston County, NC",Feb-22,104050,100732,3318,3.20000000
CN3710300000000,37,103,"Jones County, NC",Feb-22,4113,3981,132,3.20000000
CN3710500000000,37,105,"Lee County, NC",Feb-22,25720,24613,1107,4.30000000
CN3710700000000,37,107,"Lenoir County, NC",Feb-22,26920,25882,1038,3.90000000
CN3710900000000,37,109,"Lincoln County, NC",Feb-22,44660,43294,1366,3.10000000
CN3711100000000,37,111,"McDowell County, NC",Feb-22,19873,19221,652,3.30000000
CN3711300000000,37,113,"Macon County, NC",Feb-22,15004,14460,544,3.60000000
CN3711500000000,37,115,"Madison County, NC",Feb-22,9803,9490,313,3.20000000
CN3711700000000,37,117,"Martin County, NC",Feb-22,8572,8199,373,4.40000000
CN3711900000000,37,119,"Mecklenburg County, NC",Feb-22,630926,607527,23399,3.70000000
CN3712100000000,37,121,"Mitchell County, NC",Feb-22,5945,5692,253,4.30000000
CN3712300000000,37,123,"Montgomery County, NC",Feb-22,10918,10531,387,3.50000000
CN3712500000000,37,125,"Moore County, NC",Feb-22,40434,38995,1439,3.60000000
CN3712700000000,37,127,"Nash County, NC",Feb-22,41428,39225,2203,5.30000000
CN3712900000000,37,129,"New Hanover County, NC",Feb-22,125387,121330,4057,3.20000000
CN3713100000000,37,131,"Northampton County, NC",Feb-22,7114,6765,349,4.90000000
CN3713300000000,37,133,"Onslow County, NC",Feb-22,66111,63493,2618,4.00000000
CN3713500000000,37,135,"Orange County, NC",Feb-22,81103,79048,2055,2.50000000
CN3713700000000,37,137,"Pamlico County, NC",Feb-22,5321,5129,192,3.60000000
CN3713900000000,37,139,"Pasquotank County, NC",Feb-22,16205,15500,705,4.40000000
CN3714100000000,37,141,"Pender County, NC",Feb-22,29566,28596,970,3.30000000
CN3714300000000,37,143,"Perquimans County, NC",Feb-22,4776,4553,223,4.70000000
CN3714500000000,37,145,"Person County, NC",Feb-22,18755,18054,701,3.70000000
CN3714700000000,37,147,"Pitt County, NC",Feb-22,89023,85593,3430,3.90000000
CN3714900000000,37,149,"Polk County, NC",Feb-22,9061,8717,344,3.80000000
CN3715100000000,37,151,"Randolph County, NC",Feb-22,64624,62400,2224,3.40000000
CN3715300000000,37,153,"Richmond County, NC",Feb-22,16323,15325,998,6.10000000
CN3715500000000,37,155,"Robeson County, NC",Feb-22,48237,45228,3009,6.20000000
CN3715700000000,37,157,"Rockingham County, NC",Feb-22,39151,37525,1626,4.20000000
CN3715900000000,37,159,"Rowan County, NC",Feb-22,65312,62902,2410,3.70000000
CN3716100000000,37,161,"Rutherford County, NC",Feb-22,24165,22922,1243,5.10000000
CN3716300000000,37,163,"Sampson County, NC",Feb-22,27295,26309,986,3.60000000
CN3716500000000,37,165,"Scotland County, NC",Feb-22,11147,10276,871,7.80000000
CN3716700000000,37,167,"Stanly County, NC",Feb-22,29851,28886,965,3.20000000
CN3716900000000,37,169,"Stokes County, NC",Feb-22,21226,20561,665,3.10000000
CN3717100000000,37,171,"Surry County, NC",Feb-22,32021,30971,1050,3.30000000
CN3717300000000,37,173,"Swain County, NC",Feb-22,6740,6483,257,3.80000000
CN3717500000000,37,175,"Transylvania County, NC",Feb-22,14040,13577,463,3.30000000
CN3717700000000,37,177,"Tyrrell County, NC",Feb-22,1128,1048,80,7.10000000
CN3717900000000,37,179,"Union County, NC",Feb-22,125324,121577,3747,3.00000000
CN3718100000000,37,181,"Vance County, NC",Feb-22,16839,15740,1099,6.50000000
CN3718300000000,37,183,"Wake County, NC",Feb-22,609991,591893,18098,3.00000000
CN3718500000000,37,185,"Warren County, NC",Feb-22,6378,5945,433,6.80000000
CN3718700000000,37,187,"Washington County, NC",Feb-22,4157,3913,244,5.90000000
CN3718900000000,37,189,"Watauga County, NC",Feb-22,29255,28464,791,2.70000000
CN3719100000000,37,191,"Wayne County, NC",Feb-22,50693,48706,1987,3.90000000
CN3719300000000,37,193,"Wilkes County, NC",Feb-22,27023,26032,991,3.70000000
CN3719500000000,37,195,"Wilson County, NC",Feb-22,32916,31115,1801,5.50000000
CN3719700000000,37,197,"Yadkin County, NC",Feb-22,17221,16664,557,3.20000000
CN3719900000000,37,199,"Yancey County, NC",Feb-22,8037,7759,278,3.50000000
CN3800100000000,38,001,"Adams County, ND",Feb-22,940,914,26,2.80000000
CN3800300000000,38,003,"Barnes County, ND",Feb-22,5299,5140,159,3.00000000
CN3800500000000,38,005,"Benson County, ND",Feb-22,2274,2176,98,4.30000000
CN3800700000000,38,007,"Billings County, ND",Feb-22,374,364,10,2.70000000
CN3800900000000,38,009,"Bottineau County, ND",Feb-22,2916,2768,148,5.10000000
CN3801100000000,38,011,"Bowman County, ND",Feb-22,1560,1530,30,1.90000000
CN3801300000000,38,013,"Burke County, ND",Feb-22,1027,992,35,3.40000000
CN3801500000000,38,015,"Burleigh County, ND",Feb-22,52286,50832,1454,2.80000000
CN3801700000000,38,017,"Cass County, ND",Feb-22,108825,106125,2700,2.50000000
CN3801900000000,38,019,"Cavalier County, ND",Feb-22,1843,1777,66,3.60000000
CN3802100000000,38,021,"Dickey County, ND",Feb-22,2242,2189,53,2.40000000
CN3802300000000,38,023,"Divide County, ND",Feb-22,1369,1342,27,2.00000000
CN3802500000000,38,025,"Dunn County, ND",Feb-22,3170,3103,67,2.10000000
CN3802700000000,38,027,"Eddy County, ND",Feb-22,1180,1125,55,4.70000000
CN3802900000000,38,029,"Emmons County, ND",Feb-22,1474,1386,88,6.00000000
CN3803100000000,38,031,"Foster County, ND",Feb-22,1484,1441,43,2.90000000
CN3803300000000,38,033,"Golden Valley County, ND",Feb-22,831,815,16,1.90000000
CN3803500000000,38,035,"Grand Forks County, ND",Feb-22,38073,37116,957,2.50000000
CN3803700000000,38,037,"Grant County, ND",Feb-22,1233,1201,32,2.60000000
CN3803900000000,38,039,"Griggs County, ND",Feb-22,1027,998,29,2.80000000
CN3804100000000,38,041,"Hettinger County, ND",Feb-22,1357,1323,34,2.50000000
CN3804300000000,38,043,"Kidder County, ND",Feb-22,1324,1243,81,6.10000000
CN3804500000000,38,045,"LaMoure County, ND",Feb-22,2013,1957,56,2.80000000
CN3804700000000,38,047,"Logan County, ND",Feb-22,857,832,25,2.90000000
CN3804900000000,38,049,"McHenry County, ND",Feb-22,3159,2991,168,5.30000000
CN3805100000000,38,051,"McIntosh County, ND",Feb-22,1066,1036,30,2.80000000
CN3805300000000,38,053,"McKenzie County, ND",Feb-22,8616,8320,296,3.40000000
CN3805500000000,38,055,"McLean County, ND",Feb-22,4592,4376,216,4.70000000
CN3805700000000,38,057,"Mercer County, ND",Feb-22,3445,3277,168,4.90000000
CN3805900000000,38,059,"Morton County, ND",Feb-22,17300,16668,632,3.70000000
CN3806100000000,38,061,"Mountrail County, ND",Feb-22,6337,6187,150,2.40000000
CN3806300000000,38,063,"Nelson County, ND",Feb-22,1394,1333,61,4.40000000
CN3806500000000,38,065,"Oliver County, ND",Feb-22,878,843,35,4.00000000
CN3806700000000,38,067,"Pembina County, ND",Feb-22,3229,3076,153,4.70000000
CN3806900000000,38,069,"Pierce County, ND",Feb-22,1657,1595,62,3.70000000
CN3807100000000,38,071,"Ramsey County, ND",Feb-22,5644,5462,182,3.20000000
CN3807300000000,38,073,"Ransom County, ND",Feb-22,2660,2595,65,2.40000000
CN3807500000000,38,075,"Renville County, ND",Feb-22,1180,1148,32,2.70000000
CN3807700000000,38,077,"Richland County, ND",Feb-22,8637,8406,231,2.70000000
CN3807900000000,38,079,"Rolette County, ND",Feb-22,4866,4447,419,8.60000000
CN3808100000000,38,081,"Sargent County, ND",Feb-22,2311,2250,61,2.60000000
CN3808300000000,38,083,"Sheridan County, ND",Feb-22,643,606,37,5.80000000
CN3808500000000,38,085,"Sioux County, ND",Feb-22,1206,1174,32,2.70000000
CN3808700000000,38,087,"Slope County, ND",Feb-22,348,339,9,2.60000000
CN3808900000000,38,089,"Stark County, ND",Feb-22,17528,16995,533,3.00000000
CN3809100000000,38,091,"Steele County, ND",Feb-22,902,872,30,3.30000000
CN3809300000000,38,093,"Stutsman County, ND",Feb-22,10314,10008,306,3.00000000
CN3809500000000,38,095,"Towner County, ND",Feb-22,1089,1057,32,2.90000000
CN3809700000000,38,097,"Traill County, ND",Feb-22,4438,4318,120,2.70000000
CN3809900000000,38,099,"Walsh County, ND",Feb-22,5192,4958,234,4.50000000
CN3810100000000,38,101,"Ward County, ND",Feb-22,31471,30390,1081,3.40000000
CN3810300000000,38,103,"Wells County, ND",Feb-22,1853,1763,90,4.90000000
CN3810500000000,38,105,"Williams County, ND",Feb-22,20369,19460,909,4.50000000
CN3900100000000,39,001,"Adams County, OH",Feb-22,11113,10341,772,6.90000000
CN3900300000000,39,003,"Allen County, OH",Feb-22,47627,44747,2880,6.00000000
CN3900500000000,39,005,"Ashland County, OH",Feb-22,26330,25172,1158,4.40000000
CN3900700000000,39,007,"Ashtabula County, OH",Feb-22,43218,40836,2382,5.50000000
CN3900900000000,39,009,"Athens County, OH",Feb-22,26499,25134,1365,5.20000000
CN3901100000000,39,011,"Auglaize County, OH",Feb-22,24325,23450,875,3.60000000
CN3901300000000,39,013,"Belmont County, OH",Feb-22,28255,26502,1753,6.20000000
CN3901500000000,39,015,"Brown County, OH",Feb-22,19548,18461,1087,5.60000000
CN3901700000000,39,017,"Butler County, OH",Feb-22,195822,188252,7570,3.90000000
CN3901900000000,39,019,"Carroll County, OH",Feb-22,12813,12132,681,5.30000000
CN3902100000000,39,021,"Champaign County, OH",Feb-22,19478,18712,766,3.90000000
CN3902300000000,39,023,"Clark County, OH",Feb-22,62771,60038,2733,4.40000000
CN3902500000000,39,025,"Clermont County, OH",Feb-22,107594,103300,4294,4.00000000
CN3902700000000,39,027,"Clinton County, OH",Feb-22,18225,17318,907,5.00000000
CN3902900000000,39,029,"Columbiana County, OH",Feb-22,45269,42867,2402,5.30000000
CN3903100000000,39,031,"Coshocton County, OH",Feb-22,13556,12773,783,5.80000000
CN3903300000000,39,033,"Crawford County, OH",Feb-22,17754,16790,964,5.40000000
CN3903500000000,39,035,"Cuyahoga County, OH",Feb-22,589831,550919,38912,6.60000000
CN3903700000000,39,037,"Darke County, OH",Feb-22,25790,24734,1056,4.10000000
CN3903900000000,39,039,"Defiance County, OH",Feb-22,17421,16712,709,4.10000000
CN3904100000000,39,041,"Delaware County, OH",Feb-22,115977,112451,3526,3.00000000
CN3904300000000,39,043,"Erie County, OH",Feb-22,36244,33716,2528,7.00000000
CN3904500000000,39,045,"Fairfield County, OH",Feb-22,80695,77682,3013,3.70000000
CN3904700000000,39,047,"Fayette County, OH",Feb-22,13716,13116,600,4.40000000
CN3904900000000,39,049,"Franklin County, OH",Feb-22,712857,686454,26403,3.70000000
CN3905100000000,39,051,"Fulton County, OH",Feb-22,22177,21092,1085,4.90000000
CN3905300000000,39,053,"Gallia County, OH",Feb-22,12254,11572,682,5.60000000
CN3905500000000,39,055,"Geauga County, OH",Feb-22,47361,44813,2548,5.40000000
CN3905700000000,39,057,"Greene County, OH",Feb-22,83968,80860,3108,3.70000000
CN3905900000000,39,059,"Guernsey County, OH",Feb-22,17733,16659,1074,6.10000000
CN3906100000000,39,061,"Hamilton County, OH",Feb-22,415111,398851,16260,3.90000000
CN3906300000000,39,063,"Hancock County, OH",Feb-22,40965,39324,1641,4.00000000
CN3906500000000,39,065,"Hardin County, OH",Feb-22,13702,13048,654,4.80000000
CN3906700000000,39,067,"Harrison County, OH",Feb-22,6437,6031,406,6.30000000
CN3906900000000,39,069,"Henry County, OH",Feb-22,12644,11917,727,5.70000000
CN3907100000000,39,071,"Highland County, OH",Feb-22,17568,16591,977,5.60000000
CN3907300000000,39,073,"Hocking County, OH",Feb-22,13110,12471,639,4.90000000
CN3907500000000,39,075,"Holmes County, OH",Feb-22,21248,20644,604,2.80000000
CN3907700000000,39,077,"Huron County, OH",Feb-22,27643,25631,2012,7.30000000
CN3907900000000,39,079,"Jackson County, OH",Feb-22,12546,11793,753,6.00000000
CN3908100000000,39,081,"Jefferson County, OH",Feb-22,27499,25827,1672,6.10000000
CN3908300000000,39,083,"Knox County, OH",Feb-22,31068,29876,1192,3.80000000
CN3908500000000,39,085,"Lake County, OH",Feb-22,122360,115175,7185,5.90000000
CN3908700000000,39,087,"Lawrence County, OH",Feb-22,23653,22531,1122,4.70000000
CN3908900000000,39,089,"Licking County, OH",Feb-22,92534,89110,3424,3.70000000
CN3909100000000,39,091,"Logan County, OH",Feb-22,22546,21658,888,3.90000000
CN3909300000000,39,093,"Lorain County, OH",Feb-22,151686,141062,10624,7.00000000
CN3909500000000,39,095,"Lucas County, OH",Feb-22,207775,197372,10403,5.00000000
CN3909700000000,39,097,"Madison County, OH",Feb-22,21072,20322,750,3.60000000
CN3909900000000,39,099,"Mahoning County, OH",Feb-22,98999,93165,5834,5.90000000
CN3910100000000,39,101,"Marion County, OH",Feb-22,27968,26782,1186,4.20000000
CN3910300000000,39,103,"Medina County, OH",Feb-22,95569,90467,5102,5.30000000
CN3910500000000,39,105,"Meigs County, OH",Feb-22,8830,8186,644,7.30000000
CN3910700000000,39,107,"Mercer County, OH",Feb-22,22498,21816,682,3.00000000
CN3910900000000,39,109,"Miami County, OH",Feb-22,54736,52554,2182,4.00000000
CN3911100000000,39,111,"Monroe County, OH",Feb-22,5255,4821,434,8.30000000
CN3911300000000,39,113,"Montgomery County, OH",Feb-22,251991,240752,11239,4.50000000
CN3911500000000,39,115,"Morgan County, OH",Feb-22,6846,6319,527,7.70000000
CN3911700000000,39,117,"Morrow County, OH",Feb-22,17168,16409,759,4.40000000
CN3911900000000,39,119,"Muskingum County, OH",Feb-22,40510,38295,2215,5.50000000
CN3912100000000,39,121,"Noble County, OH",Feb-22,4579,4233,346,7.60000000
CN3912300000000,39,123,"Ottawa County, OH",Feb-22,19850,18388,1462,7.40000000
CN3912500000000,39,125,"Paulding County, OH",Feb-22,8548,8193,355,4.20000000
CN3912700000000,39,127,"Perry County, OH",Feb-22,16195,15292,903,5.60000000
CN3912900000000,39,129,"Pickaway County, OH",Feb-22,27019,25877,1142,4.20000000
CN3913100000000,39,131,"Pike County, OH",Feb-22,10881,10188,693,6.40000000
CN3913300000000,39,133,"Portage County, OH",Feb-22,85136,81312,3824,4.50000000
CN3913500000000,39,135,"Preble County, OH",Feb-22,21918,21075,843,3.80000000
CN3913700000000,39,137,"Putnam County, OH",Feb-22,18825,18102,723,3.80000000
CN3913900000000,39,139,"Richland County, OH",Feb-22,51929,49245,2684,5.20000000
CN3914100000000,39,141,"Ross County, OH",Feb-22,35116,33483,1633,4.70000000
CN3914300000000,39,143,"Sandusky County, OH",Feb-22,30388,28895,1493,4.90000000
CN3914500000000,39,145,"Scioto County, OH",Feb-22,29503,27764,1739,5.90000000
CN3914700000000,39,147,"Seneca County, OH",Feb-22,26658,25376,1282,4.80000000
CN3914900000000,39,149,"Shelby County, OH",Feb-22,23742,22794,948,4.00000000
CN3915100000000,39,151,"Stark County, OH",Feb-22,183558,174900,8658,4.70000000
CN3915300000000,39,153,"Summit County, OH",Feb-22,265173,252482,12691,4.80000000
CN3915500000000,39,155,"Trumbull County, OH",Feb-22,83742,78611,5131,6.10000000
CN3915700000000,39,157,"Tuscarawas County, OH",Feb-22,44042,42013,2029,4.60000000
CN3915900000000,39,159,"Union County, OH",Feb-22,30347,29361,986,3.20000000
CN3916100000000,39,161,"Van Wert County, OH",Feb-22,14650,14070,580,4.00000000
CN3916300000000,39,163,"Vinton County, OH",Feb-22,5495,5158,337,6.10000000
CN3916500000000,39,165,"Warren County, OH",Feb-22,121771,117453,4318,3.50000000
CN3916700000000,39,167,"Washington County, OH",Feb-22,26771,25273,1498,5.60000000
CN3916900000000,39,169,"Wayne County, OH",Feb-22,59945,57834,2111,3.50000000
CN3917100000000,39,171,"Williams County, OH",Feb-22,18406,17702,704,3.80000000
CN3917300000000,39,173,"Wood County, OH",Feb-22,70667,67980,2687,3.80000000
CN3917500000000,39,175,"Wyandot County, OH",Feb-22,12853,12378,475,3.70000000
CN4000100000000,40,001,"Adair County, OK",Feb-22,8601,8303,298,3.50000000
CN4000300000000,40,003,"Alfalfa County, OK",Feb-22,2698,2641,57,2.10000000
CN4000500000000,40,005,"Atoka County, OK",Feb-22,5037,4840,197,3.90000000
CN4000700000000,40,007,"Beaver County, OK",Feb-22,2648,2602,46,1.70000000
CN4000900000000,40,009,"Beckham County, OK",Feb-22,9399,9093,306,3.30000000
CN4001100000000,40,011,"Blaine County, OK",Feb-22,4354,4251,103,2.40000000
CN4001300000000,40,013,"Bryan County, OK",Feb-22,21912,21290,622,2.80000000
CN4001500000000,40,015,"Caddo County, OK",Feb-22,12246,11859,387,3.20000000
CN4001700000000,40,017,"Canadian County, OK",Feb-22,79455,77364,2091,2.60000000
CN4001900000000,40,019,"Carter County, OK",Feb-22,21118,20335,783,3.70000000
CN4002100000000,40,021,"Cherokee County, OK",Feb-22,19986,19261,725,3.60000000
CN4002300000000,40,023,"Choctaw County, OK",Feb-22,6056,5785,271,4.50000000
CN4002500000000,40,025,"Cimarron County, OK",Feb-22,1547,1527,20,1.30000000
CN4002700000000,40,027,"Cleveland County, OK",Feb-22,146355,142523,3832,2.60000000
CN4002900000000,40,029,"Coal County, OK",Feb-22,2329,2252,77,3.30000000
CN4003100000000,40,031,"Comanche County, OK",Feb-22,47122,45425,1697,3.60000000
CN4003300000000,40,033,"Cotton County, OK",Feb-22,2681,2602,79,2.90000000
CN4003500000000,40,035,"Craig County, OK",Feb-22,5626,5442,184,3.30000000
CN4003700000000,40,037,"Creek County, OK",Feb-22,31270,30125,1145,3.70000000
CN4003900000000,40,039,"Custer County, OK",Feb-22,15227,14794,433,2.80000000
CN4004100000000,40,041,"Delaware County, OK",Feb-22,18683,18091,592,3.20000000
CN4004300000000,40,043,"Dewey County, OK",Feb-22,2980,2920,60,2.00000000
CN4004500000000,40,045,"Ellis County, OK",Feb-22,2106,2051,55,2.60000000
CN4004700000000,40,047,"Garfield County, OK",Feb-22,26420,25628,792,3.00000000
CN4004900000000,40,049,"Garvin County, OK",Feb-22,12740,12359,381,3.00000000
CN4005100000000,40,051,"Grady County, OK",Feb-22,27088,26331,757,2.80000000
CN4005300000000,40,053,"Grant County, OK",Feb-22,2697,2639,58,2.20000000
CN4005500000000,40,055,"Greer County, OK",Feb-22,1836,1767,69,3.80000000
CN4005700000000,40,057,"Harmon County, OK",Feb-22,1188,1158,30,2.50000000
CN4005900000000,40,059,"Harper County, OK",Feb-22,1816,1778,38,2.10000000
CN4006100000000,40,061,"Haskell County, OK",Feb-22,4206,4019,187,4.40000000
CN4006300000000,40,063,"Hughes County, OK",Feb-22,5232,4989,243,4.60000000
CN4006500000000,40,065,"Jackson County, OK",Feb-22,10843,10557,286,2.60000000
CN4006700000000,40,067,"Jefferson County, OK",Feb-22,2478,2400,78,3.10000000
CN4006900000000,40,069,"Johnston County, OK",Feb-22,3592,3444,148,4.10000000
CN4007100000000,40,071,"Kay County, OK",Feb-22,18034,17368,666,3.70000000
CN4007300000000,40,073,"Kingfisher County, OK",Feb-22,8782,8603,179,2.00000000
CN4007500000000,40,075,"Kiowa County, OK",Feb-22,3641,3532,109,3.00000000
CN4007700000000,40,077,"Latimer County, OK",Feb-22,3049,2846,203,6.70000000
CN4007900000000,40,079,"Le Flore County, OK",Feb-22,19441,18653,788,4.10000000
CN4008100000000,40,081,"Lincoln County, OK",Feb-22,16079,15591,488,3.00000000
CN4008300000000,40,083,"Logan County, OK",Feb-22,23125,22470,655,2.80000000
CN4008500000000,40,085,"Love County, OK",Feb-22,5950,5815,135,2.30000000
CN4008700000000,40,087,"McClain County, OK",Feb-22,20747,20208,539,2.60000000
CN4008900000000,40,089,"McCurtain County, OK",Feb-22,16018,15359,659,4.10000000
CN4009100000000,40,091,"McIntosh County, OK",Feb-22,7022,6636,386,5.50000000
CN4009300000000,40,093,"Major County, OK",Feb-22,3694,3605,89,2.40000000
CN4009500000000,40,095,"Marshall County, OK",Feb-22,7000,6773,227,3.20000000
CN4009700000000,40,097,"Mayes County, OK",Feb-22,19289,18671,618,3.20000000
CN4009900000000,40,099,"Murray County, OK",Feb-22,6010,5820,190,3.20000000
CN4010100000000,40,101,"Muskogee County, OK",Feb-22,28282,27247,1035,3.70000000
CN4010300000000,40,103,"Noble County, OK",Feb-22,5615,5497,118,2.10000000
CN4010500000000,40,105,"Nowata County, OK",Feb-22,4621,4489,132,2.90000000
CN4010700000000,40,107,"Okfuskee County, OK",Feb-22,4404,4216,188,4.30000000
CN4010900000000,40,109,"Oklahoma County, OK",Feb-22,393493,381409,12084,3.10000000
CN4011100000000,40,111,"Okmulgee County, OK",Feb-22,15538,14829,709,4.60000000
CN4011300000000,40,113,"Osage County, OK",Feb-22,20380,19623,757,3.70000000
CN4011500000000,40,115,"Ottawa County, OK",Feb-22,14545,14132,413,2.80000000
CN4011700000000,40,117,"Pawnee County, OK",Feb-22,7349,7073,276,3.80000000
CN4011900000000,40,119,"Payne County, OK",Feb-22,38580,37469,1111,2.90000000
CN4012100000000,40,121,"Pittsburg County, OK",Feb-22,16157,15394,763,4.70000000
CN4012300000000,40,123,"Pontotoc County, OK",Feb-22,19230,18657,573,3.00000000
CN4012500000000,40,125,"Pottawatomie County, OK",Feb-22,32901,31773,1128,3.40000000
CN4012700000000,40,127,"Pushmataha County, OK",Feb-22,4855,4689,166,3.40000000
CN4012900000000,40,129,"Roger Mills County, OK",Feb-22,1803,1757,46,2.60000000
CN4013100000000,40,131,"Rogers County, OK",Feb-22,45028,43690,1338,3.00000000
CN4013300000000,40,133,"Seminole County, OK",Feb-22,9063,8671,392,4.30000000
CN4013500000000,40,135,"Sequoyah County, OK",Feb-22,16731,16107,624,3.70000000
CN4013700000000,40,137,"Stephens County, OK",Feb-22,19093,18418,675,3.50000000
CN4013900000000,40,139,"Texas County, OK",Feb-22,11514,11285,229,2.00000000
CN4014100000000,40,141,"Tillman County, OK",Feb-22,2826,2729,97,3.40000000
CN4014300000000,40,143,"Tulsa County, OK",Feb-22,324266,313908,10358,3.20000000
CN4014500000000,40,145,"Wagoner County, OK",Feb-22,38831,37652,1179,3.00000000
CN4014700000000,40,147,"Washington County, OK",Feb-22,22275,21532,743,3.30000000
CN4014900000000,40,149,"Washita County, OK",Feb-22,4872,4685,187,3.80000000
CN4015100000000,40,151,"Woods County, OK",Feb-22,4736,4643,93,2.00000000
CN4015300000000,40,153,"Woodward County, OK",Feb-22,8511,8228,283,3.30000000
CN4100100000000,41,001,"Baker County, OR",Feb-22,7497,7141,356,4.70000000
CN4100300000000,41,003,"Benton County, OR",Feb-22,49563,48185,1378,2.80000000
CN4100500000000,41,005,"Clackamas County, OR",Feb-22,228771,220786,7985,3.50000000
CN4100700000000,41,007,"Clatsop County, OR",Feb-22,19274,18414,860,4.50000000
CN4100900000000,41,009,"Columbia County, OR",Feb-22,25363,24220,1143,4.50000000
CN4101100000000,41,011,"Coos County, OR",Feb-22,27073,25761,1312,4.80000000
CN4101300000000,41,013,"Crook County, OR",Feb-22,11114,10486,628,5.70000000
CN4101500000000,41,015,"Curry County, OR",Feb-22,9034,8529,505,5.60000000
CN4101700000000,41,017,"Deschutes County, OR",Feb-22,104967,100746,4221,4.00000000
CN4101900000000,41,019,"Douglas County, OR",Feb-22,47854,45560,2294,4.80000000
CN4102100000000,41,021,"Gilliam County, OR",Feb-22,1024,993,31,3.00000000
CN4102300000000,41,023,"Grant County, OR",Feb-22,3161,2920,241,7.60000000
CN4102500000000,41,025,"Harney County, OR",Feb-22,3663,3455,208,5.70000000
CN4102700000000,41,027,"Hood River County, OR",Feb-22,14352,13902,450,3.10000000
CN4102900000000,41,029,"Jackson County, OR",Feb-22,108084,103516,4568,4.20000000
CN4103100000000,41,031,"Jefferson County, OR",Feb-22,10470,9890,580,5.50000000
CN4103300000000,41,033,"Josephine County, OR",Feb-22,37374,35453,1921,5.10000000
CN4103500000000,41,035,"Klamath County, OR",Feb-22,29602,27727,1875,6.30000000
CN4103700000000,41,037,"Lake County, OR",Feb-22,3613,3400,213,5.90000000
CN4103900000000,41,039,"Lane County, OR",Feb-22,185109,177544,7565,4.10000000
CN4104100000000,41,041,"Lincoln County, OR",Feb-22,20846,19730,1116,5.40000000
CN4104300000000,41,043,"Linn County, OR",Feb-22,61778,59091,2687,4.30000000
CN4104500000000,41,045,"Malheur County, OR",Feb-22,12581,12100,481,3.80000000
CN4104700000000,41,047,"Marion County, OR",Feb-22,167541,161015,6526,3.90000000
CN4104900000000,41,049,"Morrow County, OR",Feb-22,5938,5726,212,3.60000000
CN4105100000000,41,051,"Multnomah County, OR",Feb-22,473755,455045,18710,3.90000000
CN4105300000000,41,053,"Polk County, OR",Feb-22,42211,40644,1567,3.70000000
CN4105500000000,41,055,"Sherman County, OR",Feb-22,937,903,34,3.60000000
CN4105700000000,41,057,"Tillamook County, OR",Feb-22,12112,11616,496,4.10000000
CN4105900000000,41,059,"Umatilla County, OR",Feb-22,37503,35873,1630,4.30000000
CN4106100000000,41,061,"Union County, OR",Feb-22,12242,11682,560,4.60000000
CN4106300000000,41,063,"Wallowa County, OR",Feb-22,3507,3297,210,6.00000000
CN4106500000000,41,065,"Wasco County, OR",Feb-22,12949,12363,586,4.50000000
CN4106700000000,41,067,"Washington County, OR",Feb-22,336622,326261,10361,3.10000000
CN4106900000000,41,069,"Wheeler County, OR",Feb-22,747,722,25,3.30000000
CN4107100000000,41,071,"Yamhill County, OR",Feb-22,56728,54775,1953,3.40000000
CN4200100000000,42,001,"Adams County, PA",Feb-22,54489,52745,1744,3.20000000
CN4200300000000,42,003,"Allegheny County, PA",Feb-22,619040,589940,29100,4.70000000
CN4200500000000,42,005,"Armstrong County, PA",Feb-22,30764,28702,2062,6.70000000
CN4200700000000,42,007,"Beaver County, PA",Feb-22,80402,75536,4866,6.10000000
CN4200900000000,42,009,"Bedford County, PA",Feb-22,23250,21983,1267,5.40000000
CN4201100000000,42,011,"Berks County, PA",Feb-22,207688,197113,10575,5.10000000
CN4201300000000,42,013,"Blair County, PA",Feb-22,58601,55739,2862,4.90000000
CN4201500000000,42,015,"Bradford County, PA",Feb-22,27270,25965,1305,4.80000000
CN4201700000000,42,017,"Bucks County, PA",Feb-22,341275,327168,14107,4.10000000
CN4201900000000,42,019,"Butler County, PA",Feb-22,96649,92097,4552,4.70000000
CN4202100000000,42,021,"Cambria County, PA",Feb-22,55163,51929,3234,5.90000000
CN4202300000000,42,023,"Cameron County, PA",Feb-22,1934,1804,130,6.70000000
CN4202500000000,42,025,"Carbon County, PA",Feb-22,32196,30369,1827,5.70000000
CN4202700000000,42,027,"Centre County, PA",Feb-22,77060,74425,2635,3.40000000
CN4202900000000,42,029,"Chester County, PA",Feb-22,284488,275507,8981,3.20000000
CN4203100000000,42,031,"Clarion County, PA",Feb-22,16459,15529,930,5.70000000
CN4203300000000,42,033,"Clearfield County, PA",Feb-22,35029,32800,2229,6.40000000
CN4203500000000,42,035,"Clinton County, PA",Feb-22,16985,15915,1070,6.30000000
CN4203700000000,42,037,"Columbia County, PA",Feb-22,33297,31716,1581,4.70000000
CN4203900000000,42,039,"Crawford County, PA",Feb-22,36693,34665,2028,5.50000000
CN4204100000000,42,041,"Cumberland County, PA",Feb-22,133768,129294,4474,3.30000000
CN4204300000000,42,043,"Dauphin County, PA",Feb-22,145744,139309,6435,4.40000000
CN4204500000000,42,045,"Delaware County, PA",Feb-22,293478,279653,13825,4.70000000
CN4204700000000,42,047,"Elk County, PA",Feb-22,14514,13716,798,5.50000000
CN4204900000000,42,049,"Erie County, PA",Feb-22,126007,118407,7600,6.00000000
CN4205100000000,42,051,"Fayette County, PA",Feb-22,54548,50378,4170,7.60000000
CN4205300000000,42,053,"Forest County, PA",Feb-22,1677,1555,122,7.30000000
CN4205500000000,42,055,"Franklin County, PA",Feb-22,76240,73305,2935,3.80000000
CN4205700000000,42,057,"Fulton County, PA",Feb-22,6987,6602,385,5.50000000
CN4205900000000,42,059,"Greene County, PA",Feb-22,15385,14413,972,6.30000000
CN4206100000000,42,061,"Huntingdon County, PA",Feb-22,18797,17500,1297,6.90000000
CN4206300000000,42,063,"Indiana County, PA",Feb-22,36373,34218,2155,5.90000000
CN4206500000000,42,065,"Jefferson County, PA",Feb-22,19218,18106,1112,5.80000000
CN4206700000000,42,067,"Juniata County, PA",Feb-22,12336,11764,572,4.60000000
CN4206900000000,42,069,"Lackawanna County, PA",Feb-22,103108,97488,5620,5.50000000
CN4207100000000,42,071,"Lancaster County, PA",Feb-22,280850,270509,10341,3.70000000
CN4207300000000,42,073,"Lawrence County, PA",Feb-22,38730,35972,2758,7.10000000
CN4207500000000,42,075,"Lebanon County, PA",Feb-22,72151,69262,2889,4.00000000
CN4207700000000,42,077,"Lehigh County, PA",Feb-22,195619,185544,10075,5.20000000
CN4207900000000,42,079,"Luzerne County, PA",Feb-22,156178,145829,10349,6.60000000
CN4208100000000,42,081,"Lycoming County, PA",Feb-22,54625,51575,3050,5.60000000
CN4208300000000,42,083,"McKean County, PA",Feb-22,16399,15415,984,6.00000000
CN4208500000000,42,085,"Mercer County, PA",Feb-22,46629,43959,2670,5.70000000
CN4208700000000,42,087,"Mifflin County, PA",Feb-22,20380,19257,1123,5.50000000
CN4208900000000,42,089,"Monroe County, PA",Feb-22,82104,76722,5382,6.60000000
CN4209100000000,42,091,"Montgomery County, PA",Feb-22,453668,436983,16685,3.70000000
CN4209300000000,42,093,"Montour County, PA",Feb-22,9015,8721,294,3.30000000
CN4209500000000,42,095,"Northampton County, PA",Feb-22,162286,154805,7481,4.60000000
CN4209700000000,42,097,"Northumberland County, PA",Feb-22,40698,38293,2405,5.90000000
CN4209900000000,42,099,"Perry County, PA",Feb-22,24383,23458,925,3.80000000
CN4210100000000,42,101,"Philadelphia County/city, PA",Feb-22,721261,672211,49050,6.80000000
CN4210300000000,42,103,"Pike County, PA",Feb-22,25288,23585,1703,6.70000000
CN4210500000000,42,105,"Potter County, PA",Feb-22,6916,6432,484,7.00000000
CN4210700000000,42,107,"Schuylkill County, PA",Feb-22,63956,60356,3600,5.60000000
CN4210900000000,42,109,"Snyder County, PA",Feb-22,19214,18336,878,4.60000000
CN4211100000000,42,111,"Somerset County, PA",Feb-22,32381,30319,2062,6.40000000
CN4211300000000,42,113,"Sullivan County, PA",Feb-22,2484,2312,172,6.90000000
CN4211500000000,42,115,"Susquehanna County, PA",Feb-22,19794,18791,1003,5.10000000
CN4211700000000,42,117,"Tioga County, PA",Feb-22,18455,17383,1072,5.80000000
CN4211900000000,42,119,"Union County, PA",Feb-22,19118,18377,741,3.90000000
CN4212100000000,42,121,"Venango County, PA",Feb-22,20926,19715,1211,5.80000000
CN4212300000000,42,123,"Warren County, PA",Feb-22,17118,16148,970,5.70000000
CN4212500000000,42,125,"Washington County, PA",Feb-22,102978,97316,5662,5.50000000
CN4212700000000,42,127,"Wayne County, PA",Feb-22,21728,20315,1413,6.50000000
CN4212900000000,42,129,"Westmoreland County, PA",Feb-22,172423,163338,9085,5.30000000
CN4213100000000,42,131,"Wyoming County, PA",Feb-22,13229,12466,763,5.80000000
CN4213300000000,42,133,"York County, PA",Feb-22,234208,224998,9210,3.90000000
CN4400100000000,44,001,"Bristol County, RI",Feb-22,26559,25616,943,3.60000000
CN4400300000000,44,003,"Kent County, RI",Feb-22,93965,90151,3814,4.10000000
CN4400500000000,44,005,"Newport County, RI",Feb-22,45379,43465,1914,4.20000000
CN4400700000000,44,007,"Providence County, RI",Feb-22,336021,320027,15994,4.80000000
CN4400900000000,44,009,"Washington County, RI",Feb-22,69994,67170,2824,4.00000000
CN4500100000000,45,001,"Abbeville County, SC",Feb-22,9604,9160,444,4.60000000
CN4500300000000,45,003,"Aiken County, SC",Feb-22,74512,71714,2798,3.80000000
CN4500500000000,45,005,"Allendale County, SC",Feb-22,2380,2196,184,7.70000000
CN4500700000000,45,007,"Anderson County, SC",Feb-22,92301,88886,3415,3.70000000
CN4500900000000,45,009,"Bamberg County, SC",Feb-22,4692,4352,340,7.20000000
CN4501100000000,45,011,"Barnwell County, SC",Feb-22,7455,6956,499,6.70000000
CN4501300000000,45,013,"Beaufort County, SC",Feb-22,76640,73612,3028,4.00000000
CN4501500000000,45,015,"Berkeley County, SC",Feb-22,109470,105422,4048,3.70000000
CN4501700000000,45,017,"Calhoun County, SC",Feb-22,6410,6121,289,4.50000000
CN4501900000000,45,019,"Charleston County, SC",Feb-22,214861,207198,7663,3.60000000
CN4502100000000,45,021,"Cherokee County, SC",Feb-22,24873,23649,1224,4.90000000
CN4502300000000,45,023,"Chester County, SC",Feb-22,13460,12683,777,5.80000000
CN4502500000000,45,025,"Chesterfield County, SC",Feb-22,21560,20563,997,4.60000000
CN4502700000000,45,027,"Clarendon County, SC",Feb-22,12025,11412,613,5.10000000
CN4502900000000,45,029,"Colleton County, SC",Feb-22,16060,15344,716,4.50000000
CN4503100000000,45,031,"Darlington County, SC",Feb-22,29637,28299,1338,4.50000000
CN4503300000000,45,033,"Dillon County, SC",Feb-22,13104,12316,788,6.00000000
CN4503500000000,45,035,"Dorchester County, SC",Feb-22,79390,76534,2856,3.60000000
CN4503700000000,45,037,"Edgefield County, SC",Feb-22,10395,9998,397,3.80000000
CN4503900000000,45,039,"Fairfield County, SC",Feb-22,9287,8712,575,6.20000000
CN4504100000000,45,041,"Florence County, SC",Feb-22,65703,62993,2710,4.10000000
CN4504300000000,45,043,"Georgetown County, SC",Feb-22,25598,24298,1300,5.10000000
CN4504500000000,45,045,"Greenville County, SC",Feb-22,262398,253236,9162,3.50000000
CN4504700000000,45,047,"Greenwood County, SC",Feb-22,30208,28845,1363,4.50000000
CN4504900000000,45,049,"Hampton County, SC",Feb-22,7928,7653,275,3.50000000
CN4505100000000,45,051,"Horry County, SC",Feb-22,148600,140420,8180,5.50000000
CN4505300000000,45,053,"Jasper County, SC",Feb-22,13123,12636,487,3.70000000
CN4505500000000,45,055,"Kershaw County, SC",Feb-22,29315,28160,1155,3.90000000
CN4505700000000,45,057,"Lancaster County, SC",Feb-22,43745,41698,2047,4.70000000
CN4505900000000,45,059,"Laurens County, SC",Feb-22,30382,29088,1294,4.30000000
CN4506100000000,45,061,"Lee County, SC",Feb-22,6514,6151,363,5.60000000
CN4506300000000,45,063,"Lexington County, SC",Feb-22,150965,145967,4998,3.30000000
CN4506500000000,45,065,"McCormick County, SC",Feb-22,3285,3132,153,4.70000000
CN4506700000000,45,067,"Marion County, SC",Feb-22,12724,11864,860,6.80000000
CN4506900000000,45,069,"Marlboro County, SC",Feb-22,8709,7934,775,8.90000000
CN4507100000000,45,071,"Newberry County, SC",Feb-22,19195,18531,664,3.50000000
CN4507300000000,45,073,"Oconee County, SC",Feb-22,34119,32739,1380,4.00000000
CN4507500000000,45,075,"Orangeburg County, SC",Feb-22,34064,31731,2333,6.80000000
CN4507700000000,45,077,"Pickens County, SC",Feb-22,58431,56262,2169,3.70000000
CN4507900000000,45,079,"Richland County, SC",Feb-22,197519,189551,7968,4.00000000
CN4508100000000,45,081,"Saluda County, SC",Feb-22,8318,8024,294,3.50000000
CN4508300000000,45,083,"Spartanburg County, SC",Feb-22,158232,152153,6079,3.80000000
CN4508500000000,45,085,"Sumter County, SC",Feb-22,42442,40471,1971,4.60000000
CN4508700000000,45,087,"Union County, SC",Feb-22,11575,10864,711,6.10000000
CN4508900000000,45,089,"Williamsburg County, SC",Feb-22,10829,10171,658,6.10000000
CN4509100000000,45,091,"York County, SC",Feb-22,148373,142481,5892,4.00000000
CN4600300000000,46,003,"Aurora County, SD",Feb-22,1500,1466,34,2.30000000
CN4600500000000,46,005,"Beadle County, SD",Feb-22,9178,8911,267,2.90000000
CN4600700000000,46,007,"Bennett County, SD",Feb-22,1045,1005,40,3.80000000
CN4600900000000,46,009,"Bon Homme County, SD",Feb-22,2864,2791,73,2.50000000
CN4601100000000,46,011,"Brookings County, SD",Feb-22,18970,18430,540,2.80000000
CN4601300000000,46,013,"Brown County, SD",Feb-22,20491,19865,626,3.10000000
CN4601500000000,46,015,"Brule County, SD",Feb-22,2576,2517,59,2.30000000
CN4601700000000,46,017,"Buffalo County, SD",Feb-22,682,656,26,3.80000000
CN4601900000000,46,019,"Butte County, SD",Feb-22,4955,4819,136,2.70000000
CN4602100000000,46,021,"Campbell County, SD",Feb-22,790,762,28,3.50000000
CN4602300000000,46,023,"Charles Mix County, SD",Feb-22,3805,3693,112,2.90000000
CN4602500000000,46,025,"Clark County, SD",Feb-22,1926,1852,74,3.80000000
CN4602700000000,46,027,"Clay County, SD",Feb-22,7829,7624,205,2.60000000
CN4602900000000,46,029,"Codington County, SD",Feb-22,15848,15363,485,3.10000000
CN4603100000000,46,031,"Corson County, SD",Feb-22,1360,1315,45,3.30000000
CN4603300000000,46,033,"Custer County, SD",Feb-22,4210,4035,175,4.20000000
CN4603500000000,46,035,"Davison County, SD",Feb-22,10834,10544,290,2.70000000
CN4603700000000,46,037,"Day County, SD",Feb-22,2711,2563,148,5.50000000
CN4603900000000,46,039,"Deuel County, SD",Feb-22,2232,2122,110,4.90000000
CN4604100000000,46,041,"Dewey County, SD",Feb-22,2288,2183,105,4.60000000
CN4604300000000,46,043,"Douglas County, SD",Feb-22,1565,1522,43,2.70000000
CN4604500000000,46,045,"Edmunds County, SD",Feb-22,2052,2004,48,2.30000000
CN4604700000000,46,047,"Fall River County, SD",Feb-22,3021,2920,101,3.30000000
CN4604900000000,46,049,"Faulk County, SD",Feb-22,1100,1074,26,2.40000000
CN4605100000000,46,051,"Grant County, SD",Feb-22,4396,4197,199,4.50000000
CN4605300000000,46,053,"Gregory County, SD",Feb-22,2091,2036,55,2.60000000
CN4605500000000,46,055,"Haakon County, SD",Feb-22,1078,1046,32,3.00000000
CN4605700000000,46,057,"Hamlin County, SD",Feb-22,3505,3403,102,2.90000000
CN4605900000000,46,059,"Hand County, SD",Feb-22,1803,1759,44,2.40000000
CN4606100000000,46,061,"Hanson County, SD",Feb-22,1793,1714,79,4.40000000
CN4606300000000,46,063,"Harding County, SD",Feb-22,770,753,17,2.20000000
CN4606500000000,46,065,"Hughes County, SD",Feb-22,9694,9451,243,2.50000000
CN4606700000000,46,067,"Hutchinson County, SD",Feb-22,3684,3552,132,3.60000000
CN4606900000000,46,069,"Hyde County, SD",Feb-22,667,652,15,2.20000000
CN4607100000000,46,071,"Jackson County, SD",Feb-22,1171,1119,52,4.40000000
CN4607300000000,46,073,"Jerauld County, SD",Feb-22,1369,1344,25,1.80000000
CN4607500000000,46,075,"Jones County, SD",Feb-22,510,491,19,3.70000000
CN4607700000000,46,077,"Kingsbury County, SD",Feb-22,2700,2620,80,3.00000000
CN4607900000000,46,079,"Lake County, SD",Feb-22,6557,6375,182,2.80000000
CN4608100000000,46,081,"Lawrence County, SD",Feb-22,13683,13349,334,2.40000000
CN4608300000000,46,083,"Lincoln County, SD",Feb-22,36765,35905,860,2.30000000
CN4608500000000,46,085,"Lyman County, SD",Feb-22,1671,1613,58,3.50000000
CN4608700000000,46,087,"McCook County, SD",Feb-22,3100,3021,79,2.50000000
CN4608900000000,46,089,"McPherson County, SD",Feb-22,1000,964,36,3.60000000
CN4609100000000,46,091,"Marshall County, SD",Feb-22,2470,2364,106,4.30000000
CN4609300000000,46,093,"Meade County, SD",Feb-22,14128,13734,394,2.80000000
CN4609500000000,46,095,"Mellette County, SD",Feb-22,772,746,26,3.40000000
CN4609700000000,46,097,"Miner County, SD",Feb-22,1203,1173,30,2.50000000
CN4609900000000,46,099,"Minnehaha County, SD",Feb-22,114347,111168,3179,2.80000000
CN4610100000000,46,101,"Moody County, SD",Feb-22,4024,3915,109,2.70000000
CN4610200000000,46,102,"Oglala Lakota County, SD",Feb-22,3992,3748,244,6.10000000
CN4610300000000,46,103,"Pennington County, SD",Feb-22,58099,56485,1614,2.80000000
CN4610500000000,46,105,"Perkins County, SD",Feb-22,1441,1401,40,2.80000000
CN4610700000000,46,107,"Potter County, SD",Feb-22,1039,1002,37,3.60000000
CN4610900000000,46,109,"Roberts County, SD",Feb-22,4774,4504,270,5.70000000
CN4611100000000,46,111,"Sanborn County, SD",Feb-22,1244,1201,43,3.50000000
CN4611500000000,46,115,"Spink County, SD",Feb-22,3139,3018,121,3.90000000
CN4611700000000,46,117,"Stanley County, SD",Feb-22,1931,1865,66,3.40000000
CN4611900000000,46,119,"Sully County, SD",Feb-22,828,810,18,2.20000000
CN4612100000000,46,121,"Todd County, SD",Feb-22,3243,3094,149,4.60000000
CN4612300000000,46,123,"Tripp County, SD",Feb-22,3059,2987,72,2.40000000
CN4612500000000,46,125,"Turner County, SD",Feb-22,4728,4604,124,2.60000000
CN4612700000000,46,127,"Union County, SD",Feb-22,8700,8444,256,2.90000000
CN4612900000000,46,129,"Walworth County, SD",Feb-22,2123,2000,123,5.80000000
CN4613500000000,46,135,"Yankton County, SD",Feb-22,11581,11296,285,2.50000000
CN4613700000000,46,137,"Ziebach County, SD",Feb-22,964,930,34,3.50000000
CN4700100000000,47,001,"Anderson County, TN",Feb-22,35703,34656,1047,2.90000000
CN4700300000000,47,003,"Bedford County, TN",Feb-22,21378,20741,637,3.00000000
CN4700500000000,47,005,"Benton County, TN",Feb-22,6792,6532,260,3.80000000
CN4700700000000,47,007,"Bledsoe County, TN",Feb-22,4279,4080,199,4.70000000
CN4700900000000,47,009,"Blount County, TN",Feb-22,66370,64455,1915,2.90000000
CN4701100000000,47,011,"Bradley County, TN",Feb-22,51186,49351,1835,3.60000000
CN4701300000000,47,013,"Campbell County, TN",Feb-22,15116,14549,567,3.80000000
CN4701500000000,47,015,"Cannon County, TN",Feb-22,6869,6701,168,2.40000000
CN4701700000000,47,017,"Carroll County, TN",Feb-22,11409,11004,405,3.50000000
CN4701900000000,47,019,"Carter County, TN",Feb-22,24434,23640,794,3.20000000
CN4702100000000,47,021,"Cheatham County, TN",Feb-22,22656,22084,572,2.50000000
CN4702300000000,47,023,"Chester County, TN",Feb-22,8545,8342,203,2.40000000
CN4702500000000,47,025,"Claiborne County, TN",Feb-22,12977,12543,434,3.30000000
CN4702700000000,47,027,"Clay County, TN",Feb-22,2782,2644,138,5.00000000
CN4702900000000,47,029,"Cocke County, TN",Feb-22,14560,13647,913,6.30000000
CN4703100000000,47,031,"Coffee County, TN",Feb-22,25220,24445,775,3.10000000
CN4703300000000,47,033,"Crockett County, TN",Feb-22,6845,6638,207,3.00000000
CN4703500000000,47,035,"Cumberland County, TN",Feb-22,22310,21320,990,4.40000000
CN4703700000000,47,037,"Davidson County, TN",Feb-22,416798,404527,12271,2.90000000
CN4703900000000,47,039,"Decatur County, TN",Feb-22,4245,4053,192,4.50000000
CN4704100000000,47,041,"DeKalb County, TN",Feb-22,7797,7529,268,3.40000000
CN4704300000000,47,043,"Dickson County, TN",Feb-22,28052,27312,740,2.60000000
CN4704500000000,47,045,"Dyer County, TN",Feb-22,16155,15592,563,3.50000000
CN4704700000000,47,047,"Fayette County, TN",Feb-22,19558,18914,644,3.30000000
CN4704900000000,47,049,"Fentress County, TN",Feb-22,7524,7253,271,3.60000000
CN4705100000000,47,051,"Franklin County, TN",Feb-22,19627,19045,582,3.00000000
CN4705300000000,47,053,"Gibson County, TN",Feb-22,21454,20739,715,3.30000000
CN4705500000000,47,055,"Giles County, TN",Feb-22,14779,14305,474,3.20000000
CN4705700000000,47,057,"Grainger County, TN",Feb-22,9793,9454,339,3.50000000
CN4705900000000,47,059,"Greene County, TN",Feb-22,28981,27981,1000,3.50000000
CN4706100000000,47,061,"Grundy County, TN",Feb-22,5057,4854,203,4.00000000
CN4706300000000,47,063,"Hamblen County, TN",Feb-22,28472,27502,970,3.40000000
CN4706500000000,47,065,"Hamilton County, TN",Feb-22,186541,180175,6366,3.40000000
CN4706700000000,47,067,"Hancock County, TN",Feb-22,2295,2205,90,3.90000000
CN4706900000000,47,069,"Hardeman County, TN",Feb-22,8818,8416,402,4.60000000
CN4707100000000,47,071,"Hardin County, TN",Feb-22,9979,9611,368,3.70000000
CN4707300000000,47,073,"Hawkins County, TN",Feb-22,23492,22699,793,3.40000000
CN4707500000000,47,075,"Haywood County, TN",Feb-22,7599,7254,345,4.50000000
CN4707700000000,47,077,"Henderson County, TN",Feb-22,11917,11529,388,3.30000000
CN4707900000000,47,079,"Henry County, TN",Feb-22,14100,13585,515,3.70000000
CN4708100000000,47,081,"Hickman County, TN",Feb-22,11756,11443,313,2.70000000
CN4708300000000,47,083,"Houston County, TN",Feb-22,3208,3073,135,4.20000000
CN4708500000000,47,085,"Humphreys County, TN",Feb-22,8641,8382,259,3.00000000
CN4708700000000,47,087,"Jackson County, TN",Feb-22,4802,4640,162,3.40000000
CN4708900000000,47,089,"Jefferson County, TN",Feb-22,25367,24434,933,3.70000000
CN4709100000000,47,091,"Johnson County, TN",Feb-22,7793,7561,232,3.00000000
CN4709300000000,47,093,"Knox County, TN",Feb-22,254203,247795,6408,2.50000000
CN4709500000000,47,095,"Lake County, TN",Feb-22,1661,1563,98,5.90000000
CN4709700000000,47,097,"Lauderdale County, TN",Feb-22,9619,9178,441,4.60000000
CN4709900000000,47,099,"Lawrence County, TN",Feb-22,19470,18880,590,3.00000000
CN4710100000000,47,101,"Lewis County, TN",Feb-22,5576,5395,181,3.20000000
CN4710300000000,47,103,"Lincoln County, TN",Feb-22,16075,15567,508,3.20000000
CN4710500000000,47,105,"Loudon County, TN",Feb-22,24604,23915,689,2.80000000
CN4710700000000,47,107,"McMinn County, TN",Feb-22,22189,21400,789,3.60000000
CN4710900000000,47,109,"McNairy County, TN",Feb-22,8246,7904,342,4.10000000
CN4711100000000,47,111,"Macon County, TN",Feb-22,11628,11320,308,2.60000000
CN4711300000000,47,113,"Madison County, TN",Feb-22,49436,47804,1632,3.30000000
CN4711500000000,47,115,"Marion County, TN",Feb-22,12460,12004,456,3.70000000
CN4711700000000,47,117,"Marshall County, TN",Feb-22,15539,15072,467,3.00000000
CN4711900000000,47,119,"Maury County, TN",Feb-22,53373,51755,1618,3.00000000
CN4712100000000,47,121,"Meigs County, TN",Feb-22,5190,4984,206,4.00000000
CN4712300000000,47,123,"Monroe County, TN",Feb-22,20987,20371,616,2.90000000
CN4712500000000,47,125,"Montgomery County, TN",Feb-22,89626,86572,3054,3.40000000
CN4712700000000,47,127,"Moore County, TN",Feb-22,3642,3578,64,1.80000000
CN4712900000000,47,129,"Morgan County, TN",Feb-22,7933,7678,255,3.20000000
CN4713100000000,47,131,"Obion County, TN",Feb-22,12326,11855,471,3.80000000
CN4713300000000,47,133,"Overton County, TN",Feb-22,9994,9682,312,3.10000000
CN4713500000000,47,135,"Perry County, TN",Feb-22,2804,2643,161,5.70000000
CN4713700000000,47,137,"Pickett County, TN",Feb-22,2135,2052,83,3.90000000
CN4713900000000,47,139,"Polk County, TN",Feb-22,7139,6899,240,3.40000000
CN4714100000000,47,141,"Putnam County, TN",Feb-22,35730,34726,1004,2.80000000
CN4714300000000,47,143,"Rhea County, TN",Feb-22,13962,13453,509,3.60000000
CN4714500000000,47,145,"Roane County, TN",Feb-22,24030,23270,760,3.20000000
CN4714700000000,47,147,"Robertson County, TN",Feb-22,39371,38371,1000,2.50000000
CN4714900000000,47,149,"Rutherford County, TN",Feb-22,197172,192082,5090,2.60000000
CN4715100000000,47,151,"Scott County, TN",Feb-22,8080,7722,358,4.40000000
CN4715300000000,47,153,"Sequatchie County, TN",Feb-22,6245,5990,255,4.10000000
CN4715500000000,47,155,"Sevier County, TN",Feb-22,53315,50966,2349,4.40000000
CN4715700000000,47,157,"Shelby County, TN",Feb-22,452149,428928,23221,5.10000000
CN4715900000000,47,159,"Smith County, TN",Feb-22,9770,9515,255,2.60000000
CN4716100000000,47,161,"Stewart County, TN",Feb-22,5402,5213,189,3.50000000
CN4716300000000,47,163,"Sullivan County, TN",Feb-22,69820,67624,2196,3.10000000
CN4716500000000,47,165,"Sumner County, TN",Feb-22,109313,106530,2783,2.50000000
CN4716700000000,47,167,"Tipton County, TN",Feb-22,28197,27256,941,3.30000000
CN4716900000000,47,169,"Trousdale County, TN",Feb-22,5753,5591,162,2.80000000
CN4717100000000,47,171,"Unicoi County, TN",Feb-22,7182,6885,297,4.10000000
CN4717300000000,47,173,"Union County, TN",Feb-22,7900,7640,260,3.30000000
CN4717500000000,47,175,"Van Buren County, TN",Feb-22,2000,1921,79,4.00000000
CN4717700000000,47,177,"Warren County, TN",Feb-22,16476,15888,588,3.60000000
CN4717900000000,47,179,"Washington County, TN",Feb-22,62454,60757,1697,2.70000000
CN4718100000000,47,181,"Wayne County, TN",Feb-22,6344,6066,278,4.40000000
CN4718300000000,47,183,"Weakley County, TN",Feb-22,15621,15195,426,2.70000000
CN4718500000000,47,185,"White County, TN",Feb-22,11678,11314,364,3.10000000
CN4718700000000,47,187,"Williamson County, TN",Feb-22,138400,135571,2829,2.00000000
CN4718900000000,47,189,"Wilson County, TN",Feb-22,82392,80428,1964,2.40000000
CN4800100000000,48,001,"Anderson County, TX",Feb-22,23324,22402,922,4.00000000
CN4800300000000,48,003,"Andrews County, TX",Feb-22,8964,8553,411,4.60000000
CN4800500000000,48,005,"Angelina County, TX",Feb-22,35792,33753,2039,5.70000000
CN4800700000000,48,007,"Aransas County, TX",Feb-22,9336,8734,602,6.40000000
CN4800900000000,48,009,"Archer County, TX",Feb-22,4033,3879,154,3.80000000
CN4801100000000,48,011,"Armstrong County, TX",Feb-22,944,915,29,3.10000000
CN4801300000000,48,013,"Atascosa County, TX",Feb-22,22389,21253,1136,5.10000000
CN4801500000000,48,015,"Austin County, TX",Feb-22,14004,13357,647,4.60000000
CN4801700000000,48,017,"Bailey County, TX",Feb-22,2426,2316,110,4.50000000
CN4801900000000,48,019,"Bandera County, TX",Feb-22,10478,10049,429,4.10000000
CN4802100000000,48,021,"Bastrop County, TX",Feb-22,46704,44922,1782,3.80000000
CN4802300000000,48,023,"Baylor County, TX",Feb-22,1845,1787,58,3.10000000
CN4802500000000,48,025,"Bee County, TX",Feb-22,9134,8444,690,7.60000000
CN4802700000000,48,027,"Bell County, TX",Feb-22,150040,142571,7469,5.00000000
CN4802900000000,48,029,"Bexar County, TX",Feb-22,967234,925357,41877,4.30000000
CN4803100000000,48,031,"Blanco County, TX",Feb-22,7005,6788,217,3.10000000
CN4803300000000,48,033,"Borden County, TX",Feb-22,667,651,16,2.40000000
CN4803500000000,48,035,"Bosque County, TX",Feb-22,8684,8319,365,4.20000000
CN4803700000000,48,037,"Bowie County, TX",Feb-22,39851,37751,2100,5.30000000
CN4803900000000,48,039,"Brazoria County, TX",Feb-22,183865,173193,10672,5.80000000
CN4804100000000,48,041,"Brazos County, TX",Feb-22,125508,121213,4295,3.40000000
CN4804300000000,48,043,"Brewster County, TX",Feb-22,4206,4038,168,4.00000000
CN4804500000000,48,045,"Briscoe County, TX",Feb-22,578,554,24,4.20000000
CN4804700000000,48,047,"Brooks County, TX",Feb-22,2551,2350,201,7.90000000
CN4804900000000,48,049,"Brown County, TX",Feb-22,15187,14497,690,4.50000000
CN4805100000000,48,051,"Burleson County, TX",Feb-22,8682,8321,361,4.20000000
CN4805300000000,48,053,"Burnet County, TX",Feb-22,24911,24073,838,3.40000000
CN4805500000000,48,055,"Caldwell County, TX",Feb-22,20635,19820,815,3.90000000
CN4805700000000,48,057,"Calhoun County, TX",Feb-22,12321,11815,506,4.10000000
CN4805900000000,48,059,"Callahan County, TX",Feb-22,6195,5950,245,4.00000000
CN4806100000000,48,061,"Cameron County, TX",Feb-22,177711,164714,12997,7.30000000
CN4806300000000,48,063,"Camp County, TX",Feb-22,5212,4935,277,5.30000000
CN4806500000000,48,065,"Carson County, TX",Feb-22,3038,2930,108,3.60000000
CN4806700000000,48,067,"Cass County, TX",Feb-22,12422,11711,711,5.70000000
CN4806900000000,48,069,"Castro County, TX",Feb-22,3472,3364,108,3.10000000
CN4807100000000,48,071,"Chambers County, TX",Feb-22,21039,19561,1478,7.00000000
CN4807300000000,48,073,"Cherokee County, TX",Feb-22,20827,19671,1156,5.60000000
CN4807500000000,48,075,"Childress County, TX",Feb-22,2984,2888,96,3.20000000
CN4807700000000,48,077,"Clay County, TX",Feb-22,4899,4692,207,4.20000000
CN4807900000000,48,079,"Cochran County, TX",Feb-22,1112,1045,67,6.00000000
CN4808100000000,48,081,"Coke County, TX",Feb-22,1366,1306,60,4.40000000
CN4808300000000,48,083,"Coleman County, TX",Feb-22,2942,2785,157,5.30000000
CN4808500000000,48,085,"Collin County, TX",Feb-22,620354,598500,21854,3.50000000
CN4808700000000,48,087,"Collingsworth County, TX",Feb-22,1109,1071,38,3.40000000
CN4808900000000,48,089,"Colorado County, TX",Feb-22,10067,9649,418,4.20000000
CN4809100000000,48,091,"Comal County, TX",Feb-22,80938,77836,3102,3.80000000
CN4809300000000,48,093,"Comanche County, TX",Feb-22,6269,6034,235,3.70000000
CN4809500000000,48,095,"Concho County, TX",Feb-22,1407,1357,50,3.60000000
CN4809700000000,48,097,"Cooke County, TX",Feb-22,19613,18830,783,4.00000000
CN4809900000000,48,099,"Coryell County, TX",Feb-22,24799,23549,1250,5.00000000
CN4810100000000,48,101,"Cottle County, TX",Feb-22,614,587,27,4.40000000
CN4810300000000,48,103,"Crane County, TX",Feb-22,1587,1459,128,8.10000000
CN4810500000000,48,105,"Crockett County, TX",Feb-22,1419,1338,81,5.70000000
CN4810700000000,48,107,"Crosby County, TX",Feb-22,2464,2357,107,4.30000000
CN4810900000000,48,109,"Culberson County, TX",Feb-22,1080,1040,40,3.70000000
CN4811100000000,48,111,"Dallam County, TX",Feb-22,3846,3759,87,2.30000000
CN4811300000000,48,113,"Dallas County, TX",Feb-22,1414338,1351349,62989,4.50000000
CN4811500000000,48,115,"Dawson County, TX",Feb-22,4625,4360,265,5.70000000
CN4811700000000,48,117,"Deaf Smith County, TX",Feb-22,9108,8813,295,3.20000000
CN4811900000000,48,119,"Delta County, TX",Feb-22,2486,2373,113,4.50000000
CN4812100000000,48,121,"Denton County, TX",Feb-22,547442,527912,19530,3.60000000
CN4812300000000,48,123,"DeWitt County, TX",Feb-22,9669,9304,365,3.80000000
CN4812500000000,48,125,"Dickens County, TX",Feb-22,723,692,31,4.30000000
CN4812700000000,48,127,"Dimmit County, TX",Feb-22,5758,5499,259,4.50000000
CN4812900000000,48,129,"Donley County, TX",Feb-22,1459,1409,50,3.40000000
CN4813100000000,48,131,"Duval County, TX",Feb-22,5553,5194,359,6.50000000
CN4813300000000,48,133,"Eastland County, TX",Feb-22,7214,6865,349,4.80000000
CN4813500000000,48,135,"Ector County, TX",Feb-22,81635,76571,5064,6.20000000
CN4813700000000,48,137,"Edwards County, TX",Feb-22,1297,1251,46,3.50000000
CN4813900000000,48,139,"Ellis County, TX",Feb-22,102464,98549,3915,3.80000000
CN4814100000000,48,141,"El Paso County, TX",Feb-22,366804,347500,19304,5.30000000
CN4814300000000,48,143,"Erath County, TX",Feb-22,21376,20571,805,3.80000000
CN4814500000000,48,145,"Falls County, TX",Feb-22,6797,6496,301,4.40000000
CN4814700000000,48,147,"Fannin County, TX",Feb-22,17520,16911,609,3.50000000
CN4814900000000,48,149,"Fayette County, TX",Feb-22,11802,11352,450,3.80000000
CN4815100000000,48,151,"Fisher County, TX",Feb-22,1623,1567,56,3.50000000
CN4815300000000,48,153,"Floyd County, TX",Feb-22,2537,2416,121,4.80000000
CN4815500000000,48,155,"Foard County, TX",Feb-22,611,590,21,3.40000000
CN4815700000000,48,157,"Fort Bend County, TX",Feb-22,415233,395072,20161,4.90000000
CN4815900000000,48,159,"Franklin County, TX",Feb-22,5244,5049,195,3.70000000
CN4816100000000,48,161,"Freestone County, TX",Feb-22,6286,5881,405,6.40000000
CN4816300000000,48,163,"Frio County, TX",Feb-22,9442,9054,388,4.10000000
CN4816500000000,48,165,"Gaines County, TX",Feb-22,10008,9659,349,3.50000000
CN4816700000000,48,167,"Galveston County, TX",Feb-22,168136,158837,9299,5.50000000
CN4816900000000,48,169,"Garza County, TX",Feb-22,1976,1902,74,3.70000000
CN4817100000000,48,171,"Gillespie County, TX",Feb-22,14051,13626,425,3.00000000
CN4817300000000,48,173,"Glasscock County, TX",Feb-22,847,821,26,3.10000000
CN4817500000000,48,175,"Goliad County, TX",Feb-22,3168,2996,172,5.40000000
CN4817700000000,48,177,"Gonzales County, TX",Feb-22,9775,9440,335,3.40000000
CN4817900000000,48,179,"Gray County, TX",Feb-22,7666,7237,429,5.60000000
CN4818100000000,48,181,"Grayson County, TX",Feb-22,67159,64490,2669,4.00000000
CN4818300000000,48,183,"Gregg County, TX",Feb-22,56980,53914,3066,5.40000000
CN4818500000000,48,185,"Grimes County, TX",Feb-22,11333,10680,653,5.80000000
CN4818700000000,48,187,"Guadalupe County, TX",Feb-22,84524,81332,3192,3.80000000
CN4818900000000,48,189,"Hale County, TX",Feb-22,12101,11467,634,5.20000000
CN4819100000000,48,191,"Hall County, TX",Feb-22,1104,1053,51,4.60000000
CN4819300000000,48,193,"Hamilton County, TX",Feb-22,3812,3675,137,3.60000000
CN4819500000000,48,195,"Hansford County, TX",Feb-22,2615,2542,73,2.80000000
CN4819700000000,48,197,"Hardeman County, TX",Feb-22,1723,1650,73,4.20000000
CN4819900000000,48,199,"Hardin County, TX",Feb-22,25169,23443,1726,6.90000000
CN4820100000000,48,201,"Harris County, TX",Feb-22,2323068,2199403,123665,5.30000000
CN4820300000000,48,203,"Harrison County, TX",Feb-22,28467,26836,1631,5.70000000
CN4820500000000,48,205,"Hartley County, TX",Feb-22,2805,2751,54,1.90000000
CN4820700000000,48,207,"Haskell County, TX",Feb-22,2828,2732,96,3.40000000
CN4820900000000,48,209,"Hays County, TX",Feb-22,134205,129545,4660,3.50000000
CN4821100000000,48,211,"Hemphill County, TX",Feb-22,1549,1479,70,4.50000000
CN4821300000000,48,213,"Henderson County, TX",Feb-22,38707,37028,1679,4.30000000
CN4821500000000,48,215,"Hidalgo County, TX",Feb-22,373560,342196,31364,8.40000000
CN4821700000000,48,217,"Hill County, TX",Feb-22,17197,16469,728,4.20000000
CN4821900000000,48,219,"Hockley County, TX",Feb-22,10919,10424,495,4.50000000
CN4822100000000,48,221,"Hood County, TX",Feb-22,29515,28256,1259,4.30000000
CN4822300000000,48,223,"Hopkins County, TX",Feb-22,18097,17413,684,3.80000000
CN4822500000000,48,225,"Houston County, TX",Feb-22,10610,10161,449,4.20000000
CN4822700000000,48,227,"Howard County, TX",Feb-22,13514,12620,894,6.60000000
CN4822900000000,48,229,"Hudspeth County, TX",Feb-22,1892,1805,87,4.60000000
CN4823100000000,48,231,"Hunt County, TX",Feb-22,46494,44455,2039,4.40000000
CN4823300000000,48,233,"Hutchinson County, TX",Feb-22,8273,7813,460,5.60000000
CN4823500000000,48,235,"Irion County, TX",Feb-22,782,753,29,3.70000000
CN4823700000000,48,237,"Jack County, TX",Feb-22,3431,3273,158,4.60000000
CN4823900000000,48,239,"Jackson County, TX",Feb-22,7113,6825,288,4.00000000
CN4824100000000,48,241,"Jasper County, TX",Feb-22,12960,11862,1098,8.50000000
CN4824300000000,48,243,"Jeff Davis County, TX",Feb-22,1035,997,38,3.70000000
CN4824500000000,48,245,"Jefferson County, TX",Feb-22,102681,94098,8583,8.40000000
CN4824700000000,48,247,"Jim Hogg County, TX",Feb-22,1850,1699,151,8.20000000
CN4824900000000,48,249,"Jim Wells County, TX",Feb-22,15606,14329,1277,8.20000000
CN4825100000000,48,251,"Johnson County, TX",Feb-22,87934,84434,3500,4.00000000
CN4825300000000,48,253,"Jones County, TX",Feb-22,5820,5526,294,5.10000000
CN4825500000000,48,255,"Karnes County, TX",Feb-22,6997,6720,277,4.00000000
CN4825700000000,48,257,"Kaufman County, TX",Feb-22,74561,71513,3048,4.10000000
CN4825900000000,48,259,"Kendall County, TX",Feb-22,23380,22593,787,3.40000000
CN4826100000000,48,261,"Kenedy County, TX",Feb-22,201,190,11,5.50000000
CN4826300000000,48,263,"Kent County, TX",Feb-22,453,440,13,2.90000000
CN4826500000000,48,265,"Kerr County, TX",Feb-22,22086,21194,892,4.00000000
CN4826700000000,48,267,"Kimble County, TX",Feb-22,1924,1854,70,3.60000000
CN4826900000000,48,269,"King County, TX",Feb-22,631,627,4,0.60000000
CN4827100000000,48,271,"Kinney County, TX",Feb-22,1214,1144,70,5.80000000
CN4827300000000,48,273,"Kleberg County, TX",Feb-22,13362,12572,790,5.90000000
CN4827500000000,48,275,"Knox County, TX",Feb-22,1505,1438,67,4.50000000
CN4827700000000,48,277,"Lamar County, TX",Feb-22,24612,23390,1222,5.00000000
CN4827900000000,48,279,"Lamb County, TX",Feb-22,5322,5095,227,4.30000000
CN4828100000000,48,281,"Lampasas County, TX",Feb-22,9455,9062,393,4.20000000
CN4828300000000,48,283,"La Salle County, TX",Feb-22,3945,3812,133,3.40000000
CN4828500000000,48,285,"Lavaca County, TX",Feb-22,8665,8317,348,4.00000000
CN4828700000000,48,287,"Lee County, TX",Feb-22,8838,8486,352,4.00000000
CN4828900000000,48,289,"Leon County, TX",Feb-22,6197,5809,388,6.30000000
CN4829100000000,48,291,"Liberty County, TX",Feb-22,35441,32671,2770,7.80000000
CN4829300000000,48,293,"Limestone County, TX",Feb-22,8610,8141,469,5.40000000
CN4829500000000,48,295,"Lipscomb County, TX",Feb-22,1524,1473,51,3.30000000
CN4829700000000,48,297,"Live Oak County, TX",Feb-22,4883,4612,271,5.50000000
CN4829900000000,48,299,"Llano County, TX",Feb-22,8787,8389,398,4.50000000
CN4830100000000,48,301,"Loving County, TX",Feb-22,489,485,4,0.80000000
CN4830300000000,48,303,"Lubbock County, TX",Feb-22,164009,157950,6059,3.70000000
CN4830500000000,48,305,"Lynn County, TX",Feb-22,2911,2806,105,3.60000000
CN4830700000000,48,307,"McCulloch County, TX",Feb-22,3109,2941,168,5.40000000
CN4830900000000,48,309,"McLennan County, TX",Feb-22,125449,120375,5074,4.00000000
CN4831100000000,48,311,"McMullen County, TX",Feb-22,786,770,16,2.00000000
CN4831300000000,48,313,"Madison County, TX",Feb-22,4820,4575,245,5.10000000
CN4831500000000,48,315,"Marion County, TX",Feb-22,4263,3999,264,6.20000000
CN4831700000000,48,317,"Martin County, TX",Feb-22,2701,2593,108,4.00000000
CN4831900000000,48,319,"Mason County, TX",Feb-22,1824,1753,71,3.90000000
CN4832100000000,48,321,"Matagorda County, TX",Feb-22,16770,15483,1287,7.70000000
CN4832300000000,48,323,"Maverick County, TX",Feb-22,24055,21177,2878,12.00000000
CN4832500000000,48,325,"Medina County, TX",Feb-22,22448,21490,958,4.30000000
CN4832700000000,48,327,"Menard County, TX",Feb-22,811,774,37,4.60000000
CN4832900000000,48,329,"Midland County, TX",Feb-22,101468,97083,4385,4.30000000
CN4833100000000,48,331,"Milam County, TX",Feb-22,10455,9943,512,4.90000000
CN4833300000000,48,333,"Mills County, TX",Feb-22,1928,1834,94,4.90000000
CN4833500000000,48,335,"Mitchell County, TX",Feb-22,2369,2225,144,6.10000000
CN4833700000000,48,337,"Montague County, TX",Feb-22,9373,8994,379,4.00000000
CN4833900000000,48,339,"Montgomery County, TX",Feb-22,299110,284665,14445,4.80000000
CN4834100000000,48,341,"Moore County, TX",Feb-22,11241,10915,326,2.90000000
CN4834300000000,48,343,"Morris County, TX",Feb-22,4551,4148,403,8.90000000
CN4834500000000,48,345,"Motley County, TX",Feb-22,475,451,24,5.10000000
CN4834700000000,48,347,"Nacogdoches County, TX",Feb-22,28391,27052,1339,4.70000000
CN4834900000000,48,349,"Navarro County, TX",Feb-22,23729,22657,1072,4.50000000
CN4835100000000,48,351,"Newton County, TX",Feb-22,4972,4524,448,9.00000000
CN4835300000000,48,353,"Nolan County, TX",Feb-22,7142,6851,291,4.10000000
CN4835500000000,48,355,"Nueces County, TX",Feb-22,165388,155460,9928,6.00000000
CN4835700000000,48,357,"Ochiltree County, TX",Feb-22,3970,3820,150,3.80000000
CN4835900000000,48,359,"Oldham County, TX",Feb-22,948,917,31,3.30000000
CN4836100000000,48,361,"Orange County, TX",Feb-22,35268,32579,2689,7.60000000
CN4836300000000,48,363,"Palo Pinto County, TX",Feb-22,12779,12163,616,4.80000000
CN4836500000000,48,365,"Panola County, TX",Feb-22,9852,9270,582,5.90000000
CN4836700000000,48,367,"Parker County, TX",Feb-22,73638,70899,2739,3.70000000
CN4836900000000,48,369,"Parmer County, TX",Feb-22,5111,4984,127,2.50000000
CN4837100000000,48,371,"Pecos County, TX",Feb-22,5916,5552,364,6.20000000
CN4837300000000,48,373,"Polk County, TX",Feb-22,18669,17315,1354,7.30000000
CN4837500000000,48,375,"Potter County, TX",Feb-22,55029,52982,2047,3.70000000
CN4837700000000,48,377,"Presidio County, TX",Feb-22,3142,2885,257,8.20000000
CN4837900000000,48,379,"Rains County, TX",Feb-22,6633,6391,242,3.60000000
CN4838100000000,48,381,"Randall County, TX",Feb-22,76075,73710,2365,3.10000000
CN4838300000000,48,383,"Reagan County, TX",Feb-22,1615,1527,88,5.40000000
CN4838500000000,48,385,"Real County, TX",Feb-22,1097,1034,63,5.70000000
CN4838700000000,48,387,"Red River County, TX",Feb-22,5395,5096,299,5.50000000
CN4838900000000,48,389,"Reeves County, TX",Feb-22,9115,8712,403,4.40000000
CN4839100000000,48,391,"Refugio County, TX",Feb-22,3084,2904,180,5.80000000
CN4839300000000,48,393,"Roberts County, TX",Feb-22,399,380,19,4.80000000
CN4839500000000,48,395,"Robertson County, TX",Feb-22,7842,7491,351,4.50000000
CN4839700000000,48,397,"Rockwall County, TX",Feb-22,58688,56560,2128,3.60000000
CN4839900000000,48,399,"Runnels County, TX",Feb-22,4684,4519,165,3.50000000
CN4840100000000,48,401,"Rusk County, TX",Feb-22,22375,21254,1121,5.00000000
CN4840300000000,48,403,"Sabine County, TX",Feb-22,4006,3650,356,8.90000000
CN4840500000000,48,405,"San Augustine County, TX",Feb-22,3027,2807,220,7.30000000
CN4840700000000,48,407,"San Jacinto County, TX",Feb-22,12021,11275,746,6.20000000
CN4840900000000,48,409,"San Patricio County, TX",Feb-22,29838,27443,2395,8.00000000
CN4841100000000,48,411,"San Saba County, TX",Feb-22,2229,2138,91,4.10000000
CN4841300000000,48,413,"Schleicher County, TX",Feb-22,1182,1128,54,4.60000000
CN4841500000000,48,415,"Scurry County, TX",Feb-22,5964,5626,338,5.70000000
CN4841700000000,48,417,"Shackelford County, TX",Feb-22,1884,1827,57,3.00000000
CN4841900000000,48,419,"Shelby County, TX",Feb-22,11628,11075,553,4.80000000
CN4842100000000,48,421,"Sherman County, TX",Feb-22,1487,1446,41,2.80000000
CN4842300000000,48,423,"Smith County, TX",Feb-22,111842,107086,4756,4.30000000
CN4842500000000,48,425,"Somervell County, TX",Feb-22,4500,4316,184,4.10000000
CN4842700000000,48,427,"Starr County, TX",Feb-22,25631,21567,4064,15.90000000
CN4842900000000,48,429,"Stephens County, TX",Feb-22,4367,4196,171,3.90000000
CN4843100000000,48,431,"Sterling County, TX",Feb-22,600,574,26,4.30000000
CN4843300000000,48,433,"Stonewall County, TX",Feb-22,588,565,23,3.90000000
CN4843500000000,48,435,"Sutton County, TX",Feb-22,1111,1033,78,7.00000000
CN4843700000000,48,437,"Swisher County, TX",Feb-22,2625,2520,105,4.00000000
CN4843900000000,48,439,"Tarrant County, TX",Feb-22,1127267,1079670,47597,4.20000000
CN4844100000000,48,441,"Taylor County, TX",Feb-22,68137,65597,2540,3.70000000
CN4844300000000,48,443,"Terrell County, TX",Feb-22,434,417,17,3.90000000
CN4844500000000,48,445,"Terry County, TX",Feb-22,4823,4578,245,5.10000000
CN4844700000000,48,447,"Throckmorton County, TX",Feb-22,1202,1176,26,2.20000000
CN4844900000000,48,449,"Titus County, TX",Feb-22,13851,13190,661,4.80000000
CN4845100000000,48,451,"Tom Green County, TX",Feb-22,54889,52659,2230,4.10000000
CN4845300000000,48,453,"Travis County, TX",Feb-22,795999,770032,25967,3.30000000
CN4845500000000,48,455,"Trinity County, TX",Feb-22,5352,4983,369,6.90000000
CN4845700000000,48,457,"Tyler County, TX",Feb-22,7601,7035,566,7.40000000
CN4845900000000,48,459,"Upshur County, TX",Feb-22,17830,16878,952,5.30000000
CN4846100000000,48,461,"Upton County, TX",Feb-22,1809,1728,81,4.50000000
CN4846300000000,48,463,"Uvalde County, TX",Feb-22,11212,10667,545,4.90000000
CN4846500000000,48,465,"Val Verde County, TX",Feb-22,22103,20901,1202,5.40000000
CN4846700000000,48,467,"Van Zandt County, TX",Feb-22,27200,26137,1063,3.90000000
CN4846900000000,48,469,"Victoria County, TX",Feb-22,41019,38791,2228,5.40000000
CN4847100000000,48,471,"Walker County, TX",Feb-22,23964,22640,1324,5.50000000
CN4847300000000,48,473,"Waller County, TX",Feb-22,25282,23983,1299,5.10000000
CN4847500000000,48,475,"Ward County, TX",Feb-22,6009,5690,319,5.30000000
CN4847700000000,48,477,"Washington County, TX",Feb-22,15023,14366,657,4.40000000
CN4847900000000,48,479,"Webb County, TX",Feb-22,118697,112407,6290,5.30000000
CN4848100000000,48,481,"Wharton County, TX",Feb-22,21220,20214,1006,4.70000000
CN4848300000000,48,483,"Wheeler County, TX",Feb-22,1949,1846,103,5.30000000
CN4848500000000,48,485,"Wichita County, TX",Feb-22,55530,53062,2468,4.40000000
CN4848700000000,48,487,"Wilbarger County, TX",Feb-22,4867,4582,285,5.90000000
CN4848900000000,48,489,"Willacy County, TX",Feb-22,7341,6600,741,10.10000000
CN4849100000000,48,491,"Williamson County, TX",Feb-22,353017,341294,11723,3.30000000
CN4849300000000,48,493,"Wilson County, TX",Feb-22,25674,24709,965,3.80000000
CN4849500000000,48,495,"Winkler County, TX",Feb-22,3757,3509,248,6.60000000
CN4849700000000,48,497,"Wise County, TX",Feb-22,33904,32540,1364,4.00000000
CN4849900000000,48,499,"Wood County, TX",Feb-22,17972,17044,928,5.20000000
CN4850100000000,48,501,"Yoakum County, TX",Feb-22,3276,3084,192,5.90000000
CN4850300000000,48,503,"Young County, TX",Feb-22,8086,7768,318,3.90000000
CN4850500000000,48,505,"Zapata County, TX",Feb-22,4463,3994,469,10.50000000
CN4850700000000,48,507,"Zavala County, TX",Feb-22,3329,2963,366,11.00000000
CN4900100000000,49,001,"Beaver County, UT",Feb-22,3025,2956,69,2.30000000
CN4900300000000,49,003,"Box Elder County, UT",Feb-22,27385,26828,557,2.00000000
CN4900500000000,49,005,"Cache County, UT",Feb-22,70888,69703,1185,1.70000000
CN4900700000000,49,007,"Carbon County, UT",Feb-22,8508,8222,286,3.40000000
CN4900900000000,49,009,"Daggett County, UT",Feb-22,373,354,19,5.10000000
CN4901100000000,49,011,"Davis County, UT",Feb-22,180964,177578,3386,1.90000000
CN4901300000000,49,013,"Duchesne County, UT",Feb-22,7821,7527,294,3.80000000
CN4901500000000,49,015,"Emery County, UT",Feb-22,4383,4238,145,3.30000000
CN4901700000000,49,017,"Garfield County, UT",Feb-22,2448,2167,281,11.50000000
CN4901900000000,49,019,"Grand County, UT",Feb-22,5970,5587,383,6.40000000
CN4902100000000,49,021,"Iron County, UT",Feb-22,27241,26642,599,2.20000000
CN4902300000000,49,023,"Juab County, UT",Feb-22,6373,6268,105,1.60000000
CN4902500000000,49,025,"Kane County, UT",Feb-22,3831,3723,108,2.80000000
CN4902700000000,49,027,"Millard County, UT",Feb-22,6254,6127,127,2.00000000
CN4902900000000,49,029,"Morgan County, UT",Feb-22,5855,5761,94,1.60000000
CN4903100000000,49,031,"Piute County, UT",Feb-22,493,474,19,3.90000000
CN4903300000000,49,033,"Rich County, UT",Feb-22,1052,1020,32,3.00000000
CN4903500000000,49,035,"Salt Lake County, UT",Feb-22,661541,647198,14343,2.20000000
CN4903700000000,49,037,"San Juan County, UT",Feb-22,5442,5130,312,5.70000000
CN4903900000000,49,039,"Sanpete County, UT",Feb-22,13478,13168,310,2.30000000
CN4904100000000,49,041,"Sevier County, UT",Feb-22,10127,9824,303,3.00000000
CN4904300000000,49,043,"Summit County, UT",Feb-22,27403,26924,479,1.70000000
CN4904500000000,49,045,"Tooele County, UT",Feb-22,37205,36353,852,2.30000000
CN4904700000000,49,047,"Uintah County, UT",Feb-22,13703,13128,575,4.20000000
CN4904900000000,49,049,"Utah County, UT",Feb-22,343022,336978,6044,1.80000000
CN4905100000000,49,051,"Wasatch County, UT",Feb-22,17304,16944,360,2.10000000
CN4905300000000,49,053,"Washington County, UT",Feb-22,85294,83292,2002,2.30000000
CN4905500000000,49,055,"Wayne County, UT",Feb-22,1418,1324,94,6.60000000
CN4905700000000,49,057,"Weber County, UT",Feb-22,132994,129888,3106,2.30000000
CN5000100000000,50,001,"Addison County, VT",Feb-22,19834,19281,553,2.80000000
CN5000300000000,50,003,"Bennington County, VT",Feb-22,17003,16411,592,3.50000000
CN5000500000000,50,005,"Caledonia County, VT",Feb-22,13806,13333,473,3.40000000
CN5000700000000,50,007,"Chittenden County, VT",Feb-22,93664,91933,1731,1.80000000
CN5000900000000,50,009,"Essex County, VT",Feb-22,2569,2462,107,4.20000000
CN5001100000000,50,011,"Franklin County, VT",Feb-22,27029,26210,819,3.00000000
CN5001300000000,50,013,"Grand Isle County, VT",Feb-22,4055,3857,198,4.90000000
CN5001500000000,50,015,"Lamoille County, VT",Feb-22,13521,12990,531,3.90000000
CN5001700000000,50,017,"Orange County, VT",Feb-22,15202,14744,458,3.00000000
CN5001900000000,50,019,"Orleans County, VT",Feb-22,13005,12267,738,5.70000000
CN5002100000000,50,021,"Rutland County, VT",Feb-22,29198,28203,995,3.40000000
CN5002300000000,50,023,"Washington County, VT",Feb-22,32743,31907,836,2.60000000
CN5002500000000,50,025,"Windham County, VT",Feb-22,20485,19886,599,2.90000000
CN5002700000000,50,027,"Windsor County, VT",Feb-22,28858,28248,610,2.10000000
CN5100100000000,51,001,"Accomack County, VA",Feb-22,14922,14372,550,3.70000000
CN5100300000000,51,003,"Albemarle County, VA",Feb-22,56404,55004,1400,2.50000000
CN5100500000000,51,005,"Alleghany County, VA",Feb-22,6614,6389,225,3.40000000
CN5100700000000,51,007,"Amelia County, VA",Feb-22,5921,5754,167,2.80000000
CN5100900000000,51,009,"Amherst County, VA",Feb-22,14395,13965,430,3.00000000
CN5101100000000,51,011,"Appomattox County, VA",Feb-22,6893,6692,201,2.90000000
CN5101300000000,51,013,"Arlington County, VA",Feb-22,152673,149475,3198,2.10000000
CN5101500000000,51,015,"Augusta County, VA",Feb-22,36920,36044,876,2.40000000
CN5101700000000,51,017,"Bath County, VA",Feb-22,2258,2185,73,3.20000000
CN5101900000000,51,019,"Bedford County, VA",Feb-22,37491,36474,1017,2.70000000
CN5102100000000,51,021,"Bland County, VA",Feb-22,2792,2715,77,2.80000000
CN5102300000000,51,023,"Botetourt County, VA",Feb-22,17024,16624,400,2.30000000
CN5102500000000,51,025,"Brunswick County, VA",Feb-22,5840,5527,313,5.40000000
CN5102700000000,51,027,"Buchanan County, VA",Feb-22,6421,6078,343,5.30000000
CN5102900000000,51,029,"Buckingham County, VA",Feb-22,6278,5993,285,4.50000000
CN5103100000000,51,031,"Campbell County, VA",Feb-22,25139,24375,764,3.00000000
CN5103300000000,51,033,"Caroline County, VA",Feb-22,14617,14116,501,3.40000000
CN5103500000000,51,035,"Carroll County, VA",Feb-22,13065,12596,469,3.60000000
CN5103600000000,51,036,"Charles City County, VA",Feb-22,3392,3277,115,3.40000000
CN5103700000000,51,037,"Charlotte County, VA",Feb-22,5495,5353,142,2.60000000
CN5104100000000,51,041,"Chesterfield County, VA",Feb-22,184051,179034,5017,2.70000000
CN5104300000000,51,043,"Clarke County, VA",Feb-22,7381,7210,171,2.30000000
CN5104500000000,51,045,"Craig County, VA",Feb-22,2228,2171,57,2.60000000
CN5104700000000,51,047,"Culpeper County, VA",Feb-22,24785,24128,657,2.70000000
CN5104900000000,51,049,"Cumberland County, VA",Feb-22,4655,4498,157,3.40000000
CN5105100000000,51,051,"Dickenson County, VA",Feb-22,4917,4720,197,4.00000000
CN5105300000000,51,053,"Dinwiddie County, VA",Feb-22,13132,12678,454,3.50000000
CN5105700000000,51,057,"Essex County, VA",Feb-22,5241,5042,199,3.80000000
CN5105900000000,51,059,"Fairfax County, VA",Feb-22,622368,606999,15369,2.50000000
CN5106100000000,51,061,"Fauquier County, VA",Feb-22,36367,35507,860,2.40000000
CN5106300000000,51,063,"Floyd County, VA",Feb-22,8413,8206,207,2.50000000
CN5106500000000,51,065,"Fluvanna County, VA",Feb-22,13850,13514,336,2.40000000
CN5106700000000,51,067,"Franklin County, VA",Feb-22,25513,24806,707,2.80000000
CN5106900000000,51,069,"Frederick County, VA",Feb-22,49920,48797,1123,2.20000000
CN5107100000000,51,071,"Giles County, VA",Feb-22,8145,7909,236,2.90000000
CN5107300000000,51,073,"Gloucester County, VA",Feb-22,18701,18218,483,2.60000000
CN5107500000000,51,075,"Goochland County, VA",Feb-22,11249,10966,283,2.50000000
CN5107700000000,51,077,"Grayson County, VA",Feb-22,8335,8121,214,2.60000000
CN5107900000000,51,079,"Greene County, VA",Feb-22,10336,10118,218,2.10000000
CN5108100000000,51,081,"Greensville County, VA",Feb-22,4384,4207,177,4.00000000
CN5108300000000,51,083,"Halifax County, VA",Feb-22,15243,14653,590,3.90000000
CN5108500000000,51,085,"Hanover County, VA",Feb-22,56945,55641,1304,2.30000000
CN5108700000000,51,087,"Henrico County, VA",Feb-22,176524,171337,5187,2.90000000
CN5108900000000,51,089,"Henry County, VA",Feb-22,24604,23762,842,3.40000000
CN5109100000000,51,091,"Highland County, VA",Feb-22,1176,1140,36,3.10000000
CN5109300000000,51,093,"Isle of Wight County, VA",Feb-22,18886,18373,513,2.70000000
CN5109500000000,51,095,"James City County, VA",Feb-22,35668,34608,1060,3.00000000
CN5109700000000,51,097,"King and Queen County, VA",Feb-22,3858,3768,90,2.30000000
CN5109900000000,51,099,"King George County, VA",Feb-22,14452,14113,339,2.30000000
CN5110100000000,51,101,"King William County, VA",Feb-22,9110,8871,239,2.60000000
CN5110300000000,51,103,"Lancaster County, VA",Feb-22,5189,4914,275,5.30000000
CN5110500000000,51,105,"Lee County, VA",Feb-22,8370,8096,274,3.30000000
CN5110700000000,51,107,"Loudoun County, VA",Feb-22,225277,220197,5080,2.30000000
CN5110900000000,51,109,"Louisa County, VA",Feb-22,20569,20016,553,2.70000000
CN5111100000000,51,111,"Lunenburg County, VA",Feb-22,5155,4994,161,3.10000000
CN5111300000000,51,113,"Madison County, VA",Feb-22,7408,7266,142,1.90000000
CN5111500000000,51,115,"Mathews County, VA",Feb-22,3929,3826,103,2.60000000
CN5111700000000,51,117,"Mecklenburg County, VA",Feb-22,12860,12381,479,3.70000000
CN5111900000000,51,119,"Middlesex County, VA",Feb-22,5139,5004,135,2.60000000
CN5112100000000,51,121,"Montgomery County, VA",Feb-22,52188,50988,1200,2.30000000
CN5112500000000,51,125,"Nelson County, VA",Feb-22,7167,6975,192,2.70000000
CN5112700000000,51,127,"New Kent County, VA",Feb-22,12556,12278,278,2.20000000
CN5113100000000,51,131,"Northampton County, VA",Feb-22,5122,4891,231,4.50000000
CN5113300000000,51,133,"Northumberland County, VA",Feb-22,5530,5258,272,4.90000000
CN5113500000000,51,135,"Nottoway County, VA",Feb-22,7236,7022,214,3.00000000
CN5113700000000,51,137,"Orange County, VA",Feb-22,17242,16752,490,2.80000000
CN5113900000000,51,139,"Page County, VA",Feb-22,12071,11578,493,4.10000000
CN5114100000000,51,141,"Patrick County, VA",Feb-22,7139,6871,268,3.80000000
CN5114300000000,51,143,"Pittsylvania County, VA",Feb-22,30247,29311,936,3.10000000
CN5114500000000,51,145,"Powhatan County, VA",Feb-22,13944,13625,319,2.30000000
CN5114700000000,51,147,"Prince Edward County, VA",Feb-22,10563,10194,369,3.50000000
CN5114900000000,51,149,"Prince George County, VA",Feb-22,14628,14115,513,3.50000000
CN5115300000000,51,153,"Prince William County, VA",Feb-22,244261,237316,6945,2.80000000
CN5115500000000,51,155,"Pulaski County, VA",Feb-22,16836,16299,537,3.20000000
CN5115700000000,51,157,"Rappahannock County, VA",Feb-22,3599,3516,83,2.30000000
CN5115900000000,51,159,"Richmond County, VA",Feb-22,3969,3848,121,3.00000000
CN5116100000000,51,161,"Roanoke County, VA",Feb-22,48221,47064,1157,2.40000000
CN5116300000000,51,163,"Rockbridge County, VA",Feb-22,10702,10411,291,2.70000000
CN5116500000000,51,165,"Rockingham County, VA",Feb-22,42182,41239,943,2.20000000
CN5116700000000,51,167,"Russell County, VA",Feb-22,11000,10605,395,3.60000000
CN5116900000000,51,169,"Scott County, VA",Feb-22,8889,8635,254,2.90000000
CN5117100000000,51,171,"Shenandoah County, VA",Feb-22,22131,21571,560,2.50000000
CN5117300000000,51,173,"Smyth County, VA",Feb-22,14398,13962,436,3.00000000
CN5117500000000,51,175,"Southampton County, VA",Feb-22,8639,8401,238,2.80000000
CN5117700000000,51,177,"Spotsylvania County, VA",Feb-22,67408,65465,1943,2.90000000
CN5117900000000,51,179,"Stafford County, VA",Feb-22,73337,71351,1986,2.70000000
CN5118100000000,51,181,"Surry County, VA",Feb-22,3477,3372,105,3.00000000
CN5118300000000,51,183,"Sussex County, VA",Feb-22,3440,3260,180,5.20000000
CN5118500000000,51,185,"Tazewell County, VA",Feb-22,15614,14934,680,4.40000000
CN5118700000000,51,187,"Warren County, VA",Feb-22,20152,19613,539,2.70000000
CN5119100000000,51,191,"Washington County, VA",Feb-22,25569,24858,711,2.80000000
CN5119300000000,51,193,"Westmoreland County, VA",Feb-22,9634,9303,331,3.40000000
CN5119500000000,51,195,"Wise County, VA",Feb-22,13575,13058,517,3.80000000
CN5119700000000,51,197,"Wythe County, VA",Feb-22,14009,13574,435,3.10000000
CN5119900000000,51,199,"York County, VA",Feb-22,31899,31067,832,2.60000000
CN5151000000000,51,510,"Alexandria city, VA",Feb-22,98302,95775,2527,2.60000000
CN5152000000000,51,520,"Bristol city, VA",Feb-22,7415,7154,261,3.50000000
CN5153000000000,51,530,"Buena Vista city, VA",Feb-22,2987,2894,93,3.10000000
CN5154000000000,51,540,"Charlottesville city, VA",Feb-22,25050,24402,648,2.60000000
CN5155000000000,51,550,"Chesapeake city, VA",Feb-22,119186,115706,3480,2.90000000
CN5157000000000,51,570,"Colonial Heights city, VA",Feb-22,8146,7860,286,3.50000000
CN5158000000000,51,580,"Covington city, VA",Feb-22,2318,2213,105,4.50000000
CN5159000000000,51,590,"Danville city, VA",Feb-22,18868,17866,1002,5.30000000
CN5159500000000,51,595,"Emporia city, VA",Feb-22,2393,2241,152,6.40000000
CN5160000000000,51,600,"Fairfax city, VA",Feb-22,12597,12281,316,2.50000000
CN5161000000000,51,610,"Falls Church city, VA",Feb-22,8322,8164,158,1.90000000
CN5162000000000,51,620,"Franklin city, VA",Feb-22,3444,3270,174,5.10000000
CN5163000000000,51,630,"Fredericksburg city, VA",Feb-22,13985,13506,479,3.40000000
CN5164000000000,51,640,"Galax city, VA",Feb-22,2894,2807,87,3.00000000
CN5165000000000,51,650,"Hampton city, VA",Feb-22,62390,59605,2785,4.50000000
CN5166000000000,51,660,"Harrisonburg city, VA",Feb-22,24696,23948,748,3.00000000
CN5167000000000,51,670,"Hopewell city, VA",Feb-22,9285,8744,541,5.80000000
CN5167800000000,51,678,"Lexington city, VA",Feb-22,2157,2079,78,3.60000000
CN5168000000000,51,680,"Lynchburg city, VA",Feb-22,34731,33429,1302,3.70000000
CN5168300000000,51,683,"Manassas city, VA",Feb-22,21221,20620,601,2.80000000
CN5168500000000,51,685,"Manassas Park city, VA",Feb-22,9567,9312,255,2.70000000
CN5169000000000,51,690,"Martinsville city, VA",Feb-22,5722,5387,335,5.90000000
CN5170000000000,51,700,"Newport News city, VA",Feb-22,85714,82010,3704,4.30000000
CN5171000000000,51,710,"Norfolk city, VA",Feb-22,106872,102308,4564,4.30000000
CN5172000000000,51,720,"Norton city, VA",Feb-22,1693,1633,60,3.50000000
CN5173000000000,51,730,"Petersburg city, VA",Feb-22,12329,11322,1007,8.20000000
CN5173500000000,51,735,"Poquoson city, VA",Feb-22,6089,5952,137,2.20000000
CN5174000000000,51,740,"Portsmouth city, VA",Feb-22,42979,40826,2153,5.00000000
CN5175000000000,51,750,"Radford city, VA",Feb-22,9011,8750,261,2.90000000
CN5176000000000,51,760,"Richmond city, VA",Feb-22,115756,111066,4690,4.10000000
CN5177000000000,51,770,"Roanoke city, VA",Feb-22,47711,46034,1677,3.50000000
CN5177500000000,51,775,"Salem city, VA",Feb-22,12469,12129,340,2.70000000
CN5179000000000,51,790,"Staunton city, VA",Feb-22,12104,11778,326,2.70000000
CN5180000000000,51,800,"Suffolk city, VA",Feb-22,43889,42462,1427,3.30000000
CN5181000000000,51,810,"Virginia Beach city, VA",Feb-22,223303,217207,6096,2.70000000
CN5182000000000,51,820,"Waynesboro city, VA",Feb-22,10521,10220,301,2.90000000
CN5183000000000,51,830,"Williamsburg city, VA",Feb-22,6553,6304,249,3.80000000
CN5184000000000,51,840,"Winchester city, VA",Feb-22,14594,14218,376,2.60000000
CN5300100000000,53,001,"Adams County, WA",Feb-22,9414,8776,638,6.80000000
CN5300300000000,53,003,"Asotin County, WA",Feb-22,10937,10494,443,4.10000000
CN5300500000000,53,005,"Benton County, WA",Feb-22,107075,100966,6109,5.70000000
CN5300700000000,53,007,"Chelan County, WA",Feb-22,43757,41111,2646,6.00000000
CN5300900000000,53,009,"Clallam County, WA",Feb-22,31019,29004,2015,6.50000000
CN5301100000000,53,011,"Clark County, WA",Feb-22,255824,242792,13032,5.10000000
CN5301300000000,53,013,"Columbia County, WA",Feb-22,1866,1747,119,6.40000000
CN5301500000000,53,015,"Cowlitz County, WA",Feb-22,50308,47212,3096,6.20000000
CN5301700000000,53,017,"Douglas County, WA",Feb-22,21451,20106,1345,6.30000000
CN5301900000000,53,019,"Ferry County, WA",Feb-22,2496,2237,259,10.40000000
CN5302100000000,53,021,"Franklin County, WA",Feb-22,43697,40357,3340,7.60000000
CN5302300000000,53,023,"Garfield County, WA",Feb-22,861,796,65,7.50000000
CN5302500000000,53,025,"Grant County, WA",Feb-22,47511,43728,3783,8.00000000
CN5302700000000,53,027,"Grays Harbor County, WA",Feb-22,30311,28024,2287,7.50000000
CN5302900000000,53,029,"Island County, WA",Feb-22,37241,35250,1991,5.30000000
CN5303100000000,53,031,"Jefferson County, WA",Feb-22,13049,12254,795,6.10000000
CN5303300000000,53,033,"King County, WA",Feb-22,1332725,1294190,38535,2.90000000
CN5303500000000,53,035,"Kitsap County, WA",Feb-22,132998,126720,6278,4.70000000
CN5303700000000,53,037,"Kittitas County, WA",Feb-22,23415,21843,1572,6.70000000
CN5303900000000,53,039,"Klickitat County, WA",Feb-22,10455,9779,676,6.50000000
CN5304100000000,53,041,"Lewis County, WA",Feb-22,36013,33683,2330,6.50000000
CN5304300000000,53,043,"Lincoln County, WA",Feb-22,4869,4582,287,5.90000000
CN5304500000000,53,045,"Mason County, WA",Feb-22,26236,24429,1807,6.90000000
CN5304700000000,53,047,"Okanogan County, WA",Feb-22,19307,17687,1620,8.40000000
CN5304900000000,53,049,"Pacific County, WA",Feb-22,8966,8288,678,7.60000000
CN5305100000000,53,051,"Pend Oreille County, WA",Feb-22,5406,4966,440,8.10000000
CN5305300000000,53,053,"Pierce County, WA",Feb-22,463362,436504,26858,5.80000000
CN5305500000000,53,055,"San Juan County, WA",Feb-22,8813,8409,404,4.60000000
CN5305700000000,53,057,"Skagit County, WA",Feb-22,63787,59928,3859,6.00000000
CN5305900000000,53,059,"Skamania County, WA",Feb-22,5722,5376,346,6.00000000
CN5306100000000,53,061,"Snohomish County, WA",Feb-22,455027,439364,15663,3.40000000
CN5306300000000,53,063,"Spokane County, WA",Feb-22,273363,258730,14633,5.40000000
CN5306500000000,53,065,"Stevens County, WA",Feb-22,20094,18513,1581,7.90000000
CN5306700000000,53,067,"Thurston County, WA",Feb-22,151738,144255,7483,4.90000000
CN5306900000000,53,069,"Wahkiakum County, WA",Feb-22,1412,1311,101,7.20000000
CN5307100000000,53,071,"Walla Walla County, WA",Feb-22,31713,30132,1581,5.00000000
CN5307300000000,53,073,"Whatcom County, WA",Feb-22,118863,112411,6452,5.40000000
CN5307500000000,53,075,"Whitman County, WA",Feb-22,23963,22855,1108,4.60000000
CN5307700000000,53,077,"Yakima County, WA",Feb-22,130193,119575,10618,8.20000000
CN5400100000000,54,001,"Barbour County, WV",Feb-22,7274,6925,349,4.80000000
CN5400300000000,54,003,"Berkeley County, WV",Feb-22,60174,58423,1751,2.90000000
CN5400500000000,54,005,"Boone County, WV",Feb-22,7209,6831,378,5.20000000
CN5400700000000,54,007,"Braxton County, WV",Feb-22,5141,4730,411,8.00000000
CN5400900000000,54,009,"Brooke County, WV",Feb-22,9910,9373,537,5.40000000
CN5401100000000,54,011,"Cabell County, WV",Feb-22,41546,39979,1567,3.80000000
CN5401300000000,54,013,"Calhoun County, WV",Feb-22,2633,2299,334,12.70000000
CN5401500000000,54,015,"Clay County, WV",Feb-22,3057,2826,231,7.60000000
CN5401700000000,54,017,"Doddridge County, WV",Feb-22,3815,3681,134,3.50000000
CN5401900000000,54,019,"Fayette County, WV",Feb-22,15870,14965,905,5.70000000
CN5402100000000,54,021,"Gilmer County, WV",Feb-22,2363,2207,156,6.60000000
CN5402300000000,54,023,"Grant County, WV",Feb-22,6047,5771,276,4.60000000
CN5402500000000,54,025,"Greenbrier County, WV",Feb-22,15526,14871,655,4.20000000
CN5402700000000,54,027,"Hampshire County, WV",Feb-22,11294,10992,302,2.70000000
CN5402900000000,54,029,"Hancock County, WV",Feb-22,13034,12310,724,5.60000000
CN5403100000000,54,031,"Hardy County, WV",Feb-22,5816,5557,259,4.50000000
CN5403300000000,54,033,"Harrison County, WV",Feb-22,33767,32296,1471,4.40000000
CN5403500000000,54,035,"Jackson County, WV",Feb-22,12120,11483,637,5.30000000
CN5403700000000,54,037,"Jefferson County, WV",Feb-22,30529,29788,741,2.40000000
CN5403900000000,54,039,"Kanawha County, WV",Feb-22,81298,77726,3572,4.40000000
CN5404100000000,54,041,"Lewis County, WV",Feb-22,6094,5696,398,6.50000000
CN5404300000000,54,043,"Lincoln County, WV",Feb-22,7151,6701,450,6.30000000
CN5404500000000,54,045,"Logan County, WV",Feb-22,11095,10511,584,5.30000000
CN5404700000000,54,047,"McDowell County, WV",Feb-22,4238,3932,306,7.20000000
CN5404900000000,54,049,"Marion County, WV",Feb-22,25507,24275,1232,4.80000000
CN5405100000000,54,051,"Marshall County, WV",Feb-22,13442,12554,888,6.60000000
CN5405300000000,54,053,"Mason County, WV",Feb-22,10202,9662,540,5.30000000
CN5405500000000,54,055,"Mercer County, WV",Feb-22,20615,19587,1028,5.00000000
CN5405700000000,54,057,"Mineral County, WV",Feb-22,12294,11750,544,4.40000000
CN5405900000000,54,059,"Mingo County, WV",Feb-22,6114,5648,466,7.60000000
CN5406100000000,54,061,"Monongalia County, WV",Feb-22,56542,54537,2005,3.50000000
CN5406300000000,54,063,"Monroe County, WV",Feb-22,6230,6034,196,3.10000000
CN5406500000000,54,065,"Morgan County, WV",Feb-22,8562,8315,247,2.90000000
CN5406700000000,54,067,"Nicholas County, WV",Feb-22,9107,8590,517,5.70000000
CN5406900000000,54,069,"Ohio County, WV",Feb-22,20236,19322,914,4.50000000
CN5407100000000,54,071,"Pendleton County, WV",Feb-22,3832,3718,114,3.00000000
CN5407300000000,54,073,"Pleasants County, WV",Feb-22,2715,2525,190,7.00000000
CN5407500000000,54,075,"Pocahontas County, WV",Feb-22,4224,4060,164,3.90000000
CN5407700000000,54,077,"Preston County, WV",Feb-22,15977,15248,729,4.60000000
CN5407900000000,54,079,"Putnam County, WV",Feb-22,27061,26070,991,3.70000000
CN5408100000000,54,081,"Raleigh County, WV",Feb-22,29729,28439,1290,4.30000000
CN5408300000000,54,083,"Randolph County, WV",Feb-22,12090,11456,634,5.20000000
CN5408500000000,54,085,"Ritchie County, WV",Feb-22,4310,4076,234,5.40000000
CN5408700000000,54,087,"Roane County, WV",Feb-22,5153,4695,458,8.90000000
CN5408900000000,54,089,"Summers County, WV",Feb-22,4469,4285,184,4.10000000
CN5409100000000,54,091,"Taylor County, WV",Feb-22,7930,7558,372,4.70000000
CN5409300000000,54,093,"Tucker County, WV",Feb-22,3406,3237,169,5.00000000
CN5409500000000,54,095,"Tyler County, WV",Feb-22,3055,2813,242,7.90000000
CN5409700000000,54,097,"Upshur County, WV",Feb-22,9910,9345,565,5.70000000
CN5409900000000,54,099,"Wayne County, WV",Feb-22,15666,14948,718,4.60000000
CN5410100000000,54,101,"Webster County, WV",Feb-22,3255,3080,175,5.40000000
CN5410300000000,54,103,"Wetzel County, WV",Feb-22,7022,6530,492,7.00000000
CN5410500000000,54,105,"Wirt County, WV",Feb-22,2302,2119,183,7.90000000
CN5410700000000,54,107,"Wood County, WV",Feb-22,36688,34838,1850,5.00000000
CN5410900000000,54,109,"Wyoming County, WV",Feb-22,7300,6952,348,4.80000000
CN5500100000000,55,001,"Adams County, WI",Feb-22,7900,7374,526,6.70000000
CN5500300000000,55,003,"Ashland County, WI",Feb-22,7417,7061,356,4.80000000
CN5500500000000,55,005,"Barron County, WI",Feb-22,24512,23457,1055,4.30000000
CN5500700000000,55,007,"Bayfield County, WI",Feb-22,7436,6951,485,6.50000000
CN5500900000000,55,009,"Brown County, WI",Feb-22,142716,138572,4144,2.90000000
CN5501100000000,55,011,"Buffalo County, WI",Feb-22,6557,6225,332,5.10000000
CN5501300000000,55,013,"Burnett County, WI",Feb-22,7373,6891,482,6.50000000
CN5501500000000,55,015,"Calumet County, WI",Feb-22,28131,27436,695,2.50000000
CN5501700000000,55,017,"Chippewa County, WI",Feb-22,34447,32932,1515,4.40000000
CN5501900000000,55,019,"Clark County, WI",Feb-22,18380,17772,608,3.30000000
CN5502100000000,55,021,"Columbia County, WI",Feb-22,32465,31407,1058,3.30000000
CN5502300000000,55,023,"Crawford County, WI",Feb-22,7536,7132,404,5.40000000
CN5502500000000,55,025,"Dane County, WI",Feb-22,332882,325232,7650,2.30000000
CN5502700000000,55,027,"Dodge County, WI",Feb-22,48409,46938,1471,3.00000000
CN5502900000000,55,029,"Door County, WI",Feb-22,14127,13448,679,4.80000000
CN5503100000000,55,031,"Douglas County, WI",Feb-22,23534,22416,1118,4.80000000
CN5503300000000,55,033,"Dunn County, WI",Feb-22,25062,24153,909,3.60000000
CN5503500000000,55,035,"Eau Claire County, WI",Feb-22,60176,58494,1682,2.80000000
CN5503700000000,55,037,"Florence County, WI",Feb-22,2256,2158,98,4.30000000
CN5503900000000,55,039,"Fond du Lac County, WI",Feb-22,58173,56543,1630,2.80000000
CN5504100000000,55,041,"Forest County, WI",Feb-22,4054,3790,264,6.50000000
CN5504300000000,55,043,"Grant County, WI",Feb-22,28601,27693,908,3.20000000
CN5504500000000,55,045,"Green County, WI",Feb-22,21426,20788,638,3.00000000
CN5504700000000,55,047,"Green Lake County, WI",Feb-22,9220,8812,408,4.40000000
CN5504900000000,55,049,"Iowa County, WI",Feb-22,14184,13675,509,3.60000000
CN5505100000000,55,051,"Iron County, WI",Feb-22,2601,2441,160,6.20000000
CN5505300000000,55,053,"Jackson County, WI",Feb-22,9599,9077,522,5.40000000
CN5505500000000,55,055,"Jefferson County, WI",Feb-22,46592,45059,1533,3.30000000
CN5505700000000,55,057,"Juneau County, WI",Feb-22,13389,12807,582,4.30000000
CN5505900000000,55,059,"Kenosha County, WI",Feb-22,91330,87798,3532,3.90000000
CN5506100000000,55,061,"Kewaunee County, WI",Feb-22,11207,10882,325,2.90000000
CN5506300000000,55,063,"La Crosse County, WI",Feb-22,68087,66196,1891,2.80000000
CN5506500000000,55,065,"Lafayette County, WI",Feb-22,10707,10392,315,2.90000000
CN5506700000000,55,067,"Langlade County, WI",Feb-22,9608,9197,411,4.30000000
CN5506900000000,55,069,"Lincoln County, WI",Feb-22,14807,14258,549,3.70000000
CN5507100000000,55,071,"Manitowoc County, WI",Feb-22,41165,39854,1311,3.20000000
CN5507300000000,55,073,"Marathon County, WI",Feb-22,75474,73410,2064,2.70000000
CN5507500000000,55,075,"Marinette County, WI",Feb-22,19311,18449,862,4.50000000
CN5507700000000,55,077,"Marquette County, WI",Feb-22,7874,7485,389,4.90000000
CN5507800000000,55,078,"Menominee County, WI",Feb-22,1573,1472,101,6.40000000
CN5507900000000,55,079,"Milwaukee County, WI",Feb-22,464220,443601,20619,4.40000000
CN5508100000000,55,081,"Monroe County, WI",Feb-22,23820,23092,728,3.10000000
CN5508300000000,55,083,"Oconto County, WI",Feb-22,21174,20358,816,3.90000000
CN5508500000000,55,085,"Oneida County, WI",Feb-22,17407,16651,756,4.30000000
CN5508700000000,55,087,"Outagamie County, WI",Feb-22,105552,102643,2909,2.80000000
CN5508900000000,55,089,"Ozaukee County, WI",Feb-22,49265,48020,1245,2.50000000
CN5509100000000,55,091,"Pepin County, WI",Feb-22,4152,3972,180,4.30000000
CN5509300000000,55,093,"Pierce County, WI",Feb-22,25489,24508,981,3.80000000
CN5509500000000,55,095,"Polk County, WI",Feb-22,25273,23964,1309,5.20000000
CN5509700000000,55,097,"Portage County, WI",Feb-22,38729,37451,1278,3.30000000
CN5509900000000,55,099,"Price County, WI",Feb-22,6284,6039,245,3.90000000
CN5510100000000,55,101,"Racine County, WI",Feb-22,98756,94508,4248,4.30000000
CN5510300000000,55,103,"Richland County, WI",Feb-22,9159,8848,311,3.40000000
CN5510500000000,55,105,"Rock County, WI",Feb-22,87387,83891,3496,4.00000000
CN5510700000000,55,107,"Rusk County, WI",Feb-22,6781,6446,335,4.90000000
CN5510900000000,55,109,"St. Croix County, WI",Feb-22,51367,49596,1771,3.40000000
CN5511100000000,55,111,"Sauk County, WI",Feb-22,34442,33194,1248,3.60000000
CN5511300000000,55,113,"Sawyer County, WI",Feb-22,7897,7479,418,5.30000000
CN5511500000000,55,115,"Shawano County, WI",Feb-22,21302,20555,747,3.50000000
CN5511700000000,55,117,"Sheboygan County, WI",Feb-22,62798,61170,1628,2.60000000
CN5511900000000,55,119,"Taylor County, WI",Feb-22,11423,10918,505,4.40000000
CN5512100000000,55,121,"Trempealeau County, WI",Feb-22,15822,15197,625,4.00000000
CN5512300000000,55,123,"Vernon County, WI",Feb-22,15914,15379,535,3.40000000
CN5512500000000,55,125,"Vilas County, WI",Feb-22,9942,9480,462,4.60000000
CN5512700000000,55,127,"Walworth County, WI",Feb-22,57999,56011,1988,3.40000000
CN5512900000000,55,129,"Washburn County, WI",Feb-22,7868,7472,396,5.00000000
CN5513100000000,55,131,"Washington County, WI",Feb-22,77068,75003,2065,2.70000000
CN5513300000000,55,133,"Waukesha County, WI",Feb-22,224471,218496,5975,2.70000000
CN5513500000000,55,135,"Waupaca County, WI",Feb-22,26178,25275,903,3.40000000
CN5513700000000,55,137,"Waushara County, WI",Feb-22,11505,11011,494,4.30000000
CN5513900000000,55,139,"Winnebago County, WI",Feb-22,93027,90571,2456,2.60000000
CN5514100000000,55,141,"Wood County, WI",Feb-22,34376,33053,1323,3.80000000
CN5600100000000,56,001,"Albany County, WY",Feb-22,21029,20378,651,3.10000000
CN5600300000000,56,003,"Big Horn County, WY",Feb-22,5079,4824,255,5.00000000
CN5600500000000,56,005,"Campbell County, WY",Feb-22,21928,20981,947,4.30000000
CN5600700000000,56,007,"Carbon County, WY",Feb-22,7624,7336,288,3.80000000
CN5600900000000,56,009,"Converse County, WY",Feb-22,7536,7250,286,3.80000000
CN5601100000000,56,011,"Crook County, WY",Feb-22,3780,3659,121,3.20000000
CN5601300000000,56,013,"Fremont County, WY",Feb-22,18762,17928,834,4.40000000
CN5601500000000,56,015,"Goshen County, WY",Feb-22,6525,6321,204,3.10000000
CN5601700000000,56,017,"Hot Springs County, WY",Feb-22,2176,2107,69,3.20000000
CN5601900000000,56,019,"Johnson County, WY",Feb-22,4080,3910,170,4.20000000
CN5602100000000,56,021,"Laramie County, WY",Feb-22,50337,48493,1844,3.70000000
CN5602300000000,56,023,"Lincoln County, WY",Feb-22,9418,9094,324,3.40000000
CN5602500000000,56,025,"Natrona County, WY",Feb-22,39290,37334,1956,5.00000000
CN5602700000000,56,027,"Niobrara County, WY",Feb-22,1225,1193,32,2.60000000
CN5602900000000,56,029,"Park County, WY",Feb-22,14676,14036,640,4.40000000
CN5603100000000,56,031,"Platte County, WY",Feb-22,4446,4279,167,3.80000000
CN5603300000000,56,033,"Sheridan County, WY",Feb-22,15910,15322,588,3.70000000
CN5603500000000,56,035,"Sublette County, WY",Feb-22,3865,3681,184,4.80000000
CN5603700000000,56,037,"Sweetwater County, WY",Feb-22,19175,18211,964,5.00000000
CN5603900000000,56,039,"Teton County, WY",Feb-22,15669,15281,388,2.50000000
CN5604100000000,56,041,"Uinta County, WY",Feb-22,8520,8150,370,4.30000000
CN5604300000000,56,043,"Washakie County, WY",Feb-22,3927,3764,163,4.20000000
CN5604500000000,56,045,"Weston County, WY",Feb-22,3735,3621,114,3.10000000
CN7200100000000,72,001,"Adjuntas Municipio, PR",Feb-22,4550,4112,438,9.60000000
CN7200300000000,72,003,"Aguada Municipio, PR",Feb-22,13569,12506,1063,7.80000000
CN7200500000000,72,005,"Aguadilla Municipio, PR",Feb-22,16304,15037,1267,7.80000000
CN7200700000000,72,007,"Aguas Buenas Municipio, PR",Feb-22,7318,6811,507,6.90000000
CN7200900000000,72,009,"Aibonito Municipio, PR",Feb-22,6966,6521,445,6.40000000
CN7201100000000,72,011,"Anasco Municipio, PR",Feb-22,10101,9475,626,6.20000000
CN7201300000000,72,013,"Arecibo Municipio, PR",Feb-22,26589,24817,1772,6.70000000
CN7201500000000,72,015,"Arroyo Municipio, PR",Feb-22,5126,4753,373,7.30000000
CN7201700000000,72,017,"Barceloneta Municipio, PR",Feb-22,6649,6088,561,8.40000000
CN7201900000000,72,019,"Barranquitas Municipio, PR",Feb-22,8057,7519,538,6.70000000
CN7202100000000,72,021,"Bayamon Municipio, PR",Feb-22,72785,69006,3779,5.20000000
CN7202300000000,72,023,"Cabo Rojo Municipio, PR",Feb-22,15651,14624,1027,6.60000000
CN7202500000000,72,025,"Caguas Municipio, PR",Feb-22,53377,50887,2490,4.70000000
CN7202700000000,72,027,"Camuy Municipio, PR",Feb-22,10587,9995,592,5.60000000
CN7202900000000,72,029,"Canovanas Municipio, PR",Feb-22,18301,17390,911,5.00000000
CN7203100000000,72,031,"Carolina Municipio, PR",Feb-22,68956,65449,3507,5.10000000
CN7203300000000,72,033,"Catano Municipio, PR",Feb-22,8752,8234,518,5.90000000
CN7203500000000,72,035,"Cayey Municipio, PR",Feb-22,17984,17216,768,4.30000000
CN7203700000000,72,037,"Ceiba Municipio, PR",Feb-22,4002,3738,264,6.60000000
CN7203900000000,72,039,"Ciales Municipio, PR",Feb-22,4081,3705,376,9.20000000
CN7204100000000,72,041,"Cidra Municipio, PR",Feb-22,17193,16492,701,4.10000000
CN7204300000000,72,043,"Coamo Municipio, PR",Feb-22,11193,10391,802,7.20000000
CN7204500000000,72,045,"Comerio Municipio, PR",Feb-22,5455,5082,373,6.80000000
CN7204700000000,72,047,"Corozal Municipio, PR",Feb-22,9856,9135,721,7.30000000
CN7204900000000,72,049,"Culebra Municipio, PR",Feb-22,1019,983,36,3.50000000
CN7205100000000,72,051,"Dorado Municipio, PR",Feb-22,15091,14447,644,4.30000000
CN7205300000000,72,053,"Fajardo Municipio, PR",Feb-22,11848,11009,839,7.10000000
CN7205400000000,72,054,"Florida Municipio, PR",Feb-22,3655,3370,285,7.80000000
CN7205500000000,72,055,"Guanica Municipio, PR",Feb-22,4318,3830,488,11.30000000
CN7205700000000,72,057,"Guayama Municipio, PR",Feb-22,12057,11360,697,5.80000000
CN7205900000000,72,059,"Guayanilla Municipio, PR",Feb-22,5329,4787,542,10.20000000
CN7206100000000,72,061,"Guaynabo Municipio, PR",Feb-22,42532,41253,1279,3.00000000
CN7206300000000,72,063,"Gurabo Municipio, PR",Feb-22,20957,20234,723,3.40000000
CN7206500000000,72,065,"Hatillo Municipio, PR",Feb-22,15098,13893,1205,8.00000000
CN7206700000000,72,067,"Hormigueros Municipio, PR",Feb-22,6212,5756,456,7.30000000
CN7206900000000,72,069,"Humacao Municipio, PR",Feb-22,19319,18054,1265,6.50000000
CN7207100000000,72,071,"Isabela Municipio, PR",Feb-22,13287,12466,821,6.20000000
CN7207300000000,72,073,"Jayuya Municipio, PR",Feb-22,4541,4101,440,9.70000000
CN7207500000000,72,075,"Juana Diaz Municipio, PR",Feb-22,17237,16234,1003,5.80000000
CN7207700000000,72,077,"Juncos Municipio, PR",Feb-22,13907,13060,847,6.10000000
CN7207900000000,72,079,"Lajas Municipio, PR",Feb-22,5819,5222,597,10.30000000
CN7208100000000,72,081,"Lares Municipio, PR",Feb-22,7489,6680,809,10.80000000
CN7208300000000,72,083,"Las Marias Municipio, PR",Feb-22,2870,2597,273,9.50000000
CN7208500000000,72,085,"Las Piedras Municipio, PR",Feb-22,12785,12060,725,5.70000000
CN7208700000000,72,087,"Loiza Municipio, PR",Feb-22,9381,8753,628,6.70000000
CN7208900000000,72,089,"Luquillo Municipio, PR",Feb-22,6876,6436,440,6.40000000
CN7209100000000,72,091,"Manati Municipio, PR",Feb-22,12516,11789,727,5.80000000
CN7209300000000,72,093,"Maricao Municipio, PR",Feb-22,2099,1844,255,12.10000000
CN7209500000000,72,095,"Maunabo Municipio, PR",Feb-22,3206,2832,374,11.70000000
CN7209700000000,72,097,"Mayaguez Municipio, PR",Feb-22,24387,22679,1708,7.00000000
CN7209900000000,72,099,"Moca Municipio, PR",Feb-22,11798,10856,942,8.00000000
CN7210100000000,72,101,"Morovis Municipio, PR",Feb-22,9017,8384,633,7.00000000
CN7210300000000,72,103,"Naguabo Municipio, PR",Feb-22,9246,8677,569,6.20000000
CN7210500000000,72,105,"Naranjito Municipio, PR",Feb-22,7968,7362,606,7.60000000
CN7210700000000,72,107,"Orocovis Municipio, PR",Feb-22,5377,4954,423,7.90000000
CN7210900000000,72,109,"Patillas Municipio, PR",Feb-22,4664,4191,473,10.10000000
CN7211100000000,72,111,"Penuelas Municipio, PR",Feb-22,6364,5772,592,9.30000000
CN7211300000000,72,113,"Ponce Municipio, PR",Feb-22,50539,46894,3645,7.20000000
CN7211500000000,72,115,"Quebradillas Municipio, PR",Feb-22,6731,6234,497,7.40000000
CN7211700000000,72,117,"Rincon Municipio, PR",Feb-22,5339,4826,513,9.60000000
CN7211900000000,72,119,"Rio Grande Municipio, PR",Feb-22,19157,17982,1175,6.10000000
CN7212100000000,72,121,"Sabana Grande Municipio, PR",Feb-22,6686,6110,576,8.60000000
CN7212300000000,72,123,"Salinas Municipio, PR",Feb-22,7649,6997,652,8.50000000
CN7212500000000,72,125,"San German Municipio, PR",Feb-22,10907,9992,915,8.40000000
CN7212700000000,72,127,"San Juan Municipio, PR",Feb-22,149751,143061,6690,4.50000000
CN7212900000000,72,129,"San Lorenzo Municipio, PR",Feb-22,12864,12151,713,5.50000000
CN7213100000000,72,131,"San Sebastian Municipio, PR",Feb-22,11194,10076,1118,10.00000000
CN7213300000000,72,133,"Santa Isabel Municipio, PR",Feb-22,10103,9363,740,7.30000000
CN7213500000000,72,135,"Toa Alta Municipio, PR",Feb-22,31278,29877,1401,4.50000000
CN7213700000000,72,137,"Toa Baja Municipio, PR",Feb-22,32542,31011,1531,4.70000000
CN7213900000000,72,139,"Trujillo Alto Municipio, PR",Feb-22,30409,29311,1098,3.60000000
CN7214100000000,72,141,"Utuado Municipio, PR",Feb-22,7346,6735,611,8.30000000
CN7214300000000,72,143,"Vega Alta Municipio, PR",Feb-22,11070,10264,806,7.30000000
CN7214500000000,72,145,"Vega Baja Municipio, PR",Feb-22,14777,13617,1160,7.90000000
CN7214700000000,72,147,"Vieques Municipio, PR",Feb-22,2891,2613,278,9.60000000
CN7214900000000,72,149,"Villalba Municipio, PR",Feb-22,7998,7213,785,9.80000000
CN7215100000000,72,151,"Yabucoa Municipio, PR",Feb-22,9594,8752,842,8.80000000
CN7215300000000,72,153,"Yauco Municipio, PR",Feb-22,10639,9531,1108,10.40000000
CN0100100000000,01,001,"Autauga County, AL",Mar-22,26649,26093,556,2.10000000
CN0100300000000,01,003,"Baldwin County, AL",Mar-22,101024,98799,2225,2.20000000
CN0100500000000,01,005,"Barbour County, AL",Mar-22,8339,8020,319,3.80000000
CN0100700000000,01,007,"Bibb County, AL",Mar-22,8695,8492,203,2.30000000
CN0100900000000,01,009,"Blount County, AL",Mar-22,25579,25071,508,2.00000000
CN0101100000000,01,011,"Bullock County, AL",Mar-22,4508,4384,124,2.80000000
CN0101300000000,01,013,"Butler County, AL",Mar-22,8877,8555,322,3.60000000
CN0101500000000,01,015,"Calhoun County, AL",Mar-22,46791,45371,1420,3.00000000
CN0101700000000,01,017,"Chambers County, AL",Mar-22,16041,15660,381,2.40000000
CN0101900000000,01,019,"Cherokee County, AL",Mar-22,11715,11475,240,2.00000000
CN0102100000000,01,021,"Chilton County, AL",Mar-22,20135,19684,451,2.20000000
CN0102300000000,01,023,"Choctaw County, AL",Mar-22,4435,4290,145,3.30000000
CN0102500000000,01,025,"Clarke County, AL",Mar-22,7833,7480,353,4.50000000
CN0102700000000,01,027,"Clay County, AL",Mar-22,6101,5977,124,2.00000000
CN0102900000000,01,029,"Cleburne County, AL",Mar-22,5988,5859,129,2.20000000
CN0103100000000,01,031,"Coffee County, AL",Mar-22,21722,21228,494,2.30000000
CN0103300000000,01,033,"Colbert County, AL",Mar-22,23781,23105,676,2.80000000
CN0103500000000,01,035,"Conecuh County, AL",Mar-22,4287,4141,146,3.40000000
CN0103700000000,01,037,"Coosa County, AL",Mar-22,4432,4334,98,2.20000000
CN0103900000000,01,039,"Covington County, AL",Mar-22,15193,14851,342,2.30000000
CN0104100000000,01,041,"Crenshaw County, AL",Mar-22,5948,5801,147,2.50000000
CN0104300000000,01,043,"Cullman County, AL",Mar-22,39707,38982,725,1.80000000
CN0104500000000,01,045,"Dale County, AL",Mar-22,21003,20507,496,2.40000000
CN0104700000000,01,047,"Dallas County, AL",Mar-22,13863,13104,759,5.50000000
CN0104900000000,01,049,"DeKalb County, AL",Mar-22,31217,30583,634,2.00000000
CN0105100000000,01,051,"Elmore County, AL",Mar-22,38094,37331,763,2.00000000
CN0105300000000,01,053,"Escambia County, AL",Mar-22,14258,13867,391,2.70000000
CN0105500000000,01,055,"Etowah County, AL",Mar-22,39512,38345,1167,3.00000000
CN0105700000000,01,057,"Fayette County, AL",Mar-22,6747,6594,153,2.30000000
CN0105900000000,01,059,"Franklin County, AL",Mar-22,14526,14239,287,2.00000000
CN0106100000000,01,061,"Geneva County, AL",Mar-22,10997,10753,244,2.20000000
CN0106300000000,01,063,"Greene County, AL",Mar-22,2813,2676,137,4.90000000
CN0106500000000,01,065,"Hale County, AL",Mar-22,5835,5603,232,4.00000000
CN0106700000000,01,067,"Henry County, AL",Mar-22,6933,6762,171,2.50000000
CN0106900000000,01,069,"Houston County, AL",Mar-22,47540,46404,1136,2.40000000
CN0107100000000,01,071,"Jackson County, AL",Mar-22,23386,22896,490,2.10000000
CN0107300000000,01,073,"Jefferson County, AL",Mar-22,323344,315176,8168,2.50000000
CN0107500000000,01,075,"Lamar County, AL",Mar-22,5727,5600,127,2.20000000
CN0107700000000,01,077,"Lauderdale County, AL",Mar-22,42719,41725,994,2.30000000
CN0107900000000,01,079,"Lawrence County, AL",Mar-22,14507,14191,316,2.20000000
CN0108100000000,01,081,"Lee County, AL",Mar-22,78892,77201,1691,2.10000000
CN0108300000000,01,083,"Limestone County, AL",Mar-22,47648,46747,901,1.90000000
CN0108500000000,01,085,"Lowndes County, AL",Mar-22,3526,3298,228,6.50000000
CN0108700000000,01,087,"Macon County, AL",Mar-22,7907,7577,330,4.20000000
CN0108900000000,01,089,"Madison County, AL",Mar-22,196927,193067,3860,2.00000000
CN0109100000000,01,091,"Marengo County, AL",Mar-22,7668,7436,232,3.00000000
CN0109300000000,01,093,"Marion County, AL",Mar-22,13842,13558,284,2.10000000
CN0109500000000,01,095,"Marshall County, AL",Mar-22,45236,44394,842,1.90000000
CN0109700000000,01,097,"Mobile County, AL",Mar-22,192694,186415,6279,3.30000000
CN0109900000000,01,099,"Monroe County, AL",Mar-22,7426,7136,290,3.90000000
CN0110100000000,01,101,"Montgomery County, AL",Mar-22,107325,103840,3485,3.20000000
CN0110300000000,01,103,"Morgan County, AL",Mar-22,60184,59018,1166,1.90000000
CN0110500000000,01,105,"Perry County, AL",Mar-22,3096,2902,194,6.30000000
CN0110700000000,01,107,"Pickens County, AL",Mar-22,7578,7352,226,3.00000000
CN0110900000000,01,109,"Pike County, AL",Mar-22,16541,16152,389,2.40000000
CN0111100000000,01,111,"Randolph County, AL",Mar-22,9624,9420,204,2.10000000
CN0111300000000,01,113,"Russell County, AL",Mar-22,23911,23387,524,2.20000000
CN0111500000000,01,115,"St. Clair County, AL",Mar-22,42078,41241,837,2.00000000
CN0111700000000,01,117,"Shelby County, AL",Mar-22,121166,119173,1993,1.60000000
CN0111900000000,01,119,"Sumter County, AL",Mar-22,4579,4428,151,3.30000000
CN0112100000000,01,121,"Talladega County, AL",Mar-22,36403,35307,1096,3.00000000
CN0112300000000,01,123,"Tallapoosa County, AL",Mar-22,18013,17507,506,2.80000000
CN0112500000000,01,125,"Tuscaloosa County, AL",Mar-22,103289,100774,2515,2.40000000
CN0112700000000,01,127,"Walker County, AL",Mar-22,25458,24806,652,2.60000000
CN0112900000000,01,129,"Washington County, AL",Mar-22,6602,6366,236,3.60000000
CN0113100000000,01,131,"Wilcox County, AL",Mar-22,2578,2352,226,8.80000000
CN0113300000000,01,133,"Winston County, AL",Mar-22,10229,10021,208,2.00000000
CN0201300000000,02,013,"Aleutians East Borough, AK",Mar-22,2339,2299,40,1.70000000
CN0201600000000,02,016,"Aleutians West Census Area, AK",Mar-22,4726,4635,91,1.90000000
CN0202000000000,02,020,"Anchorage Borough/municipality, AK",Mar-22,152737,146686,6051,4.00000000
CN0205000000000,02,050,"Bethel Census Area, AK",Mar-22,6960,6164,796,11.40000000
CN0206000000000,02,060,"Bristol Bay Borough, AK",Mar-22,240,216,24,10.00000000
CN0206300000000,02,063,"Chugach Census Area, AK",Mar-22,2957,2788,169,5.70000000
CN0206600000000,02,066,"Copper River Census Area, AK",Mar-22,1271,1085,186,14.60000000
CN0206800000000,02,068,"Denali Borough, AK",Mar-22,604,517,87,14.40000000
CN0207000000000,02,070,"Dillingham Census Area, AK",Mar-22,1550,1435,115,7.40000000
CN0209000000000,02,090,"Fairbanks North Star Borough, AK",Mar-22,46031,44100,1931,4.20000000
CN0210000000000,02,100,"Haines Borough, AK",Mar-22,958,852,106,11.10000000
CN0210500000000,02,105,"Hoonah-Angoon Census Area, AK",Mar-22,1014,911,103,10.20000000
CN0211000000000,02,110,"Juneau Borough/city, AK",Mar-22,16880,16327,553,3.30000000
CN0212200000000,02,122,"Kenai Peninsula Borough, AK",Mar-22,27057,25345,1712,6.30000000
CN0213000000000,02,130,"Ketchikan Gateway Borough, AK",Mar-22,6325,5970,355,5.60000000
CN0215000000000,02,150,"Kodiak Island Borough, AK",Mar-22,6093,5827,266,4.40000000
CN0215800000000,02,158,"Kusilvak Census Area, AK",Mar-22,2355,1967,388,16.50000000
CN0216400000000,02,164,"Lake and Peninsula Borough, AK",Mar-22,554,501,53,9.60000000
CN0217000000000,02,170,"Matanuska-Susitna Borough, AK",Mar-22,50748,47703,3045,6.00000000
CN0218000000000,02,180,"Nome Census Area, AK",Mar-22,3890,3510,380,9.80000000
CN0218500000000,02,185,"North Slope Borough, AK",Mar-22,3017,2853,164,5.40000000
CN0218800000000,02,188,"Northwest Arctic Borough, AK",Mar-22,2957,2642,315,10.70000000
CN0219500000000,02,195,"Petersburg Borough, AK",Mar-22,1592,1490,102,6.40000000
CN0219800000000,02,198,"Prince of Wales-Hyder Census Area, AK",Mar-22,2778,2586,192,6.90000000
CN0222000000000,02,220,"Sitka Borough/city, AK",Mar-22,4300,4155,145,3.40000000
CN0223000000000,02,230,"Skagway Municipality, AK",Mar-22,558,482,76,13.60000000
CN0224000000000,02,240,"Southeast Fairbanks Census Area, AK",Mar-22,3248,3027,221,6.80000000
CN0227500000000,02,275,"Wrangell Borough/city, AK",Mar-22,970,912,58,6.00000000
CN0228200000000,02,282,"Yakutat Borough/city, AK",Mar-22,295,275,20,6.80000000
CN0229000000000,02,290,"Yukon-Koyukuk Census Area, AK",Mar-22,2445,2177,268,11.00000000
CN0400100000000,04,001,"Apache County, AZ",Mar-22,18627,17428,1199,6.40000000
CN0400300000000,04,003,"Cochise County, AZ",Mar-22,49561,48093,1468,3.00000000
CN0400500000000,04,005,"Coconino County, AZ",Mar-22,74729,71994,2735,3.70000000
CN0400700000000,04,007,"Gila County, AZ",Mar-22,20468,19865,603,2.90000000
CN0400900000000,04,009,"Graham County, AZ",Mar-22,16236,15870,366,2.30000000
CN0401100000000,04,011,"Greenlee County, AZ",Mar-22,4440,4347,93,2.10000000
CN0401200000000,04,012,"La Paz County, AZ",Mar-22,9515,9221,294,3.10000000
CN0401300000000,04,013,"Maricopa County, AZ",Mar-22,2334867,2278791,56076,2.40000000
CN0401500000000,04,015,"Mohave County, AZ",Mar-22,88698,85600,3098,3.50000000
CN0401700000000,04,017,"Navajo County, AZ",Mar-22,39104,37440,1664,4.30000000
CN0401900000000,04,019,"Pima County, AZ",Mar-22,486744,473180,13564,2.80000000
CN0402100000000,04,021,"Pinal County, AZ",Mar-22,196826,191539,5287,2.70000000
CN0402300000000,04,023,"Santa Cruz County, AZ",Mar-22,19517,18373,1144,5.90000000
CN0402500000000,04,025,"Yavapai County, AZ",Mar-22,106883,104450,2433,2.30000000
CN0402700000000,04,027,"Yuma County, AZ",Mar-22,98905,88906,9999,10.10000000
CN0500100000000,05,001,"Arkansas County, AR",Mar-22,9597,9267,330,3.40000000
CN0500300000000,05,003,"Ashley County, AR",Mar-22,6825,6405,420,6.20000000
CN0500500000000,05,005,"Baxter County, AR",Mar-22,16490,15965,525,3.20000000
CN0500700000000,05,007,"Benton County, AR",Mar-22,147622,144321,3301,2.20000000
CN0500900000000,05,009,"Boone County, AR",Mar-22,15980,15586,394,2.50000000
CN0501100000000,05,011,"Bradley County, AR",Mar-22,4139,3976,163,3.90000000
CN0501300000000,05,013,"Calhoun County, AR",Mar-22,2429,2364,65,2.70000000
CN0501500000000,05,015,"Carroll County, AR",Mar-22,12769,12418,351,2.70000000
CN0501700000000,05,017,"Chicot County, AR",Mar-22,3042,2832,210,6.90000000
CN0501900000000,05,019,"Clark County, AR",Mar-22,8846,8505,341,3.90000000
CN0502100000000,05,021,"Clay County, AR",Mar-22,5506,5307,199,3.60000000
CN0502300000000,05,023,"Cleburne County, AR",Mar-22,8960,8586,374,4.20000000
CN0502500000000,05,025,"Cleveland County, AR",Mar-22,3166,3056,110,3.50000000
CN0502700000000,05,027,"Columbia County, AR",Mar-22,8920,8540,380,4.30000000
CN0502900000000,05,029,"Conway County, AR",Mar-22,8401,8099,302,3.60000000
CN0503100000000,05,031,"Craighead County, AR",Mar-22,56508,55056,1452,2.60000000
CN0503300000000,05,033,"Crawford County, AR",Mar-22,26157,25359,798,3.10000000
CN0503500000000,05,035,"Crittenden County, AR",Mar-22,20658,19882,776,3.80000000
CN0503700000000,05,037,"Cross County, AR",Mar-22,7122,6872,250,3.50000000
CN0503900000000,05,039,"Dallas County, AR",Mar-22,2796,2692,104,3.70000000
CN0504100000000,05,041,"Desha County, AR",Mar-22,5003,4726,277,5.50000000
CN0504300000000,05,043,"Drew County, AR",Mar-22,7597,7278,319,4.20000000
CN0504500000000,05,045,"Faulkner County, AR",Mar-22,61617,59893,1724,2.80000000
CN0504700000000,05,047,"Franklin County, AR",Mar-22,7369,7133,236,3.20000000
CN0504900000000,05,049,"Fulton County, AR",Mar-22,5025,4870,155,3.10000000
CN0505100000000,05,051,"Garland County, AR",Mar-22,40349,38746,1603,4.00000000
CN0505300000000,05,053,"Grant County, AR",Mar-22,8306,8068,238,2.90000000
CN0505500000000,05,055,"Greene County, AR",Mar-22,19711,19167,544,2.80000000
CN0505700000000,05,057,"Hempstead County, AR",Mar-22,9099,8812,287,3.20000000
CN0505900000000,05,059,"Hot Spring County, AR",Mar-22,13830,13388,442,3.20000000
CN0506100000000,05,061,"Howard County, AR",Mar-22,5553,5395,158,2.80000000
CN0506300000000,05,063,"Independence County, AR",Mar-22,16777,16254,523,3.10000000
CN0506500000000,05,065,"Izard County, AR",Mar-22,4465,4255,210,4.70000000
CN0506700000000,05,067,"Jackson County, AR",Mar-22,5647,5387,260,4.60000000
CN0506900000000,05,069,"Jefferson County, AR",Mar-22,26204,24724,1480,5.60000000
CN0507100000000,05,071,"Johnson County, AR",Mar-22,10080,9705,375,3.70000000
CN0507300000000,05,073,"Lafayette County, AR",Mar-22,2344,2240,104,4.40000000
CN0507500000000,05,075,"Lawrence County, AR",Mar-22,6865,6628,237,3.50000000
CN0507700000000,05,077,"Lee County, AR",Mar-22,2617,2494,123,4.70000000
CN0507900000000,05,079,"Lincoln County, AR",Mar-22,3811,3650,161,4.20000000
CN0508100000000,05,081,"Little River County, AR",Mar-22,5323,5132,191,3.60000000
CN0508300000000,05,083,"Logan County, AR",Mar-22,8395,8106,289,3.40000000
CN0508500000000,05,085,"Lonoke County, AR",Mar-22,33660,32733,927,2.80000000
CN0508700000000,05,087,"Madison County, AR",Mar-22,7753,7563,190,2.50000000
CN0508900000000,05,089,"Marion County, AR",Mar-22,6231,6017,214,3.40000000
CN0509100000000,05,091,"Miller County, AR",Mar-22,19190,18461,729,3.80000000
CN0509300000000,05,093,"Mississippi County, AR",Mar-22,16487,15537,950,5.80000000
CN0509500000000,05,095,"Monroe County, AR",Mar-22,2694,2576,118,4.40000000
CN0509700000000,05,097,"Montgomery County, AR",Mar-22,2957,2825,132,4.50000000
CN0509900000000,05,099,"Nevada County, AR",Mar-22,3323,3194,129,3.90000000
CN0510100000000,05,101,"Newton County, AR",Mar-22,3251,3160,91,2.80000000
CN0510300000000,05,103,"Ouachita County, AR",Mar-22,9781,9420,361,3.70000000
CN0510500000000,05,105,"Perry County, AR",Mar-22,4157,4005,152,3.70000000
CN0510700000000,05,107,"Phillips County, AR",Mar-22,5879,5491,388,6.60000000
CN0510900000000,05,109,"Pike County, AR",Mar-22,4256,4098,158,3.70000000
CN0511100000000,05,111,"Poinsett County, AR",Mar-22,9928,9608,320,3.20000000
CN0511300000000,05,113,"Polk County, AR",Mar-22,7859,7578,281,3.60000000
CN0511500000000,05,115,"Pope County, AR",Mar-22,27422,26517,905,3.30000000
CN0511700000000,05,117,"Prairie County, AR",Mar-22,3645,3546,99,2.70000000
CN0511900000000,05,119,"Pulaski County, AR",Mar-22,185481,178563,6918,3.70000000
CN0512100000000,05,121,"Randolph County, AR",Mar-22,7335,7098,237,3.20000000
CN0512300000000,05,123,"St. Francis County, AR",Mar-22,7672,7276,396,5.20000000
CN0512500000000,05,125,"Saline County, AR",Mar-22,58501,56954,1547,2.60000000
CN0512700000000,05,127,"Scott County, AR",Mar-22,4225,4111,114,2.70000000
CN0512900000000,05,129,"Searcy County, AR",Mar-22,2961,2841,120,4.10000000
CN0513100000000,05,131,"Sebastian County, AR",Mar-22,54829,53186,1643,3.00000000
CN0513300000000,05,133,"Sevier County, AR",Mar-22,5357,5162,195,3.60000000
CN0513500000000,05,135,"Sharp County, AR",Mar-22,5785,5556,229,4.00000000
CN0513700000000,05,137,"Stone County, AR",Mar-22,4598,4422,176,3.80000000
CN0513900000000,05,139,"Union County, AR",Mar-22,15027,14276,751,5.00000000
CN0514100000000,05,141,"Van Buren County, AR",Mar-22,5938,5691,247,4.20000000
CN0514300000000,05,143,"Washington County, AR",Mar-22,130520,127571,2949,2.30000000
CN0514500000000,05,145,"White County, AR",Mar-22,34140,32979,1161,3.40000000
CN0514700000000,05,147,"Woodruff County, AR",Mar-22,2875,2770,105,3.70000000
CN0514900000000,05,149,"Yell County, AR",Mar-22,7993,7721,272,3.40000000
CN0600100000000,06,001,"Alameda County, CA",Mar-22,833224,806288,26936,3.20000000
CN0600300000000,06,003,"Alpine County, CA",Mar-22,564,534,30,5.30000000
CN0600500000000,06,005,"Amador County, CA",Mar-22,14502,13843,659,4.50000000
CN0600700000000,06,007,"Butte County, CA",Mar-22,93163,89012,4151,4.50000000
CN0600900000000,06,009,"Calaveras County, CA",Mar-22,21694,20924,770,3.50000000
CN0601100000000,06,011,"Colusa County, CA",Mar-22,10871,9494,1377,12.70000000
CN0601300000000,06,013,"Contra Costa County, CA",Mar-22,557041,537631,19410,3.50000000
CN0601500000000,06,015,"Del Norte County, CA",Mar-22,9401,8914,487,5.20000000
CN0601700000000,06,017,"El Dorado County, CA",Mar-22,93903,90808,3095,3.30000000
CN0601900000000,06,019,"Fresno County, CA",Mar-22,453887,422464,31423,6.90000000
CN0602100000000,06,021,"Glenn County, CA",Mar-22,12703,12049,654,5.10000000
CN0602300000000,06,023,"Humboldt County, CA",Mar-22,59980,57746,2234,3.70000000
CN0602500000000,06,025,"Imperial County, CA",Mar-22,69393,60650,8743,12.60000000
CN0602700000000,06,027,"Inyo County, CA",Mar-22,8312,8007,305,3.70000000
CN0602900000000,06,029,"Kern County, CA",Mar-22,379919,350473,29446,7.80000000
CN0603100000000,06,031,"Kings County, CA",Mar-22,56680,52365,4315,7.60000000
CN0603300000000,06,033,"Lake County, CA",Mar-22,28798,27336,1462,5.10000000
CN0603500000000,06,035,"Lassen County, CA",Mar-22,8835,8437,398,4.50000000
CN0603700000000,06,037,"Los Angeles County, CA",Mar-22,5051030,4790465,260565,5.20000000
CN0603900000000,06,039,"Madera County, CA",Mar-22,63667,59542,4125,6.50000000
CN0604100000000,06,041,"Marin County, CA",Mar-22,131647,128522,3125,2.40000000
CN0604300000000,06,043,"Mariposa County, CA",Mar-22,6365,6001,364,5.70000000
CN0604500000000,06,045,"Mendocino County, CA",Mar-22,37621,36143,1478,3.90000000
CN0604700000000,06,047,"Merced County, CA",Mar-22,117002,107165,9837,8.40000000
CN0604900000000,06,049,"Modoc County, CA",Mar-22,3171,2984,187,5.90000000
CN0605100000000,06,051,"Mono County, CA",Mar-22,9551,9200,351,3.70000000
CN0605300000000,06,053,"Monterey County, CA",Mar-22,207616,191614,16002,7.70000000
CN0605500000000,06,055,"Napa County, CA",Mar-22,70275,67995,2280,3.20000000
CN0605700000000,06,057,"Nevada County, CA",Mar-22,48129,46509,1620,3.40000000
CN0605900000000,06,059,"Orange County, CA",Mar-22,1599751,1549819,49932,3.10000000
CN0606100000000,06,061,"Placer County, CA",Mar-22,194405,189025,5380,2.80000000
CN0606300000000,06,063,"Plumas County, CA",Mar-22,6978,6377,601,8.60000000
CN0606500000000,06,065,"Riverside County, CA",Mar-22,1166010,1116237,49773,4.30000000
CN0606700000000,06,067,"Sacramento County, CA",Mar-22,732460,702886,29574,4.00000000
CN0606900000000,06,069,"San Benito County, CA",Mar-22,32836,31081,1755,5.30000000
CN0607100000000,06,071,"San Bernardino County, CA",Mar-22,1020521,976234,44287,4.30000000
CN0607300000000,06,073,"San Diego County, CA",Mar-22,1594932,1539994,54938,3.40000000
CN0607500000000,06,075,"San Francisco County/city, CA",Mar-22,572530,557987,14543,2.50000000
CN0607700000000,06,077,"San Joaquin County, CA",Mar-22,339031,319610,19421,5.70000000
CN0607900000000,06,079,"San Luis Obispo County, CA",Mar-22,140061,136185,3876,2.80000000
CN0608100000000,06,081,"San Mateo County, CA",Mar-22,452882,442496,10386,2.30000000
CN0608300000000,06,083,"Santa Barbara County, CA",Mar-22,221989,214104,7885,3.60000000
CN0608500000000,06,085,"Santa Clara County, CA",Mar-22,1048883,1023123,25760,2.50000000
CN0608700000000,06,087,"Santa Cruz County, CA",Mar-22,134763,127642,7121,5.30000000
CN0608900000000,06,089,"Shasta County, CA",Mar-22,74068,70662,3406,4.60000000
CN0609100000000,06,091,"Sierra County, CA",Mar-22,1311,1248,63,4.80000000
CN0609300000000,06,093,"Siskiyou County, CA",Mar-22,16080,15025,1055,6.60000000
CN0609500000000,06,095,"Solano County, CA",Mar-22,202510,193234,9276,4.60000000
CN0609700000000,06,097,"Sonoma County, CA",Mar-22,249049,241585,7464,3.00000000
CN0609900000000,06,099,"Stanislaus County, CA",Mar-22,241826,227976,13850,5.70000000
CN0610100000000,06,101,"Sutter County, CA",Mar-22,45877,42593,3284,7.20000000
CN0610300000000,06,103,"Tehama County, CA",Mar-22,25347,24129,1218,4.80000000
CN0610500000000,06,105,"Trinity County, CA",Mar-22,4316,4111,205,4.70000000
CN0610700000000,06,107,"Tulare County, CA",Mar-22,203613,186352,17261,8.50000000
CN0610900000000,06,109,"Tuolumne County, CA",Mar-22,20014,19076,938,4.70000000
CN0611100000000,06,111,"Ventura County, CA",Mar-22,415125,400625,14500,3.50000000
CN0611300000000,06,113,"Yolo County, CA",Mar-22,109565,105453,4112,3.80000000
CN0611500000000,06,115,"Yuba County, CA",Mar-22,31488,29673,1815,5.80000000
CN0800100000000,08,001,"Adams County, CO",Mar-22,282279,270079,12200,4.30000000
CN0800300000000,08,003,"Alamosa County, CO",Mar-22,8637,8306,331,3.80000000
CN0800500000000,08,005,"Arapahoe County, CO",Mar-22,374757,360571,14186,3.80000000
CN0800700000000,08,007,"Archuleta County, CO",Mar-22,7136,6879,257,3.60000000
CN0800900000000,08,009,"Baca County, CO",Mar-22,2079,2046,33,1.60000000
CN0801100000000,08,011,"Bent County, CO",Mar-22,1871,1794,77,4.10000000
CN0801300000000,08,013,"Boulder County, CO",Mar-22,201517,195953,5564,2.80000000
CN0801400000000,08,014,"Broomfield County/city, CO",Mar-22,42224,41039,1185,2.80000000
CN0801500000000,08,015,"Chaffee County, CO",Mar-22,10301,10018,283,2.70000000
CN0801700000000,08,017,"Cheyenne County, CO",Mar-22,1099,1082,17,1.50000000
CN0801900000000,08,019,"Clear Creek County, CO",Mar-22,6137,5920,217,3.50000000
CN0802100000000,08,021,"Conejos County, CO",Mar-22,4141,3996,145,3.50000000
CN0802300000000,08,023,"Costilla County, CO",Mar-22,1894,1806,88,4.60000000
CN0802500000000,08,025,"Crowley County, CO",Mar-22,1456,1403,53,3.60000000
CN0802700000000,08,027,"Custer County, CO",Mar-22,2356,2292,64,2.70000000
CN0802900000000,08,029,"Delta County, CO",Mar-22,14029,13467,562,4.00000000
CN0803100000000,08,031,"Denver County/city, CO",Mar-22,436110,419157,16953,3.90000000
CN0803300000000,08,033,"Dolores County, CO",Mar-22,1172,1128,44,3.80000000
CN0803500000000,08,035,"Douglas County, CO",Mar-22,206208,200770,5438,2.60000000
CN0803700000000,08,037,"Eagle County, CO",Mar-22,40197,39190,1007,2.50000000
CN0803900000000,08,039,"Elbert County, CO",Mar-22,15813,15402,411,2.60000000
CN0804100000000,08,041,"El Paso County, CO",Mar-22,355907,342474,13433,3.80000000
CN0804300000000,08,043,"Fremont County, CO",Mar-22,15595,14759,836,5.40000000
CN0804500000000,08,045,"Garfield County, CO",Mar-22,33587,32510,1077,3.20000000
CN0804700000000,08,047,"Gilpin County, CO",Mar-22,3931,3787,144,3.70000000
CN0804900000000,08,049,"Grand County, CO",Mar-22,10672,10394,278,2.60000000
CN0805100000000,08,051,"Gunnison County, CO",Mar-22,12373,12075,298,2.40000000
CN0805300000000,08,053,"Hinsdale County, CO",Mar-22,407,395,12,2.90000000
CN0805500000000,08,055,"Huerfano County, CO",Mar-22,2561,2388,173,6.80000000
CN0805700000000,08,057,"Jackson County, CO",Mar-22,938,914,24,2.60000000
CN0805900000000,08,059,"Jefferson County, CO",Mar-22,341562,330496,11066,3.20000000
CN0806100000000,08,061,"Kiowa County, CO",Mar-22,905,888,17,1.90000000
CN0806300000000,08,063,"Kit Carson County, CO",Mar-22,4194,4103,91,2.20000000
CN0806500000000,08,065,"Lake County, CO",Mar-22,5374,5230,144,2.70000000
CN0806700000000,08,067,"La Plata County, CO",Mar-22,31491,30377,1114,3.50000000
CN0806900000000,08,069,"Larimer County, CO",Mar-22,210799,204365,6434,3.10000000
CN0807100000000,08,071,"Las Animas County, CO",Mar-22,6462,6132,330,5.10000000
CN0807300000000,08,073,"Lincoln County, CO",Mar-22,2342,2277,65,2.80000000
CN0807500000000,08,075,"Logan County, CO",Mar-22,10900,10591,309,2.80000000
CN0807700000000,08,077,"Mesa County, CO",Mar-22,79321,76207,3114,3.90000000
CN0807900000000,08,079,"Mineral County, CO",Mar-22,516,502,14,2.70000000
CN0808100000000,08,081,"Moffat County, CO",Mar-22,7272,7004,268,3.70000000
CN0808300000000,08,083,"Montezuma County, CO",Mar-22,13156,12582,574,4.40000000
CN0808500000000,08,085,"Montrose County, CO",Mar-22,22831,21963,868,3.80000000
CN0808700000000,08,087,"Morgan County, CO",Mar-22,16203,15622,581,3.60000000
CN0808900000000,08,089,"Otero County, CO",Mar-22,8267,7895,372,4.50000000
CN0809100000000,08,091,"Ouray County, CO",Mar-22,2678,2591,87,3.20000000
CN0809300000000,08,093,"Park County, CO",Mar-22,11507,11188,319,2.80000000
CN0809500000000,08,095,"Phillips County, CO",Mar-22,2467,2412,55,2.20000000
CN0809700000000,08,097,"Pitkin County, CO",Mar-22,11436,11094,342,3.00000000
CN0809900000000,08,099,"Prowers County, CO",Mar-22,6316,6123,193,3.10000000
CN0810100000000,08,101,"Pueblo County, CO",Mar-22,79180,74592,4588,5.80000000
CN0810300000000,08,103,"Rio Blanco County, CO",Mar-22,2867,2739,128,4.50000000
CN0810500000000,08,105,"Rio Grande County, CO",Mar-22,5429,5156,273,5.00000000
CN0810700000000,08,107,"Routt County, CO",Mar-22,16533,16102,431,2.60000000
CN0810900000000,08,109,"Saguache County, CO",Mar-22,3460,3321,139,4.00000000
CN0811100000000,08,111,"San Juan County, CO",Mar-22,615,598,17,2.80000000
CN0811300000000,08,113,"San Miguel County, CO",Mar-22,6979,6819,160,2.30000000
CN0811500000000,08,115,"Sedgwick County, CO",Mar-22,1169,1141,28,2.40000000
CN0811700000000,08,117,"Summit County, CO",Mar-22,25904,25357,547,2.10000000
CN0811900000000,08,119,"Teller County, CO",Mar-22,13280,12827,453,3.40000000
CN0812100000000,08,121,"Washington County, CO",Mar-22,2737,2670,67,2.40000000
CN0812300000000,08,123,"Weld County, CO",Mar-22,168683,162153,6530,3.90000000
CN0812500000000,08,125,"Yuma County, CO",Mar-22,5644,5532,112,2.00000000
CN0900100000000,09,001,"Fairfield County, CT",Mar-22,475748,455706,20042,4.20000000
CN0900300000000,09,003,"Hartford County, CT",Mar-22,480044,459333,20711,4.30000000
CN0900500000000,09,005,"Litchfield County, CT",Mar-22,103413,99110,4303,4.20000000
CN0900700000000,09,007,"Middlesex County, CT",Mar-22,93667,90318,3349,3.60000000
CN0900900000000,09,009,"New Haven County, CT",Mar-22,464881,444490,20391,4.40000000
CN0901100000000,09,011,"New London County, CT",Mar-22,130755,124569,6186,4.70000000
CN0901300000000,09,013,"Tolland County, CT",Mar-22,86634,83391,3243,3.70000000
CN0901500000000,09,015,"Windham County, CT",Mar-22,63254,60495,2759,4.40000000
CN1000100000000,10,001,"Kent County, DE",Mar-22,82128,77808,4320,5.30000000
CN1000300000000,10,003,"New Castle County, DE",Mar-22,306578,292845,13733,4.50000000
CN1000500000000,10,005,"Sussex County, DE",Mar-22,109897,104757,5140,4.70000000
CN1100100000000,11,001,District of Columbia,Mar-22,388830,368965,19865,5.10000000
CN1200100000000,12,001,"Alachua County, FL",Mar-22,141317,138009,3308,2.30000000
CN1200300000000,12,003,"Baker County, FL",Mar-22,12409,12116,293,2.40000000
CN1200500000000,12,005,"Bay County, FL",Mar-22,86914,84859,2055,2.40000000
CN1200700000000,12,007,"Bradford County, FL",Mar-22,10930,10635,295,2.70000000
CN1200900000000,12,009,"Brevard County, FL",Mar-22,293263,285948,7315,2.50000000
CN1201100000000,12,011,"Broward County, FL",Mar-22,1040339,1011529,28810,2.80000000
CN1201300000000,12,013,"Calhoun County, FL",Mar-22,4889,4754,135,2.80000000
CN1201500000000,12,015,"Charlotte County, FL",Mar-22,75460,73325,2135,2.80000000
CN1201700000000,12,017,"Citrus County, FL",Mar-22,47643,45890,1753,3.70000000
CN1201900000000,12,019,"Clay County, FL",Mar-22,110914,108404,2510,2.30000000
CN1202100000000,12,021,"Collier County, FL",Mar-22,187927,183778,4149,2.20000000
CN1202300000000,12,023,"Columbia County, FL",Mar-22,29016,28177,839,2.90000000
CN1202700000000,12,027,"DeSoto County, FL",Mar-22,15534,15168,366,2.40000000
CN1202900000000,12,029,"Dixie County, FL",Mar-22,5901,5729,172,2.90000000
CN1203100000000,12,031,"Duval County, FL",Mar-22,503762,490215,13547,2.70000000
CN1203300000000,12,033,"Escambia County, FL",Mar-22,147976,143923,4053,2.70000000
CN1203500000000,12,035,"Flagler County, FL",Mar-22,49073,47625,1448,3.00000000
CN1203700000000,12,037,"Franklin County, FL",Mar-22,4771,4649,122,2.60000000
CN1203900000000,12,039,"Gadsden County, FL",Mar-22,20183,19514,669,3.30000000
CN1204100000000,12,041,"Gilchrist County, FL",Mar-22,7355,7167,188,2.60000000
CN1204300000000,12,043,"Glades County, FL",Mar-22,5392,5257,135,2.50000000
CN1204500000000,12,045,"Gulf County, FL",Mar-22,5342,5219,123,2.30000000
CN1204700000000,12,047,"Hamilton County, FL",Mar-22,4063,3906,157,3.90000000
CN1204900000000,12,049,"Hardee County, FL",Mar-22,9162,8900,262,2.90000000
CN1205100000000,12,051,"Hendry County, FL",Mar-22,16593,16030,563,3.40000000
CN1205300000000,12,053,"Hernando County, FL",Mar-22,75010,72583,2427,3.20000000
CN1205500000000,12,055,"Highlands County, FL",Mar-22,34683,33356,1327,3.80000000
CN1205700000000,12,057,"Hillsborough County, FL",Mar-22,789073,769479,19594,2.50000000
CN1205900000000,12,059,"Holmes County, FL",Mar-22,7012,6827,185,2.60000000
CN1206100000000,12,061,"Indian River County, FL",Mar-22,66431,64466,1965,3.00000000
CN1206300000000,12,063,"Jackson County, FL",Mar-22,17171,16691,480,2.80000000
CN1206500000000,12,065,"Jefferson County, FL",Mar-22,5700,5551,149,2.60000000
CN1206700000000,12,067,"Lafayette County, FL",Mar-22,2793,2715,78,2.80000000
CN1206900000000,12,069,"Lake County, FL",Mar-22,165053,160413,4640,2.80000000
CN1207100000000,12,071,"Lee County, FL",Mar-22,367599,358358,9241,2.50000000
CN1207300000000,12,073,"Leon County, FL",Mar-22,157134,153070,4064,2.60000000
CN1207500000000,12,075,"Levy County, FL",Mar-22,16930,16417,513,3.00000000
CN1207700000000,12,077,"Liberty County, FL",Mar-22,2589,2518,71,2.70000000
CN1207900000000,12,079,"Madison County, FL",Mar-22,7828,7601,227,2.90000000
CN1208100000000,12,081,"Manatee County, FL",Mar-22,189943,185415,4528,2.40000000
CN1208300000000,12,083,"Marion County, FL",Mar-22,142594,138158,4436,3.10000000
CN1208500000000,12,085,"Martin County, FL",Mar-22,75080,73371,1709,2.30000000
CN1208600000000,12,086,"Miami-Dade County, FL",Mar-22,1353913,1313296,40617,3.00000000
CN1208700000000,12,087,"Monroe County, FL",Mar-22,49117,48285,832,1.70000000
CN1208900000000,12,089,"Nassau County, FL",Mar-22,43917,42964,953,2.20000000
CN1209100000000,12,091,"Okaloosa County, FL",Mar-22,100446,98332,2114,2.10000000
CN1209300000000,12,093,"Okeechobee County, FL",Mar-22,17929,17454,475,2.60000000
CN1209500000000,12,095,"Orange County, FL",Mar-22,764390,742448,21942,2.90000000
CN1209700000000,12,097,"Osceola County, FL",Mar-22,190733,184013,6720,3.50000000
CN1209900000000,12,099,"Palm Beach County, FL",Mar-22,750769,731490,19279,2.60000000
CN1210100000000,12,101,"Pasco County, FL",Mar-22,251978,245184,6794,2.70000000
CN1210300000000,12,103,"Pinellas County, FL",Mar-22,497897,485972,11925,2.40000000
CN1210500000000,12,105,"Polk County, FL",Mar-22,334950,324382,10568,3.20000000
CN1210700000000,12,107,"Putnam County, FL",Mar-22,27417,26366,1051,3.80000000
CN1210900000000,12,109,"St. Johns County, FL",Mar-22,146305,143426,2879,2.00000000
CN1211100000000,12,111,"St. Lucie County, FL",Mar-22,152846,148182,4664,3.10000000
CN1211300000000,12,113,"Santa Rosa County, FL",Mar-22,86631,84668,1963,2.30000000
CN1211500000000,12,115,"Sarasota County, FL",Mar-22,198633,193889,4744,2.40000000
CN1211700000000,12,117,"Seminole County, FL",Mar-22,253746,247567,6179,2.40000000
CN1211900000000,12,119,"Sumter County, FL",Mar-22,35587,34301,1286,3.60000000
CN1212100000000,12,121,"Suwannee County, FL",Mar-22,17296,16816,480,2.80000000
CN1212300000000,12,123,"Taylor County, FL",Mar-22,7902,7657,245,3.10000000
CN1212500000000,12,125,"Union County, FL",Mar-22,4606,4506,100,2.20000000
CN1212700000000,12,127,"Volusia County, FL",Mar-22,258824,251485,7339,2.80000000
CN1212900000000,12,129,"Wakulla County, FL",Mar-22,15820,15490,330,2.10000000
CN1213100000000,12,131,"Walton County, FL",Mar-22,34076,33300,776,2.30000000
CN1213300000000,12,133,"Washington County, FL",Mar-22,9547,9280,267,2.80000000
CN1300100000000,13,001,"Appling County, GA",Mar-22,9130,8815,315,3.50000000
CN1300300000000,13,003,"Atkinson County, GA",Mar-22,4592,4466,126,2.70000000
CN1300500000000,13,005,"Bacon County, GA",Mar-22,4811,4662,149,3.10000000
CN1300700000000,13,007,"Baker County, GA",Mar-22,1145,1094,51,4.50000000
CN1300900000000,13,009,"Baldwin County, GA",Mar-22,17806,17075,731,4.10000000
CN1301100000000,13,011,"Banks County, GA",Mar-22,10290,10031,259,2.50000000
CN1301300000000,13,013,"Barrow County, GA",Mar-22,43612,42461,1151,2.60000000
CN1301500000000,13,015,"Bartow County, GA",Mar-22,52964,51353,1611,3.00000000
CN1301700000000,13,017,"Ben Hill County, GA",Mar-22,5536,5282,254,4.60000000
CN1301900000000,13,019,"Berrien County, GA",Mar-22,7735,7474,261,3.40000000
CN1302100000000,13,021,"Bibb County, GA",Mar-22,68653,65901,2752,4.00000000
CN1302300000000,13,023,"Bleckley County, GA",Mar-22,4700,4498,202,4.30000000
CN1302500000000,13,025,"Brantley County, GA",Mar-22,7356,7095,261,3.50000000
CN1302700000000,13,027,"Brooks County, GA",Mar-22,6812,6593,219,3.20000000
CN1302900000000,13,029,"Bryan County, GA",Mar-22,20659,20107,552,2.70000000
CN1303100000000,13,031,"Bulloch County, GA",Mar-22,38537,37170,1367,3.50000000
CN1303300000000,13,033,"Burke County, GA",Mar-22,9188,8687,501,5.50000000
CN1303500000000,13,035,"Butts County, GA",Mar-22,11492,11142,350,3.00000000
CN1303700000000,13,037,"Calhoun County, GA",Mar-22,2259,2185,74,3.30000000
CN1303900000000,13,039,"Camden County, GA",Mar-22,22079,21378,701,3.20000000
CN1304300000000,13,043,"Candler County, GA",Mar-22,6065,5907,158,2.60000000
CN1304500000000,13,045,"Carroll County, GA",Mar-22,57927,56069,1858,3.20000000
CN1304700000000,13,047,"Catoosa County, GA",Mar-22,33734,32809,925,2.70000000
CN1304900000000,13,049,"Charlton County, GA",Mar-22,5008,4834,174,3.50000000
CN1305100000000,13,051,"Chatham County, GA",Mar-22,148437,143371,5066,3.40000000
CN1305300000000,13,053,"Chattahoochee County, GA",Mar-22,1957,1862,95,4.90000000
CN1305500000000,13,055,"Chattooga County, GA",Mar-22,9453,9069,384,4.10000000
CN1305700000000,13,057,"Cherokee County, GA",Mar-22,144344,140802,3542,2.50000000
CN1305900000000,13,059,"Clarke County, GA",Mar-22,61229,59250,1979,3.20000000
CN1306100000000,13,061,"Clay County, GA",Mar-22,882,799,83,9.40000000
CN1306300000000,13,063,"Clayton County, GA",Mar-22,143477,136240,7237,5.00000000
CN1306500000000,13,065,"Clinch County, GA",Mar-22,3102,3019,83,2.70000000
CN1306700000000,13,067,"Cobb County, GA",Mar-22,436828,424697,12131,2.80000000
CN1306900000000,13,069,"Coffee County, GA",Mar-22,18699,17998,701,3.70000000
CN1307100000000,13,071,"Colquitt County, GA",Mar-22,22266,21600,666,3.00000000
CN1307300000000,13,073,"Columbia County, GA",Mar-22,76977,74831,2146,2.80000000
CN1307500000000,13,075,"Cook County, GA",Mar-22,8271,8002,269,3.30000000
CN1307700000000,13,077,"Coweta County, GA",Mar-22,78743,76489,2254,2.90000000
CN1307900000000,13,079,"Crawford County, GA",Mar-22,5611,5434,177,3.20000000
CN1308100000000,13,081,"Crisp County, GA",Mar-22,9609,9104,505,5.30000000
CN1308300000000,13,083,"Dade County, GA",Mar-22,8072,7859,213,2.60000000
CN1308500000000,13,085,"Dawson County, GA",Mar-22,13552,13205,347,2.60000000
CN1308700000000,13,087,"Decatur County, GA",Mar-22,11472,11078,394,3.40000000
CN1308900000000,13,089,"DeKalb County, GA",Mar-22,411702,396753,14949,3.60000000
CN1309100000000,13,091,"Dodge County, GA",Mar-22,7023,6747,276,3.90000000
CN1309300000000,13,093,"Dooly County, GA",Mar-22,4766,4542,224,4.70000000
CN1309500000000,13,095,"Dougherty County, GA",Mar-22,37361,35528,1833,4.90000000
CN1309700000000,13,097,"Douglas County, GA",Mar-22,76161,73459,2702,3.50000000
CN1309900000000,13,099,"Early County, GA",Mar-22,4343,4156,187,4.30000000
CN1310100000000,13,101,"Echols County, GA",Mar-22,1915,1860,55,2.90000000
CN1310300000000,13,103,"Effingham County, GA",Mar-22,34595,33667,928,2.70000000
CN1310500000000,13,105,"Elbert County, GA",Mar-22,7759,7441,318,4.10000000
CN1310700000000,13,107,"Emanuel County, GA",Mar-22,8636,8257,379,4.40000000
CN1310900000000,13,109,"Evans County, GA",Mar-22,5268,5115,153,2.90000000
CN1311100000000,13,111,"Fannin County, GA",Mar-22,12039,11701,338,2.80000000
CN1311300000000,13,113,"Fayette County, GA",Mar-22,60279,58659,1620,2.70000000
CN1311500000000,13,115,"Floyd County, GA",Mar-22,44082,42669,1413,3.20000000
CN1311700000000,13,117,"Forsyth County, GA",Mar-22,131725,128558,3167,2.40000000
CN1311900000000,13,119,"Franklin County, GA",Mar-22,10238,9903,335,3.30000000
CN1312100000000,13,121,"Fulton County, GA",Mar-22,584700,563323,21377,3.70000000
CN1312300000000,13,123,"Gilmer County, GA",Mar-22,12442,12050,392,3.20000000
CN1312500000000,13,125,"Glascock County, GA",Mar-22,1270,1235,35,2.80000000
CN1312700000000,13,127,"Glynn County, GA",Mar-22,39531,38260,1271,3.20000000
CN1312900000000,13,129,"Gordon County, GA",Mar-22,29388,28576,812,2.80000000
CN1313100000000,13,131,"Grady County, GA",Mar-22,11184,10850,334,3.00000000
CN1313300000000,13,133,"Greene County, GA",Mar-22,7271,7028,243,3.30000000
CN1313500000000,13,135,"Gwinnett County, GA",Mar-22,507438,492617,14821,2.90000000
CN1313700000000,13,137,"Habersham County, GA",Mar-22,18803,18198,605,3.20000000
CN1313900000000,13,139,"Hall County, GA",Mar-22,107119,104458,2661,2.50000000
CN1314100000000,13,141,"Hancock County, GA",Mar-22,2545,2399,146,5.70000000
CN1314300000000,13,143,"Haralson County, GA",Mar-22,13162,12750,412,3.10000000
CN1314500000000,13,145,"Harris County, GA",Mar-22,17165,16684,481,2.80000000
CN1314700000000,13,147,"Hart County, GA",Mar-22,11938,11519,419,3.50000000
CN1314900000000,13,149,"Heard County, GA",Mar-22,5398,5223,175,3.20000000
CN1315100000000,13,151,"Henry County, GA",Mar-22,122496,118253,4243,3.50000000
CN1315300000000,13,153,"Houston County, GA",Mar-22,72349,70090,2259,3.10000000
CN1315500000000,13,155,"Irwin County, GA",Mar-22,3616,3468,148,4.10000000
CN1315700000000,13,157,"Jackson County, GA",Mar-22,44211,43200,1011,2.30000000
CN1315900000000,13,159,"Jasper County, GA",Mar-22,7289,7085,204,2.80000000
CN1316100000000,13,161,"Jeff Davis County, GA",Mar-22,6222,5996,226,3.60000000
CN1316300000000,13,163,"Jefferson County, GA",Mar-22,7051,6758,293,4.20000000
CN1316500000000,13,165,"Jenkins County, GA",Mar-22,3186,3050,136,4.30000000
CN1316700000000,13,167,"Johnson County, GA",Mar-22,4145,4010,135,3.30000000
CN1316900000000,13,169,"Jones County, GA",Mar-22,13909,13507,402,2.90000000
CN1317100000000,13,171,"Lamar County, GA",Mar-22,8480,8188,292,3.40000000
CN1317300000000,13,173,"Lanier County, GA",Mar-22,3850,3716,134,3.50000000
CN1317500000000,13,175,"Laurens County, GA",Mar-22,19734,18990,744,3.80000000
CN1317700000000,13,177,"Lee County, GA",Mar-22,15333,14879,454,3.00000000
CN1317900000000,13,179,"Liberty County, GA",Mar-22,26587,25669,918,3.50000000
CN1318100000000,13,181,"Lincoln County, GA",Mar-22,3577,3438,139,3.90000000
CN1318300000000,13,183,"Long County, GA",Mar-22,8596,8317,279,3.20000000
CN1318500000000,13,185,"Lowndes County, GA",Mar-22,51618,49871,1747,3.40000000
CN1318700000000,13,187,"Lumpkin County, GA",Mar-22,17845,17394,451,2.50000000
CN1318900000000,13,189,"McDuffie County, GA",Mar-22,8548,8162,386,4.50000000
CN1319100000000,13,191,"McIntosh County, GA",Mar-22,6200,5990,210,3.40000000
CN1319300000000,13,193,"Macon County, GA",Mar-22,4621,4422,199,4.30000000
CN1319500000000,13,195,"Madison County, GA",Mar-22,14086,13686,400,2.80000000
CN1319700000000,13,197,"Marion County, GA",Mar-22,3303,3190,113,3.40000000
CN1319900000000,13,199,"Meriwether County, GA",Mar-22,9116,8726,390,4.30000000
CN1320100000000,13,201,"Miller County, GA",Mar-22,2798,2713,85,3.00000000
CN1320500000000,13,205,"Mitchell County, GA",Mar-22,8202,7851,351,4.30000000
CN1320700000000,13,207,"Monroe County, GA",Mar-22,13356,12972,384,2.90000000
CN1320900000000,13,209,"Montgomery County, GA",Mar-22,3827,3675,152,4.00000000
CN1321100000000,13,211,"Morgan County, GA",Mar-22,9803,9517,286,2.90000000
CN1321300000000,13,213,"Murray County, GA",Mar-22,15618,15041,577,3.70000000
CN1321500000000,13,215,"Muscogee County, GA",Mar-22,77392,73863,3529,4.60000000
CN1321700000000,13,217,"Newton County, GA",Mar-22,55082,53021,2061,3.70000000
CN1321900000000,13,219,"Oconee County, GA",Mar-22,21068,20599,469,2.20000000
CN1322100000000,13,221,"Oglethorpe County, GA",Mar-22,7290,7094,196,2.70000000
CN1322300000000,13,223,"Paulding County, GA",Mar-22,92556,90033,2523,2.70000000
CN1322500000000,13,225,"Peach County, GA",Mar-22,12091,11638,453,3.70000000
CN1322700000000,13,227,"Pickens County, GA",Mar-22,16116,15677,439,2.70000000
CN1322900000000,13,229,"Pierce County, GA",Mar-22,8606,8358,248,2.90000000
CN1323100000000,13,231,"Pike County, GA",Mar-22,9294,9041,253,2.70000000
CN1323300000000,13,233,"Polk County, GA",Mar-22,18640,18000,640,3.40000000
CN1323500000000,13,235,"Pulaski County, GA",Mar-22,4079,3948,131,3.20000000
CN1323700000000,13,237,"Putnam County, GA",Mar-22,8827,8499,328,3.70000000
CN1323900000000,13,239,"Quitman County, GA",Mar-22,768,733,35,4.60000000
CN1324100000000,13,241,"Rabun County, GA",Mar-22,7505,7255,250,3.30000000
CN1324300000000,13,243,"Randolph County, GA",Mar-22,2420,2297,123,5.10000000
CN1324500000000,13,245,"Richmond County, GA",Mar-22,84337,80460,3877,4.60000000
CN1324700000000,13,247,"Rockdale County, GA",Mar-22,45896,44145,1751,3.80000000
CN1324900000000,13,249,"Schley County, GA",Mar-22,2128,2045,83,3.90000000
CN1325100000000,13,251,"Screven County, GA",Mar-22,5115,4873,242,4.70000000
CN1325300000000,13,253,"Seminole County, GA",Mar-22,3033,2913,120,4.00000000
CN1325500000000,13,255,"Spalding County, GA",Mar-22,29762,28676,1086,3.60000000
CN1325700000000,13,257,"Stephens County, GA",Mar-22,10575,10180,395,3.70000000
CN1325900000000,13,259,"Stewart County, GA",Mar-22,2621,2534,87,3.30000000
CN1326100000000,13,261,"Sumter County, GA",Mar-22,12147,11580,567,4.70000000
CN1326300000000,13,263,"Talbot County, GA",Mar-22,2818,2705,113,4.00000000
CN1326500000000,13,265,"Taliaferro County, GA",Mar-22,536,513,23,4.30000000
CN1326700000000,13,267,"Tattnall County, GA",Mar-22,9826,9511,315,3.20000000
CN1326900000000,13,269,"Taylor County, GA",Mar-22,2939,2798,141,4.80000000
CN1327100000000,13,271,"Telfair County, GA",Mar-22,3709,3478,231,6.20000000
CN1327300000000,13,273,"Terrell County, GA",Mar-22,3578,3385,193,5.40000000
CN1327500000000,13,275,"Thomas County, GA",Mar-22,17731,17080,651,3.70000000
CN1327700000000,13,277,"Tift County, GA",Mar-22,21503,20896,607,2.80000000
CN1327900000000,13,279,"Toombs County, GA",Mar-22,12015,11541,474,3.90000000
CN1328100000000,13,281,"Towns County, GA",Mar-22,4101,3932,169,4.10000000
CN1328300000000,13,283,"Treutlen County, GA",Mar-22,2647,2543,104,3.90000000
CN1328500000000,13,285,"Troup County, GA",Mar-22,37682,36444,1238,3.30000000
CN1328700000000,13,287,"Turner County, GA",Mar-22,3257,3100,157,4.80000000
CN1328900000000,13,289,"Twiggs County, GA",Mar-22,2868,2728,140,4.90000000
CN1329100000000,13,291,"Union County, GA",Mar-22,11321,10998,323,2.90000000
CN1329300000000,13,293,"Upson County, GA",Mar-22,11935,11543,392,3.30000000
CN1329500000000,13,295,"Walker County, GA",Mar-22,31496,30571,925,2.90000000
CN1329700000000,13,297,"Walton County, GA",Mar-22,48633,47202,1431,2.90000000
CN1329900000000,13,299,"Ware County, GA",Mar-22,15324,14854,470,3.10000000
CN1330100000000,13,301,"Warren County, GA",Mar-22,2670,2575,95,3.60000000
CN1330300000000,13,303,"Washington County, GA",Mar-22,6781,6478,303,4.50000000
CN1330500000000,13,305,"Wayne County, GA",Mar-22,12010,11615,395,3.30000000
CN1330700000000,13,307,"Webster County, GA",Mar-22,998,960,38,3.80000000
CN1330900000000,13,309,"Wheeler County, GA",Mar-22,1643,1559,84,5.10000000
CN1331100000000,13,311,"White County, GA",Mar-22,16712,16303,409,2.40000000
CN1331300000000,13,313,"Whitfield County, GA",Mar-22,43879,42317,1562,3.60000000
CN1331500000000,13,315,"Wilcox County, GA",Mar-22,2745,2648,97,3.50000000
CN1331700000000,13,317,"Wilkes County, GA",Mar-22,3684,3521,163,4.40000000
CN1331900000000,13,319,"Wilkinson County, GA",Mar-22,3629,3500,129,3.60000000
CN1332100000000,13,321,"Worth County, GA",Mar-22,8934,8640,294,3.30000000
CN1500100000000,15,001,"Hawaii County, HI",Mar-22,93458,90366,3092,3.30000000
CN1500300000000,15,003,"Honolulu County/city, HI",Mar-22,452044,437569,14475,3.20000000
CN1500700000000,15,007,"Kauai County, HI",Mar-22,36309,34646,1663,4.60000000
CN1500900000000,15,009,"Maui County, HI",Mar-22,87366,83663,3703,4.20000000
CN1600100000000,16,001,"Ada County, ID",Mar-22,276607,269528,7079,2.60000000
CN1600300000000,16,003,"Adams County, ID",Mar-22,1769,1611,158,8.90000000
CN1600500000000,16,005,"Bannock County, ID",Mar-22,44843,43488,1355,3.00000000
CN1600700000000,16,007,"Bear Lake County, ID",Mar-22,3228,3128,100,3.10000000
CN1600900000000,16,009,"Benewah County, ID",Mar-22,4005,3781,224,5.60000000
CN1601100000000,16,011,"Bingham County, ID",Mar-22,24665,23944,721,2.90000000
CN1601300000000,16,013,"Blaine County, ID",Mar-22,13001,12568,433,3.30000000
CN1601500000000,16,015,"Boise County, ID",Mar-22,3860,3676,184,4.80000000
CN1601700000000,16,017,"Bonner County, ID",Mar-22,21844,20812,1032,4.70000000
CN1601900000000,16,019,"Bonneville County, ID",Mar-22,63237,61516,1721,2.70000000
CN1602100000000,16,021,"Boundary County, ID",Mar-22,5556,5276,280,5.00000000
CN1602300000000,16,023,"Butte County, ID",Mar-22,1495,1433,62,4.10000000
CN1602500000000,16,025,"Camas County, ID",Mar-22,710,684,26,3.70000000
CN1602700000000,16,027,"Canyon County, ID",Mar-22,113581,109982,3599,3.20000000
CN1602900000000,16,029,"Caribou County, ID",Mar-22,4177,4024,153,3.70000000
CN1603100000000,16,031,"Cassia County, ID",Mar-22,12627,12295,332,2.60000000
CN1603300000000,16,033,"Clark County, ID",Mar-22,369,353,16,4.30000000
CN1603500000000,16,035,"Clearwater County, ID",Mar-22,2966,2768,198,6.70000000
CN1603700000000,16,037,"Custer County, ID",Mar-22,2071,1976,95,4.60000000
CN1603900000000,16,039,"Elmore County, ID",Mar-22,12117,11705,412,3.40000000
CN1604100000000,16,041,"Franklin County, ID",Mar-22,7740,7569,171,2.20000000
CN1604300000000,16,043,"Fremont County, ID",Mar-22,8430,8182,248,2.90000000
CN1604500000000,16,045,"Gem County, ID",Mar-22,8979,8673,306,3.40000000
CN1604700000000,16,047,"Gooding County, ID",Mar-22,8502,8233,269,3.20000000
CN1604900000000,16,049,"Idaho County, ID",Mar-22,6741,6429,312,4.60000000
CN1605100000000,16,051,"Jefferson County, ID",Mar-22,15176,14781,395,2.60000000
CN1605300000000,16,053,"Jerome County, ID",Mar-22,12861,12444,417,3.20000000
CN1605500000000,16,055,"Kootenai County, ID",Mar-22,85312,82095,3217,3.80000000
CN1605700000000,16,057,"Latah County, ID",Mar-22,20905,20317,588,2.80000000
CN1605900000000,16,059,"Lemhi County, ID",Mar-22,3539,3355,184,5.20000000
CN1606100000000,16,061,"Lewis County, ID",Mar-22,1609,1531,78,4.80000000
CN1606300000000,16,063,"Lincoln County, ID",Mar-22,2746,2582,164,6.00000000
CN1606500000000,16,065,"Madison County, ID",Mar-22,24368,23881,487,2.00000000
CN1606700000000,16,067,"Minidoka County, ID",Mar-22,11938,11610,328,2.70000000
CN1606900000000,16,069,"Nez Perce County, ID",Mar-22,21451,20833,618,2.90000000
CN1607100000000,16,071,"Oneida County, ID",Mar-22,2735,2667,68,2.50000000
CN1607300000000,16,073,"Owyhee County, ID",Mar-22,5712,5502,210,3.70000000
CN1607500000000,16,075,"Payette County, ID",Mar-22,12328,11909,419,3.40000000
CN1607700000000,16,077,"Power County, ID",Mar-22,4102,3955,147,3.60000000
CN1607900000000,16,079,"Shoshone County, ID",Mar-22,5628,5294,334,5.90000000
CN1608100000000,16,081,"Teton County, ID",Mar-22,6943,6774,169,2.40000000
CN1608300000000,16,083,"Twin Falls County, ID",Mar-22,43678,42359,1319,3.00000000
CN1608500000000,16,085,"Valley County, ID",Mar-22,5706,5409,297,5.20000000
CN1608700000000,16,087,"Washington County, ID",Mar-22,4876,4678,198,4.10000000
CN1700100000000,17,001,"Adams County, IL",Mar-22,30601,29564,1037,3.40000000
CN1700300000000,17,003,"Alexander County, IL",Mar-22,1836,1699,137,7.50000000
CN1700500000000,17,005,"Bond County, IL",Mar-22,7430,7143,287,3.90000000
CN1700700000000,17,007,"Boone County, IL",Mar-22,25610,23156,2454,9.60000000
CN1700900000000,17,009,"Brown County, IL",Mar-22,3120,3055,65,2.10000000
CN1701100000000,17,011,"Bureau County, IL",Mar-22,16205,15381,824,5.10000000
CN1701300000000,17,013,"Calhoun County, IL",Mar-22,2170,2080,90,4.10000000
CN1701500000000,17,015,"Carroll County, IL",Mar-22,7386,7074,312,4.20000000
CN1701700000000,17,017,"Cass County, IL",Mar-22,5601,5349,252,4.50000000
CN1701900000000,17,019,"Champaign County, IL",Mar-22,109958,105740,4218,3.80000000
CN1702100000000,17,021,"Christian County, IL",Mar-22,13365,12713,652,4.90000000
CN1702300000000,17,023,"Clark County, IL",Mar-22,7157,6817,340,4.80000000
CN1702500000000,17,025,"Clay County, IL",Mar-22,5779,5489,290,5.00000000
CN1702700000000,17,027,"Clinton County, IL",Mar-22,19825,19231,594,3.00000000
CN1702900000000,17,029,"Coles County, IL",Mar-22,22872,21899,973,4.30000000
CN1703100000000,17,031,"Cook County, IL",Mar-22,2674019,2543121,130898,4.90000000
CN1703300000000,17,033,"Crawford County, IL",Mar-22,8756,8388,368,4.20000000
CN1703500000000,17,035,"Cumberland County, IL",Mar-22,6021,5799,222,3.70000000
CN1703700000000,17,037,"DeKalb County, IL",Mar-22,53907,51235,2672,5.00000000
CN1703900000000,17,039,"De Witt County, IL",Mar-22,7298,6985,313,4.30000000
CN1704100000000,17,041,"Douglas County, IL",Mar-22,10116,9788,328,3.20000000
CN1704300000000,17,043,"DuPage County, IL",Mar-22,518497,503089,15408,3.00000000
CN1704500000000,17,045,"Edgar County, IL",Mar-22,8891,8575,316,3.60000000
CN1704700000000,17,047,"Edwards County, IL",Mar-22,2510,2408,102,4.10000000
CN1704900000000,17,049,"Effingham County, IL",Mar-22,19768,19142,626,3.20000000
CN1705100000000,17,051,"Fayette County, IL",Mar-22,9761,9305,456,4.70000000
CN1705300000000,17,053,"Ford County, IL",Mar-22,6318,6060,258,4.10000000
CN1705500000000,17,055,"Franklin County, IL",Mar-22,15743,14849,894,5.70000000
CN1705700000000,17,057,"Fulton County, IL",Mar-22,14380,13582,798,5.50000000
CN1705900000000,17,059,"Gallatin County, IL",Mar-22,1991,1890,101,5.10000000
CN1706100000000,17,061,"Greene County, IL",Mar-22,5867,5633,234,4.00000000
CN1706300000000,17,063,"Grundy County, IL",Mar-22,26153,25080,1073,4.10000000
CN1706500000000,17,065,"Hamilton County, IL",Mar-22,4247,4087,160,3.80000000
CN1706700000000,17,067,"Hancock County, IL",Mar-22,8122,7807,315,3.90000000
CN1706900000000,17,069,"Hardin County, IL",Mar-22,1309,1237,72,5.50000000
CN1707100000000,17,071,"Henderson County, IL",Mar-22,3606,3447,159,4.40000000
CN1707300000000,17,073,"Henry County, IL",Mar-22,23804,22724,1080,4.50000000
CN1707500000000,17,075,"Iroquois County, IL",Mar-22,12865,12230,635,4.90000000
CN1707700000000,17,077,"Jackson County, IL",Mar-22,27715,26518,1197,4.30000000
CN1707900000000,17,079,"Jasper County, IL",Mar-22,4803,4620,183,3.80000000
CN1708100000000,17,081,"Jefferson County, IL",Mar-22,16398,15562,836,5.10000000
CN1708300000000,17,083,"Jersey County, IL",Mar-22,10557,10182,375,3.60000000
CN1708500000000,17,085,"Jo Daviess County, IL",Mar-22,10345,9881,464,4.50000000
CN1708700000000,17,087,"Johnson County, IL",Mar-22,4202,3978,224,5.30000000
CN1708900000000,17,089,"Kane County, IL",Mar-22,265122,250590,14532,5.50000000
CN1709100000000,17,091,"Kankakee County, IL",Mar-22,52621,49453,3168,6.00000000
CN1709300000000,17,093,"Kendall County, IL",Mar-22,72179,69844,2335,3.20000000
CN1709500000000,17,095,"Knox County, IL",Mar-22,20162,18931,1231,6.10000000
CN1709700000000,17,097,"Lake County, IL",Mar-22,368298,349809,18489,5.00000000
CN1709900000000,17,099,"LaSalle County, IL",Mar-22,52556,49585,2971,5.70000000
CN1710100000000,17,101,"Lawrence County, IL",Mar-22,5590,5278,312,5.60000000
CN1710300000000,17,103,"Lee County, IL",Mar-22,16639,15902,737,4.40000000
CN1710500000000,17,105,"Livingston County, IL",Mar-22,15388,14707,681,4.40000000
CN1710700000000,17,107,"Logan County, IL",Mar-22,11820,11322,498,4.20000000
CN1710900000000,17,109,"McDonough County, IL",Mar-22,12799,12290,509,4.00000000
CN1711100000000,17,111,"McHenry County, IL",Mar-22,169666,163829,5837,3.40000000
CN1711300000000,17,113,"McLean County, IL",Mar-22,87971,84746,3225,3.70000000
CN1711500000000,17,115,"Macon County, IL",Mar-22,46829,43651,3178,6.80000000
CN1711700000000,17,117,"Macoupin County, IL",Mar-22,22032,21184,848,3.80000000
CN1711900000000,17,119,"Madison County, IL",Mar-22,130655,125610,5045,3.90000000
CN1712100000000,17,121,"Marion County, IL",Mar-22,16587,15756,831,5.00000000
CN1712300000000,17,123,"Marshall County, IL",Mar-22,5114,4841,273,5.30000000
CN1712500000000,17,125,"Mason County, IL",Mar-22,5799,5513,286,4.90000000
CN1712700000000,17,127,"Massac County, IL",Mar-22,5298,5053,245,4.60000000
CN1712900000000,17,129,"Menard County, IL",Mar-22,6262,6020,242,3.90000000
CN1713100000000,17,131,"Mercer County, IL",Mar-22,7643,7257,386,5.10000000
CN1713300000000,17,133,"Monroe County, IL",Mar-22,18549,18052,497,2.70000000
CN1713500000000,17,135,"Montgomery County, IL",Mar-22,11224,10682,542,4.80000000
CN1713700000000,17,137,"Morgan County, IL",Mar-22,15701,15013,688,4.40000000
CN1713900000000,17,139,"Moultrie County, IL",Mar-22,7445,7215,230,3.10000000
CN1714100000000,17,141,"Ogle County, IL",Mar-22,23835,22424,1411,5.90000000
CN1714300000000,17,143,"Peoria County, IL",Mar-22,82557,77311,5246,6.40000000
CN1714500000000,17,145,"Perry County, IL",Mar-22,8005,7608,397,5.00000000
CN1714700000000,17,147,"Piatt County, IL",Mar-22,8643,8340,303,3.50000000
CN1714900000000,17,149,"Pike County, IL",Mar-22,6715,6411,304,4.50000000
CN1715100000000,17,151,"Pope County, IL",Mar-22,1715,1635,80,4.70000000
CN1715300000000,17,153,"Pulaski County, IL",Mar-22,1705,1563,142,8.30000000
CN1715500000000,17,155,"Putnam County, IL",Mar-22,2916,2758,158,5.40000000
CN1715700000000,17,157,"Randolph County, IL",Mar-22,13648,13183,465,3.40000000
CN1715900000000,17,159,"Richland County, IL",Mar-22,7110,6849,261,3.70000000
CN1716100000000,17,161,"Rock Island County, IL",Mar-22,67980,64635,3345,4.90000000
CN1716300000000,17,163,"St. Clair County, IL",Mar-22,123329,117346,5983,4.90000000
CN1716500000000,17,165,"Saline County, IL",Mar-22,9202,8702,500,5.40000000
CN1716700000000,17,167,"Sangamon County, IL",Mar-22,99008,94495,4513,4.60000000
CN1716900000000,17,169,"Schuyler County, IL",Mar-22,3163,3033,130,4.10000000
CN1717100000000,17,171,"Scott County, IL",Mar-22,2313,2176,137,5.90000000
CN1717300000000,17,173,"Shelby County, IL",Mar-22,10329,9918,411,4.00000000
CN1717500000000,17,175,"Stark County, IL",Mar-22,2386,2246,140,5.90000000
CN1717700000000,17,177,"Stephenson County, IL",Mar-22,20596,19518,1078,5.20000000
CN1717900000000,17,179,"Tazewell County, IL",Mar-22,61396,58707,2689,4.40000000
CN1718100000000,17,181,"Union County, IL",Mar-22,7311,6909,402,5.50000000
CN1718300000000,17,183,"Vermilion County, IL",Mar-22,31670,29886,1784,5.60000000
CN1718500000000,17,185,"Wabash County, IL",Mar-22,5480,5276,204,3.70000000
CN1718700000000,17,187,"Warren County, IL",Mar-22,7643,7334,309,4.00000000
CN1718900000000,17,189,"Washington County, IL",Mar-22,9650,9428,222,2.30000000
CN1719100000000,17,191,"Wayne County, IL",Mar-22,6866,6597,269,3.90000000
CN1719300000000,17,193,"White County, IL",Mar-22,5979,5727,252,4.20000000
CN1719500000000,17,195,"Whiteside County, IL",Mar-22,27308,26164,1144,4.20000000
CN1719700000000,17,197,"Will County, IL",Mar-22,367774,352481,15293,4.20000000
CN1719900000000,17,199,"Williamson County, IL",Mar-22,31829,30328,1501,4.70000000
CN1720100000000,17,201,"Winnebago County, IL",Mar-22,135088,123851,11237,8.30000000
CN1720300000000,17,203,"Woodford County, IL",Mar-22,18046,17409,637,3.50000000
CN1800100000000,18,001,"Adams County, IN",Mar-22,16784,16454,330,2.00000000
CN1800300000000,18,003,"Allen County, IN",Mar-22,186833,181950,4883,2.60000000
CN1800500000000,18,005,"Bartholomew County, IN",Mar-22,43338,42358,980,2.30000000
CN1800700000000,18,007,"Benton County, IN",Mar-22,4247,4144,103,2.40000000
CN1800900000000,18,009,"Blackford County, IN",Mar-22,4713,4565,148,3.10000000
CN1801100000000,18,011,"Boone County, IN",Mar-22,37737,37040,697,1.80000000
CN1801300000000,18,013,"Brown County, IN",Mar-22,7747,7533,214,2.80000000
CN1801500000000,18,015,"Carroll County, IN",Mar-22,9689,9429,260,2.70000000
CN1801700000000,18,017,"Cass County, IN",Mar-22,17046,16529,517,3.00000000
CN1801900000000,18,019,"Clark County, IN",Mar-22,62261,60609,1652,2.70000000
CN1802100000000,18,021,"Clay County, IN",Mar-22,11609,11278,331,2.90000000
CN1802300000000,18,023,"Clinton County, IN",Mar-22,16770,16397,373,2.20000000
CN1802500000000,18,025,"Crawford County, IN",Mar-22,4764,4602,162,3.40000000
CN1802700000000,18,027,"Daviess County, IN",Mar-22,16293,15961,332,2.00000000
CN1802900000000,18,029,"Dearborn County, IN",Mar-22,25223,24587,636,2.50000000
CN1803100000000,18,031,"Decatur County, IN",Mar-22,14684,14327,357,2.40000000
CN1803300000000,18,033,"DeKalb County, IN",Mar-22,22233,21767,466,2.10000000
CN1803500000000,18,035,"Delaware County, IN",Mar-22,52731,51103,1628,3.10000000
CN1803700000000,18,037,"Dubois County, IN",Mar-22,21719,21291,428,2.00000000
CN1803900000000,18,039,"Elkhart County, IN",Mar-22,120444,118269,2175,1.80000000
CN1804100000000,18,041,"Fayette County, IN",Mar-22,8263,7952,311,3.80000000
CN1804300000000,18,043,"Floyd County, IN",Mar-22,41887,40900,987,2.40000000
CN1804500000000,18,045,"Fountain County, IN",Mar-22,7762,7565,197,2.50000000
CN1804700000000,18,047,"Franklin County, IN",Mar-22,10963,10683,280,2.60000000
CN1804900000000,18,049,"Fulton County, IN",Mar-22,9132,8854,278,3.00000000
CN1805100000000,18,051,"Gibson County, IN",Mar-22,19309,18925,384,2.00000000
CN1805300000000,18,053,"Grant County, IN",Mar-22,31813,30913,900,2.80000000
CN1805500000000,18,055,"Greene County, IN",Mar-22,13545,13149,396,2.90000000
CN1805700000000,18,057,"Hamilton County, IN",Mar-22,193491,189978,3513,1.80000000
CN1805900000000,18,059,"Hancock County, IN",Mar-22,42272,41319,953,2.30000000
CN1806100000000,18,061,"Harrison County, IN",Mar-22,20294,19778,516,2.50000000
CN1806300000000,18,063,"Hendricks County, IN",Mar-22,94329,92389,1940,2.10000000
CN1806500000000,18,065,"Henry County, IN",Mar-22,21932,21336,596,2.70000000
CN1806700000000,18,067,"Howard County, IN",Mar-22,33580,32065,1515,4.50000000
CN1806900000000,18,069,"Huntington County, IN",Mar-22,18109,17672,437,2.40000000
CN1807100000000,18,071,"Jackson County, IN",Mar-22,23297,22766,531,2.30000000
CN1807300000000,18,073,"Jasper County, IN",Mar-22,15490,15002,488,3.20000000
CN1807500000000,18,075,"Jay County, IN",Mar-22,8575,8361,214,2.50000000
CN1807700000000,18,077,"Jefferson County, IN",Mar-22,15018,14657,361,2.40000000
CN1807900000000,18,079,"Jennings County, IN",Mar-22,13426,13023,403,3.00000000
CN1808100000000,18,081,"Johnson County, IN",Mar-22,86023,84239,1784,2.10000000
CN1808300000000,18,083,"Knox County, IN",Mar-22,18047,17634,413,2.30000000
CN1808500000000,18,085,"Kosciusko County, IN",Mar-22,40143,39275,868,2.20000000
CN1808700000000,18,087,"LaGrange County, IN",Mar-22,20780,20435,345,1.70000000
CN1808900000000,18,089,"Lake County, IN",Mar-22,224641,214264,10377,4.60000000
CN1809100000000,18,091,"LaPorte County, IN",Mar-22,46328,44531,1797,3.90000000
CN1809300000000,18,093,"Lawrence County, IN",Mar-22,21093,20498,595,2.80000000
CN1809500000000,18,095,"Madison County, IN",Mar-22,59581,57767,1814,3.00000000
CN1809700000000,18,097,"Marion County, IN",Mar-22,504444,489218,15226,3.00000000
CN1809900000000,18,099,"Marshall County, IN",Mar-22,22501,21993,508,2.30000000
CN1810100000000,18,101,"Martin County, IN",Mar-22,5377,5262,115,2.10000000
CN1810300000000,18,103,"Miami County, IN",Mar-22,14318,13808,510,3.60000000
CN1810500000000,18,105,"Monroe County, IN",Mar-22,71764,70054,1710,2.40000000
CN1810700000000,18,107,"Montgomery County, IN",Mar-22,18526,18112,414,2.20000000
CN1810900000000,18,109,"Morgan County, IN",Mar-22,36942,36034,908,2.50000000
CN1811100000000,18,111,"Newton County, IN",Mar-22,6545,6321,224,3.40000000
CN1811300000000,18,113,"Noble County, IN",Mar-22,21573,21014,559,2.60000000
CN1811500000000,18,115,"Ohio County, IN",Mar-22,3124,3059,65,2.10000000
CN1811700000000,18,117,"Orange County, IN",Mar-22,8187,7914,273,3.30000000
CN1811900000000,18,119,"Owen County, IN",Mar-22,9420,9134,286,3.00000000
CN1812100000000,18,121,"Parke County, IN",Mar-22,6784,6593,191,2.80000000
CN1812300000000,18,123,"Perry County, IN",Mar-22,8810,8586,224,2.50000000
CN1812500000000,18,125,"Pike County, IN",Mar-22,5677,5514,163,2.90000000
CN1812700000000,18,127,"Porter County, IN",Mar-22,84363,81802,2561,3.00000000
CN1812900000000,18,129,"Posey County, IN",Mar-22,12928,12636,292,2.30000000
CN1813100000000,18,131,"Pulaski County, IN",Mar-22,6312,6148,164,2.60000000
CN1813300000000,18,133,"Putnam County, IN",Mar-22,16648,16224,424,2.50000000
CN1813500000000,18,135,"Randolph County, IN",Mar-22,12031,11710,321,2.70000000
CN1813700000000,18,137,"Ripley County, IN",Mar-22,13369,13031,338,2.50000000
CN1813900000000,18,139,"Rush County, IN",Mar-22,8718,8519,199,2.30000000
CN1814100000000,18,141,"St. Joseph County, IN",Mar-22,131468,127568,3900,3.00000000
CN1814300000000,18,143,"Scott County, IN",Mar-22,10451,10129,322,3.10000000
CN1814500000000,18,145,"Shelby County, IN",Mar-22,23467,22908,559,2.40000000
CN1814700000000,18,147,"Spencer County, IN",Mar-22,10063,9812,251,2.50000000
CN1814900000000,18,149,"Starke County, IN",Mar-22,9362,9028,334,3.60000000
CN1815100000000,18,151,"Steuben County, IN",Mar-22,20513,20126,387,1.90000000
CN1815300000000,18,153,"Sullivan County, IN",Mar-22,7936,7661,275,3.50000000
CN1815500000000,18,155,"Switzerland County, IN",Mar-22,4554,4429,125,2.70000000
CN1815700000000,18,157,"Tippecanoe County, IN",Mar-22,96550,94159,2391,2.50000000
CN1815900000000,18,159,"Tipton County, IN",Mar-22,8940,8727,213,2.40000000
CN1816100000000,18,161,"Union County, IN",Mar-22,3467,3383,84,2.40000000
CN1816300000000,18,163,"Vanderburgh County, IN",Mar-22,92482,89971,2511,2.70000000
CN1816500000000,18,165,"Vermillion County, IN",Mar-22,6546,6316,230,3.50000000
CN1816700000000,18,167,"Vigo County, IN",Mar-22,46157,44599,1558,3.40000000
CN1816900000000,18,169,"Wabash County, IN",Mar-22,14551,14187,364,2.50000000
CN1817100000000,18,171,"Warren County, IN",Mar-22,4033,3937,96,2.40000000
CN1817300000000,18,173,"Warrick County, IN",Mar-22,32361,31613,748,2.30000000
CN1817500000000,18,175,"Washington County, IN",Mar-22,13492,13117,375,2.80000000
CN1817700000000,18,177,"Wayne County, IN",Mar-22,29422,28577,845,2.90000000
CN1817900000000,18,179,"Wells County, IN",Mar-22,14050,13728,322,2.30000000
CN1818100000000,18,181,"White County, IN",Mar-22,12853,12557,296,2.30000000
CN1818300000000,18,183,"Whitley County, IN",Mar-22,17568,17187,381,2.20000000
CN1900100000000,19,001,"Adair County, IA",Mar-22,4504,4384,120,2.70000000
CN1900300000000,19,003,"Adams County, IA",Mar-22,2059,2014,45,2.20000000
CN1900500000000,19,005,"Allamakee County, IA",Mar-22,7232,6866,366,5.10000000
CN1900700000000,19,007,"Appanoose County, IA",Mar-22,6178,5963,215,3.50000000
CN1900900000000,19,009,"Audubon County, IA",Mar-22,3161,3075,86,2.70000000
CN1901100000000,19,011,"Benton County, IA",Mar-22,12953,12483,470,3.60000000
CN1901300000000,19,013,"Black Hawk County, IA",Mar-22,68037,65715,2322,3.40000000
CN1901500000000,19,015,"Boone County, IA",Mar-22,14850,14433,417,2.80000000
CN1901700000000,19,017,"Bremer County, IA",Mar-22,14159,13759,400,2.80000000
CN1901900000000,19,019,"Buchanan County, IA",Mar-22,11340,10937,403,3.60000000
CN1902100000000,19,021,"Buena Vista County, IA",Mar-22,12274,12003,271,2.20000000
CN1902300000000,19,023,"Butler County, IA",Mar-22,8101,7804,297,3.70000000
CN1902500000000,19,025,"Calhoun County, IA",Mar-22,4100,3981,119,2.90000000
CN1902700000000,19,027,"Carroll County, IA",Mar-22,10949,10701,248,2.30000000
CN1902900000000,19,029,"Cass County, IA",Mar-22,6896,6675,221,3.20000000
CN1903100000000,19,031,"Cedar County, IA",Mar-22,10637,10278,359,3.40000000
CN1903300000000,19,033,"Cerro Gordo County, IA",Mar-22,22219,21497,722,3.20000000
CN1903500000000,19,035,"Cherokee County, IA",Mar-22,6212,6034,178,2.90000000
CN1903700000000,19,037,"Chickasaw County, IA",Mar-22,6564,6341,223,3.40000000
CN1903900000000,19,039,"Clarke County, IA",Mar-22,4938,4748,190,3.80000000
CN1904100000000,19,041,"Clay County, IA",Mar-22,8600,8340,260,3.00000000
CN1904300000000,19,043,"Clayton County, IA",Mar-22,9796,9223,573,5.80000000
CN1904500000000,19,045,"Clinton County, IA",Mar-22,22102,21196,906,4.10000000
CN1904700000000,19,047,"Crawford County, IA",Mar-22,8175,7726,449,5.50000000
CN1904900000000,19,049,"Dallas County, IA",Mar-22,52777,51568,1209,2.30000000
CN1905100000000,19,051,"Davis County, IA",Mar-22,4322,4204,118,2.70000000
CN1905300000000,19,053,"Decatur County, IA",Mar-22,4491,4362,129,2.90000000
CN1905500000000,19,055,"Delaware County, IA",Mar-22,10775,10479,296,2.70000000
CN1905700000000,19,057,"Des Moines County, IA",Mar-22,18188,17288,900,4.90000000
CN1905900000000,19,059,"Dickinson County, IA",Mar-22,9908,9513,395,4.00000000
CN1906100000000,19,061,"Dubuque County, IA",Mar-22,55115,53134,1981,3.60000000
CN1906300000000,19,063,"Emmet County, IA",Mar-22,4973,4795,178,3.60000000
CN1906500000000,19,065,"Fayette County, IA",Mar-22,10476,10009,467,4.50000000
CN1906700000000,19,067,"Floyd County, IA",Mar-22,8347,8049,298,3.60000000
CN1906900000000,19,069,"Franklin County, IA",Mar-22,5695,5519,176,3.10000000
CN1907100000000,19,071,"Fremont County, IA",Mar-22,3757,3664,93,2.50000000
CN1907300000000,19,073,"Greene County, IA",Mar-22,5452,5318,134,2.50000000
CN1907500000000,19,075,"Grundy County, IA",Mar-22,6559,6354,205,3.10000000
CN1907700000000,19,077,"Guthrie County, IA",Mar-22,5688,5474,214,3.80000000
CN1907900000000,19,079,"Hamilton County, IA",Mar-22,7012,6784,228,3.30000000
CN1908100000000,19,081,"Hancock County, IA",Mar-22,5784,5632,152,2.60000000
CN1908300000000,19,083,"Hardin County, IA",Mar-22,8050,7747,303,3.80000000
CN1908500000000,19,085,"Harrison County, IA",Mar-22,7200,6984,216,3.00000000
CN1908700000000,19,087,"Henry County, IA",Mar-22,9738,9415,323,3.30000000
CN1908900000000,19,089,"Howard County, IA",Mar-22,5361,5133,228,4.30000000
CN1909100000000,19,091,"Humboldt County, IA",Mar-22,5006,4843,163,3.30000000
CN1909300000000,19,093,"Ida County, IA",Mar-22,4037,3922,115,2.80000000
CN1909500000000,19,095,"Iowa County, IA",Mar-22,10133,9790,343,3.40000000
CN1909700000000,19,097,"Jackson County, IA",Mar-22,10818,10345,473,4.40000000
CN1909900000000,19,099,"Jasper County, IA",Mar-22,18657,17952,705,3.80000000
CN1910100000000,19,101,"Jefferson County, IA",Mar-22,10149,9858,291,2.90000000
CN1910300000000,19,103,"Johnson County, IA",Mar-22,86285,84125,2160,2.50000000
CN1910500000000,19,105,"Jones County, IA",Mar-22,10415,9946,469,4.50000000
CN1910700000000,19,107,"Keokuk County, IA",Mar-22,5253,5054,199,3.80000000
CN1910900000000,19,109,"Kossuth County, IA",Mar-22,8318,8065,253,3.00000000
CN1911100000000,19,111,"Lee County, IA",Mar-22,15240,14578,662,4.30000000
CN1911300000000,19,113,"Linn County, IA",Mar-22,118047,113763,4284,3.60000000
CN1911500000000,19,115,"Louisa County, IA",Mar-22,5936,5705,231,3.90000000
CN1911700000000,19,117,"Lucas County, IA",Mar-22,4753,4636,117,2.50000000
CN1911900000000,19,119,"Lyon County, IA",Mar-22,7121,6979,142,2.00000000
CN1912100000000,19,121,"Madison County, IA",Mar-22,8729,8341,388,4.40000000
CN1912300000000,19,123,"Mahaska County, IA",Mar-22,12110,11787,323,2.70000000
CN1912500000000,19,125,"Marion County, IA",Mar-22,18916,18442,474,2.50000000
CN1912700000000,19,127,"Marshall County, IA",Mar-22,17750,16318,1432,8.10000000
CN1912900000000,19,129,"Mills County, IA",Mar-22,7131,6946,185,2.60000000
CN1913100000000,19,131,"Mitchell County, IA",Mar-22,5814,5657,157,2.70000000
CN1913300000000,19,133,"Monona County, IA",Mar-22,4525,4360,165,3.60000000
CN1913500000000,19,135,"Monroe County, IA",Mar-22,3961,3839,122,3.10000000
CN1913700000000,19,137,"Montgomery County, IA",Mar-22,5004,4857,147,2.90000000
CN1913900000000,19,139,"Muscatine County, IA",Mar-22,20574,19820,754,3.70000000
CN1914100000000,19,141,"O'Brien County, IA",Mar-22,8231,8038,193,2.30000000
CN1914300000000,19,143,"Osceola County, IA",Mar-22,3670,3602,68,1.90000000
CN1914500000000,19,145,"Page County, IA",Mar-22,6418,6240,178,2.80000000
CN1914700000000,19,147,"Palo Alto County, IA",Mar-22,4548,4410,138,3.00000000
CN1914900000000,19,149,"Plymouth County, IA",Mar-22,14838,14499,339,2.30000000
CN1915100000000,19,151,"Pocahontas County, IA",Mar-22,4383,4285,98,2.20000000
CN1915300000000,19,153,"Polk County, IA",Mar-22,270425,261397,9028,3.30000000
CN1915500000000,19,155,"Pottawattamie County, IA",Mar-22,47617,46081,1536,3.20000000
CN1915700000000,19,157,"Poweshiek County, IA",Mar-22,10597,10241,356,3.40000000
CN1915900000000,19,159,"Ringgold County, IA",Mar-22,2431,2376,55,2.30000000
CN1916100000000,19,161,"Sac County, IA",Mar-22,5400,5228,172,3.20000000
CN1916300000000,19,163,"Scott County, IA",Mar-22,87701,84343,3358,3.80000000
CN1916500000000,19,165,"Shelby County, IA",Mar-22,6363,6198,165,2.60000000
CN1916700000000,19,167,"Sioux County, IA",Mar-22,22900,22335,565,2.50000000
CN1916900000000,19,169,"Story County, IA",Mar-22,59693,58422,1271,2.10000000
CN1917100000000,19,171,"Tama County, IA",Mar-22,9419,8978,441,4.70000000
CN1917300000000,19,173,"Taylor County, IA",Mar-22,3188,3118,70,2.20000000
CN1917500000000,19,175,"Union County, IA",Mar-22,6264,6039,225,3.60000000
CN1917700000000,19,177,"Van Buren County, IA",Mar-22,3726,3606,120,3.20000000
CN1917900000000,19,179,"Wapello County, IA",Mar-22,17084,16481,603,3.50000000
CN1918100000000,19,181,"Warren County, IA",Mar-22,28720,27870,850,3.00000000
CN1918300000000,19,183,"Washington County, IA",Mar-22,11932,11537,395,3.30000000
CN1918500000000,19,185,"Wayne County, IA",Mar-22,2953,2858,95,3.20000000
CN1918700000000,19,187,"Webster County, IA",Mar-22,18421,17792,629,3.40000000
CN1918900000000,19,189,"Winnebago County, IA",Mar-22,4938,4781,157,3.20000000
CN1919100000000,19,191,"Winneshiek County, IA",Mar-22,12019,11495,524,4.40000000
CN1919300000000,19,193,"Woodbury County, IA",Mar-22,55410,53660,1750,3.20000000
CN1919500000000,19,195,"Worth County, IA",Mar-22,4072,3926,146,3.60000000
CN1919700000000,19,197,"Wright County, IA",Mar-22,6762,6546,216,3.20000000
CN2000100000000,20,001,"Allen County, KS",Mar-22,6678,6498,180,2.70000000
CN2000300000000,20,003,"Anderson County, KS",Mar-22,4754,4657,97,2.00000000
CN2000500000000,20,005,"Atchison County, KS",Mar-22,6708,6478,230,3.40000000
CN2000700000000,20,007,"Barber County, KS",Mar-22,2221,2185,36,1.60000000
CN2000900000000,20,009,"Barton County, KS",Mar-22,13253,12937,316,2.40000000
CN2001100000000,20,011,"Bourbon County, KS",Mar-22,6458,6225,233,3.60000000
CN2001300000000,20,013,"Brown County, KS",Mar-22,5003,4884,119,2.40000000
CN2001500000000,20,015,"Butler County, KS",Mar-22,32918,32016,902,2.70000000
CN2001700000000,20,017,"Chase County, KS",Mar-22,1330,1304,26,2.00000000
CN2001900000000,20,019,"Chautauqua County, KS",Mar-22,1391,1352,39,2.80000000
CN2002100000000,20,021,"Cherokee County, KS",Mar-22,9851,9612,239,2.40000000
CN2002300000000,20,023,"Cheyenne County, KS",Mar-22,1236,1213,23,1.90000000
CN2002500000000,20,025,"Clark County, KS",Mar-22,1110,1094,16,1.40000000
CN2002700000000,20,027,"Clay County, KS",Mar-22,3706,3615,91,2.50000000
CN2002900000000,20,029,"Cloud County, KS",Mar-22,3854,3770,84,2.20000000
CN2003100000000,20,031,"Coffey County, KS",Mar-22,3804,3675,129,3.40000000
CN2003300000000,20,033,"Comanche County, KS",Mar-22,861,847,14,1.60000000
CN2003500000000,20,035,"Cowley County, KS",Mar-22,16694,16200,494,3.00000000
CN2003700000000,20,037,"Crawford County, KS",Mar-22,19048,18509,539,2.80000000
CN2003900000000,20,039,"Decatur County, KS",Mar-22,1147,1119,28,2.40000000
CN2004100000000,20,041,"Dickinson County, KS",Mar-22,8929,8671,258,2.90000000
CN2004300000000,20,043,"Doniphan County, KS",Mar-22,4160,4066,94,2.30000000
CN2004500000000,20,045,"Douglas County, KS",Mar-22,67174,65516,1658,2.50000000
CN2004700000000,20,047,"Edwards County, KS",Mar-22,1421,1393,28,2.00000000
CN2004900000000,20,049,"Elk County, KS",Mar-22,1164,1138,26,2.20000000
CN2005100000000,20,051,"Ellis County, KS",Mar-22,17014,16739,275,1.60000000
CN2005300000000,20,053,"Ellsworth County, KS",Mar-22,2681,2629,52,1.90000000
CN2005500000000,20,055,"Finney County, KS",Mar-22,20035,19664,371,1.90000000
CN2005700000000,20,057,"Ford County, KS",Mar-22,17680,17341,339,1.90000000
CN2005900000000,20,059,"Franklin County, KS",Mar-22,14675,14304,371,2.50000000
CN2006100000000,20,061,"Geary County, KS",Mar-22,11460,11015,445,3.90000000
CN2006300000000,20,063,"Gove County, KS",Mar-22,1425,1402,23,1.60000000
CN2006500000000,20,065,"Graham County, KS",Mar-22,1110,1085,25,2.30000000
CN2006700000000,20,067,"Grant County, KS",Mar-22,2801,2731,70,2.50000000
CN2006900000000,20,069,"Gray County, KS",Mar-22,3120,3072,48,1.50000000
CN2007100000000,20,071,"Greeley County, KS",Mar-22,782,773,9,1.20000000
CN2007300000000,20,073,"Greenwood County, KS",Mar-22,2898,2830,68,2.30000000
CN2007500000000,20,075,"Hamilton County, KS",Mar-22,1550,1527,23,1.50000000
CN2007700000000,20,077,"Harper County, KS",Mar-22,2850,2796,54,1.90000000
CN2007900000000,20,079,"Harvey County, KS",Mar-22,17177,16764,413,2.40000000
CN2008100000000,20,081,"Haskell County, KS",Mar-22,2153,2120,33,1.50000000
CN2008300000000,20,083,"Hodgeman County, KS",Mar-22,995,978,17,1.70000000
CN2008500000000,20,085,"Jackson County, KS",Mar-22,7234,7063,171,2.40000000
CN2008700000000,20,087,"Jefferson County, KS",Mar-22,10320,10032,288,2.80000000
CN2008900000000,20,089,"Jewell County, KS",Mar-22,1168,1143,25,2.10000000
CN2009100000000,20,091,"Johnson County, KS",Mar-22,346253,338644,7609,2.20000000
CN2009300000000,20,093,"Kearny County, KS",Mar-22,2043,2005,38,1.90000000
CN2009500000000,20,095,"Kingman County, KS",Mar-22,3262,3192,70,2.10000000
CN2009700000000,20,097,"Kiowa County, KS",Mar-22,1180,1155,25,2.10000000
CN2009900000000,20,099,"Labette County, KS",Mar-22,9241,8960,281,3.00000000
CN2010100000000,20,101,"Lane County, KS",Mar-22,692,673,19,2.70000000
CN2010300000000,20,103,"Leavenworth County, KS",Mar-22,37138,36040,1098,3.00000000
CN2010500000000,20,105,"Lincoln County, KS",Mar-22,1631,1590,41,2.50000000
CN2010700000000,20,107,"Linn County, KS",Mar-22,4353,4162,191,4.40000000
CN2010900000000,20,109,"Logan County, KS",Mar-22,1631,1605,26,1.60000000
CN2011100000000,20,111,"Lyon County, KS",Mar-22,17148,16740,408,2.40000000
CN2011300000000,20,113,"McPherson County, KS",Mar-22,17213,16920,293,1.70000000
CN2011500000000,20,115,"Marion County, KS",Mar-22,5932,5800,132,2.20000000
CN2011700000000,20,117,"Marshall County, KS",Mar-22,5319,5226,93,1.70000000
CN2011900000000,20,119,"Meade County, KS",Mar-22,2131,2099,32,1.50000000
CN2012100000000,20,121,"Miami County, KS",Mar-22,17898,17422,476,2.70000000
CN2012300000000,20,123,"Mitchell County, KS",Mar-22,3356,3307,49,1.50000000
CN2012500000000,20,125,"Montgomery County, KS",Mar-22,14655,14206,449,3.10000000
CN2012700000000,20,127,"Morris County, KS",Mar-22,3002,2927,75,2.50000000
CN2012900000000,20,129,"Morton County, KS",Mar-22,1097,1068,29,2.60000000
CN2013100000000,20,131,"Nemaha County, KS",Mar-22,5454,5369,85,1.60000000
CN2013300000000,20,133,"Neosho County, KS",Mar-22,6022,5815,207,3.40000000
CN2013500000000,20,135,"Ness County, KS",Mar-22,1290,1267,23,1.80000000
CN2013700000000,20,137,"Norton County, KS",Mar-22,2602,2563,39,1.50000000
CN2013900000000,20,139,"Osage County, KS",Mar-22,7982,7758,224,2.80000000
CN2014100000000,20,141,"Osborne County, KS",Mar-22,1900,1867,33,1.70000000
CN2014300000000,20,143,"Ottawa County, KS",Mar-22,2898,2833,65,2.20000000
CN2014500000000,20,145,"Pawnee County, KS",Mar-22,2712,2651,61,2.20000000
CN2014700000000,20,147,"Phillips County, KS",Mar-22,2580,2529,51,2.00000000
CN2014900000000,20,149,"Pottawatomie County, KS",Mar-22,12515,12224,291,2.30000000
CN2015100000000,20,151,"Pratt County, KS",Mar-22,4929,4833,96,1.90000000
CN2015300000000,20,153,"Rawlins County, KS",Mar-22,1657,1629,28,1.70000000
CN2015500000000,20,155,"Reno County, KS",Mar-22,29557,28803,754,2.60000000
CN2015700000000,20,157,"Republic County, KS",Mar-22,2266,2220,46,2.00000000
CN2015900000000,20,159,"Rice County, KS",Mar-22,5364,5257,107,2.00000000
CN2016100000000,20,161,"Riley County, KS",Mar-22,34570,33742,828,2.40000000
CN2016300000000,20,163,"Rooks County, KS",Mar-22,2353,2297,56,2.40000000
CN2016500000000,20,165,"Rush County, KS",Mar-22,1560,1530,30,1.90000000
CN2016700000000,20,167,"Russell County, KS",Mar-22,3296,3235,61,1.90000000
CN2016900000000,20,169,"Saline County, KS",Mar-22,28901,28187,714,2.50000000
CN2017100000000,20,171,"Scott County, KS",Mar-22,2723,2685,38,1.40000000
CN2017300000000,20,173,"Sedgwick County, KS",Mar-22,258262,249291,8971,3.50000000
CN2017500000000,20,175,"Seward County, KS",Mar-22,9875,9639,236,2.40000000
CN2017700000000,20,177,"Shawnee County, KS",Mar-22,91409,88856,2553,2.80000000
CN2017900000000,20,179,"Sheridan County, KS",Mar-22,1423,1397,26,1.80000000
CN2018100000000,20,181,"Sherman County, KS",Mar-22,2794,2743,51,1.80000000
CN2018300000000,20,183,"Smith County, KS",Mar-22,1959,1929,30,1.50000000
CN2018500000000,20,185,"Stafford County, KS",Mar-22,1959,1920,39,2.00000000
CN2018700000000,20,187,"Stanton County, KS",Mar-22,1126,1109,17,1.50000000
CN2018900000000,20,189,"Stevens County, KS",Mar-22,2902,2854,48,1.70000000
CN2019100000000,20,191,"Sumner County, KS",Mar-22,10826,10483,343,3.20000000
CN2019300000000,20,193,"Thomas County, KS",Mar-22,4236,4177,59,1.40000000
CN2019500000000,20,195,"Trego County, KS",Mar-22,1396,1370,26,1.90000000
CN2019700000000,20,197,"Wabaunsee County, KS",Mar-22,3694,3603,91,2.50000000
CN2019900000000,20,199,"Wallace County, KS",Mar-22,862,848,14,1.60000000
CN2020100000000,20,201,"Washington County, KS",Mar-22,2970,2918,52,1.80000000
CN2020300000000,20,203,"Wichita County, KS",Mar-22,1130,1111,19,1.70000000
CN2020500000000,20,205,"Wilson County, KS",Mar-22,3759,3637,122,3.20000000
CN2020700000000,20,207,"Woodson County, KS",Mar-22,1528,1472,56,3.70000000
CN2020900000000,20,209,"Wyandotte County, KS",Mar-22,77726,74811,2915,3.80000000
CN2100100000000,21,001,"Adair County, KY",Mar-22,7392,7064,328,4.40000000
CN2100300000000,21,003,"Allen County, KY",Mar-22,9000,8656,344,3.80000000
CN2100500000000,21,005,"Anderson County, KY",Mar-22,11910,11502,408,3.40000000
CN2100700000000,21,007,"Ballard County, KY",Mar-22,3466,3291,175,5.00000000
CN2100900000000,21,009,"Barren County, KY",Mar-22,18123,17336,787,4.30000000
CN2101100000000,21,011,"Bath County, KY",Mar-22,4701,4442,259,5.50000000
CN2101300000000,21,013,"Bell County, KY",Mar-22,8314,7891,423,5.10000000
CN2101500000000,21,015,"Boone County, KY",Mar-22,72206,69932,2274,3.10000000
CN2101700000000,21,017,"Bourbon County, KY",Mar-22,9459,9128,331,3.50000000
CN2101900000000,21,019,"Boyd County, KY",Mar-22,17611,16665,946,5.40000000
CN2102100000000,21,021,"Boyle County, KY",Mar-22,12797,12280,517,4.00000000
CN2102300000000,21,023,"Bracken County, KY",Mar-22,3822,3632,190,5.00000000
CN2102500000000,21,025,"Breathitt County, KY",Mar-22,3339,3047,292,8.70000000
CN2102700000000,21,027,"Breckinridge County, KY",Mar-22,7987,7604,383,4.80000000
CN2102900000000,21,029,"Bullitt County, KY",Mar-22,44349,41888,2461,5.50000000
CN2103100000000,21,031,"Butler County, KY",Mar-22,5087,4881,206,4.00000000
CN2103300000000,21,033,"Caldwell County, KY",Mar-22,6050,5843,207,3.40000000
CN2103500000000,21,035,"Calloway County, KY",Mar-22,17322,16612,710,4.10000000
CN2103700000000,21,037,"Campbell County, KY",Mar-22,50864,49119,1745,3.40000000
CN2103900000000,21,039,"Carlisle County, KY",Mar-22,2184,2100,84,3.80000000
CN2104100000000,21,041,"Carroll County, KY",Mar-22,5456,5259,197,3.60000000
CN2104300000000,21,043,"Carter County, KY",Mar-22,9916,9161,755,7.60000000
CN2104500000000,21,045,"Casey County, KY",Mar-22,6760,6506,254,3.80000000
CN2104700000000,21,047,"Christian County, KY",Mar-22,25337,24135,1202,4.70000000
CN2104900000000,21,049,"Clark County, KY",Mar-22,17328,16690,638,3.70000000
CN2105100000000,21,051,"Clay County, KY",Mar-22,5230,4944,286,5.50000000
CN2105300000000,21,053,"Clinton County, KY",Mar-22,3955,3782,173,4.40000000
CN2105500000000,21,055,"Crittenden County, KY",Mar-22,3845,3697,148,3.80000000
CN2105700000000,21,057,"Cumberland County, KY",Mar-22,3326,3210,116,3.50000000
CN2105900000000,21,059,"Daviess County, KY",Mar-22,47072,45394,1678,3.60000000
CN2106100000000,21,061,"Edmonson County, KY",Mar-22,4809,4565,244,5.10000000
CN2106300000000,21,063,"Elliott County, KY",Mar-22,1879,1716,163,8.70000000
CN2106500000000,21,065,"Estill County, KY",Mar-22,5240,4983,257,4.90000000
CN2106700000000,21,067,"Fayette County, KY",Mar-22,175844,170415,5429,3.10000000
CN2106900000000,21,069,"Fleming County, KY",Mar-22,6115,5840,275,4.50000000
CN2107100000000,21,071,"Floyd County, KY",Mar-22,11101,10396,705,6.40000000
CN2107300000000,21,073,"Franklin County, KY",Mar-22,25000,24083,917,3.70000000
CN2107500000000,21,075,"Fulton County, KY",Mar-22,2082,1988,94,4.50000000
CN2107700000000,21,077,"Gallatin County, KY",Mar-22,4007,3854,153,3.80000000
CN2107900000000,21,079,"Garrard County, KY",Mar-22,7757,7443,314,4.00000000
CN2108100000000,21,081,"Grant County, KY",Mar-22,11741,11268,473,4.00000000
CN2108300000000,21,083,"Graves County, KY",Mar-22,16007,15268,739,4.60000000
CN2108500000000,21,085,"Grayson County, KY",Mar-22,10571,10041,530,5.00000000
CN2108700000000,21,087,"Green County, KY",Mar-22,5315,5131,184,3.50000000
CN2108900000000,21,089,"Greenup County, KY",Mar-22,13256,12433,823,6.20000000
CN2109100000000,21,091,"Hancock County, KY",Mar-22,3908,3767,141,3.60000000
CN2109300000000,21,093,"Hardin County, KY",Mar-22,47706,45679,2027,4.20000000
CN2109500000000,21,095,"Harlan County, KY",Mar-22,6734,6273,461,6.80000000
CN2109700000000,21,097,"Harrison County, KY",Mar-22,8914,8622,292,3.30000000
CN2109900000000,21,099,"Hart County, KY",Mar-22,7700,7402,298,3.90000000
CN2110100000000,21,101,"Henderson County, KY",Mar-22,21161,20359,802,3.80000000
CN2110300000000,21,103,"Henry County, KY",Mar-22,8345,7926,419,5.00000000
CN2110500000000,21,105,"Hickman County, KY",Mar-22,1682,1610,72,4.30000000
CN2110700000000,21,107,"Hopkins County, KY",Mar-22,18319,17486,833,4.50000000
CN2110900000000,21,109,"Jackson County, KY",Mar-22,4171,3930,241,5.80000000
CN2111100000000,21,111,"Jefferson County, KY",Mar-22,404597,385736,18861,4.70000000
CN2111300000000,21,113,"Jessamine County, KY",Mar-22,26689,25830,859,3.20000000
CN2111500000000,21,115,"Johnson County, KY",Mar-22,6710,6275,435,6.50000000
CN2111700000000,21,117,"Kenton County, KY",Mar-22,87929,84929,3000,3.40000000
CN2111900000000,21,119,"Knott County, KY",Mar-22,4348,4067,281,6.50000000
CN2112100000000,21,121,"Knox County, KY",Mar-22,10311,9775,536,5.20000000
CN2112300000000,21,123,"Larue County, KY",Mar-22,5864,5598,266,4.50000000
CN2112500000000,21,125,"Laurel County, KY",Mar-22,26020,25015,1005,3.90000000
CN2112700000000,21,127,"Lawrence County, KY",Mar-22,5591,5280,311,5.60000000
CN2112900000000,21,129,"Lee County, KY",Mar-22,2068,1953,115,5.60000000
CN2113100000000,21,131,"Leslie County, KY",Mar-22,2572,2390,182,7.10000000
CN2113300000000,21,133,"Letcher County, KY",Mar-22,6188,5807,381,6.20000000
CN2113500000000,21,135,"Lewis County, KY",Mar-22,4754,4397,357,7.50000000
CN2113700000000,21,137,"Lincoln County, KY",Mar-22,9370,8922,448,4.80000000
CN2113900000000,21,139,"Livingston County, KY",Mar-22,3641,3440,201,5.50000000
CN2114100000000,21,141,"Logan County, KY",Mar-22,12523,12104,419,3.30000000
CN2114300000000,21,143,"Lyon County, KY",Mar-22,3166,3025,141,4.50000000
CN2114500000000,21,145,"McCracken County, KY",Mar-22,29774,28549,1225,4.10000000
CN2114700000000,21,147,"McCreary County, KY",Mar-22,4885,4632,253,5.20000000
CN2114900000000,21,149,"McLean County, KY",Mar-22,4052,3883,169,4.20000000
CN2115100000000,21,151,"Madison County, KY",Mar-22,48095,46430,1665,3.50000000
CN2115300000000,21,153,"Magoffin County, KY",Mar-22,3426,3001,425,12.40000000
CN2115500000000,21,155,"Marion County, KY",Mar-22,9277,8894,383,4.10000000
CN2115700000000,21,157,"Marshall County, KY",Mar-22,14485,13896,589,4.10000000
CN2115900000000,21,159,"Martin County, KY",Mar-22,2330,2146,184,7.90000000
CN2116100000000,21,161,"Mason County, KY",Mar-22,6792,6460,332,4.90000000
CN2116300000000,21,163,"Meade County, KY",Mar-22,11785,11221,564,4.80000000
CN2116500000000,21,165,"Menifee County, KY",Mar-22,2374,2223,151,6.40000000
CN2116700000000,21,167,"Mercer County, KY",Mar-22,10028,9628,400,4.00000000
CN2116900000000,21,169,"Metcalfe County, KY",Mar-22,3961,3773,188,4.70000000
CN2117100000000,21,171,"Monroe County, KY",Mar-22,4635,4473,162,3.50000000
CN2117300000000,21,173,"Montgomery County, KY",Mar-22,11888,11306,582,4.90000000
CN2117500000000,21,175,"Morgan County, KY",Mar-22,4384,4139,245,5.60000000
CN2117700000000,21,177,"Muhlenberg County, KY",Mar-22,9860,9288,572,5.80000000
CN2117900000000,21,179,"Nelson County, KY",Mar-22,23841,22641,1200,5.00000000
CN2118100000000,21,181,"Nicholas County, KY",Mar-22,3355,3227,128,3.80000000
CN2118300000000,21,183,"Ohio County, KY",Mar-22,9000,8556,444,4.90000000
CN2118500000000,21,185,"Oldham County, KY",Mar-22,34244,32707,1537,4.50000000
CN2118700000000,21,187,"Owen County, KY",Mar-22,5054,4878,176,3.50000000
CN2118900000000,21,189,"Owsley County, KY",Mar-22,1059,986,73,6.90000000
CN2119100000000,21,191,"Pendleton County, KY",Mar-22,6964,6708,256,3.70000000
CN2119300000000,21,193,"Perry County, KY",Mar-22,8151,7721,430,5.30000000
CN2119500000000,21,195,"Pike County, KY",Mar-22,19392,18333,1059,5.50000000
CN2119700000000,21,197,"Powell County, KY",Mar-22,5197,4974,223,4.30000000
CN2119900000000,21,199,"Pulaski County, KY",Mar-22,25975,24811,1164,4.50000000
CN2120100000000,21,201,"Robertson County, KY",Mar-22,813,766,47,5.80000000
CN2120300000000,21,203,"Rockcastle County, KY",Mar-22,6655,6361,294,4.40000000
CN2120500000000,21,205,"Rowan County, KY",Mar-22,10113,9653,460,4.50000000
CN2120700000000,21,207,"Russell County, KY",Mar-22,6244,5925,319,5.10000000
CN2120900000000,21,209,"Scott County, KY",Mar-22,30362,29441,921,3.00000000
CN2121100000000,21,211,"Shelby County, KY",Mar-22,26382,25289,1093,4.10000000
CN2121300000000,21,213,"Simpson County, KY",Mar-22,8997,8697,300,3.30000000
CN2121500000000,21,215,"Spencer County, KY",Mar-22,11029,10344,685,6.20000000
CN2121700000000,21,217,"Taylor County, KY",Mar-22,12783,12333,450,3.50000000
CN2121900000000,21,219,"Todd County, KY",Mar-22,5529,5353,176,3.20000000
CN2122100000000,21,221,"Trigg County, KY",Mar-22,6147,5875,272,4.40000000
CN2122300000000,21,223,"Trimble County, KY",Mar-22,3926,3710,216,5.50000000
CN2122500000000,21,225,"Union County, KY",Mar-22,6025,5786,239,4.00000000
CN2122700000000,21,227,"Warren County, KY",Mar-22,66462,64053,2409,3.60000000
CN2122900000000,21,229,"Washington County, KY",Mar-22,6249,5971,278,4.40000000
CN2123100000000,21,231,"Wayne County, KY",Mar-22,7235,6885,350,4.80000000
CN2123300000000,21,233,"Webster County, KY",Mar-22,5341,5127,214,4.00000000
CN2123500000000,21,235,"Whitley County, KY",Mar-22,14396,13808,588,4.10000000
CN2123700000000,21,237,"Wolfe County, KY",Mar-22,2238,2119,119,5.30000000
CN2123900000000,21,239,"Woodford County, KY",Mar-22,14826,14401,425,2.90000000
CN2200100000000,22,001,"Acadia Parish, LA",Mar-22,24068,23256,812,3.40000000
CN2200300000000,22,003,"Allen Parish, LA",Mar-22,8285,7956,329,4.00000000
CN2200500000000,22,005,"Ascension Parish, LA",Mar-22,65961,64089,1872,2.80000000
CN2200700000000,22,007,"Assumption Parish, LA",Mar-22,8694,8222,472,5.40000000
CN2200900000000,22,009,"Avoyelles Parish, LA",Mar-22,14666,14129,537,3.70000000
CN2201100000000,22,011,"Beauregard Parish, LA",Mar-22,14984,14540,444,3.00000000
CN2201300000000,22,013,"Bienville Parish, LA",Mar-22,5258,5044,214,4.10000000
CN2201500000000,22,015,"Bossier Parish, LA",Mar-22,58419,56874,1545,2.60000000
CN2201700000000,22,017,"Caddo Parish, LA",Mar-22,103269,98641,4628,4.50000000
CN2201900000000,22,019,"Calcasieu Parish, LA",Mar-22,99423,95723,3700,3.70000000
CN2202100000000,22,021,"Caldwell Parish, LA",Mar-22,3709,3585,124,3.30000000
CN2202300000000,22,023,"Cameron Parish, LA",Mar-22,3664,3577,87,2.40000000
CN2202500000000,22,025,"Catahoula Parish, LA",Mar-22,3466,3338,128,3.70000000
CN2202700000000,22,027,"Claiborne Parish, LA",Mar-22,5413,5223,190,3.50000000
CN2202900000000,22,029,"Concordia Parish, LA",Mar-22,6952,6644,308,4.40000000
CN2203100000000,22,031,"De Soto Parish, LA",Mar-22,10977,10596,381,3.50000000
CN2203300000000,22,033,"East Baton Rouge Parish, LA",Mar-22,230866,222533,8333,3.60000000
CN2203500000000,22,035,"East Carroll Parish, LA",Mar-22,1703,1564,139,8.20000000
CN2203700000000,22,037,"East Feliciana Parish, LA",Mar-22,7795,7547,248,3.20000000
CN2203900000000,22,039,"Evangeline Parish, LA",Mar-22,12149,11671,478,3.90000000
CN2204100000000,22,041,"Franklin Parish, LA",Mar-22,7534,7200,334,4.40000000
CN2204300000000,22,043,"Grant Parish, LA",Mar-22,8395,8154,241,2.90000000
CN2204500000000,22,045,"Iberia Parish, LA",Mar-22,28162,26778,1384,4.90000000
CN2204700000000,22,047,"Iberville Parish, LA",Mar-22,13848,13104,744,5.40000000
CN2204900000000,22,049,"Jackson Parish, LA",Mar-22,6887,6688,199,2.90000000
CN2205100000000,22,051,"Jefferson Parish, LA",Mar-22,212396,203624,8772,4.10000000
CN2205300000000,22,053,"Jefferson Davis Parish, LA",Mar-22,12790,12376,414,3.20000000
CN2205500000000,22,055,"Lafayette Parish, LA",Mar-22,117788,114265,3523,3.00000000
CN2205700000000,22,057,"Lafourche Parish, LA",Mar-22,40599,39289,1310,3.20000000
CN2205900000000,22,059,"LaSalle Parish, LA",Mar-22,6674,6520,154,2.30000000
CN2206100000000,22,061,"Lincoln Parish, LA",Mar-22,21585,20954,631,2.90000000
CN2206300000000,22,063,"Livingston Parish, LA",Mar-22,70646,68804,1842,2.60000000
CN2206500000000,22,065,"Madison Parish, LA",Mar-22,3442,3267,175,5.10000000
CN2206700000000,22,067,"Morehouse Parish, LA",Mar-22,10128,9515,613,6.10000000
CN2206900000000,22,069,"Natchitoches Parish, LA",Mar-22,17009,16461,548,3.20000000
CN2207100000000,22,071,"Orleans Parish, LA",Mar-22,179925,169296,10629,5.90000000
CN2207300000000,22,073,"Ouachita Parish, LA",Mar-22,69511,67033,2478,3.60000000
CN2207500000000,22,075,"Plaquemines Parish, LA",Mar-22,9783,9491,292,3.00000000
CN2207700000000,22,077,"Pointe Coupee Parish, LA",Mar-22,9690,9302,388,4.00000000
CN2207900000000,22,079,"Rapides Parish, LA",Mar-22,56662,55073,1589,2.80000000
CN2208100000000,22,081,"Red River Parish, LA",Mar-22,3795,3680,115,3.00000000
CN2208300000000,22,083,"Richland Parish, LA",Mar-22,8278,7963,315,3.80000000
CN2208500000000,22,085,"Sabine Parish, LA",Mar-22,9323,9070,253,2.70000000
CN2208700000000,22,087,"St. Bernard Parish, LA",Mar-22,20248,19271,977,4.80000000
CN2208900000000,22,089,"St. Charles Parish, LA",Mar-22,24893,24052,841,3.40000000
CN2209100000000,22,091,"St. Helena Parish, LA",Mar-22,4281,3996,285,6.70000000
CN2209300000000,22,093,"St. James Parish, LA",Mar-22,9009,8518,491,5.50000000
CN2209500000000,22,095,"St. John the Baptist Parish, LA",Mar-22,19445,18205,1240,6.40000000
CN2209700000000,22,097,"St. Landry Parish, LA",Mar-22,32440,30937,1503,4.60000000
CN2209900000000,22,099,"St. Martin Parish, LA",Mar-22,22348,21497,851,3.80000000
CN2210100000000,22,101,"St. Mary Parish, LA",Mar-22,19309,18350,959,5.00000000
CN2210300000000,22,103,"St. Tammany Parish, LA",Mar-22,119810,116669,3141,2.60000000
CN2210500000000,22,105,"Tangipahoa Parish, LA",Mar-22,56489,53863,2626,4.60000000
CN2210700000000,22,107,"Tensas Parish, LA",Mar-22,1314,1254,60,4.60000000
CN2210900000000,22,109,"Terrebonne Parish, LA",Mar-22,44808,42956,1852,4.10000000
CN2211100000000,22,111,"Union Parish, LA",Mar-22,9036,8715,321,3.60000000
CN2211300000000,22,113,"Vermilion Parish, LA",Mar-22,24377,23535,842,3.50000000
CN2211500000000,22,115,"Vernon Parish, LA",Mar-22,16007,15476,531,3.30000000
CN2211700000000,22,117,"Washington Parish, LA",Mar-22,17124,16415,709,4.10000000
CN2211900000000,22,119,"Webster Parish, LA",Mar-22,14256,13721,535,3.80000000
CN2212100000000,22,121,"West Baton Rouge Parish, LA",Mar-22,13825,13375,450,3.30000000
CN2212300000000,22,123,"West Carroll Parish, LA",Mar-22,3545,3360,185,5.20000000
CN2212500000000,22,125,"West Feliciana Parish, LA",Mar-22,5360,5230,130,2.40000000
CN2212700000000,22,127,"Winn Parish, LA",Mar-22,4611,4452,159,3.40000000
CN2300100000000,23,001,"Androscoggin County, ME",Mar-22,54220,52127,2093,3.90000000
CN2300300000000,23,003,"Aroostook County, ME",Mar-22,28843,27302,1541,5.30000000
CN2300500000000,23,005,"Cumberland County, ME",Mar-22,160313,155293,5020,3.10000000
CN2300700000000,23,007,"Franklin County, ME",Mar-22,13859,13216,643,4.60000000
CN2300900000000,23,009,"Hancock County, ME",Mar-22,27132,25569,1563,5.80000000
CN2301100000000,23,011,"Kennebec County, ME",Mar-22,61256,58932,2324,3.80000000
CN2301300000000,23,013,"Knox County, ME",Mar-22,19231,18380,851,4.40000000
CN2301500000000,23,015,"Lincoln County, ME",Mar-22,16001,15300,701,4.40000000
CN2301700000000,23,017,"Oxford County, ME",Mar-22,26035,24828,1207,4.60000000
CN2301900000000,23,019,"Penobscot County, ME",Mar-22,76203,73101,3102,4.10000000
CN2302100000000,23,021,"Piscataquis County, ME",Mar-22,7293,6926,367,5.00000000
CN2302300000000,23,023,"Sagadahoc County, ME",Mar-22,19052,18448,604,3.20000000
CN2302500000000,23,025,"Somerset County, ME",Mar-22,22122,20869,1253,5.70000000
CN2302700000000,23,027,"Waldo County, ME",Mar-22,20057,19184,873,4.40000000
CN2302900000000,23,029,"Washington County, ME",Mar-22,13118,12272,846,6.40000000
CN2303100000000,23,031,"York County, ME",Mar-22,111017,106518,4499,4.10000000
CN2400100000000,24,001,"Allegany County, MD",Mar-22,30638,28984,1654,5.40000000
CN2400300000000,24,003,"Anne Arundel County, MD",Mar-22,318420,307033,11387,3.60000000
CN2400500000000,24,005,"Baltimore County, MD",Mar-22,452029,432770,19259,4.30000000
CN2400900000000,24,009,"Calvert County, MD",Mar-22,49294,47459,1835,3.70000000
CN2401100000000,24,011,"Caroline County, MD",Mar-22,17652,16971,681,3.90000000
CN2401300000000,24,013,"Carroll County, MD",Mar-22,95918,92782,3136,3.30000000
CN2401500000000,24,015,"Cecil County, MD",Mar-22,52639,50386,2253,4.30000000
CN2401700000000,24,017,"Charles County, MD",Mar-22,86747,82950,3797,4.40000000
CN2401900000000,24,019,"Dorchester County, MD",Mar-22,15980,15242,738,4.60000000
CN2402100000000,24,021,"Frederick County, MD",Mar-22,137226,132128,5098,3.70000000
CN2402300000000,24,023,"Garrett County, MD",Mar-22,15330,14630,700,4.60000000
CN2402500000000,24,025,"Harford County, MD",Mar-22,142145,136881,5264,3.70000000
CN2402700000000,24,027,"Howard County, MD",Mar-22,190241,183969,6272,3.30000000
CN2402900000000,24,029,"Kent County, MD",Mar-22,9647,9207,440,4.60000000
CN2403100000000,24,031,"Montgomery County, MD",Mar-22,552383,530987,21396,3.90000000
CN2403300000000,24,033,"Prince George's County, MD",Mar-22,501975,474834,27141,5.40000000
CN2403500000000,24,035,"Queen Anne's County, MD",Mar-22,28385,27411,974,3.40000000
CN2403700000000,24,037,"St. Mary's County, MD",Mar-22,57946,55783,2163,3.70000000
CN2403900000000,24,039,"Somerset County, MD",Mar-22,8739,8170,569,6.50000000
CN2404100000000,24,041,"Talbot County, MD",Mar-22,17413,16655,758,4.40000000
CN2404300000000,24,043,"Washington County, MD",Mar-22,72980,69865,3115,4.30000000
CN2404500000000,24,045,"Wicomico County, MD",Mar-22,49097,46597,2500,5.10000000
CN2404700000000,24,047,"Worcester County, MD",Mar-22,24649,22712,1937,7.90000000
CN2451000000000,24,510,"Baltimore city, MD",Mar-22,280784,264394,16390,5.80000000
CN2500100000000,25,001,"Barnstable County, MA",Mar-22,108939,102483,6456,5.90000000
CN2500300000000,25,003,"Berkshire County, MA",Mar-22,61686,58698,2988,4.80000000
CN2500500000000,25,005,"Bristol County, MA",Mar-22,300943,285871,15072,5.00000000
CN2500700000000,25,007,"Dukes County, MA",Mar-22,8828,8192,636,7.20000000
CN2500900000000,25,009,"Essex County, MA",Mar-22,425879,408324,17555,4.10000000
CN2501100000000,25,011,"Franklin County, MA",Mar-22,41228,39839,1389,3.40000000
CN2501300000000,25,013,"Hampden County, MA",Mar-22,229156,217695,11461,5.00000000
CN2501500000000,25,015,"Hampshire County, MA",Mar-22,91285,88361,2924,3.20000000
CN2501700000000,25,017,"Middlesex County, MA",Mar-22,922304,896448,25856,2.80000000
CN2501900000000,25,019,"Nantucket County/town, MA",Mar-22,6626,5875,751,11.30000000
CN2502100000000,25,021,"Norfolk County, MA",Mar-22,396960,384419,12541,3.20000000
CN2502300000000,25,023,"Plymouth County, MA",Mar-22,286508,274162,12346,4.30000000
CN2502500000000,25,025,"Suffolk County, MA",Mar-22,457677,442578,15099,3.30000000
CN2502700000000,25,027,"Worcester County, MA",Mar-22,444600,427204,17396,3.90000000
CN2600100000000,26,001,"Alcona County, MI",Mar-22,3683,3415,268,7.30000000
CN2600300000000,26,003,"Alger County, MI",Mar-22,3011,2779,232,7.70000000
CN2600500000000,26,005,"Allegan County, MI",Mar-22,61347,59199,2148,3.50000000
CN2600700000000,26,007,"Alpena County, MI",Mar-22,13569,12927,642,4.70000000
CN2600900000000,26,009,"Antrim County, MI",Mar-22,9505,8878,627,6.60000000
CN2601100000000,26,011,"Arenac County, MI",Mar-22,5686,5200,486,8.50000000
CN2601300000000,26,013,"Baraga County, MI",Mar-22,3034,2800,234,7.70000000
CN2601500000000,26,015,"Barry County, MI",Mar-22,31491,30356,1135,3.60000000
CN2601700000000,26,017,"Bay County, MI",Mar-22,48790,46287,2503,5.10000000
CN2601900000000,26,019,"Benzie County, MI",Mar-22,8451,7953,498,5.90000000
CN2602100000000,26,021,"Berrien County, MI",Mar-22,71228,68106,3122,4.40000000
CN2602300000000,26,023,"Branch County, MI",Mar-22,19083,18370,713,3.70000000
CN2602500000000,26,025,"Calhoun County, MI",Mar-22,60028,57185,2843,4.70000000
CN2602700000000,26,027,"Cass County, MI",Mar-22,23498,22596,902,3.80000000
CN2602900000000,26,029,"Charlevoix County, MI",Mar-22,11931,11305,626,5.20000000
CN2603100000000,26,031,"Cheboygan County, MI",Mar-22,9506,8450,1056,11.10000000
CN2603300000000,26,033,"Chippewa County, MI",Mar-22,16173,15080,1093,6.80000000
CN2603500000000,26,035,"Clare County, MI",Mar-22,11151,10316,835,7.50000000
CN2603700000000,26,037,"Clinton County, MI",Mar-22,40002,38677,1325,3.30000000
CN2603900000000,26,039,"Crawford County, MI",Mar-22,5231,4880,351,6.70000000
CN2604100000000,26,041,"Delta County, MI",Mar-22,16279,15314,965,5.90000000
CN2604300000000,26,043,"Dickinson County, MI",Mar-22,12244,11736,508,4.10000000
CN2604500000000,26,045,"Eaton County, MI",Mar-22,55520,53459,2061,3.70000000
CN2604700000000,26,047,"Emmet County, MI",Mar-22,15760,14729,1031,6.50000000
CN2604900000000,26,049,"Genesee County, MI",Mar-22,176424,166260,10164,5.80000000
CN2605100000000,26,051,"Gladwin County, MI",Mar-22,9462,8862,600,6.30000000
CN2605300000000,26,053,"Gogebic County, MI",Mar-22,5780,5512,268,4.60000000
CN2605500000000,26,055,"Grand Traverse County, MI",Mar-22,47481,45591,1890,4.00000000
CN2605700000000,26,057,"Gratiot County, MI",Mar-22,17192,16442,750,4.40000000
CN2605900000000,26,059,"Hillsdale County, MI",Mar-22,19812,18989,823,4.20000000
CN2606100000000,26,061,"Houghton County, MI",Mar-22,16165,15424,741,4.60000000
CN2606300000000,26,063,"Huron County, MI",Mar-22,14591,13905,686,4.70000000
CN2606500000000,26,065,"Ingham County, MI",Mar-22,145346,139643,5703,3.90000000
CN2606700000000,26,067,"Ionia County, MI",Mar-22,29734,28672,1062,3.60000000
CN2606900000000,26,069,"Iosco County, MI",Mar-22,9852,9150,702,7.10000000
CN2607100000000,26,071,"Iron County, MI",Mar-22,4860,4583,277,5.70000000
CN2607300000000,26,073,"Isabella County, MI",Mar-22,32309,30868,1441,4.50000000
CN2607500000000,26,075,"Jackson County, MI",Mar-22,73376,70228,3148,4.30000000
CN2607700000000,26,077,"Kalamazoo County, MI",Mar-22,131822,127096,4726,3.60000000
CN2607900000000,26,079,"Kalkaska County, MI",Mar-22,7609,7087,522,6.90000000
CN2608100000000,26,081,"Kent County, MI",Mar-22,355471,343890,11581,3.30000000
CN2608300000000,26,083,"Keweenaw County, MI",Mar-22,901,851,50,5.50000000
CN2608500000000,26,085,"Lake County, MI",Mar-22,3878,3604,274,7.10000000
CN2608700000000,26,087,"Lapeer County, MI",Mar-22,40980,38716,2264,5.50000000
CN2608900000000,26,089,"Leelanau County, MI",Mar-22,9979,9511,468,4.70000000
CN2609100000000,26,091,"Lenawee County, MI",Mar-22,44762,42819,1943,4.30000000
CN2609300000000,26,093,"Livingston County, MI",Mar-22,103826,100410,3416,3.30000000
CN2609500000000,26,095,"Luce County, MI",Mar-22,2063,1936,127,6.20000000
CN2609700000000,26,097,"Mackinac County, MI",Mar-22,4112,3513,599,14.60000000
CN2609900000000,26,099,"Macomb County, MI",Mar-22,445723,426043,19680,4.40000000
CN2610100000000,26,101,"Manistee County, MI",Mar-22,9692,9073,619,6.40000000
CN2610300000000,26,103,"Marquette County, MI",Mar-22,31687,30119,1568,4.90000000
CN2610500000000,26,105,"Mason County, MI",Mar-22,12729,11984,745,5.90000000
CN2610700000000,26,107,"Mecosta County, MI",Mar-22,18199,17231,968,5.30000000
CN2610900000000,26,109,"Menominee County, MI",Mar-22,10443,10024,419,4.00000000
CN2611100000000,26,111,"Midland County, MI",Mar-22,38646,37031,1615,4.20000000
CN2611300000000,26,113,"Missaukee County, MI",Mar-22,6790,6436,354,5.20000000
CN2611500000000,26,115,"Monroe County, MI",Mar-22,74147,70792,3355,4.50000000
CN2611700000000,26,117,"Montcalm County, MI",Mar-22,27527,26325,1202,4.40000000
CN2611900000000,26,119,"Montmorency County, MI",Mar-22,2963,2699,264,8.90000000
CN2612100000000,26,121,"Muskegon County, MI",Mar-22,76676,72624,4052,5.30000000
CN2612300000000,26,123,"Newaygo County, MI",Mar-22,23158,22097,1061,4.60000000
CN2612500000000,26,125,"Oakland County, MI",Mar-22,671417,648066,23351,3.50000000
CN2612700000000,26,127,"Oceana County, MI",Mar-22,11395,10581,814,7.10000000
CN2612900000000,26,129,"Ogemaw County, MI",Mar-22,7798,7183,615,7.90000000
CN2613100000000,26,131,"Ontonagon County, MI",Mar-22,2069,1929,140,6.80000000
CN2613300000000,26,133,"Osceola County, MI",Mar-22,11474,10948,526,4.60000000
CN2613500000000,26,135,"Oscoda County, MI",Mar-22,2502,2282,220,8.80000000
CN2613700000000,26,137,"Otsego County, MI",Mar-22,11265,10626,639,5.70000000
CN2613900000000,26,139,"Ottawa County, MI",Mar-22,159871,155094,4777,3.00000000
CN2614100000000,26,141,"Presque Isle County, MI",Mar-22,4834,4389,445,9.20000000
CN2614300000000,26,143,"Roscommon County, MI",Mar-22,7128,6411,717,10.10000000
CN2614500000000,26,145,"Saginaw County, MI",Mar-22,81914,77257,4657,5.70000000
CN2614700000000,26,147,"St. Clair County, MI",Mar-22,75415,71846,3569,4.70000000
CN2614900000000,26,149,"St. Joseph County, MI",Mar-22,27921,26943,978,3.50000000
CN2615100000000,26,151,"Sanilac County, MI",Mar-22,19026,18086,940,4.90000000
CN2615300000000,26,153,"Schoolcraft County, MI",Mar-22,3089,2813,276,8.90000000
CN2615500000000,26,155,"Shiawassee County, MI",Mar-22,32373,30930,1443,4.50000000
CN2615700000000,26,157,"Tuscola County, MI",Mar-22,22847,21634,1213,5.30000000
CN2615900000000,26,159,"Van Buren County, MI",Mar-22,34538,32795,1743,5.00000000
CN2616100000000,26,161,"Washtenaw County, MI",Mar-22,198756,192620,6136,3.10000000
CN2616300000000,26,163,"Wayne County, MI",Mar-22,810431,763231,47200,5.80000000
CN2616500000000,26,165,"Wexford County, MI",Mar-22,14563,13884,679,4.70000000
CN2700100000000,27,001,"Aitkin County, MN",Mar-22,7340,6955,385,5.20000000
CN2700300000000,27,003,"Anoka County, MN",Mar-22,199992,194671,5321,2.70000000
CN2700500000000,27,005,"Becker County, MN",Mar-22,18898,18235,663,3.50000000
CN2700700000000,27,007,"Beltrami County, MN",Mar-22,24197,23296,901,3.70000000
CN2700900000000,27,009,"Benton County, MN",Mar-22,22015,21166,849,3.90000000
CN2701100000000,27,011,"Big Stone County, MN",Mar-22,2327,2234,93,4.00000000
CN2701300000000,27,013,"Blue Earth County, MN",Mar-22,40657,39727,930,2.30000000
CN2701500000000,27,015,"Brown County, MN",Mar-22,13475,13032,443,3.30000000
CN2701700000000,27,017,"Carlton County, MN",Mar-22,17766,17079,687,3.90000000
CN2701900000000,27,019,"Carver County, MN",Mar-22,59615,58313,1302,2.20000000
CN2702100000000,27,021,"Cass County, MN",Mar-22,16558,15850,708,4.30000000
CN2702300000000,27,023,"Chippewa County, MN",Mar-22,6495,6321,174,2.70000000
CN2702500000000,27,025,"Chisago County, MN",Mar-22,30172,29123,1049,3.50000000
CN2702700000000,27,027,"Clay County, MN",Mar-22,36965,36061,904,2.40000000
CN2702900000000,27,029,"Clearwater County, MN",Mar-22,4529,4147,382,8.40000000
CN2703100000000,27,031,"Cook County, MN",Mar-22,2598,2478,120,4.60000000
CN2703300000000,27,033,"Cottonwood County, MN",Mar-22,6671,6520,151,2.30000000
CN2703500000000,27,035,"Crow Wing County, MN",Mar-22,31277,30020,1257,4.00000000
CN2703700000000,27,037,"Dakota County, MN",Mar-22,243825,238023,5802,2.40000000
CN2703900000000,27,039,"Dodge County, MN",Mar-22,12111,11728,383,3.20000000
CN2704100000000,27,041,"Douglas County, MN",Mar-22,20833,20256,577,2.80000000
CN2704300000000,27,043,"Faribault County, MN",Mar-22,6735,6503,232,3.40000000
CN2704500000000,27,045,"Fillmore County, MN",Mar-22,11538,11207,331,2.90000000
CN2704700000000,27,047,"Freeborn County, MN",Mar-22,15426,14979,447,2.90000000
CN2704900000000,27,049,"Goodhue County, MN",Mar-22,26333,25588,745,2.80000000
CN2705100000000,27,051,"Grant County, MN",Mar-22,3169,3051,118,3.70000000
CN2705300000000,27,053,"Hennepin County, MN",Mar-22,706795,690099,16696,2.40000000
CN2705500000000,27,055,"Houston County, MN",Mar-22,10440,10150,290,2.80000000
CN2705700000000,27,057,"Hubbard County, MN",Mar-22,9905,9432,473,4.80000000
CN2705900000000,27,059,"Isanti County, MN",Mar-22,21962,21118,844,3.80000000
CN2706100000000,27,061,"Itasca County, MN",Mar-22,21035,19999,1036,4.90000000
CN2706300000000,27,063,"Jackson County, MN",Mar-22,5355,5215,140,2.60000000
CN2706500000000,27,065,"Kanabec County, MN",Mar-22,9185,8608,577,6.30000000
CN2706700000000,27,067,"Kandiyohi County, MN",Mar-22,22638,21860,778,3.40000000
CN2706900000000,27,069,"Kittson County, MN",Mar-22,2216,2151,65,2.90000000
CN2707100000000,27,071,"Koochiching County, MN",Mar-22,5495,5285,210,3.80000000
CN2707300000000,27,073,"Lac qui Parle County, MN",Mar-22,3336,3225,111,3.30000000
CN2707500000000,27,075,"Lake County, MN",Mar-22,5146,4995,151,2.90000000
CN2707700000000,27,077,"Lake of the Woods County, MN",Mar-22,2461,2394,67,2.70000000
CN2707900000000,27,079,"Le Sueur County, MN",Mar-22,16072,15378,694,4.30000000
CN2708100000000,27,081,"Lincoln County, MN",Mar-22,2891,2776,115,4.00000000
CN2708300000000,27,083,"Lyon County, MN",Mar-22,14178,13772,406,2.90000000
CN2708500000000,27,085,"McLeod County, MN",Mar-22,18959,18350,609,3.20000000
CN2708700000000,27,087,"Mahnomen County, MN",Mar-22,2244,2123,121,5.40000000
CN2708900000000,27,089,"Marshall County, MN",Mar-22,5259,4982,277,5.30000000
CN2709100000000,27,091,"Martin County, MN",Mar-22,9336,9067,269,2.90000000
CN2709300000000,27,093,"Meeker County, MN",Mar-22,13146,12677,469,3.60000000
CN2709500000000,27,095,"Mille Lacs County, MN",Mar-22,12856,12153,703,5.50000000
CN2709700000000,27,097,"Morrison County, MN",Mar-22,17501,16560,941,5.40000000
CN2709900000000,27,099,"Mower County, MN",Mar-22,20631,20070,561,2.70000000
CN2710100000000,27,101,"Murray County, MN",Mar-22,4500,4302,198,4.40000000
CN2710300000000,27,103,"Nicollet County, MN",Mar-22,20809,20359,450,2.20000000
CN2710500000000,27,105,"Nobles County, MN",Mar-22,11195,10941,254,2.30000000
CN2710700000000,27,107,"Norman County, MN",Mar-22,3223,3090,133,4.10000000
CN2710900000000,27,109,"Olmsted County, MN",Mar-22,92434,90396,2038,2.20000000
CN2711100000000,27,111,"Otter Tail County, MN",Mar-22,30451,29325,1126,3.70000000
CN2711300000000,27,113,"Pennington County, MN",Mar-22,8770,8419,351,4.00000000
CN2711500000000,27,115,"Pine County, MN",Mar-22,14231,13459,772,5.40000000
CN2711700000000,27,117,"Pipestone County, MN",Mar-22,4322,4174,148,3.40000000
CN2711900000000,27,119,"Polk County, MN",Mar-22,16128,15587,541,3.40000000
CN2712100000000,27,121,"Pope County, MN",Mar-22,6248,6071,177,2.80000000
CN2712300000000,27,123,"Ramsey County, MN",Mar-22,286632,279206,7426,2.60000000
CN2712500000000,27,125,"Red Lake County, MN",Mar-22,2177,2084,93,4.30000000
CN2712700000000,27,127,"Redwood County, MN",Mar-22,7359,7149,210,2.90000000
CN2712900000000,27,129,"Renville County, MN",Mar-22,8166,7824,342,4.20000000
CN2713100000000,27,131,"Rice County, MN",Mar-22,37037,35999,1038,2.80000000
CN2713300000000,27,133,"Rock County, MN",Mar-22,5944,5829,115,1.90000000
CN2713500000000,27,135,"Roseau County, MN",Mar-22,7936,7740,196,2.50000000
CN2713700000000,27,137,"St. Louis County, MN",Mar-22,101172,97927,3245,3.20000000
CN2713900000000,27,139,"Scott County, MN",Mar-22,84874,82938,1936,2.30000000
CN2714100000000,27,141,"Sherburne County, MN",Mar-22,53667,51961,1706,3.20000000
CN2714300000000,27,143,"Sibley County, MN",Mar-22,8126,7826,300,3.70000000
CN2714500000000,27,145,"Stearns County, MN",Mar-22,90954,88333,2621,2.90000000
CN2714700000000,27,147,"Steele County, MN",Mar-22,19562,18994,568,2.90000000
CN2714900000000,27,149,"Stevens County, MN",Mar-22,5170,5042,128,2.50000000
CN2715100000000,27,151,"Swift County, MN",Mar-22,4589,4428,161,3.50000000
CN2715300000000,27,153,"Todd County, MN",Mar-22,13326,12843,483,3.60000000
CN2715500000000,27,155,"Traverse County, MN",Mar-22,1630,1576,54,3.30000000
CN2715700000000,27,157,"Wabasha County, MN",Mar-22,12285,11932,353,2.90000000
CN2715900000000,27,159,"Wadena County, MN",Mar-22,5979,5689,290,4.90000000
CN2716100000000,27,161,"Waseca County, MN",Mar-22,8564,8235,329,3.80000000
CN2716300000000,27,163,"Washington County, MN",Mar-22,145801,142517,3284,2.30000000
CN2716500000000,27,165,"Watonwan County, MN",Mar-22,6460,6283,177,2.70000000
CN2716700000000,27,167,"Wilkin County, MN",Mar-22,3313,3233,80,2.40000000
CN2716900000000,27,169,"Winona County, MN",Mar-22,27756,27128,628,2.30000000
CN2717100000000,27,171,"Wright County, MN",Mar-22,77084,74926,2158,2.80000000
CN2717300000000,27,173,"Yellow Medicine County, MN",Mar-22,4948,4784,164,3.30000000
CN2800100000000,28,001,"Adams County, MS",Mar-22,10456,9912,544,5.20000000
CN2800300000000,28,003,"Alcorn County, MS",Mar-22,15444,14961,483,3.10000000
CN2800500000000,28,005,"Amite County, MS",Mar-22,4427,4220,207,4.70000000
CN2800700000000,28,007,"Attala County, MS",Mar-22,7079,6817,262,3.70000000
CN2800900000000,28,009,"Benton County, MS",Mar-22,3082,2953,129,4.20000000
CN2801100000000,28,011,"Bolivar County, MS",Mar-22,11420,10936,484,4.20000000
CN2801300000000,28,013,"Calhoun County, MS",Mar-22,5453,5272,181,3.30000000
CN2801500000000,28,015,"Carroll County, MS",Mar-22,3606,3467,139,3.90000000
CN2801700000000,28,017,"Chickasaw County, MS",Mar-22,6961,6709,252,3.60000000
CN2801900000000,28,019,"Choctaw County, MS",Mar-22,3631,3513,118,3.20000000
CN2802100000000,28,021,"Claiborne County, MS",Mar-22,2916,2698,218,7.50000000
CN2802300000000,28,023,"Clarke County, MS",Mar-22,5697,5453,244,4.30000000
CN2802500000000,28,025,"Clay County, MS",Mar-22,8274,7928,346,4.20000000
CN2802700000000,28,027,"Coahoma County, MS",Mar-22,7888,7470,418,5.30000000
CN2802900000000,28,029,"Copiah County, MS",Mar-22,10660,10220,440,4.10000000
CN2803100000000,28,031,"Covington County, MS",Mar-22,8153,7896,257,3.20000000
CN2803300000000,28,033,"DeSoto County, MS",Mar-22,94766,92169,2597,2.70000000
CN2803500000000,28,035,"Forrest County, MS",Mar-22,33507,32363,1144,3.40000000
CN2803700000000,28,037,"Franklin County, MS",Mar-22,2647,2530,117,4.40000000
CN2803900000000,28,039,"George County, MS",Mar-22,8720,8314,406,4.70000000
CN2804100000000,28,041,"Greene County, MS",Mar-22,4210,3994,216,5.10000000
CN2804300000000,28,043,"Grenada County, MS",Mar-22,9246,8959,287,3.10000000
CN2804500000000,28,045,"Hancock County, MS",Mar-22,19340,18638,702,3.60000000
CN2804700000000,28,047,"Harrison County, MS",Mar-22,88669,85671,2998,3.40000000
CN2804900000000,28,049,"Hinds County, MS",Mar-22,100464,96717,3747,3.70000000
CN2805100000000,28,051,"Holmes County, MS",Mar-22,5024,4687,337,6.70000000
CN2805300000000,28,053,"Humphreys County, MS",Mar-22,1981,1816,165,8.30000000
CN2805500000000,28,055,"Issaquena County, MS",Mar-22,327,304,23,7.00000000
CN2805700000000,28,057,"Itawamba County, MS",Mar-22,10403,10113,290,2.80000000
CN2805900000000,28,059,"Jackson County, MS",Mar-22,59360,57050,2310,3.90000000
CN2806100000000,28,061,"Jasper County, MS",Mar-22,5758,5480,278,4.80000000
CN2806300000000,28,063,"Jefferson County, MS",Mar-22,1838,1632,206,11.20000000
CN2806500000000,28,065,"Jefferson Davis County, MS",Mar-22,3873,3681,192,5.00000000
CN2806700000000,28,067,"Jones County, MS",Mar-22,24465,23559,906,3.70000000
CN2806900000000,28,069,"Kemper County, MS",Mar-22,3280,3119,161,4.90000000
CN2807100000000,28,071,"Lafayette County, MS",Mar-22,28699,27954,745,2.60000000
CN2807300000000,28,073,"Lamar County, MS",Mar-22,31826,30979,847,2.70000000
CN2807500000000,28,075,"Lauderdale County, MS",Mar-22,29099,28085,1014,3.50000000
CN2807700000000,28,077,"Lawrence County, MS",Mar-22,4629,4430,199,4.30000000
CN2807900000000,28,079,"Leake County, MS",Mar-22,8065,7776,289,3.60000000
CN2808100000000,28,081,"Lee County, MS",Mar-22,41319,40153,1166,2.80000000
CN2808300000000,28,083,"Leflore County, MS",Mar-22,10163,9664,499,4.90000000
CN2808500000000,28,085,"Lincoln County, MS",Mar-22,14905,14441,464,3.10000000
CN2808700000000,28,087,"Lowndes County, MS",Mar-22,25971,25039,932,3.60000000
CN2808900000000,28,089,"Madison County, MS",Mar-22,52647,51186,1461,2.80000000
CN2809100000000,28,091,"Marion County, MS",Mar-22,10549,10216,333,3.20000000
CN2809300000000,28,093,"Marshall County, MS",Mar-22,14419,13917,502,3.50000000
CN2809500000000,28,095,"Monroe County, MS",Mar-22,16074,15561,513,3.20000000
CN2809700000000,28,097,"Montgomery County, MS",Mar-22,3966,3813,153,3.90000000
CN2809900000000,28,099,"Neshoba County, MS",Mar-22,10074,9704,370,3.70000000
CN2810100000000,28,101,"Newton County, MS",Mar-22,8255,7965,290,3.50000000
CN2810300000000,28,103,"Noxubee County, MS",Mar-22,3581,3373,208,5.80000000
CN2810500000000,28,105,"Oktibbeha County, MS",Mar-22,22921,22150,771,3.40000000
CN2810700000000,28,107,"Panola County, MS",Mar-22,12599,12036,563,4.50000000
CN2810900000000,28,109,"Pearl River County, MS",Mar-22,23764,22949,815,3.40000000
CN2811100000000,28,111,"Perry County, MS",Mar-22,4272,4094,178,4.20000000
CN2811300000000,28,113,"Pike County, MS",Mar-22,14466,13805,661,4.60000000
CN2811500000000,28,115,"Pontotoc County, MS",Mar-22,15108,14699,409,2.70000000
CN2811700000000,28,117,"Prentiss County, MS",Mar-22,11458,11138,320,2.80000000
CN2811900000000,28,119,"Quitman County, MS",Mar-22,2339,2224,115,4.90000000
CN2812100000000,28,121,"Rankin County, MS",Mar-22,75423,73524,1899,2.50000000
CN2812300000000,28,123,"Scott County, MS",Mar-22,12365,12002,363,2.90000000
CN2812500000000,28,125,"Sharkey County, MS",Mar-22,1440,1359,81,5.60000000
CN2812700000000,28,127,"Simpson County, MS",Mar-22,10460,10114,346,3.30000000
CN2812900000000,28,129,"Smith County, MS",Mar-22,6668,6465,203,3.00000000
CN2813100000000,28,131,"Stone County, MS",Mar-22,7074,6823,251,3.50000000
CN2813300000000,28,133,"Sunflower County, MS",Mar-22,7466,7056,410,5.50000000
CN2813500000000,28,135,"Tallahatchie County, MS",Mar-22,4785,4601,184,3.80000000
CN2813700000000,28,137,"Tate County, MS",Mar-22,12296,11885,411,3.30000000
CN2813900000000,28,139,"Tippah County, MS",Mar-22,9899,9621,278,2.80000000
CN2814100000000,28,141,"Tishomingo County, MS",Mar-22,8437,8172,265,3.10000000
CN2814300000000,28,143,"Tunica County, MS",Mar-22,4262,4051,211,5.00000000
CN2814500000000,28,145,"Union County, MS",Mar-22,14485,14128,357,2.50000000
CN2814700000000,28,147,"Walthall County, MS",Mar-22,4970,4760,210,4.20000000
CN2814900000000,28,149,"Warren County, MS",Mar-22,19372,18616,756,3.90000000
CN2815100000000,28,151,"Washington County, MS",Mar-22,15651,14815,836,5.30000000
CN2815300000000,28,153,"Wayne County, MS",Mar-22,7497,7177,320,4.30000000
CN2815500000000,28,155,"Webster County, MS",Mar-22,4036,3899,137,3.40000000
CN2815700000000,28,157,"Wilkinson County, MS",Mar-22,2611,2437,174,6.70000000
CN2815900000000,28,159,"Winston County, MS",Mar-22,7111,6824,287,4.00000000
CN2816100000000,28,161,"Yalobusha County, MS",Mar-22,4947,4781,166,3.40000000
CN2816300000000,28,163,"Yazoo County, MS",Mar-22,8864,8458,406,4.60000000
CN2900100000000,29,001,"Adair County, MO",Mar-22,9959,9547,412,4.10000000
CN2900300000000,29,003,"Andrew County, MO",Mar-22,9808,9535,273,2.80000000
CN2900500000000,29,005,"Atchison County, MO",Mar-22,2615,2537,78,3.00000000
CN2900700000000,29,007,"Audrain County, MO",Mar-22,10169,9806,363,3.60000000
CN2900900000000,29,009,"Barry County, MO",Mar-22,14854,14295,559,3.80000000
CN2901100000000,29,011,"Barton County, MO",Mar-22,5291,5125,166,3.10000000
CN2901300000000,29,013,"Bates County, MO",Mar-22,7630,7326,304,4.00000000
CN2901500000000,29,015,"Benton County, MO",Mar-22,7402,7010,392,5.30000000
CN2901700000000,29,017,"Bollinger County, MO",Mar-22,5350,5157,193,3.60000000
CN2901900000000,29,019,"Boone County, MO",Mar-22,100858,98260,2598,2.60000000
CN2902100000000,29,021,"Buchanan County, MO",Mar-22,44135,42641,1494,3.40000000
CN2902300000000,29,023,"Butler County, MO",Mar-22,18437,17733,704,3.80000000
CN2902500000000,29,025,"Caldwell County, MO",Mar-22,4228,4069,159,3.80000000
CN2902700000000,29,027,"Callaway County, MO",Mar-22,21289,20629,660,3.10000000
CN2902900000000,29,029,"Camden County, MO",Mar-22,19110,18223,887,4.60000000
CN2903100000000,29,031,"Cape Girardeau County, MO",Mar-22,40852,39630,1222,3.00000000
CN2903300000000,29,033,"Carroll County, MO",Mar-22,4494,4321,173,3.80000000
CN2903500000000,29,035,"Carter County, MO",Mar-22,2582,2451,131,5.10000000
CN2903700000000,29,037,"Cass County, MO",Mar-22,54819,52975,1844,3.40000000
CN2903900000000,29,039,"Cedar County, MO",Mar-22,5718,5523,195,3.40000000
CN2904100000000,29,041,"Chariton County, MO",Mar-22,3743,3624,119,3.20000000
CN2904300000000,29,043,"Christian County, MO",Mar-22,47541,46226,1315,2.80000000
CN2904500000000,29,045,"Clark County, MO",Mar-22,3057,2952,105,3.40000000
CN2904700000000,29,047,"Clay County, MO",Mar-22,138143,133510,4633,3.40000000
CN2904900000000,29,049,"Clinton County, MO",Mar-22,10558,10159,399,3.80000000
CN2905100000000,29,051,"Cole County, MO",Mar-22,38659,37627,1032,2.70000000
CN2905300000000,29,053,"Cooper County, MO",Mar-22,7130,6904,226,3.20000000
CN2905500000000,29,055,"Crawford County, MO",Mar-22,11012,10579,433,3.90000000
CN2905700000000,29,057,"Dade County, MO",Mar-22,3485,3379,106,3.00000000
CN2905900000000,29,059,"Dallas County, MO",Mar-22,7235,6952,283,3.90000000
CN2906100000000,29,061,"Daviess County, MO",Mar-22,4029,3898,131,3.30000000
CN2906300000000,29,063,"DeKalb County, MO",Mar-22,4178,4037,141,3.40000000
CN2906500000000,29,065,"Dent County, MO",Mar-22,6487,6219,268,4.10000000
CN2906700000000,29,067,"Douglas County, MO",Mar-22,5210,5015,195,3.70000000
CN2906900000000,29,069,"Dunklin County, MO",Mar-22,11119,10472,647,5.80000000
CN2907100000000,29,071,"Franklin County, MO",Mar-22,53233,51458,1775,3.30000000
CN2907300000000,29,073,"Gasconade County, MO",Mar-22,7613,7369,244,3.20000000
CN2907500000000,29,075,"Gentry County, MO",Mar-22,3268,3173,95,2.90000000
CN2907700000000,29,077,"Greene County, MO",Mar-22,155103,150699,4404,2.80000000
CN2907900000000,29,079,"Grundy County, MO",Mar-22,4155,4007,148,3.60000000
CN2908100000000,29,081,"Harrison County, MO",Mar-22,3715,3583,132,3.60000000
CN2908300000000,29,083,"Henry County, MO",Mar-22,10172,9803,369,3.60000000
CN2908500000000,29,085,"Hickory County, MO",Mar-22,3892,3730,162,4.20000000
CN2908700000000,29,087,"Holt County, MO",Mar-22,2451,2386,65,2.70000000
CN2908900000000,29,089,"Howard County, MO",Mar-22,4868,4725,143,2.90000000
CN2909100000000,29,091,"Howell County, MO",Mar-22,16267,15630,637,3.90000000
CN2909300000000,29,093,"Iron County, MO",Mar-22,3514,3324,190,5.40000000
CN2909500000000,29,095,"Jackson County, MO",Mar-22,360971,345635,15336,4.20000000
CN2909700000000,29,097,"Jasper County, MO",Mar-22,58033,56197,1836,3.20000000
CN2909900000000,29,099,"Jefferson County, MO",Mar-22,119113,114994,4119,3.50000000
CN2910100000000,29,101,"Johnson County, MO",Mar-22,22976,22124,852,3.70000000
CN2910300000000,29,103,"Knox County, MO",Mar-22,1713,1652,61,3.60000000
CN2910500000000,29,105,"Laclede County, MO",Mar-22,16769,16184,585,3.50000000
CN2910700000000,29,107,"Lafayette County, MO",Mar-22,16633,16034,599,3.60000000
CN2910900000000,29,109,"Lawrence County, MO",Mar-22,17316,16744,572,3.30000000
CN2911100000000,29,111,"Lewis County, MO",Mar-22,4799,4641,158,3.30000000
CN2911300000000,29,113,"Lincoln County, MO",Mar-22,29454,28349,1105,3.80000000
CN2911500000000,29,115,"Linn County, MO",Mar-22,5087,4878,209,4.10000000
CN2911700000000,29,117,"Livingston County, MO",Mar-22,7250,7023,227,3.10000000
CN2911900000000,29,119,"McDonald County, MO",Mar-22,11005,10639,366,3.30000000
CN2912100000000,29,121,"Macon County, MO",Mar-22,7330,7077,253,3.50000000
CN2912300000000,29,123,"Madison County, MO",Mar-22,5518,5297,221,4.00000000
CN2912500000000,29,125,"Maries County, MO",Mar-22,3925,3792,133,3.40000000
CN2912700000000,29,127,"Marion County, MO",Mar-22,14024,13575,449,3.20000000
CN2912900000000,29,129,"Mercer County, MO",Mar-22,1719,1661,58,3.40000000
CN2913100000000,29,131,"Miller County, MO",Mar-22,12746,12289,457,3.60000000
CN2913300000000,29,133,"Mississippi County, MO",Mar-22,5257,5033,224,4.30000000
CN2913500000000,29,135,"Moniteau County, MO",Mar-22,6956,6727,229,3.30000000
CN2913700000000,29,137,"Monroe County, MO",Mar-22,3763,3613,150,4.00000000
CN2913900000000,29,139,"Montgomery County, MO",Mar-22,5818,5614,204,3.50000000
CN2914100000000,29,141,"Morgan County, MO",Mar-22,8317,7958,359,4.30000000
CN2914300000000,29,143,"New Madrid County, MO",Mar-22,8350,8006,344,4.10000000
CN2914500000000,29,145,"Newton County, MO",Mar-22,27426,26542,884,3.20000000
CN2914700000000,29,147,"Nodaway County, MO",Mar-22,10749,10452,297,2.80000000
CN2914900000000,29,149,"Oregon County, MO",Mar-22,3789,3626,163,4.30000000
CN2915100000000,29,151,"Osage County, MO",Mar-22,6942,6763,179,2.60000000
CN2915300000000,29,153,"Ozark County, MO",Mar-22,3438,3269,169,4.90000000
CN2915500000000,29,155,"Pemiscot County, MO",Mar-22,5880,5517,363,6.20000000
CN2915700000000,29,157,"Perry County, MO",Mar-22,9677,9397,280,2.90000000
CN2915900000000,29,159,"Pettis County, MO",Mar-22,20257,19568,689,3.40000000
CN2916100000000,29,161,"Phelps County, MO",Mar-22,20426,19776,650,3.20000000
CN2916300000000,29,163,"Pike County, MO",Mar-22,7378,7121,257,3.50000000
CN2916500000000,29,165,"Platte County, MO",Mar-22,59716,57866,1850,3.10000000
CN2916700000000,29,167,"Polk County, MO",Mar-22,14784,14325,459,3.10000000
CN2916900000000,29,169,"Pulaski County, MO",Mar-22,14818,14233,585,3.90000000
CN2917100000000,29,171,"Putnam County, MO",Mar-22,2164,2090,74,3.40000000
CN2917300000000,29,173,"Ralls County, MO",Mar-22,5514,5335,179,3.20000000
CN2917500000000,29,175,"Randolph County, MO",Mar-22,10562,10193,369,3.50000000
CN2917700000000,29,177,"Ray County, MO",Mar-22,10838,10389,449,4.10000000
CN2917900000000,29,179,"Reynolds County, MO",Mar-22,2879,2770,109,3.80000000
CN2918100000000,29,181,"Ripley County, MO",Mar-22,5134,4905,229,4.50000000
CN2918300000000,29,183,"St. Charles County, MO",Mar-22,229819,223118,6701,2.90000000
CN2918500000000,29,185,"St. Clair County, MO",Mar-22,3779,3626,153,4.00000000
CN2918600000000,29,186,"Ste. Genevieve County, MO",Mar-22,9238,8944,294,3.20000000
CN2918700000000,29,187,"St. Francois County, MO",Mar-22,26000,24904,1096,4.20000000
CN2918900000000,29,189,"St. Louis County, MO",Mar-22,530771,511754,19017,3.60000000
CN2919500000000,29,195,"Saline County, MO",Mar-22,10534,10206,328,3.10000000
CN2919700000000,29,197,"Schuyler County, MO",Mar-22,1825,1737,88,4.80000000
CN2919900000000,29,199,"Scotland County, MO",Mar-22,2252,2181,71,3.20000000
CN2920100000000,29,201,"Scott County, MO",Mar-22,20384,19728,656,3.20000000
CN2920300000000,29,203,"Shannon County, MO",Mar-22,3287,3115,172,5.20000000
CN2920500000000,29,205,"Shelby County, MO",Mar-22,2992,2893,99,3.30000000
CN2920700000000,29,207,"Stoddard County, MO",Mar-22,13357,12837,520,3.90000000
CN2920900000000,29,209,"Stone County, MO",Mar-22,13294,12523,771,5.80000000
CN2921100000000,29,211,"Sullivan County, MO",Mar-22,2616,2492,124,4.70000000
CN2921300000000,29,213,"Taney County, MO",Mar-22,25611,23882,1729,6.80000000
CN2921500000000,29,215,"Texas County, MO",Mar-22,9141,8763,378,4.10000000
CN2921700000000,29,217,"Vernon County, MO",Mar-22,9249,8952,297,3.20000000
CN2921900000000,29,219,"Warren County, MO",Mar-22,18867,18210,657,3.50000000
CN2922100000000,29,221,"Washington County, MO",Mar-22,10297,9827,470,4.60000000
CN2922300000000,29,223,"Wayne County, MO",Mar-22,4891,4655,236,4.80000000
CN2922500000000,29,225,"Webster County, MO",Mar-22,17612,17088,524,3.00000000
CN2922700000000,29,227,"Worth County, MO",Mar-22,1145,1114,31,2.70000000
CN2922900000000,29,229,"Wright County, MO",Mar-22,7747,7463,284,3.70000000
CN2951000000000,29,510,"St. Louis city, MO",Mar-22,150962,143550,7412,4.90000000
CN3000100000000,30,001,"Beaverhead County, MT",Mar-22,5224,5096,128,2.50000000
CN3000300000000,30,003,"Big Horn County, MT",Mar-22,4754,4477,277,5.80000000
CN3000500000000,30,005,"Blaine County, MT",Mar-22,2340,2268,72,3.10000000
CN3000700000000,30,007,"Broadwater County, MT",Mar-22,2730,2638,92,3.40000000
CN3000900000000,30,009,"Carbon County, MT",Mar-22,5826,5668,158,2.70000000
CN3001100000000,30,011,"Carter County, MT",Mar-22,704,689,15,2.10000000
CN3001300000000,30,013,"Cascade County, MT",Mar-22,38612,37556,1056,2.70000000
CN3001500000000,30,015,"Chouteau County, MT",Mar-22,2567,2516,51,2.00000000
CN3001700000000,30,017,"Custer County, MT",Mar-22,6506,6327,179,2.80000000
CN3001900000000,30,019,"Daniels County, MT",Mar-22,903,888,15,1.70000000
CN3002100000000,30,021,"Dawson County, MT",Mar-22,4613,4507,106,2.30000000
CN3002300000000,30,023,"Deer Lodge County, MT",Mar-22,5283,5133,150,2.80000000
CN3002500000000,30,025,"Fallon County, MT",Mar-22,1647,1618,29,1.80000000
CN3002700000000,30,027,"Fergus County, MT",Mar-22,6026,5816,210,3.50000000
CN3002900000000,30,029,"Flathead County, MT",Mar-22,51437,49568,1869,3.60000000
CN3003100000000,30,031,"Gallatin County, MT",Mar-22,76203,74855,1348,1.80000000
CN3003300000000,30,033,"Garfield County, MT",Mar-22,788,766,22,2.80000000
CN3003500000000,30,035,"Glacier County, MT",Mar-22,5560,5228,332,6.00000000
CN3003700000000,30,037,"Golden Valley County, MT",Mar-22,387,375,12,3.10000000
CN3003900000000,30,039,"Granite County, MT",Mar-22,1757,1681,76,4.30000000
CN3004100000000,30,041,"Hill County, MT",Mar-22,7591,7422,169,2.20000000
CN3004300000000,30,043,"Jefferson County, MT",Mar-22,6025,5863,162,2.70000000
CN3004500000000,30,045,"Judith Basin County, MT",Mar-22,990,964,26,2.60000000
CN3004700000000,30,047,"Lake County, MT",Mar-22,14369,13897,472,3.30000000
CN3004900000000,30,049,"Lewis and Clark County, MT",Mar-22,37825,36920,905,2.40000000
CN3005100000000,30,051,"Liberty County, MT",Mar-22,1049,1028,21,2.00000000
CN3005300000000,30,053,"Lincoln County, MT",Mar-22,8360,7849,511,6.10000000
CN3005500000000,30,055,"McCone County, MT",Mar-22,1039,1023,16,1.50000000
CN3005700000000,30,057,"Madison County, MT",Mar-22,5777,5650,127,2.20000000
CN3005900000000,30,059,"Meagher County, MT",Mar-22,1071,1047,24,2.20000000
CN3006100000000,30,061,"Mineral County, MT",Mar-22,1860,1751,109,5.90000000
CN3006300000000,30,063,"Missoula County, MT",Mar-22,66638,64755,1883,2.80000000
CN3006500000000,30,065,"Musselshell County, MT",Mar-22,2425,2350,75,3.10000000
CN3006700000000,30,067,"Park County, MT",Mar-22,9197,8916,281,3.10000000
CN3006900000000,30,069,"Petroleum County, MT",Mar-22,290,284,6,2.10000000
CN3007100000000,30,071,"Phillips County, MT",Mar-22,1892,1820,72,3.80000000
CN3007300000000,30,073,"Pondera County, MT",Mar-22,2734,2663,71,2.60000000
CN3007500000000,30,075,"Powder River County, MT",Mar-22,1044,1018,26,2.50000000
CN3007700000000,30,077,"Powell County, MT",Mar-22,2966,2880,86,2.90000000
CN3007900000000,30,079,"Prairie County, MT",Mar-22,505,485,20,4.00000000
CN3008100000000,30,081,"Ravalli County, MT",Mar-22,21806,21114,692,3.20000000
CN3008300000000,30,083,"Richland County, MT",Mar-22,5809,5644,165,2.80000000
CN3008500000000,30,085,"Roosevelt County, MT",Mar-22,4417,4255,162,3.70000000
CN3008700000000,30,087,"Rosebud County, MT",Mar-22,3638,3511,127,3.50000000
CN3008900000000,30,089,"Sanders County, MT",Mar-22,5376,5089,287,5.30000000
CN3009100000000,30,091,"Sheridan County, MT",Mar-22,1820,1780,40,2.20000000
CN3009300000000,30,093,"Silver Bow County, MT",Mar-22,17888,17316,572,3.20000000
CN3009500000000,30,095,"Stillwater County, MT",Mar-22,5622,5493,129,2.30000000
CN3009700000000,30,097,"Sweet Grass County, MT",Mar-22,1960,1920,40,2.00000000
CN3009900000000,30,099,"Teton County, MT",Mar-22,2896,2819,77,2.70000000
CN3010100000000,30,101,"Toole County, MT",Mar-22,2073,2031,42,2.00000000
CN3010300000000,30,103,"Treasure County, MT",Mar-22,377,368,9,2.40000000
CN3010500000000,30,105,"Valley County, MT",Mar-22,4069,3950,119,2.90000000
CN3010700000000,30,107,"Wheatland County, MT",Mar-22,796,763,33,4.10000000
CN3010900000000,30,109,"Wibaux County, MT",Mar-22,428,417,11,2.60000000
CN3011100000000,30,111,"Yellowstone County, MT",Mar-22,86215,84106,2109,2.40000000
CN3100100000000,31,001,"Adams County, NE",Mar-22,16966,16590,376,2.20000000
CN3100300000000,31,003,"Antelope County, NE",Mar-22,3776,3702,74,2.00000000
CN3100500000000,31,005,"Arthur County, NE",Mar-22,240,235,5,2.10000000
CN3100700000000,31,007,"Banner County, NE",Mar-22,406,395,11,2.70000000
CN3100900000000,31,009,"Blaine County, NE",Mar-22,261,253,8,3.10000000
CN3101100000000,31,011,"Boone County, NE",Mar-22,3033,2980,53,1.70000000
CN3101300000000,31,013,"Box Butte County, NE",Mar-22,5476,5360,116,2.10000000
CN3101500000000,31,015,"Boyd County, NE",Mar-22,1073,1050,23,2.10000000
CN3101700000000,31,017,"Brown County, NE",Mar-22,1447,1407,40,2.80000000
CN3101900000000,31,019,"Buffalo County, NE",Mar-22,28539,28021,518,1.80000000
CN3102100000000,31,021,"Burt County, NE",Mar-22,3954,3851,103,2.60000000
CN3102300000000,31,023,"Butler County, NE",Mar-22,4736,4654,82,1.70000000
CN3102500000000,31,025,"Cass County, NE",Mar-22,13748,13417,331,2.40000000
CN3102700000000,31,027,"Cedar County, NE",Mar-22,4714,4632,82,1.70000000
CN3102900000000,31,029,"Chase County, NE",Mar-22,2312,2275,37,1.60000000
CN3103100000000,31,031,"Cherry County, NE",Mar-22,3467,3408,59,1.70000000
CN3103300000000,31,033,"Cheyenne County, NE",Mar-22,4248,4139,109,2.60000000
CN3103500000000,31,035,"Clay County, NE",Mar-22,3275,3190,85,2.60000000
CN3103700000000,31,037,"Colfax County, NE",Mar-22,5829,5723,106,1.80000000
CN3103900000000,31,039,"Cuming County, NE",Mar-22,5030,4937,93,1.80000000
CN3104100000000,31,041,"Custer County, NE",Mar-22,6501,6391,110,1.70000000
CN3104300000000,31,043,"Dakota County, NE",Mar-22,11017,10693,324,2.90000000
CN3104500000000,31,045,"Dawes County, NE",Mar-22,5078,4984,94,1.90000000
CN3104700000000,31,047,"Dawson County, NE",Mar-22,13875,13536,339,2.40000000
CN3104900000000,31,049,"Deuel County, NE",Mar-22,987,968,19,1.90000000
CN3105100000000,31,051,"Dixon County, NE",Mar-22,3073,2998,75,2.40000000
CN3105300000000,31,053,"Dodge County, NE",Mar-22,20559,20105,454,2.20000000
CN3105500000000,31,055,"Douglas County, NE",Mar-22,307330,299118,8212,2.70000000
CN3105700000000,31,057,"Dundy County, NE",Mar-22,1201,1183,18,1.50000000
CN3105900000000,31,059,"Fillmore County, NE",Mar-22,3323,3261,62,1.90000000
CN3106100000000,31,061,"Franklin County, NE",Mar-22,1537,1503,34,2.20000000
CN3106300000000,31,063,"Frontier County, NE",Mar-22,1611,1578,33,2.00000000
CN3106500000000,31,065,"Furnas County, NE",Mar-22,2631,2580,51,1.90000000
CN3106700000000,31,067,"Gage County, NE",Mar-22,11163,10888,275,2.50000000
CN3106900000000,31,069,"Garden County, NE",Mar-22,1152,1128,24,2.10000000
CN3107100000000,31,071,"Garfield County, NE",Mar-22,1160,1136,24,2.10000000
CN3107300000000,31,073,"Gosper County, NE",Mar-22,1187,1165,22,1.90000000
CN3107500000000,31,075,"Grant County, NE",Mar-22,442,435,7,1.60000000
CN3107700000000,31,077,"Greeley County, NE",Mar-22,1272,1245,27,2.10000000
CN3107900000000,31,079,"Hall County, NE",Mar-22,32679,31847,832,2.50000000
CN3108100000000,31,081,"Hamilton County, NE",Mar-22,4921,4821,100,2.00000000
CN3108300000000,31,083,"Harlan County, NE",Mar-22,1794,1758,36,2.00000000
CN3108500000000,31,085,"Hayes County, NE",Mar-22,650,642,8,1.20000000
CN3108700000000,31,087,"Hitchcock County, NE",Mar-22,1341,1308,33,2.50000000
CN3108900000000,31,089,"Holt County, NE",Mar-22,5808,5704,104,1.80000000
CN3109100000000,31,091,"Hooker County, NE",Mar-22,385,378,7,1.80000000
CN3109300000000,31,093,"Howard County, NE",Mar-22,3490,3418,72,2.10000000
CN3109500000000,31,095,"Jefferson County, NE",Mar-22,4323,4251,72,1.70000000
CN3109700000000,31,097,"Johnson County, NE",Mar-22,2042,1978,64,3.10000000
CN3109900000000,31,099,"Kearney County, NE",Mar-22,3904,3838,66,1.70000000
CN3110100000000,31,101,"Keith County, NE",Mar-22,4593,4501,92,2.00000000
CN3110300000000,31,103,"Keya Paha County, NE",Mar-22,618,608,10,1.60000000
CN3110500000000,31,105,"Kimball County, NE",Mar-22,1980,1944,36,1.80000000
CN3110700000000,31,107,"Knox County, NE",Mar-22,4803,4683,120,2.50000000
CN3110900000000,31,109,"Lancaster County, NE",Mar-22,182001,178109,3892,2.10000000
CN3111100000000,31,111,"Lincoln County, NE",Mar-22,18451,18062,389,2.10000000
CN3111300000000,31,113,"Logan County, NE",Mar-22,479,472,7,1.50000000
CN3111500000000,31,115,"Loup County, NE",Mar-22,417,407,10,2.40000000
CN3111700000000,31,117,"McPherson County, NE",Mar-22,436,430,6,1.40000000
CN3111900000000,31,119,"Madison County, NE",Mar-22,20357,19926,431,2.10000000
CN3112100000000,31,121,"Merrick County, NE",Mar-22,4196,4114,82,2.00000000
CN3112300000000,31,123,"Morrill County, NE",Mar-22,2663,2604,59,2.20000000
CN3112500000000,31,125,"Nance County, NE",Mar-22,2002,1968,34,1.70000000
CN3112700000000,31,127,"Nemaha County, NE",Mar-22,3716,3637,79,2.10000000
CN3112900000000,31,129,"Nuckolls County, NE",Mar-22,2560,2508,52,2.00000000
CN3113100000000,31,131,"Otoe County, NE",Mar-22,8693,8494,199,2.30000000
CN3113300000000,31,133,"Pawnee County, NE",Mar-22,1556,1525,31,2.00000000
CN3113500000000,31,135,"Perkins County, NE",Mar-22,1902,1872,30,1.60000000
CN3113700000000,31,137,"Phelps County, NE",Mar-22,5064,4969,95,1.90000000
CN3113900000000,31,139,"Pierce County, NE",Mar-22,4234,4147,87,2.10000000
CN3114100000000,31,141,"Platte County, NE",Mar-22,18746,18384,362,1.90000000
CN3114300000000,31,143,"Polk County, NE",Mar-22,3024,2964,60,2.00000000
CN3114500000000,31,145,"Red Willow County, NE",Mar-22,5894,5784,110,1.90000000
CN3114700000000,31,147,"Richardson County, NE",Mar-22,4371,4288,83,1.90000000
CN3114900000000,31,149,"Rock County, NE",Mar-22,907,891,16,1.80000000
CN3115100000000,31,151,"Saline County, NE",Mar-22,7430,7244,186,2.50000000
CN3115300000000,31,153,"Sarpy County, NE",Mar-22,100143,97885,2258,2.30000000
CN3115500000000,31,155,"Saunders County, NE",Mar-22,11626,11387,239,2.10000000
CN3115700000000,31,157,"Scotts Bluff County, NE",Mar-22,17889,17450,439,2.50000000
CN3115900000000,31,159,"Seward County, NE",Mar-22,9006,8828,178,2.00000000
CN3116100000000,31,161,"Sheridan County, NE",Mar-22,2776,2723,53,1.90000000
CN3116300000000,31,163,"Sherman County, NE",Mar-22,1734,1695,39,2.20000000
CN3116500000000,31,165,"Sioux County, NE",Mar-22,780,766,14,1.80000000
CN3116700000000,31,167,"Stanton County, NE",Mar-22,3681,3610,71,1.90000000
CN3116900000000,31,169,"Thayer County, NE",Mar-22,2762,2705,57,2.10000000
CN3117100000000,31,171,"Thomas County, NE",Mar-22,440,427,13,3.00000000
CN3117300000000,31,173,"Thurston County, NE",Mar-22,3181,3087,94,3.00000000
CN3117500000000,31,175,"Valley County, NE",Mar-22,2145,2099,46,2.10000000
CN3117700000000,31,177,"Washington County, NE",Mar-22,11576,11319,257,2.20000000
CN3117900000000,31,179,"Wayne County, NE",Mar-22,5892,5783,109,1.80000000
CN3118100000000,31,181,"Webster County, NE",Mar-22,1695,1655,40,2.40000000
CN3118300000000,31,183,"Wheeler County, NE",Mar-22,611,601,10,1.60000000
CN3118500000000,31,185,"York County, NE",Mar-22,7396,7253,143,1.90000000
CN3200100000000,32,001,"Churchill County, NV",Mar-22,11485,11230,255,2.20000000
CN3200300000000,32,003,"Clark County, NV",Mar-22,1102628,1047248,55380,5.00000000
CN3200500000000,32,005,"Douglas County, NV",Mar-22,21600,20981,619,2.90000000
CN3200700000000,32,007,"Elko County, NV",Mar-22,25563,25002,561,2.20000000
CN3200900000000,32,009,"Esmeralda County, NV",Mar-22,473,463,10,2.10000000
CN3201100000000,32,011,"Eureka County, NV",Mar-22,1184,1167,17,1.40000000
CN3201300000000,32,013,"Humboldt County, NV",Mar-22,8299,8124,175,2.10000000
CN3201500000000,32,015,"Lander County, NV",Mar-22,3157,3074,83,2.60000000
CN3201700000000,32,017,"Lincoln County, NV",Mar-22,2214,2165,49,2.20000000
CN3201900000000,32,019,"Lyon County, NV",Mar-22,23445,22620,825,3.50000000
CN3202100000000,32,021,"Mineral County, NV",Mar-22,2043,1989,54,2.60000000
CN3202300000000,32,023,"Nye County, NV",Mar-22,17170,16474,696,4.10000000
CN3202700000000,32,027,"Pershing County, NV",Mar-22,2659,2588,71,2.70000000
CN3202900000000,32,029,"Storey County, NV",Mar-22,2015,1956,59,2.90000000
CN3203100000000,32,031,"Washoe County, NV",Mar-22,249438,242984,6454,2.60000000
CN3203300000000,32,033,"White Pine County, NV",Mar-22,4483,4385,98,2.20000000
CN3251000000000,32,510,"Carson City, NV",Mar-22,25116,24365,751,3.00000000
CN3300100000000,33,001,"Belknap County, NH",Mar-22,30600,29848,752,2.50000000
CN3300300000000,33,003,"Carroll County, NH",Mar-22,22840,22256,584,2.60000000
CN3300500000000,33,005,"Cheshire County, NH",Mar-22,39604,38526,1078,2.70000000
CN3300700000000,33,007,"Coos County, NH",Mar-22,14273,13823,450,3.20000000
CN3300900000000,33,009,"Grafton County, NH",Mar-22,49073,48052,1021,2.10000000
CN3301100000000,33,011,"Hillsborough County, NH",Mar-22,241236,235330,5906,2.40000000
CN3301300000000,33,013,"Merrimack County, NH",Mar-22,82922,81180,1742,2.10000000
CN3301500000000,33,015,"Rockingham County, NH",Mar-22,186752,182010,4742,2.50000000
CN3301700000000,33,017,"Strafford County, NH",Mar-22,73250,71733,1517,2.10000000
CN3301900000000,33,019,"Sullivan County, NH",Mar-22,22889,22390,499,2.20000000
CN3400100000000,34,001,"Atlantic County, NJ",Mar-22,125696,118148,7548,6.00000000
CN3400300000000,34,003,"Bergen County, NJ",Mar-22,493391,474472,18919,3.80000000
CN3400500000000,34,005,"Burlington County, NJ",Mar-22,244817,236469,8348,3.40000000
CN3400700000000,34,007,"Camden County, NJ",Mar-22,268676,256920,11756,4.40000000
CN3400900000000,34,009,"Cape May County, NJ",Mar-22,41597,37766,3831,9.20000000
CN3401100000000,34,011,"Cumberland County, NJ",Mar-22,67221,63326,3895,5.80000000
CN3401300000000,34,013,"Essex County, NJ",Mar-22,383696,363775,19921,5.20000000
CN3401500000000,34,015,"Gloucester County, NJ",Mar-22,159809,153579,6230,3.90000000
CN3401700000000,34,017,"Hudson County, NJ",Mar-22,370058,354299,15759,4.30000000
CN3401900000000,34,019,"Hunterdon County, NJ",Mar-22,66562,64516,2046,3.10000000
CN3402100000000,34,021,"Mercer County, NJ",Mar-22,210781,203793,6988,3.30000000
CN3402300000000,34,023,"Middlesex County, NJ",Mar-22,447262,430927,16335,3.70000000
CN3402500000000,34,025,"Monmouth County, NJ",Mar-22,335812,323541,12271,3.70000000
CN3402700000000,34,027,"Morris County, NJ",Mar-22,264103,255610,8493,3.20000000
CN3402900000000,34,029,"Ocean County, NJ",Mar-22,288451,276422,12029,4.20000000
CN3403100000000,34,031,"Passaic County, NJ",Mar-22,248861,235062,13799,5.50000000
CN3403300000000,34,033,"Salem County, NJ",Mar-22,29339,27830,1509,5.10000000
CN3403500000000,34,035,"Somerset County, NJ",Mar-22,176171,170392,5779,3.30000000
CN3403700000000,34,037,"Sussex County, NJ",Mar-22,76307,73098,3209,4.20000000
CN3403900000000,34,039,"Union County, NJ",Mar-22,285822,273209,12613,4.40000000
CN3404100000000,34,041,"Warren County, NJ",Mar-22,58155,55969,2186,3.80000000
CN3500100000000,35,001,"Bernalillo County, NM",Mar-22,336837,323265,13572,4.00000000
CN3500300000000,35,003,"Catron County, NM",Mar-22,1075,1019,56,5.20000000
CN3500500000000,35,005,"Chaves County, NM",Mar-22,27044,25722,1322,4.90000000
CN3500600000000,35,006,"Cibola County, NM",Mar-22,8859,8303,556,6.30000000
CN3500700000000,35,007,"Colfax County, NM",Mar-22,5399,5176,223,4.10000000
CN3500900000000,35,009,"Curry County, NM",Mar-22,21380,20674,706,3.30000000
CN3501100000000,35,011,"De Baca County, NM",Mar-22,668,643,25,3.70000000
CN3501300000000,35,013,"Dona Ana County, NM",Mar-22,98294,93537,4757,4.80000000
CN3501500000000,35,015,"Eddy County, NM",Mar-22,32055,30794,1261,3.90000000
CN3501700000000,35,017,"Grant County, NM",Mar-22,11547,10988,559,4.80000000
CN3501900000000,35,019,"Guadalupe County, NM",Mar-22,1653,1553,100,6.00000000
CN3502100000000,35,021,"Harding County, NM",Mar-22,273,263,10,3.70000000
CN3502300000000,35,023,"Hidalgo County, NM",Mar-22,1806,1740,66,3.70000000
CN3502500000000,35,025,"Lea County, NM",Mar-22,28419,26729,1690,5.90000000
CN3502700000000,35,027,"Lincoln County, NM",Mar-22,8489,8047,442,5.20000000
CN3502800000000,35,028,"Los Alamos County, NM",Mar-22,9871,9663,208,2.10000000
CN3502900000000,35,029,"Luna County, NM",Mar-22,9410,8111,1299,13.80000000
CN3503100000000,35,031,"McKinley County, NM",Mar-22,23675,22122,1553,6.60000000
CN3503300000000,35,033,"Mora County, NM",Mar-22,1922,1830,92,4.80000000
CN3503500000000,35,035,"Otero County, NM",Mar-22,24875,23781,1094,4.40000000
CN3503700000000,35,037,"Quay County, NM",Mar-22,2934,2784,150,5.10000000
CN3503900000000,35,039,"Rio Arriba County, NM",Mar-22,16463,15627,836,5.10000000
CN3504100000000,35,041,"Roosevelt County, NM",Mar-22,7719,7441,278,3.60000000
CN3504300000000,35,043,"Sandoval County, NM",Mar-22,68074,65165,2909,4.30000000
CN3504500000000,35,045,"San Juan County, NM",Mar-22,49582,46902,2680,5.40000000
CN3504700000000,35,047,"San Miguel County, NM",Mar-22,10376,9843,533,5.10000000
CN3504900000000,35,049,"Santa Fe County, NM",Mar-22,72920,70003,2917,4.00000000
CN3505100000000,35,051,"Sierra County, NM",Mar-22,3957,3668,289,7.30000000
CN3505300000000,35,053,"Socorro County, NM",Mar-22,6013,5747,266,4.40000000
CN3505500000000,35,055,"Taos County, NM",Mar-22,14226,13330,896,6.30000000
CN3505700000000,35,057,"Torrance County, NM",Mar-22,5364,5041,323,6.00000000
CN3505900000000,35,059,"Union County, NM",Mar-22,1533,1489,44,2.90000000
CN3506100000000,35,061,"Valencia County, NM",Mar-22,30988,29552,1436,4.60000000
CN3600100000000,36,001,"Albany County, NY",Mar-22,157808,152654,5154,3.30000000
CN3600300000000,36,003,"Allegany County, NY",Mar-22,19844,18975,869,4.40000000
CN3600500000000,36,005,"Bronx County, NY",Mar-22,588870,538254,50616,8.60000000
CN3600700000000,36,007,"Broome County, NY",Mar-22,82688,79163,3525,4.30000000
CN3600900000000,36,009,"Cattaraugus County, NY",Mar-22,33724,32191,1533,4.50000000
CN3601100000000,36,011,"Cayuga County, NY",Mar-22,34724,33316,1408,4.10000000
CN3601300000000,36,013,"Chautauqua County, NY",Mar-22,52624,50250,2374,4.50000000
CN3601500000000,36,015,"Chemung County, NY",Mar-22,34693,33255,1438,4.10000000
CN3601700000000,36,017,"Chenango County, NY",Mar-22,21807,20965,842,3.90000000
CN3601900000000,36,019,"Clinton County, NY",Mar-22,34951,33668,1283,3.70000000
CN3602100000000,36,021,"Columbia County, NY",Mar-22,29692,28748,944,3.20000000
CN3602300000000,36,023,"Cortland County, NY",Mar-22,22783,21787,996,4.40000000
CN3602500000000,36,025,"Delaware County, NY",Mar-22,18598,17850,748,4.00000000
CN3602700000000,36,027,"Dutchess County, NY",Mar-22,143412,138564,4848,3.40000000
CN3602900000000,36,029,"Erie County, NY",Mar-22,440949,422411,18538,4.20000000
CN3603100000000,36,031,"Essex County, NY",Mar-22,16832,16089,743,4.40000000
CN3603300000000,36,033,"Franklin County, NY",Mar-22,19166,18394,772,4.00000000
CN3603500000000,36,035,"Fulton County, NY",Mar-22,22468,21406,1062,4.70000000
CN3603700000000,36,037,"Genesee County, NY",Mar-22,29257,28185,1072,3.70000000
CN3603900000000,36,039,"Greene County, NY",Mar-22,20533,19696,837,4.10000000
CN3604100000000,36,041,"Hamilton County, NY",Mar-22,2114,2008,106,5.00000000
CN3604300000000,36,043,"Herkimer County, NY",Mar-22,27632,26273,1359,4.90000000
CN3604500000000,36,045,"Jefferson County, NY",Mar-22,43540,41474,2066,4.70000000
CN3604700000000,36,047,"Kings County, NY",Mar-22,1175624,1102233,73391,6.20000000
CN3604900000000,36,049,"Lewis County, NY",Mar-22,11611,11008,603,5.20000000
CN3605100000000,36,051,"Livingston County, NY",Mar-22,30300,29169,1131,3.70000000
CN3605300000000,36,053,"Madison County, NY",Mar-22,32322,31051,1271,3.90000000
CN3605500000000,36,055,"Monroe County, NY",Mar-22,365358,351200,14158,3.90000000
CN3605700000000,36,057,"Montgomery County, NY",Mar-22,21819,20775,1044,4.80000000
CN3605900000000,36,059,"Nassau County, NY",Mar-22,716802,693887,22915,3.20000000
CN3606100000000,36,061,"New York County, NY",Mar-22,891742,849895,41847,4.70000000
CN3606300000000,36,063,"Niagara County, NY",Mar-22,97522,92995,4527,4.60000000
CN3606500000000,36,065,"Oneida County, NY",Mar-22,100461,96498,3963,3.90000000
CN3606700000000,36,067,"Onondaga County, NY",Mar-22,220149,211958,8191,3.70000000
CN3606900000000,36,069,"Ontario County, NY",Mar-22,55961,53986,1975,3.50000000
CN3607100000000,36,071,"Orange County, NY",Mar-22,185220,178610,6610,3.60000000
CN3607300000000,36,073,"Orleans County, NY",Mar-22,17113,16374,739,4.30000000
CN3607500000000,36,075,"Oswego County, NY",Mar-22,52083,49644,2439,4.70000000
CN3607700000000,36,077,"Otsego County, NY",Mar-22,27145,26104,1041,3.80000000
CN3607900000000,36,079,"Putnam County, NY",Mar-22,50899,49272,1627,3.20000000
CN3608100000000,36,081,"Queens County, NY",Mar-22,1111442,1046995,64447,5.80000000
CN3608300000000,36,083,"Rensselaer County, NY",Mar-22,81596,78784,2812,3.40000000
CN3608500000000,36,085,"Richmond County, NY",Mar-22,219347,207103,12244,5.60000000
CN3608700000000,36,087,"Rockland County, NY",Mar-22,155525,150642,4883,3.10000000
CN3608900000000,36,089,"St. Lawrence County, NY",Mar-22,43395,41499,1896,4.40000000
CN3609100000000,36,091,"Saratoga County, NY",Mar-22,120721,117170,3551,2.90000000
CN3609300000000,36,093,"Schenectady County, NY",Mar-22,77329,74445,2884,3.70000000
CN3609500000000,36,095,"Schoharie County, NY",Mar-22,14690,14079,611,4.20000000
CN3609700000000,36,097,"Schuyler County, NY",Mar-22,7939,7562,377,4.70000000
CN3609900000000,36,099,"Seneca County, NY",Mar-22,15048,14478,570,3.80000000
CN3610100000000,36,101,"Steuben County, NY",Mar-22,41328,39553,1775,4.30000000
CN3610300000000,36,103,"Suffolk County, NY",Mar-22,786572,758875,27697,3.50000000
CN3610500000000,36,105,"Sullivan County, NY",Mar-22,36041,34630,1411,3.90000000
CN3610700000000,36,107,"Tioga County, NY",Mar-22,22340,21491,849,3.80000000
CN3610900000000,36,109,"Tompkins County, NY",Mar-22,49589,48233,1356,2.70000000
CN3611100000000,36,111,"Ulster County, NY",Mar-22,87886,84793,3093,3.50000000
CN3611300000000,36,113,"Warren County, NY",Mar-22,31027,29720,1307,4.20000000
CN3611500000000,36,115,"Washington County, NY",Mar-22,27242,26179,1063,3.90000000
CN3611700000000,36,117,"Wayne County, NY",Mar-22,43374,41776,1598,3.70000000
CN3611900000000,36,119,"Westchester County, NY",Mar-22,485893,468782,17111,3.50000000
CN3612100000000,36,121,"Wyoming County, NY",Mar-22,17876,17096,780,4.40000000
CN3612300000000,36,123,"Yates County, NY",Mar-22,11642,11266,376,3.20000000
CN3700100000000,37,001,"Alamance County, NC",Mar-22,82748,79887,2861,3.50000000
CN3700300000000,37,003,"Alexander County, NC",Mar-22,17770,17228,542,3.10000000
CN3700500000000,37,005,"Alleghany County, NC",Mar-22,4196,4056,140,3.30000000
CN3700700000000,37,007,"Anson County, NC",Mar-22,10269,9771,498,4.80000000
CN3700900000000,37,009,"Ashe County, NC",Mar-22,12674,12293,381,3.00000000
CN3701100000000,37,011,"Avery County, NC",Mar-22,7160,6931,229,3.20000000
CN3701300000000,37,013,"Beaufort County, NC",Mar-22,19854,19150,704,3.50000000
CN3701500000000,37,015,"Bertie County, NC",Mar-22,7205,6851,354,4.90000000
CN3701700000000,37,017,"Bladen County, NC",Mar-22,14135,13485,650,4.60000000
CN3701900000000,37,019,"Brunswick County, NC",Mar-22,55367,52717,2650,4.80000000
CN3702100000000,37,021,"Buncombe County, NC",Mar-22,140912,136861,4051,2.90000000
CN3702300000000,37,023,"Burke County, NC",Mar-22,40277,38994,1283,3.20000000
CN3702500000000,37,025,"Cabarrus County, NC",Mar-22,113071,109416,3655,3.20000000
CN3702700000000,37,027,"Caldwell County, NC",Mar-22,35925,34688,1237,3.40000000
CN3702900000000,37,029,"Camden County, NC",Mar-22,4547,4410,137,3.00000000
CN3703100000000,37,031,"Carteret County, NC",Mar-22,31478,30477,1001,3.20000000
CN3703300000000,37,033,"Caswell County, NC",Mar-22,9725,9357,368,3.80000000
CN3703500000000,37,035,"Catawba County, NC",Mar-22,78508,75895,2613,3.30000000
CN3703700000000,37,037,"Chatham County, NC",Mar-22,37516,36532,984,2.60000000
CN3703900000000,37,039,"Cherokee County, NC",Mar-22,10720,10316,404,3.80000000
CN3704100000000,37,041,"Chowan County, NC",Mar-22,5614,5401,213,3.80000000
CN3704300000000,37,043,"Clay County, NC",Mar-22,4015,3872,143,3.60000000
CN3704500000000,37,045,"Cleveland County, NC",Mar-22,48806,46862,1944,4.00000000
CN3704700000000,37,047,"Columbus County, NC",Mar-22,23073,21934,1139,4.90000000
CN3704900000000,37,049,"Craven County, NC",Mar-22,41167,39764,1403,3.40000000
CN3705100000000,37,051,"Cumberland County, NC",Mar-22,128780,121703,7077,5.50000000
CN3705300000000,37,053,"Currituck County, NC",Mar-22,14382,13882,500,3.50000000
CN3705500000000,37,055,"Dare County, NC",Mar-22,18365,17259,1106,6.00000000
CN3705700000000,37,057,"Davidson County, NC",Mar-22,80645,78020,2625,3.30000000
CN3705900000000,37,059,"Davie County, NC",Mar-22,20559,19914,645,3.10000000
CN3706100000000,37,061,"Duplin County, NC",Mar-22,24643,23837,806,3.30000000
CN3706300000000,37,063,"Durham County, NC",Mar-22,180437,175153,5284,2.90000000
CN3706500000000,37,065,"Edgecombe County, NC",Mar-22,20314,18715,1599,7.90000000
CN3706700000000,37,067,"Forsyth County, NC",Mar-22,187060,180415,6645,3.60000000
CN3706900000000,37,069,"Franklin County, NC",Mar-22,33269,32087,1182,3.60000000
CN3707100000000,37,071,"Gaston County, NC",Mar-22,112117,107789,4328,3.90000000
CN3707300000000,37,073,"Gates County, NC",Mar-22,4986,4838,148,3.00000000
CN3707500000000,37,075,"Graham County, NC",Mar-22,2952,2766,186,6.30000000
CN3707700000000,37,077,"Granville County, NC",Mar-22,30447,29552,895,2.90000000
CN3707900000000,37,079,"Greene County, NC",Mar-22,9515,9228,287,3.00000000
CN3708100000000,37,081,"Guilford County, NC",Mar-22,261287,250425,10862,4.20000000
CN3708300000000,37,083,"Halifax County, NC",Mar-22,19350,18153,1197,6.20000000
CN3708500000000,37,085,"Harnett County, NC",Mar-22,54312,52197,2115,3.90000000
CN3708700000000,37,087,"Haywood County, NC",Mar-22,29947,29040,907,3.00000000
CN3708900000000,37,089,"Henderson County, NC",Mar-22,54945,53384,1561,2.80000000
CN3709100000000,37,091,"Hertford County, NC",Mar-22,8552,8120,432,5.10000000
CN3709300000000,37,093,"Hoke County, NC",Mar-22,20354,19347,1007,4.90000000
CN3709500000000,37,095,"Hyde County, NC",Mar-22,1694,1547,147,8.70000000
CN3709700000000,37,097,"Iredell County, NC",Mar-22,92143,89177,2966,3.20000000
CN3709900000000,37,099,"Jackson County, NC",Mar-22,19397,18736,661,3.40000000
CN3710100000000,37,101,"Johnston County, NC",Mar-22,105518,102288,3230,3.10000000
CN3710300000000,37,103,"Jones County, NC",Mar-22,4205,4075,130,3.10000000
CN3710500000000,37,105,"Lee County, NC",Mar-22,25929,24847,1082,4.20000000
CN3710700000000,37,107,"Lenoir County, NC",Mar-22,27246,26207,1039,3.80000000
CN3710900000000,37,109,"Lincoln County, NC",Mar-22,45159,43815,1344,3.00000000
CN3711100000000,37,111,"McDowell County, NC",Mar-22,20066,19426,640,3.20000000
CN3711300000000,37,113,"Macon County, NC",Mar-22,15123,14610,513,3.40000000
CN3711500000000,37,115,"Madison County, NC",Mar-22,9970,9668,302,3.00000000
CN3711700000000,37,117,"Martin County, NC",Mar-22,8725,8338,387,4.40000000
CN3711900000000,37,119,"Mecklenburg County, NC",Mar-22,637457,614108,23349,3.70000000
CN3712100000000,37,121,"Mitchell County, NC",Mar-22,5982,5745,237,4.00000000
CN3712300000000,37,123,"Montgomery County, NC",Mar-22,11007,10636,371,3.40000000
CN3712500000000,37,125,"Moore County, NC",Mar-22,40743,39374,1369,3.40000000
CN3712700000000,37,127,"Nash County, NC",Mar-22,41956,39760,2196,5.20000000
CN3712900000000,37,129,"New Hanover County, NC",Mar-22,126092,122133,3959,3.10000000
CN3713100000000,37,131,"Northampton County, NC",Mar-22,7224,6881,343,4.70000000
CN3713300000000,37,133,"Onslow County, NC",Mar-22,66696,64140,2556,3.80000000
CN3713500000000,37,135,"Orange County, NC",Mar-22,81770,79796,1974,2.40000000
CN3713700000000,37,137,"Pamlico County, NC",Mar-22,5384,5196,188,3.50000000
CN3713900000000,37,139,"Pasquotank County, NC",Mar-22,16337,15659,678,4.20000000
CN3714100000000,37,141,"Pender County, NC",Mar-22,29859,28916,943,3.20000000
CN3714300000000,37,143,"Perquimans County, NC",Mar-22,4852,4639,213,4.40000000
CN3714500000000,37,145,"Person County, NC",Mar-22,18983,18287,696,3.70000000
CN3714700000000,37,147,"Pitt County, NC",Mar-22,89611,86223,3388,3.80000000
CN3714900000000,37,149,"Polk County, NC",Mar-22,9137,8797,340,3.70000000
CN3715100000000,37,151,"Randolph County, NC",Mar-22,65263,63133,2130,3.30000000
CN3715300000000,37,153,"Richmond County, NC",Mar-22,16425,15424,1001,6.10000000
CN3715500000000,37,155,"Robeson County, NC",Mar-22,48572,45543,3029,6.20000000
CN3715700000000,37,157,"Rockingham County, NC",Mar-22,39535,37939,1596,4.00000000
CN3715900000000,37,159,"Rowan County, NC",Mar-22,66024,63676,2348,3.60000000
CN3716100000000,37,161,"Rutherford County, NC",Mar-22,24286,23089,1197,4.90000000
CN3716300000000,37,163,"Sampson County, NC",Mar-22,28050,27084,966,3.40000000
CN3716500000000,37,165,"Scotland County, NC",Mar-22,11210,10316,894,8.00000000
CN3716700000000,37,167,"Stanly County, NC",Mar-22,30156,29226,930,3.10000000
CN3716900000000,37,169,"Stokes County, NC",Mar-22,21412,20766,646,3.00000000
CN3717100000000,37,171,"Surry County, NC",Mar-22,32270,31261,1009,3.10000000
CN3717300000000,37,173,"Swain County, NC",Mar-22,6795,6567,228,3.40000000
CN3717500000000,37,175,"Transylvania County, NC",Mar-22,14180,13755,425,3.00000000
CN3717700000000,37,177,"Tyrrell County, NC",Mar-22,1206,1125,81,6.70000000
CN3717900000000,37,179,"Union County, NC",Mar-22,126700,123096,3604,2.80000000
CN3718100000000,37,181,"Vance County, NC",Mar-22,16980,15856,1124,6.60000000
CN3718300000000,37,183,"Wake County, NC",Mar-22,617194,599385,17809,2.90000000
CN3718500000000,37,185,"Warren County, NC",Mar-22,6452,6018,434,6.70000000
CN3718700000000,37,187,"Washington County, NC",Mar-22,4210,3971,239,5.70000000
CN3718900000000,37,189,"Watauga County, NC",Mar-22,28919,28165,754,2.60000000
CN3719100000000,37,191,"Wayne County, NC",Mar-22,51379,49424,1955,3.80000000
CN3719300000000,37,193,"Wilkes County, NC",Mar-22,27204,26261,943,3.50000000
CN3719500000000,37,195,"Wilson County, NC",Mar-22,33361,31523,1838,5.50000000
CN3719700000000,37,197,"Yadkin County, NC",Mar-22,17440,16906,534,3.10000000
CN3719900000000,37,199,"Yancey County, NC",Mar-22,8111,7842,269,3.30000000
CN3800100000000,38,001,"Adams County, ND",Mar-22,945,918,27,2.90000000
CN3800300000000,38,003,"Barnes County, ND",Mar-22,5350,5172,178,3.30000000
CN3800500000000,38,005,"Benson County, ND",Mar-22,2343,2237,106,4.50000000
CN3800700000000,38,007,"Billings County, ND",Mar-22,383,370,13,3.40000000
CN3800900000000,38,009,"Bottineau County, ND",Mar-22,2953,2791,162,5.50000000
CN3801100000000,38,011,"Bowman County, ND",Mar-22,1569,1535,34,2.20000000
CN3801300000000,38,013,"Burke County, ND",Mar-22,1042,1005,37,3.60000000
CN3801500000000,38,015,"Burleigh County, ND",Mar-22,51805,50316,1489,2.90000000
CN3801700000000,38,017,"Cass County, ND",Mar-22,107420,104428,2992,2.80000000
CN3801900000000,38,019,"Cavalier County, ND",Mar-22,1920,1848,72,3.80000000
CN3802100000000,38,021,"Dickey County, ND",Mar-22,2262,2208,54,2.40000000
CN3802300000000,38,023,"Divide County, ND",Mar-22,1391,1363,28,2.00000000
CN3802500000000,38,025,"Dunn County, ND",Mar-22,3254,3183,71,2.20000000
CN3802700000000,38,027,"Eddy County, ND",Mar-22,1233,1185,48,3.90000000
CN3802900000000,38,029,"Emmons County, ND",Mar-22,1523,1425,98,6.40000000
CN3803100000000,38,031,"Foster County, ND",Mar-22,1506,1464,42,2.80000000
CN3803300000000,38,033,"Golden Valley County, ND",Mar-22,846,830,16,1.90000000
CN3803500000000,38,035,"Grand Forks County, ND",Mar-22,37681,36648,1033,2.70000000
CN3803700000000,38,037,"Grant County, ND",Mar-22,1273,1238,35,2.70000000
CN3803900000000,38,039,"Griggs County, ND",Mar-22,1052,1021,31,2.90000000
CN3804100000000,38,041,"Hettinger County, ND",Mar-22,1407,1375,32,2.30000000
CN3804300000000,38,043,"Kidder County, ND",Mar-22,1374,1296,78,5.70000000
CN3804500000000,38,045,"LaMoure County, ND",Mar-22,2105,2043,62,2.90000000
CN3804700000000,38,047,"Logan County, ND",Mar-22,887,859,28,3.20000000
CN3804900000000,38,049,"McHenry County, ND",Mar-22,3228,3045,183,5.70000000
CN3805100000000,38,051,"McIntosh County, ND",Mar-22,1095,1063,32,2.90000000
CN3805300000000,38,053,"McKenzie County, ND",Mar-22,8659,8354,305,3.50000000
CN3805500000000,38,055,"McLean County, ND",Mar-22,4697,4480,217,4.60000000
CN3805700000000,38,057,"Mercer County, ND",Mar-22,3480,3310,170,4.90000000
CN3805900000000,38,059,"Morton County, ND",Mar-22,17191,16541,650,3.80000000
CN3806100000000,38,061,"Mountrail County, ND",Mar-22,6328,6172,156,2.50000000
CN3806300000000,38,063,"Nelson County, ND",Mar-22,1428,1362,66,4.60000000
CN3806500000000,38,065,"Oliver County, ND",Mar-22,896,856,40,4.50000000
CN3806700000000,38,067,"Pembina County, ND",Mar-22,3291,3129,162,4.90000000
CN3806900000000,38,069,"Pierce County, ND",Mar-22,1676,1609,67,4.00000000
CN3807100000000,38,071,"Ramsey County, ND",Mar-22,5648,5454,194,3.40000000
CN3807300000000,38,073,"Ransom County, ND",Mar-22,2687,2625,62,2.30000000
CN3807500000000,38,075,"Renville County, ND",Mar-22,1201,1163,38,3.20000000
CN3807700000000,38,077,"Richland County, ND",Mar-22,8729,8471,258,3.00000000
CN3807900000000,38,079,"Rolette County, ND",Mar-22,4869,4423,446,9.20000000
CN3808100000000,38,081,"Sargent County, ND",Mar-22,2346,2282,64,2.70000000
CN3808300000000,38,083,"Sheridan County, ND",Mar-22,663,632,31,4.70000000
CN3808500000000,38,085,"Sioux County, ND",Mar-22,1218,1184,34,2.80000000
CN3808700000000,38,087,"Slope County, ND",Mar-22,371,362,9,2.40000000
CN3808900000000,38,089,"Stark County, ND",Mar-22,17400,16852,548,3.10000000
CN3809100000000,38,091,"Steele County, ND",Mar-22,930,902,28,3.00000000
CN3809300000000,38,093,"Stutsman County, ND",Mar-22,10354,10022,332,3.20000000
CN3809500000000,38,095,"Towner County, ND",Mar-22,1150,1116,34,3.00000000
CN3809700000000,38,097,"Traill County, ND",Mar-22,4466,4339,127,2.80000000
CN3809900000000,38,099,"Walsh County, ND",Mar-22,5309,5055,254,4.80000000
CN3810100000000,38,101,"Ward County, ND",Mar-22,31313,30143,1170,3.70000000
CN3810300000000,38,103,"Wells County, ND",Mar-22,1907,1811,96,5.00000000
CN3810500000000,38,105,"Williams County, ND",Mar-22,20163,19234,929,4.60000000
CN3900100000000,39,001,"Adams County, OH",Mar-22,11116,10487,629,5.70000000
CN3900300000000,39,003,"Allen County, OH",Mar-22,47284,45328,1956,4.10000000
CN3900500000000,39,005,"Ashland County, OH",Mar-22,26760,25743,1017,3.80000000
CN3900700000000,39,007,"Ashtabula County, OH",Mar-22,43531,41510,2021,4.60000000
CN3900900000000,39,009,"Athens County, OH",Mar-22,27442,26188,1254,4.60000000
CN3901100000000,39,011,"Auglaize County, OH",Mar-22,24545,23824,721,2.90000000
CN3901300000000,39,013,"Belmont County, OH",Mar-22,28310,26832,1478,5.20000000
CN3901500000000,39,015,"Brown County, OH",Mar-22,19562,18643,919,4.70000000
CN3901700000000,39,017,"Butler County, OH",Mar-22,196779,189898,6881,3.50000000
CN3901900000000,39,019,"Carroll County, OH",Mar-22,12764,12187,577,4.50000000
CN3902100000000,39,021,"Champaign County, OH",Mar-22,19583,18836,747,3.80000000
CN3902300000000,39,023,"Clark County, OH",Mar-22,63181,60477,2704,4.30000000
CN3902500000000,39,025,"Clermont County, OH",Mar-22,108061,104238,3823,3.50000000
CN3902700000000,39,027,"Clinton County, OH",Mar-22,18190,17384,806,4.40000000
CN3902900000000,39,029,"Columbiana County, OH",Mar-22,45724,43645,2079,4.50000000
CN3903100000000,39,031,"Coshocton County, OH",Mar-22,13906,13223,683,4.90000000
CN3903300000000,39,033,"Crawford County, OH",Mar-22,18024,17190,834,4.60000000
CN3903500000000,39,035,"Cuyahoga County, OH",Mar-22,590163,549933,40230,6.80000000
CN3903700000000,39,037,"Darke County, OH",Mar-22,26023,25084,939,3.60000000
CN3903900000000,39,039,"Defiance County, OH",Mar-22,17629,16956,673,3.80000000
CN3904100000000,39,041,"Delaware County, OH",Mar-22,116517,113273,3244,2.80000000
CN3904300000000,39,043,"Erie County, OH",Mar-22,36340,34012,2328,6.40000000
CN3904500000000,39,045,"Fairfield County, OH",Mar-22,80997,78234,2763,3.40000000
CN3904700000000,39,047,"Fayette County, OH",Mar-22,13823,13280,543,3.90000000
CN3904900000000,39,049,"Franklin County, OH",Mar-22,715138,691250,23888,3.30000000
CN3905100000000,39,051,"Fulton County, OH",Mar-22,22187,21264,923,4.20000000
CN3905300000000,39,053,"Gallia County, OH",Mar-22,12373,11815,558,4.50000000
CN3905500000000,39,055,"Geauga County, OH",Mar-22,47457,44781,2676,5.60000000
CN3905700000000,39,057,"Greene County, OH",Mar-22,84202,81342,2860,3.40000000
CN3905900000000,39,059,"Guernsey County, OH",Mar-22,17917,16969,948,5.30000000
CN3906100000000,39,061,"Hamilton County, OH",Mar-22,417161,402422,14739,3.50000000
CN3906300000000,39,063,"Hancock County, OH",Mar-22,41887,40465,1422,3.40000000
CN3906500000000,39,065,"Hardin County, OH",Mar-22,13630,13076,554,4.10000000
CN3906700000000,39,067,"Harrison County, OH",Mar-22,6538,6206,332,5.10000000
CN3906900000000,39,069,"Henry County, OH",Mar-22,12769,12133,636,5.00000000
CN3907100000000,39,071,"Highland County, OH",Mar-22,17519,16663,856,4.90000000
CN3907300000000,39,073,"Hocking County, OH",Mar-22,13114,12563,551,4.20000000
CN3907500000000,39,075,"Holmes County, OH",Mar-22,21717,21161,556,2.60000000
CN3907700000000,39,077,"Huron County, OH",Mar-22,27984,26180,1804,6.40000000
CN3907900000000,39,079,"Jackson County, OH",Mar-22,12675,12027,648,5.10000000
CN3908100000000,39,081,"Jefferson County, OH",Mar-22,27402,25947,1455,5.30000000
CN3908300000000,39,083,"Knox County, OH",Mar-22,31663,30565,1098,3.50000000
CN3908500000000,39,085,"Lake County, OH",Mar-22,122307,114965,7342,6.00000000
CN3908700000000,39,087,"Lawrence County, OH",Mar-22,23644,22636,1008,4.30000000
CN3908900000000,39,089,"Licking County, OH",Mar-22,92810,89774,3036,3.30000000
CN3909100000000,39,091,"Logan County, OH",Mar-22,22557,21762,795,3.50000000
CN3909300000000,39,093,"Lorain County, OH",Mar-22,152816,140801,12015,7.90000000
CN3909500000000,39,095,"Lucas County, OH",Mar-22,207961,198917,9044,4.30000000
CN3909700000000,39,097,"Madison County, OH",Mar-22,21141,20470,671,3.20000000
CN3909900000000,39,099,"Mahoning County, OH",Mar-22,99522,94509,5013,5.00000000
CN3910100000000,39,101,"Marion County, OH",Mar-22,28119,27074,1045,3.70000000
CN3910300000000,39,103,"Medina County, OH",Mar-22,95459,90313,5146,5.40000000
CN3910500000000,39,105,"Meigs County, OH",Mar-22,8885,8381,504,5.70000000
CN3910700000000,39,107,"Mercer County, OH",Mar-22,23090,22479,611,2.60000000
CN3910900000000,39,109,"Miami County, OH",Mar-22,54879,52852,2027,3.70000000
CN3911100000000,39,111,"Monroe County, OH",Mar-22,5237,4874,363,6.90000000
CN3911300000000,39,113,"Montgomery County, OH",Mar-22,252223,242149,10074,4.00000000
CN3911500000000,39,115,"Morgan County, OH",Mar-22,6919,6494,425,6.10000000
CN3911700000000,39,117,"Morrow County, OH",Mar-22,17206,16535,671,3.90000000
CN3911900000000,39,119,"Muskingum County, OH",Mar-22,40715,38837,1878,4.60000000
CN3912100000000,39,121,"Noble County, OH",Mar-22,4637,4347,290,6.30000000
CN3912300000000,39,123,"Ottawa County, OH",Mar-22,20013,18740,1273,6.40000000
CN3912500000000,39,125,"Paulding County, OH",Mar-22,8685,8361,324,3.70000000
CN3912700000000,39,127,"Perry County, OH",Mar-22,16166,15400,766,4.70000000
CN3912900000000,39,129,"Pickaway County, OH",Mar-22,27090,26066,1024,3.80000000
CN3913100000000,39,131,"Pike County, OH",Mar-22,10983,10379,604,5.50000000
CN3913300000000,39,133,"Portage County, OH",Mar-22,85103,81767,3336,3.90000000
CN3913500000000,39,135,"Preble County, OH",Mar-22,22034,21298,736,3.30000000
CN3913700000000,39,137,"Putnam County, OH",Mar-22,19094,18507,587,3.10000000
CN3913900000000,39,139,"Richland County, OH",Mar-22,51648,49308,2340,4.50000000
CN3914100000000,39,141,"Ross County, OH",Mar-22,35597,34182,1415,4.00000000
CN3914300000000,39,143,"Sandusky County, OH",Mar-22,30806,28737,2069,6.70000000
CN3914500000000,39,145,"Scioto County, OH",Mar-22,29996,28507,1489,5.00000000
CN3914700000000,39,147,"Seneca County, OH",Mar-22,27063,25774,1289,4.80000000
CN3914900000000,39,149,"Shelby County, OH",Mar-22,24183,23310,873,3.60000000
CN3915100000000,39,151,"Stark County, OH",Mar-22,183134,175580,7554,4.10000000
CN3915300000000,39,153,"Summit County, OH",Mar-22,264932,253842,11090,4.20000000
CN3915500000000,39,155,"Trumbull County, OH",Mar-22,84227,79756,4471,5.30000000
CN3915700000000,39,157,"Tuscarawas County, OH",Mar-22,44829,43082,1747,3.90000000
CN3915900000000,39,159,"Union County, OH",Mar-22,30486,29589,897,2.90000000
CN3916100000000,39,161,"Van Wert County, OH",Mar-22,14752,14255,497,3.40000000
CN3916300000000,39,163,"Vinton County, OH",Mar-22,5499,5212,287,5.20000000
CN3916500000000,39,165,"Warren County, OH",Mar-22,122383,118502,3881,3.20000000
CN3916700000000,39,167,"Washington County, OH",Mar-22,27218,25928,1290,4.70000000
CN3916900000000,39,169,"Wayne County, OH",Mar-22,61007,59128,1879,3.10000000
CN3917100000000,39,171,"Williams County, OH",Mar-22,18280,17589,691,3.80000000
CN3917300000000,39,173,"Wood County, OH",Mar-22,70920,68512,2408,3.40000000
CN3917500000000,39,175,"Wyandot County, OH",Mar-22,13064,12658,406,3.10000000
CN4000100000000,40,001,"Adair County, OK",Mar-22,8726,8445,281,3.20000000
CN4000300000000,40,003,"Alfalfa County, OK",Mar-22,2677,2626,51,1.90000000
CN4000500000000,40,005,"Atoka County, OK",Mar-22,4979,4796,183,3.70000000
CN4000700000000,40,007,"Beaver County, OK",Mar-22,2639,2598,41,1.60000000
CN4000900000000,40,009,"Beckham County, OK",Mar-22,9515,9227,288,3.00000000
CN4001100000000,40,011,"Blaine County, OK",Mar-22,4406,4312,94,2.10000000
CN4001300000000,40,013,"Bryan County, OK",Mar-22,22377,21802,575,2.60000000
CN4001500000000,40,015,"Caddo County, OK",Mar-22,12009,11651,358,3.00000000
CN4001700000000,40,017,"Canadian County, OK",Mar-22,80256,78297,1959,2.40000000
CN4001900000000,40,019,"Carter County, OK",Mar-22,21486,20712,774,3.60000000
CN4002100000000,40,021,"Cherokee County, OK",Mar-22,20305,19641,664,3.30000000
CN4002300000000,40,023,"Choctaw County, OK",Mar-22,6111,5850,261,4.30000000
CN4002500000000,40,025,"Cimarron County, OK",Mar-22,1550,1527,23,1.50000000
CN4002700000000,40,027,"Cleveland County, OK",Mar-22,147904,144386,3518,2.40000000
CN4002900000000,40,029,"Coal County, OK",Mar-22,2380,2299,81,3.40000000
CN4003100000000,40,031,"Comanche County, OK",Mar-22,47526,45902,1624,3.40000000
CN4003300000000,40,033,"Cotton County, OK",Mar-22,2686,2614,72,2.70000000
CN4003500000000,40,035,"Craig County, OK",Mar-22,5804,5632,172,3.00000000
CN4003700000000,40,037,"Creek County, OK",Mar-22,31664,30586,1078,3.40000000
CN4003900000000,40,039,"Custer County, OK",Mar-22,15568,15181,387,2.50000000
CN4004100000000,40,041,"Delaware County, OK",Mar-22,18676,18110,566,3.00000000
CN4004300000000,40,043,"Dewey County, OK",Mar-22,2825,2771,54,1.90000000
CN4004500000000,40,045,"Ellis County, OK",Mar-22,2117,2073,44,2.10000000
CN4004700000000,40,047,"Garfield County, OK",Mar-22,26683,25947,736,2.80000000
CN4004900000000,40,049,"Garvin County, OK",Mar-22,12647,12295,352,2.80000000
CN4005100000000,40,051,"Grady County, OK",Mar-22,27312,26610,702,2.60000000
CN4005300000000,40,053,"Grant County, OK",Mar-22,2916,2864,52,1.80000000
CN4005500000000,40,055,"Greer County, OK",Mar-22,1845,1784,61,3.30000000
CN4005700000000,40,057,"Harmon County, OK",Mar-22,1176,1148,28,2.40000000
CN4005900000000,40,059,"Harper County, OK",Mar-22,1845,1810,35,1.90000000
CN4006100000000,40,061,"Haskell County, OK",Mar-22,4167,4004,163,3.90000000
CN4006300000000,40,063,"Hughes County, OK",Mar-22,5184,4957,227,4.40000000
CN4006500000000,40,065,"Jackson County, OK",Mar-22,10946,10680,266,2.40000000
CN4006700000000,40,067,"Jefferson County, OK",Mar-22,2530,2455,75,3.00000000
CN4006900000000,40,069,"Johnston County, OK",Mar-22,3665,3528,137,3.70000000
CN4007100000000,40,071,"Kay County, OK",Mar-22,18355,17740,615,3.40000000
CN4007300000000,40,073,"Kingfisher County, OK",Mar-22,8911,8747,164,1.80000000
CN4007500000000,40,075,"Kiowa County, OK",Mar-22,3649,3548,101,2.80000000
CN4007700000000,40,077,"Latimer County, OK",Mar-22,3135,2939,196,6.30000000
CN4007900000000,40,079,"Le Flore County, OK",Mar-22,19474,18750,724,3.70000000
CN4008100000000,40,081,"Lincoln County, OK",Mar-22,16209,15762,447,2.80000000
CN4008300000000,40,083,"Logan County, OK",Mar-22,23315,22726,589,2.50000000
CN4008500000000,40,085,"Love County, OK",Mar-22,6033,5901,132,2.20000000
CN4008700000000,40,087,"McClain County, OK",Mar-22,20925,20412,513,2.50000000
CN4008900000000,40,089,"McCurtain County, OK",Mar-22,16194,15595,599,3.70000000
CN4009100000000,40,091,"McIntosh County, OK",Mar-22,7177,6809,368,5.10000000
CN4009300000000,40,093,"Major County, OK",Mar-22,3684,3604,80,2.20000000
CN4009500000000,40,095,"Marshall County, OK",Mar-22,7363,7153,210,2.90000000
CN4009700000000,40,097,"Mayes County, OK",Mar-22,19428,18841,587,3.00000000
CN4009900000000,40,099,"Murray County, OK",Mar-22,6182,6010,172,2.80000000
CN4010100000000,40,101,"Muskogee County, OK",Mar-22,28145,27160,985,3.50000000
CN4010300000000,40,103,"Noble County, OK",Mar-22,5697,5585,112,2.00000000
CN4010500000000,40,105,"Nowata County, OK",Mar-22,4691,4569,122,2.60000000
CN4010700000000,40,107,"Okfuskee County, OK",Mar-22,4460,4280,180,4.00000000
CN4010900000000,40,109,"Oklahoma County, OK",Mar-22,397904,386350,11554,2.90000000
CN4011100000000,40,111,"Okmulgee County, OK",Mar-22,15693,15037,656,4.20000000
CN4011300000000,40,113,"Osage County, OK",Mar-22,20627,19901,726,3.50000000
CN4011500000000,40,115,"Ottawa County, OK",Mar-22,14955,14566,389,2.60000000
CN4011700000000,40,117,"Pawnee County, OK",Mar-22,7416,7167,249,3.40000000
CN4011900000000,40,119,"Payne County, OK",Mar-22,38253,37264,989,2.60000000
CN4012100000000,40,121,"Pittsburg County, OK",Mar-22,16545,15828,717,4.30000000
CN4012300000000,40,123,"Pontotoc County, OK",Mar-22,19263,18747,516,2.70000000
CN4012500000000,40,125,"Pottawatomie County, OK",Mar-22,33170,32085,1085,3.30000000
CN4012700000000,40,127,"Pushmataha County, OK",Mar-22,4813,4651,162,3.40000000
CN4012900000000,40,129,"Roger Mills County, OK",Mar-22,1831,1785,46,2.50000000
CN4013100000000,40,131,"Rogers County, OK",Mar-22,45624,44369,1255,2.80000000
CN4013300000000,40,133,"Seminole County, OK",Mar-22,9292,8923,369,4.00000000
CN4013500000000,40,135,"Sequoyah County, OK",Mar-22,16774,16193,581,3.50000000
CN4013700000000,40,137,"Stephens County, OK",Mar-22,19259,18623,636,3.30000000
CN4013900000000,40,139,"Texas County, OK",Mar-22,11815,11605,210,1.80000000
CN4014100000000,40,141,"Tillman County, OK",Mar-22,2921,2833,88,3.00000000
CN4014300000000,40,143,"Tulsa County, OK",Mar-22,328760,318878,9882,3.00000000
CN4014500000000,40,145,"Wagoner County, OK",Mar-22,39347,38234,1113,2.80000000
CN4014700000000,40,147,"Washington County, OK",Mar-22,22681,21975,706,3.10000000
CN4014900000000,40,149,"Washita County, OK",Mar-22,4994,4819,175,3.50000000
CN4015100000000,40,151,"Woods County, OK",Mar-22,4787,4703,84,1.80000000
CN4015300000000,40,153,"Woodward County, OK",Mar-22,8558,8302,256,3.00000000
CN4100100000000,41,001,"Baker County, OR",Mar-22,7659,7306,353,4.60000000
CN4100300000000,41,003,"Benton County, OR",Mar-22,49948,48475,1473,2.90000000
CN4100500000000,41,005,"Clackamas County, OR",Mar-22,230451,222260,8191,3.60000000
CN4100700000000,41,007,"Clatsop County, OR",Mar-22,19478,18632,846,4.30000000
CN4100900000000,41,009,"Columbia County, OR",Mar-22,25537,24377,1160,4.50000000
CN4101100000000,41,011,"Coos County, OR",Mar-22,26924,25585,1339,5.00000000
CN4101300000000,41,013,"Crook County, OR",Mar-22,11335,10728,607,5.40000000
CN4101500000000,41,015,"Curry County, OR",Mar-22,9218,8710,508,5.50000000
CN4101700000000,41,017,"Deschutes County, OR",Mar-22,105403,101201,4202,4.00000000
CN4101900000000,41,019,"Douglas County, OR",Mar-22,48293,45961,2332,4.80000000
CN4102100000000,41,021,"Gilliam County, OR",Mar-22,1034,996,38,3.70000000
CN4102300000000,41,023,"Grant County, OR",Mar-22,3141,2911,230,7.30000000
CN4102500000000,41,025,"Harney County, OR",Mar-22,3787,3601,186,4.90000000
CN4102700000000,41,027,"Hood River County, OR",Mar-22,14495,14025,470,3.20000000
CN4102900000000,41,029,"Jackson County, OR",Mar-22,108643,103972,4671,4.30000000
CN4103100000000,41,031,"Jefferson County, OR",Mar-22,10730,10153,577,5.40000000
CN4103300000000,41,033,"Josephine County, OR",Mar-22,37666,35710,1956,5.20000000
CN4103500000000,41,035,"Klamath County, OR",Mar-22,30098,28307,1791,6.00000000
CN4103700000000,41,037,"Lake County, OR",Mar-22,3623,3408,215,5.90000000
CN4103900000000,41,039,"Lane County, OR",Mar-22,186967,179221,7746,4.10000000
CN4104100000000,41,041,"Lincoln County, OR",Mar-22,21048,19924,1124,5.30000000
CN4104300000000,41,043,"Linn County, OR",Mar-22,62045,59328,2717,4.40000000
CN4104500000000,41,045,"Malheur County, OR",Mar-22,12757,12301,456,3.60000000
CN4104700000000,41,047,"Marion County, OR",Mar-22,169547,162884,6663,3.90000000
CN4104900000000,41,049,"Morrow County, OR",Mar-22,6081,5868,213,3.50000000
CN4105100000000,41,051,"Multnomah County, OR",Mar-22,476744,457876,18868,4.00000000
CN4105300000000,41,053,"Polk County, OR",Mar-22,42643,41026,1617,3.80000000
CN4105500000000,41,055,"Sherman County, OR",Mar-22,959,927,32,3.30000000
CN4105700000000,41,057,"Tillamook County, OR",Mar-22,12262,11737,525,4.30000000
CN4105900000000,41,059,"Umatilla County, OR",Mar-22,38082,36472,1610,4.20000000
CN4106100000000,41,061,"Union County, OR",Mar-22,12345,11776,569,4.60000000
CN4106300000000,41,063,"Wallowa County, OR",Mar-22,3488,3274,214,6.10000000
CN4106500000000,41,065,"Wasco County, OR",Mar-22,13163,12601,562,4.30000000
CN4106700000000,41,067,"Washington County, OR",Mar-22,339253,328612,10641,3.10000000
CN4106900000000,41,069,"Wheeler County, OR",Mar-22,724,702,22,3.00000000
CN4107100000000,41,071,"Yamhill County, OR",Mar-22,57114,55113,2001,3.50000000
CN4200100000000,42,001,"Adams County, PA",Mar-22,54738,53103,1635,3.00000000
CN4200300000000,42,003,"Allegheny County, PA",Mar-22,627314,600358,26956,4.30000000
CN4200500000000,42,005,"Armstrong County, PA",Mar-22,30965,29187,1778,5.70000000
CN4200700000000,42,007,"Beaver County, PA",Mar-22,81361,76855,4506,5.50000000
CN4200900000000,42,009,"Bedford County, PA",Mar-22,23384,22275,1109,4.70000000
CN4201100000000,42,011,"Berks County, PA",Mar-22,209084,199304,9780,4.70000000
CN4201300000000,42,013,"Blair County, PA",Mar-22,58974,56372,2602,4.40000000
CN4201500000000,42,015,"Bradford County, PA",Mar-22,27414,26200,1214,4.40000000
CN4201700000000,42,017,"Bucks County, PA",Mar-22,344497,331425,13072,3.80000000
CN4201900000000,42,019,"Butler County, PA",Mar-22,97776,93686,4090,4.20000000
CN4202100000000,42,021,"Cambria County, PA",Mar-22,55580,52594,2986,5.40000000
CN4202300000000,42,023,"Cameron County, PA",Mar-22,1946,1823,123,6.30000000
CN4202500000000,42,025,"Carbon County, PA",Mar-22,32474,30780,1694,5.20000000
CN4202700000000,42,027,"Centre County, PA",Mar-22,77785,75205,2580,3.30000000
CN4202900000000,42,029,"Chester County, PA",Mar-22,287189,278672,8517,3.00000000
CN4203100000000,42,031,"Clarion County, PA",Mar-22,16585,15714,871,5.30000000
CN4203300000000,42,033,"Clearfield County, PA",Mar-22,35180,33170,2010,5.70000000
CN4203500000000,42,035,"Clinton County, PA",Mar-22,17065,16098,967,5.70000000
CN4203700000000,42,037,"Columbia County, PA",Mar-22,33498,31996,1502,4.50000000
CN4203900000000,42,039,"Crawford County, PA",Mar-22,36983,35106,1877,5.10000000
CN4204100000000,42,041,"Cumberland County, PA",Mar-22,135014,130780,4234,3.10000000
CN4204300000000,42,043,"Dauphin County, PA",Mar-22,146900,140950,5950,4.10000000
CN4204500000000,42,045,"Delaware County, PA",Mar-22,295863,283009,12854,4.30000000
CN4204700000000,42,047,"Elk County, PA",Mar-22,14669,13913,756,5.20000000
CN4204900000000,42,049,"Erie County, PA",Mar-22,126859,119791,7068,5.60000000
CN4205100000000,42,051,"Fayette County, PA",Mar-22,54955,51246,3709,6.70000000
CN4205300000000,42,053,"Forest County, PA",Mar-22,1679,1570,109,6.50000000
CN4205500000000,42,055,"Franklin County, PA",Mar-22,76658,73969,2689,3.50000000
CN4205700000000,42,057,"Fulton County, PA",Mar-22,6980,6657,323,4.60000000
CN4205900000000,42,059,"Greene County, PA",Mar-22,15469,14610,859,5.60000000
CN4206100000000,42,061,"Huntingdon County, PA",Mar-22,18920,17781,1139,6.00000000
CN4206300000000,42,063,"Indiana County, PA",Mar-22,36536,34539,1997,5.50000000
CN4206500000000,42,065,"Jefferson County, PA",Mar-22,19295,18308,987,5.10000000
CN4206700000000,42,067,"Juniata County, PA",Mar-22,12418,11917,501,4.00000000
CN4206900000000,42,069,"Lackawanna County, PA",Mar-22,103693,98438,5255,5.10000000
CN4207100000000,42,071,"Lancaster County, PA",Mar-22,281621,272039,9582,3.40000000
CN4207300000000,42,073,"Lawrence County, PA",Mar-22,39032,36549,2483,6.40000000
CN4207500000000,42,075,"Lebanon County, PA",Mar-22,72660,69959,2701,3.70000000
CN4207700000000,42,077,"Lehigh County, PA",Mar-22,197521,188098,9423,4.80000000
CN4207900000000,42,079,"Luzerne County, PA",Mar-22,156830,147251,9579,6.10000000
CN4208100000000,42,081,"Lycoming County, PA",Mar-22,54982,52186,2796,5.10000000
CN4208300000000,42,083,"McKean County, PA",Mar-22,16493,15576,917,5.60000000
CN4208500000000,42,085,"Mercer County, PA",Mar-22,47247,44741,2506,5.30000000
CN4208700000000,42,087,"Mifflin County, PA",Mar-22,20480,19511,969,4.70000000
CN4208900000000,42,089,"Monroe County, PA",Mar-22,82727,77683,5044,6.10000000
CN4209100000000,42,091,"Montgomery County, PA",Mar-22,458201,442701,15500,3.40000000
CN4209300000000,42,093,"Montour County, PA",Mar-22,9067,8796,271,3.00000000
CN4209500000000,42,095,"Northampton County, PA",Mar-22,163858,156933,6925,4.20000000
CN4209700000000,42,097,"Northumberland County, PA",Mar-22,41021,38793,2228,5.40000000
CN4209900000000,42,099,"Perry County, PA",Mar-22,24538,23701,837,3.40000000
CN4210100000000,42,101,"Philadelphia County/city, PA",Mar-22,725099,679776,45323,6.30000000
CN4210300000000,42,103,"Pike County, PA",Mar-22,25490,23924,1566,6.10000000
CN4210500000000,42,105,"Potter County, PA",Mar-22,6944,6494,450,6.50000000
CN4210700000000,42,107,"Schuylkill County, PA",Mar-22,64259,60975,3284,5.10000000
CN4210900000000,42,109,"Snyder County, PA",Mar-22,19365,18577,788,4.10000000
CN4211100000000,42,111,"Somerset County, PA",Mar-22,32200,30365,1835,5.70000000
CN4211300000000,42,113,"Sullivan County, PA",Mar-22,2500,2349,151,6.00000000
CN4211500000000,42,115,"Susquehanna County, PA",Mar-22,19866,18974,892,4.50000000
CN4211700000000,42,117,"Tioga County, PA",Mar-22,18565,17569,996,5.40000000
CN4211900000000,42,119,"Union County, PA",Mar-22,19366,18660,706,3.60000000
CN4212100000000,42,121,"Venango County, PA",Mar-22,21018,19912,1106,5.30000000
CN4212300000000,42,123,"Warren County, PA",Mar-22,17320,16448,872,5.00000000
CN4212500000000,42,125,"Washington County, PA",Mar-22,104109,99010,5099,4.90000000
CN4212700000000,42,127,"Wayne County, PA",Mar-22,21807,20539,1268,5.80000000
CN4212900000000,42,129,"Westmoreland County, PA",Mar-22,174442,166189,8253,4.70000000
CN4213100000000,42,131,"Wyoming County, PA",Mar-22,13276,12576,700,5.30000000
CN4213300000000,42,133,"York County, PA",Mar-22,235869,227305,8564,3.60000000
CN4400100000000,44,001,"Bristol County, RI",Mar-22,26527,25927,600,2.30000000
CN4400300000000,44,003,"Kent County, RI",Mar-22,93731,91245,2486,2.70000000
CN4400500000000,44,005,"Newport County, RI",Mar-22,45197,43993,1204,2.70000000
CN4400700000000,44,007,"Providence County, RI",Mar-22,334675,323913,10762,3.20000000
CN4400900000000,44,009,"Washington County, RI",Mar-22,69797,67968,1829,2.60000000
CN4500100000000,45,001,"Abbeville County, SC",Mar-22,9726,9368,358,3.70000000
CN4500300000000,45,003,"Aiken County, SC",Mar-22,74898,72632,2266,3.00000000
CN4500500000000,45,005,"Allendale County, SC",Mar-22,2414,2251,163,6.80000000
CN4500700000000,45,007,"Anderson County, SC",Mar-22,92232,89559,2673,2.90000000
CN4500900000000,45,009,"Bamberg County, SC",Mar-22,4642,4358,284,6.10000000
CN4501100000000,45,011,"Barnwell County, SC",Mar-22,7593,7173,420,5.50000000
CN4501300000000,45,013,"Beaufort County, SC",Mar-22,76844,74508,2336,3.00000000
CN4501500000000,45,015,"Berkeley County, SC",Mar-22,110038,106812,3226,2.90000000
CN4501700000000,45,017,"Calhoun County, SC",Mar-22,6359,6137,222,3.50000000
CN4501900000000,45,019,"Charleston County, SC",Mar-22,216169,210004,6165,2.90000000
CN4502100000000,45,021,"Cherokee County, SC",Mar-22,25264,24248,1016,4.00000000
CN4502300000000,45,023,"Chester County, SC",Mar-22,13552,12889,663,4.90000000
CN4502500000000,45,025,"Chesterfield County, SC",Mar-22,21814,20990,824,3.80000000
CN4502700000000,45,027,"Clarendon County, SC",Mar-22,12400,11905,495,4.00000000
CN4502900000000,45,029,"Colleton County, SC",Mar-22,16366,15789,577,3.50000000
CN4503100000000,45,031,"Darlington County, SC",Mar-22,29637,28554,1083,3.70000000
CN4503300000000,45,033,"Dillon County, SC",Mar-22,13196,12534,662,5.00000000
CN4503500000000,45,035,"Dorchester County, SC",Mar-22,79836,77562,2274,2.80000000
CN4503700000000,45,037,"Edgefield County, SC",Mar-22,10478,10171,307,2.90000000
CN4503900000000,45,039,"Fairfield County, SC",Mar-22,9225,8718,507,5.50000000
CN4504100000000,45,041,"Florence County, SC",Mar-22,65577,63385,2192,3.30000000
CN4504300000000,45,043,"Georgetown County, SC",Mar-22,26164,25110,1054,4.00000000
CN4504500000000,45,045,"Greenville County, SC",Mar-22,262358,255059,7299,2.80000000
CN4504700000000,45,047,"Greenwood County, SC",Mar-22,30654,29551,1103,3.60000000
CN4504900000000,45,049,"Hampton County, SC",Mar-22,8046,7816,230,2.90000000
CN4505100000000,45,051,"Horry County, SC",Mar-22,151175,144754,6421,4.20000000
CN4505300000000,45,053,"Jasper County, SC",Mar-22,13199,12809,390,3.00000000
CN4505500000000,45,055,"Kershaw County, SC",Mar-22,29115,28177,938,3.20000000
CN4505700000000,45,057,"Lancaster County, SC",Mar-22,44030,42348,1682,3.80000000
CN4505900000000,45,059,"Laurens County, SC",Mar-22,30394,29342,1052,3.50000000
CN4506100000000,45,061,"Lee County, SC",Mar-22,6578,6260,318,4.80000000
CN4506300000000,45,063,"Lexington County, SC",Mar-22,149834,145845,3989,2.70000000
CN4506500000000,45,065,"McCormick County, SC",Mar-22,3328,3196,132,4.00000000
CN4506700000000,45,067,"Marion County, SC",Mar-22,12970,12218,752,5.80000000
CN4506900000000,45,069,"Marlboro County, SC",Mar-22,8993,8335,658,7.30000000
CN4507100000000,45,071,"Newberry County, SC",Mar-22,19303,18786,517,2.70000000
CN4507300000000,45,073,"Oconee County, SC",Mar-22,34232,33182,1050,3.10000000
CN4507500000000,45,075,"Orangeburg County, SC",Mar-22,33901,31901,2000,5.90000000
CN4507700000000,45,077,"Pickens County, SC",Mar-22,58352,56667,1685,2.90000000
CN4507900000000,45,079,"Richland County, SC",Mar-22,195523,189013,6510,3.30000000
CN4508100000000,45,081,"Saluda County, SC",Mar-22,8377,8144,233,2.80000000
CN4508300000000,45,083,"Spartanburg County, SC",Mar-22,158446,153561,4885,3.10000000
CN4508500000000,45,085,"Sumter County, SC",Mar-22,42361,40746,1615,3.80000000
CN4508700000000,45,087,"Union County, SC",Mar-22,11580,10966,614,5.30000000
CN4508900000000,45,089,"Williamsburg County, SC",Mar-22,10976,10414,562,5.10000000
CN4509100000000,45,091,"York County, SC",Mar-22,149442,144535,4907,3.30000000
CN4600300000000,46,003,"Aurora County, SD",Mar-22,1521,1488,33,2.20000000
CN4600500000000,46,005,"Beadle County, SD",Mar-22,9356,9132,224,2.40000000
CN4600700000000,46,007,"Bennett County, SD",Mar-22,1056,1018,38,3.60000000
CN4600900000000,46,009,"Bon Homme County, SD",Mar-22,2902,2835,67,2.30000000
CN4601100000000,46,011,"Brookings County, SD",Mar-22,19136,18725,411,2.10000000
CN4601300000000,46,013,"Brown County, SD",Mar-22,20488,19910,578,2.80000000
CN4601500000000,46,015,"Brule County, SD",Mar-22,2634,2588,46,1.70000000
CN4601700000000,46,017,"Buffalo County, SD",Mar-22,670,649,21,3.10000000
CN4601900000000,46,019,"Butte County, SD",Mar-22,5002,4883,119,2.40000000
CN4602100000000,46,021,"Campbell County, SD",Mar-22,795,766,29,3.60000000
CN4602300000000,46,023,"Charles Mix County, SD",Mar-22,3848,3754,94,2.40000000
CN4602500000000,46,025,"Clark County, SD",Mar-22,1980,1909,71,3.60000000
CN4602700000000,46,027,"Clay County, SD",Mar-22,7691,7540,151,2.00000000
CN4602900000000,46,029,"Codington County, SD",Mar-22,15963,15515,448,2.80000000
CN4603100000000,46,031,"Corson County, SD",Mar-22,1350,1315,35,2.60000000
CN4603300000000,46,033,"Custer County, SD",Mar-22,4220,4063,157,3.70000000
CN4603500000000,46,035,"Davison County, SD",Mar-22,11142,10886,256,2.30000000
CN4603700000000,46,037,"Day County, SD",Mar-22,2705,2565,140,5.20000000
CN4603900000000,46,039,"Deuel County, SD",Mar-22,2285,2187,98,4.30000000
CN4604100000000,46,041,"Dewey County, SD",Mar-22,2290,2188,102,4.50000000
CN4604300000000,46,043,"Douglas County, SD",Mar-22,1605,1567,38,2.40000000
CN4604500000000,46,045,"Edmunds County, SD",Mar-22,2066,2015,51,2.50000000
CN4604700000000,46,047,"Fall River County, SD",Mar-22,3100,3009,91,2.90000000
CN4604900000000,46,049,"Faulk County, SD",Mar-22,1116,1095,21,1.90000000
CN4605100000000,46,051,"Grant County, SD",Mar-22,4515,4331,184,4.10000000
CN4605300000000,46,053,"Gregory County, SD",Mar-22,2134,2088,46,2.20000000
CN4605500000000,46,055,"Haakon County, SD",Mar-22,1087,1058,29,2.70000000
CN4605700000000,46,057,"Hamlin County, SD",Mar-22,3570,3478,92,2.60000000
CN4605900000000,46,059,"Hand County, SD",Mar-22,1796,1759,37,2.10000000
CN4606100000000,46,061,"Hanson County, SD",Mar-22,1844,1771,73,4.00000000
CN4606300000000,46,063,"Harding County, SD",Mar-22,757,740,17,2.20000000
CN4606500000000,46,065,"Hughes County, SD",Mar-22,9862,9643,219,2.20000000
CN4606700000000,46,067,"Hutchinson County, SD",Mar-22,3739,3614,125,3.30000000
CN4606900000000,46,069,"Hyde County, SD",Mar-22,693,677,16,2.30000000
CN4607100000000,46,071,"Jackson County, SD",Mar-22,1201,1153,48,4.00000000
CN4607300000000,46,073,"Jerauld County, SD",Mar-22,1420,1399,21,1.50000000
CN4607500000000,46,075,"Jones County, SD",Mar-22,508,489,19,3.70000000
CN4607700000000,46,077,"Kingsbury County, SD",Mar-22,2847,2771,76,2.70000000
CN4607900000000,46,079,"Lake County, SD",Mar-22,6595,6447,148,2.20000000
CN4608100000000,46,081,"Lawrence County, SD",Mar-22,13842,13567,275,2.00000000
CN4608300000000,46,083,"Lincoln County, SD",Mar-22,37185,36437,748,2.00000000
CN4608500000000,46,085,"Lyman County, SD",Mar-22,1654,1603,51,3.10000000
CN4608700000000,46,087,"McCook County, SD",Mar-22,3127,3063,64,2.00000000
CN4608900000000,46,089,"McPherson County, SD",Mar-22,1018,991,27,2.70000000
CN4609100000000,46,091,"Marshall County, SD",Mar-22,2484,2382,102,4.10000000
CN4609300000000,46,093,"Meade County, SD",Mar-22,14173,13819,354,2.50000000
CN4609500000000,46,095,"Mellette County, SD",Mar-22,777,755,22,2.80000000
CN4609700000000,46,097,"Miner County, SD",Mar-22,1217,1192,25,2.10000000
CN4609900000000,46,099,"Minnehaha County, SD",Mar-22,115629,112822,2807,2.40000000
CN4610100000000,46,101,"Moody County, SD",Mar-22,4081,3975,106,2.60000000
CN4610200000000,46,102,"Oglala Lakota County, SD",Mar-22,3685,3464,221,6.00000000
CN4610300000000,46,103,"Pennington County, SD",Mar-22,58266,56860,1406,2.40000000
CN4610500000000,46,105,"Perkins County, SD",Mar-22,1457,1422,35,2.40000000
CN4610700000000,46,107,"Potter County, SD",Mar-22,1059,1026,33,3.10000000
CN4610900000000,46,109,"Roberts County, SD",Mar-22,4707,4464,243,5.20000000
CN4611100000000,46,111,"Sanborn County, SD",Mar-22,1267,1230,37,2.90000000
CN4611500000000,46,115,"Spink County, SD",Mar-22,3193,3087,106,3.30000000
CN4611700000000,46,117,"Stanley County, SD",Mar-22,1959,1903,56,2.90000000
CN4611900000000,46,119,"Sully County, SD",Mar-22,842,826,16,1.90000000
CN4612100000000,46,121,"Todd County, SD",Mar-22,3021,2902,119,3.90000000
CN4612300000000,46,123,"Tripp County, SD",Mar-22,3148,3086,62,2.00000000
CN4612500000000,46,125,"Turner County, SD",Mar-22,4763,4661,102,2.10000000
CN4612700000000,46,127,"Union County, SD",Mar-22,8752,8530,222,2.50000000
CN4612900000000,46,129,"Walworth County, SD",Mar-22,2151,2037,114,5.30000000
CN4613500000000,46,135,"Yankton County, SD",Mar-22,11623,11382,241,2.10000000
CN4613700000000,46,137,"Ziebach County, SD",Mar-22,965,935,30,3.10000000
CN4700100000000,47,001,"Anderson County, TN",Mar-22,35732,34739,993,2.80000000
CN4700300000000,47,003,"Bedford County, TN",Mar-22,21631,21012,619,2.90000000
CN4700500000000,47,005,"Benton County, TN",Mar-22,6863,6620,243,3.50000000
CN4700700000000,47,007,"Bledsoe County, TN",Mar-22,4303,4117,186,4.30000000
CN4700900000000,47,009,"Blount County, TN",Mar-22,66329,64598,1731,2.60000000
CN4701100000000,47,011,"Bradley County, TN",Mar-22,50806,49275,1531,3.00000000
CN4701300000000,47,013,"Campbell County, TN",Mar-22,15104,14588,516,3.40000000
CN4701500000000,47,015,"Cannon County, TN",Mar-22,6901,6730,171,2.50000000
CN4701700000000,47,017,"Carroll County, TN",Mar-22,11442,11065,377,3.30000000
CN4701900000000,47,019,"Carter County, TN",Mar-22,24483,23723,760,3.10000000
CN4702100000000,47,021,"Cheatham County, TN",Mar-22,22792,22251,541,2.40000000
CN4702300000000,47,023,"Chester County, TN",Mar-22,8565,8369,196,2.30000000
CN4702500000000,47,025,"Claiborne County, TN",Mar-22,13012,12617,395,3.00000000
CN4702700000000,47,027,"Clay County, TN",Mar-22,2780,2662,118,4.20000000
CN4702900000000,47,029,"Cocke County, TN",Mar-22,14850,14087,763,5.10000000
CN4703100000000,47,031,"Coffee County, TN",Mar-22,25131,24400,731,2.90000000
CN4703300000000,47,033,"Crockett County, TN",Mar-22,6843,6650,193,2.80000000
CN4703500000000,47,035,"Cumberland County, TN",Mar-22,22484,21679,805,3.60000000
CN4703700000000,47,037,"Davidson County, TN",Mar-22,417951,406782,11169,2.70000000
CN4703900000000,47,039,"Decatur County, TN",Mar-22,4255,4077,178,4.20000000
CN4704100000000,47,041,"DeKalb County, TN",Mar-22,7852,7594,258,3.30000000
CN4704300000000,47,043,"Dickson County, TN",Mar-22,28138,27443,695,2.50000000
CN4704500000000,47,045,"Dyer County, TN",Mar-22,16053,15539,514,3.20000000
CN4704700000000,47,047,"Fayette County, TN",Mar-22,19523,18916,607,3.10000000
CN4704900000000,47,049,"Fentress County, TN",Mar-22,7523,7279,244,3.20000000
CN4705100000000,47,051,"Franklin County, TN",Mar-22,19571,19027,544,2.80000000
CN4705300000000,47,053,"Gibson County, TN",Mar-22,21472,20809,663,3.10000000
CN4705500000000,47,055,"Giles County, TN",Mar-22,14806,14369,437,3.00000000
CN4705700000000,47,057,"Grainger County, TN",Mar-22,9783,9480,303,3.10000000
CN4705900000000,47,059,"Greene County, TN",Mar-22,28898,27969,929,3.20000000
CN4706100000000,47,061,"Grundy County, TN",Mar-22,5100,4897,203,4.00000000
CN4706300000000,47,063,"Hamblen County, TN",Mar-22,28462,27585,877,3.10000000
CN4706500000000,47,065,"Hamilton County, TN",Mar-22,185515,180230,5285,2.80000000
CN4706700000000,47,067,"Hancock County, TN",Mar-22,2294,2209,85,3.70000000
CN4706900000000,47,069,"Hardeman County, TN",Mar-22,8826,8441,385,4.40000000
CN4707100000000,47,071,"Hardin County, TN",Mar-22,10102,9756,346,3.40000000
CN4707300000000,47,073,"Hawkins County, TN",Mar-22,23430,22671,759,3.20000000
CN4707500000000,47,075,"Haywood County, TN",Mar-22,7604,7291,313,4.10000000
CN4707700000000,47,077,"Henderson County, TN",Mar-22,11958,11593,365,3.10000000
CN4707900000000,47,079,"Henry County, TN",Mar-22,14337,13853,484,3.40000000
CN4708100000000,47,081,"Hickman County, TN",Mar-22,11804,11519,285,2.40000000
CN4708300000000,47,083,"Houston County, TN",Mar-22,3212,3097,115,3.60000000
CN4708500000000,47,085,"Humphreys County, TN",Mar-22,8764,8516,248,2.80000000
CN4708700000000,47,087,"Jackson County, TN",Mar-22,4830,4680,150,3.10000000
CN4708900000000,47,089,"Jefferson County, TN",Mar-22,25307,24513,794,3.10000000
CN4709100000000,47,091,"Johnson County, TN",Mar-22,7784,7571,213,2.70000000
CN4709300000000,47,093,"Knox County, TN",Mar-22,254309,248295,6014,2.40000000
CN4709500000000,47,095,"Lake County, TN",Mar-22,1641,1563,78,4.80000000
CN4709700000000,47,097,"Lauderdale County, TN",Mar-22,9617,9208,409,4.30000000
CN4709900000000,47,099,"Lawrence County, TN",Mar-22,19673,19114,559,2.80000000
CN4710100000000,47,101,"Lewis County, TN",Mar-22,5660,5488,172,3.00000000
CN4710300000000,47,103,"Lincoln County, TN",Mar-22,16189,15706,483,3.00000000
CN4710500000000,47,105,"Loudon County, TN",Mar-22,24589,23928,661,2.70000000
CN4710700000000,47,107,"McMinn County, TN",Mar-22,22141,21409,732,3.30000000
CN4710900000000,47,109,"McNairy County, TN",Mar-22,8217,7899,318,3.90000000
CN4711100000000,47,111,"Macon County, TN",Mar-22,11634,11343,291,2.50000000
CN4711300000000,47,113,"Madison County, TN",Mar-22,49564,48043,1521,3.10000000
CN4711500000000,47,115,"Marion County, TN",Mar-22,12404,12016,388,3.10000000
CN4711700000000,47,117,"Marshall County, TN",Mar-22,15603,15162,441,2.80000000
CN4711900000000,47,119,"Maury County, TN",Mar-22,53500,52009,1491,2.80000000
CN4712100000000,47,121,"Meigs County, TN",Mar-22,5207,5021,186,3.60000000
CN4712300000000,47,123,"Monroe County, TN",Mar-22,21117,20550,567,2.70000000
CN4712500000000,47,125,"Montgomery County, TN",Mar-22,89612,86716,2896,3.20000000
CN4712700000000,47,127,"Moore County, TN",Mar-22,3638,3570,68,1.90000000
CN4712900000000,47,129,"Morgan County, TN",Mar-22,7924,7674,250,3.20000000
CN4713100000000,47,131,"Obion County, TN",Mar-22,12368,11956,412,3.30000000
CN4713300000000,47,133,"Overton County, TN",Mar-22,10104,9827,277,2.70000000
CN4713500000000,47,135,"Perry County, TN",Mar-22,2808,2662,146,5.20000000
CN4713700000000,47,137,"Pickett County, TN",Mar-22,2199,2131,68,3.10000000
CN4713900000000,47,139,"Polk County, TN",Mar-22,7114,6890,224,3.10000000
CN4714100000000,47,141,"Putnam County, TN",Mar-22,35787,34807,980,2.70000000
CN4714300000000,47,143,"Rhea County, TN",Mar-22,14054,13583,471,3.40000000
CN4714500000000,47,145,"Roane County, TN",Mar-22,24011,23294,717,3.00000000
CN4714700000000,47,147,"Robertson County, TN",Mar-22,39447,38507,940,2.40000000
CN4714900000000,47,149,"Rutherford County, TN",Mar-22,197589,192946,4643,2.30000000
CN4715100000000,47,151,"Scott County, TN",Mar-22,8087,7735,352,4.40000000
CN4715300000000,47,153,"Sequatchie County, TN",Mar-22,6216,6005,211,3.40000000
CN4715500000000,47,155,"Sevier County, TN",Mar-22,56297,54719,1578,2.80000000
CN4715700000000,47,157,"Shelby County, TN",Mar-22,450382,429469,20913,4.60000000
CN4715900000000,47,159,"Smith County, TN",Mar-22,9809,9561,248,2.50000000
CN4716100000000,47,161,"Stewart County, TN",Mar-22,5430,5253,177,3.30000000
CN4716300000000,47,163,"Sullivan County, TN",Mar-22,69704,67612,2092,3.00000000
CN4716500000000,47,165,"Sumner County, TN",Mar-22,109751,107162,2589,2.40000000
CN4716700000000,47,167,"Tipton County, TN",Mar-22,28122,27265,857,3.00000000
CN4716900000000,47,169,"Trousdale County, TN",Mar-22,5763,5616,147,2.60000000
CN4717100000000,47,171,"Unicoi County, TN",Mar-22,7147,6881,266,3.70000000
CN4717300000000,47,173,"Union County, TN",Mar-22,7916,7677,239,3.00000000
CN4717500000000,47,175,"Van Buren County, TN",Mar-22,2096,2019,77,3.70000000
CN4717700000000,47,177,"Warren County, TN",Mar-22,16536,15975,561,3.40000000
CN4717900000000,47,179,"Washington County, TN",Mar-22,62471,60842,1629,2.60000000
CN4718100000000,47,181,"Wayne County, TN",Mar-22,6356,6114,242,3.80000000
CN4718300000000,47,183,"Weakley County, TN",Mar-22,15639,15234,405,2.60000000
CN4718500000000,47,185,"White County, TN",Mar-22,11714,11371,343,2.90000000
CN4718700000000,47,187,"Williamson County, TN",Mar-22,139102,136449,2653,1.90000000
CN4718900000000,47,189,"Wilson County, TN",Mar-22,82634,80797,1837,2.20000000
CN4800100000000,48,001,"Anderson County, TX",Mar-22,23428,22673,755,3.20000000
CN4800300000000,48,003,"Andrews County, TX",Mar-22,9009,8672,337,3.70000000
CN4800500000000,48,005,"Angelina County, TX",Mar-22,35730,34088,1642,4.60000000
CN4800700000000,48,007,"Aransas County, TX",Mar-22,9368,8873,495,5.30000000
CN4800900000000,48,009,"Archer County, TX",Mar-22,4067,3942,125,3.10000000
CN4801100000000,48,011,"Armstrong County, TX",Mar-22,963,940,23,2.40000000
CN4801300000000,48,013,"Atascosa County, TX",Mar-22,22356,21421,935,4.20000000
CN4801500000000,48,015,"Austin County, TX",Mar-22,14061,13529,532,3.80000000
CN4801700000000,48,017,"Bailey County, TX",Mar-22,2545,2456,89,3.50000000
CN4801900000000,48,019,"Bandera County, TX",Mar-22,10492,10147,345,3.30000000
CN4802100000000,48,021,"Bastrop County, TX",Mar-22,46961,45508,1453,3.10000000
CN4802300000000,48,023,"Baylor County, TX",Mar-22,1889,1840,49,2.60000000
CN4802500000000,48,025,"Bee County, TX",Mar-22,9199,8623,576,6.30000000
CN4802700000000,48,027,"Bell County, TX",Mar-22,149456,143338,6118,4.10000000
CN4802900000000,48,029,"Bexar County, TX",Mar-22,960301,925986,34315,3.60000000
CN4803100000000,48,031,"Blanco County, TX",Mar-22,7135,6955,180,2.50000000
CN4803300000000,48,033,"Borden County, TX",Mar-22,714,700,14,2.00000000
CN4803500000000,48,035,"Bosque County, TX",Mar-22,8788,8495,293,3.30000000
CN4803700000000,48,037,"Bowie County, TX",Mar-22,39587,37873,1714,4.30000000
CN4803900000000,48,039,"Brazoria County, TX",Mar-22,182945,174103,8842,4.80000000
CN4804100000000,48,041,"Brazos County, TX",Mar-22,125825,122331,3494,2.80000000
CN4804300000000,48,043,"Brewster County, TX",Mar-22,4254,4118,136,3.20000000
CN4804500000000,48,045,"Briscoe County, TX",Mar-22,619,600,19,3.10000000
CN4804700000000,48,047,"Brooks County, TX",Mar-22,2530,2368,162,6.40000000
CN4804900000000,48,049,"Brown County, TX",Mar-22,15272,14687,585,3.80000000
CN4805100000000,48,051,"Burleson County, TX",Mar-22,8741,8452,289,3.30000000
CN4805300000000,48,053,"Burnet County, TX",Mar-22,25242,24568,674,2.70000000
CN4805500000000,48,055,"Caldwell County, TX",Mar-22,20734,20068,666,3.20000000
CN4805700000000,48,057,"Calhoun County, TX",Mar-22,12551,12137,414,3.30000000
CN4805900000000,48,059,"Callahan County, TX",Mar-22,6222,6017,205,3.30000000
CN4806100000000,48,061,"Cameron County, TX",Mar-22,177539,166740,10799,6.10000000
CN4806300000000,48,063,"Camp County, TX",Mar-22,5288,5070,218,4.10000000
CN4806500000000,48,065,"Carson County, TX",Mar-22,3088,3004,84,2.70000000
CN4806700000000,48,067,"Cass County, TX",Mar-22,12489,11913,576,4.60000000
CN4806900000000,48,069,"Castro County, TX",Mar-22,3635,3544,91,2.50000000
CN4807100000000,48,071,"Chambers County, TX",Mar-22,20882,19660,1222,5.90000000
CN4807300000000,48,073,"Cherokee County, TX",Mar-22,21076,20145,931,4.40000000
CN4807500000000,48,075,"Childress County, TX",Mar-22,3031,2943,88,2.90000000
CN4807700000000,48,077,"Clay County, TX",Mar-22,4943,4777,166,3.40000000
CN4807900000000,48,079,"Cochran County, TX",Mar-22,1184,1127,57,4.80000000
CN4808100000000,48,081,"Coke County, TX",Mar-22,1366,1318,48,3.50000000
CN4808300000000,48,083,"Coleman County, TX",Mar-22,2985,2864,121,4.10000000
CN4808500000000,48,085,"Collin County, TX",Mar-22,621649,603432,18217,2.90000000
CN4808700000000,48,087,"Collingsworth County, TX",Mar-22,1144,1113,31,2.70000000
CN4808900000000,48,089,"Colorado County, TX",Mar-22,10199,9855,344,3.40000000
CN4809100000000,48,091,"Comal County, TX",Mar-22,80662,78130,2532,3.10000000
CN4809300000000,48,093,"Comanche County, TX",Mar-22,6403,6209,194,3.00000000
CN4809500000000,48,095,"Concho County, TX",Mar-22,1484,1445,39,2.60000000
CN4809700000000,48,097,"Cooke County, TX",Mar-22,19707,19088,619,3.10000000
CN4809900000000,48,099,"Coryell County, TX",Mar-22,24713,23695,1018,4.10000000
CN4810100000000,48,101,"Cottle County, TX",Mar-22,634,615,19,3.00000000
CN4810300000000,48,103,"Crane County, TX",Mar-22,1580,1481,99,6.30000000
CN4810500000000,48,105,"Crockett County, TX",Mar-22,1433,1369,64,4.50000000
CN4810700000000,48,107,"Crosby County, TX",Mar-22,2547,2455,92,3.60000000
CN4810900000000,48,109,"Culberson County, TX",Mar-22,1085,1054,31,2.90000000
CN4811100000000,48,111,"Dallam County, TX",Mar-22,3943,3873,70,1.80000000
CN4811300000000,48,113,"Dallas County, TX",Mar-22,1414711,1362991,51720,3.70000000
CN4811500000000,48,115,"Dawson County, TX",Mar-22,4717,4501,216,4.60000000
CN4811700000000,48,117,"Deaf Smith County, TX",Mar-22,9380,9142,238,2.50000000
CN4811900000000,48,119,"Delta County, TX",Mar-22,2501,2412,89,3.60000000
CN4812100000000,48,121,"Denton County, TX",Mar-22,548046,532013,16033,2.90000000
CN4812300000000,48,123,"DeWitt County, TX",Mar-22,9740,9439,301,3.10000000
CN4812500000000,48,125,"Dickens County, TX",Mar-22,745,720,25,3.40000000
CN4812700000000,48,127,"Dimmit County, TX",Mar-22,5744,5530,214,3.70000000
CN4812900000000,48,129,"Donley County, TX",Mar-22,1506,1464,42,2.80000000
CN4813100000000,48,131,"Duval County, TX",Mar-22,5537,5238,299,5.40000000
CN4813300000000,48,133,"Eastland County, TX",Mar-22,7325,7036,289,3.90000000
CN4813500000000,48,135,"Ector County, TX",Mar-22,81369,77227,4142,5.10000000
CN4813700000000,48,137,"Edwards County, TX",Mar-22,1269,1233,36,2.80000000
CN4813900000000,48,139,"Ellis County, TX",Mar-22,102701,99490,3211,3.10000000
CN4814100000000,48,141,"El Paso County, TX",Mar-22,364193,348354,15839,4.30000000
CN4814300000000,48,143,"Erath County, TX",Mar-22,21875,21236,639,2.90000000
CN4814500000000,48,145,"Falls County, TX",Mar-22,6860,6608,252,3.70000000
CN4814700000000,48,147,"Fannin County, TX",Mar-22,17536,17031,505,2.90000000
CN4814900000000,48,149,"Fayette County, TX",Mar-22,11978,11609,369,3.10000000
CN4815100000000,48,151,"Fisher County, TX",Mar-22,1669,1619,50,3.00000000
CN4815300000000,48,153,"Floyd County, TX",Mar-22,2618,2516,102,3.90000000
CN4815500000000,48,155,"Foard County, TX",Mar-22,626,611,15,2.40000000
CN4815700000000,48,157,"Fort Bend County, TX",Mar-22,413875,397350,16525,4.00000000
CN4815900000000,48,159,"Franklin County, TX",Mar-22,5280,5124,156,3.00000000
CN4816100000000,48,161,"Freestone County, TX",Mar-22,6402,6053,349,5.50000000
CN4816300000000,48,163,"Frio County, TX",Mar-22,9683,9366,317,3.30000000
CN4816500000000,48,165,"Gaines County, TX",Mar-22,10180,9896,284,2.80000000
CN4816700000000,48,167,"Galveston County, TX",Mar-22,167520,159856,7664,4.60000000
CN4816900000000,48,169,"Garza County, TX",Mar-22,2000,1938,62,3.10000000
CN4817100000000,48,171,"Gillespie County, TX",Mar-22,14420,14073,347,2.40000000
CN4817300000000,48,173,"Glasscock County, TX",Mar-22,908,883,25,2.80000000
CN4817500000000,48,175,"Goliad County, TX",Mar-22,3189,3047,142,4.50000000
CN4817700000000,48,177,"Gonzales County, TX",Mar-22,10153,9877,276,2.70000000
CN4817900000000,48,179,"Gray County, TX",Mar-22,7741,7391,350,4.50000000
CN4818100000000,48,181,"Grayson County, TX",Mar-22,67173,64979,2194,3.30000000
CN4818300000000,48,183,"Gregg County, TX",Mar-22,56613,54098,2515,4.40000000
CN4818500000000,48,185,"Grimes County, TX",Mar-22,11387,10860,527,4.60000000
CN4818700000000,48,187,"Guadalupe County, TX",Mar-22,83996,81389,2607,3.10000000
CN4818900000000,48,189,"Hale County, TX",Mar-22,12256,11726,530,4.30000000
CN4819100000000,48,191,"Hall County, TX",Mar-22,1139,1100,39,3.40000000
CN4819300000000,48,193,"Hamilton County, TX",Mar-22,3849,3736,113,2.90000000
CN4819500000000,48,195,"Hansford County, TX",Mar-22,2714,2655,59,2.20000000
CN4819700000000,48,197,"Hardeman County, TX",Mar-22,1750,1692,58,3.30000000
CN4819900000000,48,199,"Hardin County, TX",Mar-22,24988,23580,1408,5.60000000
CN4820100000000,48,201,"Harris County, TX",Mar-22,2315269,2213714,101555,4.40000000
CN4820300000000,48,203,"Harrison County, TX",Mar-22,28458,27103,1355,4.80000000
CN4820500000000,48,205,"Hartley County, TX",Mar-22,2876,2832,44,1.50000000
CN4820700000000,48,207,"Haskell County, TX",Mar-22,2895,2818,77,2.70000000
CN4820900000000,48,209,"Hays County, TX",Mar-22,134688,130911,3777,2.80000000
CN4821100000000,48,211,"Hemphill County, TX",Mar-22,1582,1530,52,3.30000000
CN4821300000000,48,213,"Henderson County, TX",Mar-22,39007,37634,1373,3.50000000
CN4821500000000,48,215,"Hidalgo County, TX",Mar-22,373135,347195,25940,7.00000000
CN4821700000000,48,217,"Hill County, TX",Mar-22,17332,16742,590,3.40000000
CN4821900000000,48,219,"Hockley County, TX",Mar-22,11017,10606,411,3.70000000
CN4822100000000,48,221,"Hood County, TX",Mar-22,29721,28664,1057,3.60000000
CN4822300000000,48,223,"Hopkins County, TX",Mar-22,18258,17702,556,3.00000000
CN4822500000000,48,225,"Houston County, TX",Mar-22,10784,10417,367,3.40000000
CN4822700000000,48,227,"Howard County, TX",Mar-22,13429,12702,727,5.40000000
CN4822900000000,48,229,"Hudspeth County, TX",Mar-22,1929,1857,72,3.70000000
CN4823100000000,48,231,"Hunt County, TX",Mar-22,46598,44928,1670,3.60000000
CN4823300000000,48,233,"Hutchinson County, TX",Mar-22,8297,7916,381,4.60000000
CN4823500000000,48,235,"Irion County, TX",Mar-22,803,778,25,3.10000000
CN4823700000000,48,237,"Jack County, TX",Mar-22,3435,3304,131,3.80000000
CN4823900000000,48,239,"Jackson County, TX",Mar-22,7224,6986,238,3.30000000
CN4824100000000,48,241,"Jasper County, TX",Mar-22,12952,12055,897,6.90000000
CN4824300000000,48,243,"Jeff Davis County, TX",Mar-22,1075,1044,31,2.90000000
CN4824500000000,48,245,"Jefferson County, TX",Mar-22,101771,94715,7056,6.90000000
CN4824700000000,48,247,"Jim Hogg County, TX",Mar-22,1855,1737,118,6.40000000
CN4824900000000,48,249,"Jim Wells County, TX",Mar-22,15588,14512,1076,6.90000000
CN4825100000000,48,251,"Johnson County, TX",Mar-22,88115,85254,2861,3.20000000
CN4825300000000,48,253,"Jones County, TX",Mar-22,5843,5610,233,4.00000000
CN4825500000000,48,255,"Karnes County, TX",Mar-22,6982,6763,219,3.10000000
CN4825700000000,48,257,"Kaufman County, TX",Mar-22,74607,72083,2524,3.40000000
CN4825900000000,48,259,"Kendall County, TX",Mar-22,23478,22846,632,2.70000000
CN4826100000000,48,261,"Kenedy County, TX",Mar-22,211,202,9,4.30000000
CN4826300000000,48,263,"Kent County, TX",Mar-22,471,460,11,2.30000000
CN4826500000000,48,265,"Kerr County, TX",Mar-22,22215,21488,727,3.30000000
CN4826700000000,48,267,"Kimble County, TX",Mar-22,1984,1927,57,2.90000000
CN4826900000000,48,269,"King County, TX",Mar-22,646,642,4,0.60000000
CN4827100000000,48,271,"Kinney County, TX",Mar-22,1256,1197,59,4.70000000
CN4827300000000,48,273,"Kleberg County, TX",Mar-22,13493,12835,658,4.90000000
CN4827500000000,48,275,"Knox County, TX",Mar-22,1569,1515,54,3.40000000
CN4827700000000,48,277,"Lamar County, TX",Mar-22,24724,23734,990,4.00000000
CN4827900000000,48,279,"Lamb County, TX",Mar-22,5477,5281,196,3.60000000
CN4828100000000,48,281,"Lampasas County, TX",Mar-22,9485,9168,317,3.30000000
CN4828300000000,48,283,"La Salle County, TX",Mar-22,3963,3856,107,2.70000000
CN4828500000000,48,285,"Lavaca County, TX",Mar-22,8763,8484,279,3.20000000
CN4828700000000,48,287,"Lee County, TX",Mar-22,8942,8655,287,3.20000000
CN4828900000000,48,289,"Leon County, TX",Mar-22,6309,5987,322,5.10000000
CN4829100000000,48,291,"Liberty County, TX",Mar-22,35250,32950,2300,6.50000000
CN4829300000000,48,293,"Limestone County, TX",Mar-22,8690,8302,388,4.50000000
CN4829500000000,48,295,"Lipscomb County, TX",Mar-22,1558,1520,38,2.40000000
CN4829700000000,48,297,"Live Oak County, TX",Mar-22,4920,4692,228,4.60000000
CN4829900000000,48,299,"Llano County, TX",Mar-22,9059,8733,326,3.60000000
CN4830100000000,48,301,"Loving County, TX",Mar-22,482,478,4,0.80000000
CN4830300000000,48,303,"Lubbock County, TX",Mar-22,164039,159129,4910,3.00000000
CN4830500000000,48,305,"Lynn County, TX",Mar-22,2995,2907,88,2.90000000
CN4830700000000,48,307,"McCulloch County, TX",Mar-22,3183,3042,141,4.40000000
CN4830900000000,48,309,"McLennan County, TX",Mar-22,125653,121425,4228,3.40000000
CN4831100000000,48,311,"McMullen County, TX",Mar-22,808,792,16,2.00000000
CN4831300000000,48,313,"Madison County, TX",Mar-22,4905,4707,198,4.00000000
CN4831500000000,48,315,"Marion County, TX",Mar-22,4282,4062,220,5.10000000
CN4831700000000,48,317,"Martin County, TX",Mar-22,2755,2667,88,3.20000000
CN4831900000000,48,319,"Mason County, TX",Mar-22,1918,1860,58,3.00000000
CN4832100000000,48,321,"Matagorda County, TX",Mar-22,17209,16143,1066,6.20000000
CN4832300000000,48,323,"Maverick County, TX",Mar-22,23860,21419,2441,10.20000000
CN4832500000000,48,325,"Medina County, TX",Mar-22,22423,21654,769,3.40000000
CN4832700000000,48,327,"Menard County, TX",Mar-22,832,801,31,3.70000000
CN4832900000000,48,329,"Midland County, TX",Mar-22,101589,98032,3557,3.50000000
CN4833100000000,48,331,"Milam County, TX",Mar-22,10506,10092,414,3.90000000
CN4833300000000,48,333,"Mills County, TX",Mar-22,1977,1904,73,3.70000000
CN4833500000000,48,335,"Mitchell County, TX",Mar-22,2379,2263,116,4.90000000
CN4833700000000,48,337,"Montague County, TX",Mar-22,9466,9160,306,3.20000000
CN4833900000000,48,339,"Montgomery County, TX",Mar-22,298649,286767,11882,4.00000000
CN4834100000000,48,341,"Moore County, TX",Mar-22,11330,11066,264,2.30000000
CN4834300000000,48,343,"Morris County, TX",Mar-22,4546,4209,337,7.40000000
CN4834500000000,48,345,"Motley County, TX",Mar-22,491,471,20,4.10000000
CN4834700000000,48,347,"Nacogdoches County, TX",Mar-22,28437,27360,1077,3.80000000
CN4834900000000,48,349,"Navarro County, TX",Mar-22,23639,22766,873,3.70000000
CN4835100000000,48,351,"Newton County, TX",Mar-22,4930,4566,364,7.40000000
CN4835300000000,48,353,"Nolan County, TX",Mar-22,7216,6973,243,3.40000000
CN4835500000000,48,355,"Nueces County, TX",Mar-22,165203,156868,8335,5.00000000
CN4835700000000,48,357,"Ochiltree County, TX",Mar-22,4035,3910,125,3.10000000
CN4835900000000,48,359,"Oldham County, TX",Mar-22,969,943,26,2.70000000
CN4836100000000,48,361,"Orange County, TX",Mar-22,35004,32776,2228,6.40000000
CN4836300000000,48,363,"Palo Pinto County, TX",Mar-22,12931,12426,505,3.90000000
CN4836500000000,48,365,"Panola County, TX",Mar-22,9871,9399,472,4.80000000
CN4836700000000,48,367,"Parker County, TX",Mar-22,73953,71730,2223,3.00000000
CN4836900000000,48,369,"Parmer County, TX",Mar-22,5203,5102,101,1.90000000
CN4837100000000,48,371,"Pecos County, TX",Mar-22,5984,5682,302,5.00000000
CN4837300000000,48,373,"Polk County, TX",Mar-22,18681,17559,1122,6.00000000
CN4837500000000,48,375,"Potter County, TX",Mar-22,55140,53511,1629,3.00000000
CN4837700000000,48,377,"Presidio County, TX",Mar-22,3165,2942,223,7.00000000
CN4837900000000,48,379,"Rains County, TX",Mar-22,6631,6437,194,2.90000000
CN4838100000000,48,381,"Randall County, TX",Mar-22,76318,74410,1908,2.50000000
CN4838300000000,48,383,"Reagan County, TX",Mar-22,1642,1565,77,4.70000000
CN4838500000000,48,385,"Real County, TX",Mar-22,1122,1072,50,4.50000000
CN4838700000000,48,387,"Red River County, TX",Mar-22,5449,5206,243,4.50000000
CN4838900000000,48,389,"Reeves County, TX",Mar-22,9114,8794,320,3.50000000
CN4839100000000,48,391,"Refugio County, TX",Mar-22,3102,2955,147,4.70000000
CN4839300000000,48,393,"Roberts County, TX",Mar-22,407,392,15,3.70000000
CN4839500000000,48,395,"Robertson County, TX",Mar-22,7905,7627,278,3.50000000
CN4839700000000,48,397,"Rockwall County, TX",Mar-22,58820,57072,1748,3.00000000
CN4839900000000,48,399,"Runnels County, TX",Mar-22,4764,4631,133,2.80000000
CN4840100000000,48,401,"Rusk County, TX",Mar-22,22333,21414,919,4.10000000
CN4840300000000,48,403,"Sabine County, TX",Mar-22,4076,3792,284,7.00000000
CN4840500000000,48,405,"San Augustine County, TX",Mar-22,3041,2865,176,5.80000000
CN4840700000000,48,407,"San Jacinto County, TX",Mar-22,12058,11446,612,5.10000000
CN4840900000000,48,409,"San Patricio County, TX",Mar-22,29782,27723,2059,6.90000000
CN4841100000000,48,411,"San Saba County, TX",Mar-22,2262,2188,74,3.30000000
CN4841300000000,48,413,"Schleicher County, TX",Mar-22,1201,1156,45,3.70000000
CN4841500000000,48,415,"Scurry County, TX",Mar-22,5976,5711,265,4.40000000
CN4841700000000,48,417,"Shackelford County, TX",Mar-22,1943,1895,48,2.50000000
CN4841900000000,48,419,"Shelby County, TX",Mar-22,11785,11345,440,3.70000000
CN4842100000000,48,421,"Sherman County, TX",Mar-22,1548,1514,34,2.20000000
CN4842300000000,48,423,"Smith County, TX",Mar-22,111749,107887,3862,3.50000000
CN4842500000000,48,425,"Somervell County, TX",Mar-22,4516,4364,152,3.40000000
CN4842700000000,48,427,"Starr County, TX",Mar-22,25139,21774,3365,13.40000000
CN4842900000000,48,429,"Stephens County, TX",Mar-22,4381,4239,142,3.20000000
CN4843100000000,48,431,"Sterling County, TX",Mar-22,638,615,23,3.60000000
CN4843300000000,48,433,"Stonewall County, TX",Mar-22,610,590,20,3.30000000
CN4843500000000,48,435,"Sutton County, TX",Mar-22,1131,1066,65,5.70000000
CN4843700000000,48,437,"Swisher County, TX",Mar-22,2683,2595,88,3.30000000
CN4843900000000,48,439,"Tarrant County, TX",Mar-22,1127870,1088862,39008,3.50000000
CN4844100000000,48,441,"Taylor County, TX",Mar-22,67967,65892,2075,3.10000000
CN4844300000000,48,443,"Terrell County, TX",Mar-22,449,435,14,3.10000000
CN4844500000000,48,445,"Terry County, TX",Mar-22,4975,4774,201,4.00000000
CN4844700000000,48,447,"Throckmorton County, TX",Mar-22,1237,1214,23,1.90000000
CN4844900000000,48,449,"Titus County, TX",Mar-22,13879,13367,512,3.70000000
CN4845100000000,48,451,"Tom Green County, TX",Mar-22,54781,52980,1801,3.30000000
CN4845300000000,48,453,"Travis County, TX",Mar-22,799523,778332,21191,2.70000000
CN4845500000000,48,455,"Trinity County, TX",Mar-22,5431,5138,293,5.40000000
CN4845700000000,48,457,"Tyler County, TX",Mar-22,7673,7212,461,6.00000000
CN4845900000000,48,459,"Upshur County, TX",Mar-22,17787,17006,781,4.40000000
CN4846100000000,48,461,"Upton County, TX",Mar-22,1814,1746,68,3.70000000
CN4846300000000,48,463,"Uvalde County, TX",Mar-22,11444,11002,442,3.90000000
CN4846500000000,48,465,"Val Verde County, TX",Mar-22,22082,21111,971,4.40000000
CN4846700000000,48,467,"Van Zandt County, TX",Mar-22,27461,26597,864,3.10000000
CN4846900000000,48,469,"Victoria County, TX",Mar-22,41000,39217,1783,4.30000000
CN4847100000000,48,471,"Walker County, TX",Mar-22,23921,22841,1080,4.50000000
CN4847300000000,48,473,"Waller County, TX",Mar-22,25285,24231,1054,4.20000000
CN4847500000000,48,475,"Ward County, TX",Mar-22,6044,5773,271,4.50000000
CN4847700000000,48,477,"Washington County, TX",Mar-22,15176,14625,551,3.60000000
CN4847900000000,48,479,"Webb County, TX",Mar-22,118227,113105,5122,4.30000000
CN4848100000000,48,481,"Wharton County, TX",Mar-22,21553,20736,817,3.80000000
CN4848300000000,48,483,"Wheeler County, TX",Mar-22,2019,1933,86,4.30000000
CN4848500000000,48,485,"Wichita County, TX",Mar-22,55468,53450,2018,3.60000000
CN4848700000000,48,487,"Wilbarger County, TX",Mar-22,4905,4668,237,4.80000000
CN4848900000000,48,489,"Willacy County, TX",Mar-22,7391,6768,623,8.40000000
CN4849100000000,48,491,"Williamson County, TX",Mar-22,353969,344432,9537,2.70000000
CN4849300000000,48,493,"Wilson County, TX",Mar-22,25591,24816,775,3.00000000
CN4849500000000,48,495,"Winkler County, TX",Mar-22,3750,3547,203,5.40000000
CN4849700000000,48,497,"Wise County, TX",Mar-22,34084,32972,1112,3.30000000
CN4849900000000,48,499,"Wood County, TX",Mar-22,18100,17322,778,4.30000000
CN4850100000000,48,501,"Yoakum County, TX",Mar-22,3345,3183,162,4.80000000
CN4850300000000,48,503,"Young County, TX",Mar-22,8164,7902,262,3.20000000
CN4850500000000,48,505,"Zapata County, TX",Mar-22,4448,4068,380,8.50000000
CN4850700000000,48,507,"Zavala County, TX",Mar-22,3313,3007,306,9.20000000
CN4900100000000,49,001,"Beaver County, UT",Mar-22,2950,2882,68,2.30000000
CN4900300000000,49,003,"Box Elder County, UT",Mar-22,27560,27002,558,2.00000000
CN4900500000000,49,005,"Cache County, UT",Mar-22,71630,70427,1203,1.70000000
CN4900700000000,49,007,"Carbon County, UT",Mar-22,8569,8291,278,3.20000000
CN4900900000000,49,009,"Daggett County, UT",Mar-22,368,351,17,4.60000000
CN4901100000000,49,011,"Davis County, UT",Mar-22,182948,179535,3413,1.90000000
CN4901300000000,49,013,"Duchesne County, UT",Mar-22,7881,7612,269,3.40000000
CN4901500000000,49,015,"Emery County, UT",Mar-22,4480,4340,140,3.10000000
CN4901700000000,49,017,"Garfield County, UT",Mar-22,2552,2346,206,8.10000000
CN4901900000000,49,019,"Grand County, UT",Mar-22,6586,6369,217,3.30000000
CN4902100000000,49,021,"Iron County, UT",Mar-22,27473,26878,595,2.20000000
CN4902300000000,49,023,"Juab County, UT",Mar-22,6455,6352,103,1.60000000
CN4902500000000,49,025,"Kane County, UT",Mar-22,3989,3897,92,2.30000000
CN4902700000000,49,027,"Millard County, UT",Mar-22,6240,6121,119,1.90000000
CN4902900000000,49,029,"Morgan County, UT",Mar-22,5915,5816,99,1.70000000
CN4903100000000,49,031,"Piute County, UT",Mar-22,489,470,19,3.90000000
CN4903300000000,49,033,"Rich County, UT",Mar-22,1081,1049,32,3.00000000
CN4903500000000,49,035,"Salt Lake County, UT",Mar-22,668506,654575,13931,2.10000000
CN4903700000000,49,037,"San Juan County, UT",Mar-22,5581,5325,256,4.60000000
CN4903900000000,49,039,"Sanpete County, UT",Mar-22,13571,13260,311,2.30000000
CN4904100000000,49,041,"Sevier County, UT",Mar-22,10100,9830,270,2.70000000
CN4904300000000,49,043,"Summit County, UT",Mar-22,27284,26803,481,1.80000000
CN4904500000000,49,045,"Tooele County, UT",Mar-22,37617,36766,851,2.30000000
CN4904700000000,49,047,"Uintah County, UT",Mar-22,13751,13211,540,3.90000000
CN4904900000000,49,049,"Utah County, UT",Mar-22,347726,341592,6134,1.80000000
CN4905100000000,49,051,"Wasatch County, UT",Mar-22,17414,17061,353,2.00000000
CN4905300000000,49,053,"Washington County, UT",Mar-22,86646,84725,1921,2.20000000
CN4905500000000,49,055,"Wayne County, UT",Mar-22,1432,1358,74,5.20000000
CN4905700000000,49,057,"Weber County, UT",Mar-22,134281,131256,3025,2.30000000
CN5000100000000,50,001,"Addison County, VT",Mar-22,20526,20059,467,2.30000000
CN5000300000000,50,003,"Bennington County, VT",Mar-22,17318,16808,510,2.90000000
CN5000500000000,50,005,"Caledonia County, VT",Mar-22,14064,13666,398,2.80000000
CN5000700000000,50,007,"Chittenden County, VT",Mar-22,94426,92902,1524,1.60000000
CN5000900000000,50,009,"Essex County, VT",Mar-22,2589,2503,86,3.30000000
CN5001100000000,50,011,"Franklin County, VT",Mar-22,27278,26597,681,2.50000000
CN5001300000000,50,013,"Grand Isle County, VT",Mar-22,4055,3897,158,3.90000000
CN5001500000000,50,015,"Lamoille County, VT",Mar-22,13757,13298,459,3.30000000
CN5001700000000,50,017,"Orange County, VT",Mar-22,15418,15011,407,2.60000000
CN5001900000000,50,019,"Orleans County, VT",Mar-22,13145,12530,615,4.70000000
CN5002100000000,50,021,"Rutland County, VT",Mar-22,29398,28559,839,2.90000000
CN5002300000000,50,023,"Washington County, VT",Mar-22,33169,32471,698,2.10000000
CN5002500000000,50,025,"Windham County, VT",Mar-22,20639,20127,512,2.50000000
CN5002700000000,50,027,"Windsor County, VT",Mar-22,28791,28275,516,1.80000000
CN5100100000000,51,001,"Accomack County, VA",Mar-22,15161,14664,497,3.30000000
CN5100300000000,51,003,"Albemarle County, VA",Mar-22,56788,55436,1352,2.40000000
CN5100500000000,51,005,"Alleghany County, VA",Mar-22,6691,6489,202,3.00000000
CN5100700000000,51,007,"Amelia County, VA",Mar-22,5952,5797,155,2.60000000
CN5100900000000,51,009,"Amherst County, VA",Mar-22,14595,14193,402,2.80000000
CN5101100000000,51,011,"Appomattox County, VA",Mar-22,6988,6801,187,2.70000000
CN5101300000000,51,013,"Arlington County, VA",Mar-22,154035,150991,3044,2.00000000
CN5101500000000,51,015,"Augusta County, VA",Mar-22,36904,36055,849,2.30000000
CN5101700000000,51,017,"Bath County, VA",Mar-22,2272,2212,60,2.60000000
CN5101900000000,51,019,"Bedford County, VA",Mar-22,37951,36989,962,2.50000000
CN5102100000000,51,021,"Bland County, VA",Mar-22,2810,2736,74,2.60000000
CN5102300000000,51,023,"Botetourt County, VA",Mar-22,17164,16779,385,2.20000000
CN5102500000000,51,025,"Brunswick County, VA",Mar-22,5864,5587,277,4.70000000
CN5102700000000,51,027,"Buchanan County, VA",Mar-22,6499,6183,316,4.90000000
CN5102900000000,51,029,"Buckingham County, VA",Mar-22,6291,6040,251,4.00000000
CN5103100000000,51,031,"Campbell County, VA",Mar-22,25468,24759,709,2.80000000
CN5103300000000,51,033,"Caroline County, VA",Mar-22,14711,14248,463,3.10000000
CN5103500000000,51,035,"Carroll County, VA",Mar-22,13264,12833,431,3.20000000
CN5103600000000,51,036,"Charles City County, VA",Mar-22,3414,3313,101,3.00000000
CN5103700000000,51,037,"Charlotte County, VA",Mar-22,5567,5426,141,2.50000000
CN5104100000000,51,041,"Chesterfield County, VA",Mar-22,185575,180803,4772,2.60000000
CN5104300000000,51,043,"Clarke County, VA",Mar-22,7435,7263,172,2.30000000
CN5104500000000,51,045,"Craig County, VA",Mar-22,2238,2184,54,2.40000000
CN5104700000000,51,047,"Culpeper County, VA",Mar-22,24906,24265,641,2.60000000
CN5104900000000,51,049,"Cumberland County, VA",Mar-22,4695,4558,137,2.90000000
CN5105100000000,51,051,"Dickenson County, VA",Mar-22,5035,4850,185,3.70000000
CN5105300000000,51,053,"Dinwiddie County, VA",Mar-22,13169,12759,410,3.10000000
CN5105700000000,51,057,"Essex County, VA",Mar-22,5295,5113,182,3.40000000
CN5105900000000,51,059,"Fairfax County, VA",Mar-22,626855,612329,14526,2.30000000
CN5106100000000,51,061,"Fauquier County, VA",Mar-22,36632,35806,826,2.30000000
CN5106300000000,51,063,"Floyd County, VA",Mar-22,8318,8124,194,2.30000000
CN5106500000000,51,065,"Fluvanna County, VA",Mar-22,13939,13623,316,2.30000000
CN5106700000000,51,067,"Franklin County, VA",Mar-22,25667,24988,679,2.60000000
CN5106900000000,51,069,"Frederick County, VA",Mar-22,50015,48943,1072,2.10000000
CN5107100000000,51,071,"Giles County, VA",Mar-22,8076,7840,236,2.90000000
CN5107300000000,51,073,"Gloucester County, VA",Mar-22,18863,18399,464,2.50000000
CN5107500000000,51,075,"Goochland County, VA",Mar-22,11297,11029,268,2.40000000
CN5107700000000,51,077,"Grayson County, VA",Mar-22,8467,8270,197,2.30000000
CN5107900000000,51,079,"Greene County, VA",Mar-22,10408,10187,221,2.10000000
CN5108100000000,51,081,"Greensville County, VA",Mar-22,4404,4267,137,3.10000000
CN5108300000000,51,083,"Halifax County, VA",Mar-22,15495,14949,546,3.50000000
CN5108500000000,51,085,"Hanover County, VA",Mar-22,57461,56186,1275,2.20000000
CN5108700000000,51,087,"Henrico County, VA",Mar-22,177944,173108,4836,2.70000000
CN5108900000000,51,089,"Henry County, VA",Mar-22,24802,24024,778,3.10000000
CN5109100000000,51,091,"Highland County, VA",Mar-22,1175,1145,30,2.60000000
CN5109300000000,51,093,"Isle of Wight County, VA",Mar-22,19024,18543,481,2.50000000
CN5109500000000,51,095,"James City County, VA",Mar-22,35951,34943,1008,2.80000000
CN5109700000000,51,097,"King and Queen County, VA",Mar-22,3876,3791,85,2.20000000
CN5109900000000,51,099,"King George County, VA",Mar-22,14680,14354,326,2.20000000
CN5110100000000,51,101,"King William County, VA",Mar-22,9145,8922,223,2.40000000
CN5110300000000,51,103,"Lancaster County, VA",Mar-22,5415,5173,242,4.50000000
CN5110500000000,51,105,"Lee County, VA",Mar-22,8540,8274,266,3.10000000
CN5110700000000,51,107,"Loudoun County, VA",Mar-22,227429,222539,4890,2.20000000
CN5110900000000,51,109,"Louisa County, VA",Mar-22,21049,20542,507,2.40000000
CN5111100000000,51,111,"Lunenburg County, VA",Mar-22,5198,5047,151,2.90000000
CN5111300000000,51,113,"Madison County, VA",Mar-22,7428,7289,139,1.90000000
CN5111500000000,51,115,"Mathews County, VA",Mar-22,3961,3861,100,2.50000000
CN5111700000000,51,117,"Mecklenburg County, VA",Mar-22,13008,12571,437,3.40000000
CN5111900000000,51,119,"Middlesex County, VA",Mar-22,5216,5088,128,2.50000000
CN5112100000000,51,121,"Montgomery County, VA",Mar-22,51842,50636,1206,2.30000000
CN5112500000000,51,125,"Nelson County, VA",Mar-22,7165,6982,183,2.60000000
CN5112700000000,51,127,"New Kent County, VA",Mar-22,12658,12384,274,2.20000000
CN5113100000000,51,131,"Northampton County, VA",Mar-22,5194,4990,204,3.90000000
CN5113300000000,51,133,"Northumberland County, VA",Mar-22,5563,5321,242,4.40000000
CN5113500000000,51,135,"Nottoway County, VA",Mar-22,7334,7145,189,2.60000000
CN5113700000000,51,137,"Orange County, VA",Mar-22,17426,16974,452,2.60000000
CN5113900000000,51,139,"Page County, VA",Mar-22,12242,11820,422,3.40000000
CN5114100000000,51,141,"Patrick County, VA",Mar-22,7206,6961,245,3.40000000
CN5114300000000,51,143,"Pittsylvania County, VA",Mar-22,30604,29749,855,2.80000000
CN5114500000000,51,145,"Powhatan County, VA",Mar-22,14034,13728,306,2.20000000
CN5114700000000,51,147,"Prince Edward County, VA",Mar-22,10701,10347,354,3.30000000
CN5114900000000,51,149,"Prince George County, VA",Mar-22,14724,14266,458,3.10000000
CN5115300000000,51,153,"Prince William County, VA",Mar-22,246226,239823,6403,2.60000000
CN5115500000000,51,155,"Pulaski County, VA",Mar-22,16710,16167,543,3.20000000
CN5115700000000,51,157,"Rappahannock County, VA",Mar-22,3592,3511,81,2.30000000
CN5115900000000,51,159,"Richmond County, VA",Mar-22,4017,3903,114,2.80000000
CN5116100000000,51,161,"Roanoke County, VA",Mar-22,48602,47489,1113,2.30000000
CN5116300000000,51,163,"Rockbridge County, VA",Mar-22,10901,10627,274,2.50000000
CN5116500000000,51,165,"Rockingham County, VA",Mar-22,42135,41227,908,2.20000000
CN5116700000000,51,167,"Russell County, VA",Mar-22,11163,10809,354,3.20000000
CN5116900000000,51,169,"Scott County, VA",Mar-22,8943,8702,241,2.70000000
CN5117100000000,51,171,"Shenandoah County, VA",Mar-22,22383,21858,525,2.30000000
CN5117300000000,51,173,"Smyth County, VA",Mar-22,14655,14261,394,2.70000000
CN5117500000000,51,175,"Southampton County, VA",Mar-22,8753,8535,218,2.50000000
CN5117700000000,51,177,"Spotsylvania County, VA",Mar-22,67944,66121,1823,2.70000000
CN5117900000000,51,179,"Stafford County, VA",Mar-22,74109,72198,1911,2.60000000
CN5118100000000,51,181,"Surry County, VA",Mar-22,3536,3434,102,2.90000000
CN5118300000000,51,183,"Sussex County, VA",Mar-22,3459,3293,166,4.80000000
CN5118500000000,51,185,"Tazewell County, VA",Mar-22,15867,15283,584,3.70000000
CN5118700000000,51,187,"Warren County, VA",Mar-22,20270,19763,507,2.50000000
CN5119100000000,51,191,"Washington County, VA",Mar-22,25736,25058,678,2.60000000
CN5119300000000,51,193,"Westmoreland County, VA",Mar-22,9751,9459,292,3.00000000
CN5119500000000,51,195,"Wise County, VA",Mar-22,14082,13607,475,3.40000000
CN5119700000000,51,197,"Wythe County, VA",Mar-22,14246,13824,422,3.00000000
CN5119900000000,51,199,"York County, VA",Mar-22,32237,31431,806,2.50000000
CN5151000000000,51,510,"Alexandria city, VA",Mar-22,99042,96728,2314,2.30000000
CN5152000000000,51,520,"Bristol city, VA",Mar-22,7425,7186,239,3.20000000
CN5153000000000,51,530,"Buena Vista city, VA",Mar-22,3034,2955,79,2.60000000
CN5154000000000,51,540,"Charlottesville city, VA",Mar-22,25265,24657,608,2.40000000
CN5155000000000,51,550,"Chesapeake city, VA",Mar-22,120407,117139,3268,2.70000000
CN5157000000000,51,570,"Colonial Heights city, VA",Mar-22,8192,7937,255,3.10000000
CN5158000000000,51,580,"Covington city, VA",Mar-22,2346,2251,95,4.00000000
CN5159000000000,51,590,"Danville city, VA",Mar-22,19014,18122,892,4.70000000
CN5159500000000,51,595,"Emporia city, VA",Mar-22,2415,2281,134,5.50000000
CN5160000000000,51,600,"Fairfax city, VA",Mar-22,12678,12383,295,2.30000000
CN5161000000000,51,610,"Falls Church city, VA",Mar-22,8398,8233,165,2.00000000
CN5162000000000,51,620,"Franklin city, VA",Mar-22,3475,3319,156,4.50000000
CN5163000000000,51,630,"Fredericksburg city, VA",Mar-22,14120,13659,461,3.30000000
CN5164000000000,51,640,"Galax city, VA",Mar-22,2927,2842,85,2.90000000
CN5165000000000,51,650,"Hampton city, VA",Mar-22,62853,60346,2507,4.00000000
CN5166000000000,51,660,"Harrisonburg city, VA",Mar-22,24708,23971,737,3.00000000
CN5167000000000,51,670,"Hopewell city, VA",Mar-22,9327,8848,479,5.10000000
CN5167800000000,51,678,"Lexington city, VA",Mar-22,2209,2129,80,3.60000000
CN5168000000000,51,680,"Lynchburg city, VA",Mar-22,35267,34017,1250,3.50000000
CN5168300000000,51,683,"Manassas city, VA",Mar-22,21354,20818,536,2.50000000
CN5168500000000,51,685,"Manassas Park city, VA",Mar-22,9628,9383,245,2.50000000
CN5169000000000,51,690,"Martinsville city, VA",Mar-22,5773,5469,304,5.30000000
CN5170000000000,51,700,"Newport News city, VA",Mar-22,86383,83055,3328,3.90000000
CN5171000000000,51,710,"Norfolk city, VA",Mar-22,107699,103608,4091,3.80000000
CN5172000000000,51,720,"Norton city, VA",Mar-22,1739,1681,58,3.30000000
CN5173000000000,51,730,"Petersburg city, VA",Mar-22,12311,11442,869,7.10000000
CN5173500000000,51,735,"Poquoson city, VA",Mar-22,6144,6014,130,2.10000000
CN5174000000000,51,740,"Portsmouth city, VA",Mar-22,43239,41326,1913,4.40000000
CN5175000000000,51,750,"Radford city, VA",Mar-22,8975,8703,272,3.00000000
CN5176000000000,51,760,"Richmond city, VA",Mar-22,116381,112109,4272,3.70000000
CN5177000000000,51,770,"Roanoke city, VA",Mar-22,47969,46446,1523,3.20000000
CN5177500000000,51,775,"Salem city, VA",Mar-22,12585,12255,330,2.60000000
CN5179000000000,51,790,"Staunton city, VA",Mar-22,12095,11787,308,2.50000000
CN5180000000000,51,800,"Suffolk city, VA",Mar-22,44315,43010,1305,2.90000000
CN5181000000000,51,810,"Virginia Beach city, VA",Mar-22,225384,219634,5750,2.60000000
CN5182000000000,51,820,"Waynesboro city, VA",Mar-22,10522,10233,289,2.70000000
CN5183000000000,51,830,"Williamsburg city, VA",Mar-22,6618,6371,247,3.70000000
CN5184000000000,51,840,"Winchester city, VA",Mar-22,14620,14258,362,2.50000000
CN5300100000000,53,001,"Adams County, WA",Mar-22,9813,9269,544,5.50000000
CN5300300000000,53,003,"Asotin County, WA",Mar-22,10939,10514,425,3.90000000
CN5300500000000,53,005,"Benton County, WA",Mar-22,108497,102720,5777,5.30000000
CN5300700000000,53,007,"Chelan County, WA",Mar-22,44568,42154,2414,5.40000000
CN5300900000000,53,009,"Clallam County, WA",Mar-22,30699,28754,1945,6.30000000
CN5301100000000,53,011,"Clark County, WA",Mar-22,257679,244804,12875,5.00000000
CN5301300000000,53,013,"Columbia County, WA",Mar-22,1873,1758,115,6.10000000
CN5301500000000,53,015,"Cowlitz County, WA",Mar-22,50768,47753,3015,5.90000000
CN5301700000000,53,017,"Douglas County, WA",Mar-22,21524,20288,1236,5.70000000
CN5301900000000,53,019,"Ferry County, WA",Mar-22,2442,2179,263,10.80000000
CN5302100000000,53,021,"Franklin County, WA",Mar-22,44580,41322,3258,7.30000000
CN5302300000000,53,023,"Garfield County, WA",Mar-22,835,776,59,7.10000000
CN5302500000000,53,025,"Grant County, WA",Mar-22,47470,44063,3407,7.20000000
CN5302700000000,53,027,"Grays Harbor County, WA",Mar-22,30127,27836,2291,7.60000000
CN5302900000000,53,029,"Island County, WA",Mar-22,37708,35765,1943,5.20000000
CN5303100000000,53,031,"Jefferson County, WA",Mar-22,13333,12527,806,6.00000000
CN5303300000000,53,033,"King County, WA",Mar-22,1320067,1287904,32163,2.40000000
CN5303500000000,53,035,"Kitsap County, WA",Mar-22,133545,127340,6205,4.60000000
CN5303700000000,53,037,"Kittitas County, WA",Mar-22,22917,21473,1444,6.30000000
CN5303900000000,53,039,"Klickitat County, WA",Mar-22,9943,9321,622,6.30000000
CN5304100000000,53,041,"Lewis County, WA",Mar-22,36818,34509,2309,6.30000000
CN5304300000000,53,043,"Lincoln County, WA",Mar-22,4635,4369,266,5.70000000
CN5304500000000,53,045,"Mason County, WA",Mar-22,26744,24943,1801,6.70000000
CN5304700000000,53,047,"Okanogan County, WA",Mar-22,19723,18218,1505,7.60000000
CN5304900000000,53,049,"Pacific County, WA",Mar-22,8809,8121,688,7.80000000
CN5305100000000,53,051,"Pend Oreille County, WA",Mar-22,5408,4977,431,8.00000000
CN5305300000000,53,053,"Pierce County, WA",Mar-22,465113,438632,26481,5.70000000
CN5305500000000,53,055,"San Juan County, WA",Mar-22,8376,7978,398,4.80000000
CN5305700000000,53,057,"Skagit County, WA",Mar-22,64125,60343,3782,5.90000000
CN5305900000000,53,059,"Skamania County, WA",Mar-22,5769,5420,349,6.00000000
CN5306100000000,53,061,"Snohomish County, WA",Mar-22,450516,437475,13041,2.90000000
CN5306300000000,53,063,"Spokane County, WA",Mar-22,273957,260106,13851,5.10000000
CN5306500000000,53,065,"Stevens County, WA",Mar-22,20168,18583,1585,7.90000000
CN5306700000000,53,067,"Thurston County, WA",Mar-22,151550,144103,7447,4.90000000
CN5306900000000,53,069,"Wahkiakum County, WA",Mar-22,1395,1307,88,6.30000000
CN5307100000000,53,071,"Walla Walla County, WA",Mar-22,31935,30494,1441,4.50000000
CN5307300000000,53,073,"Whatcom County, WA",Mar-22,119522,113253,6269,5.20000000
CN5307500000000,53,075,"Whitman County, WA",Mar-22,23613,22625,988,4.20000000
CN5307700000000,53,077,"Yakima County, WA",Mar-22,131903,122379,9524,7.20000000
CN5400100000000,54,001,"Barbour County, WV",Mar-22,7266,6945,321,4.40000000
CN5400300000000,54,003,"Berkeley County, WV",Mar-22,59800,58201,1599,2.70000000
CN5400500000000,54,005,"Boone County, WV",Mar-22,7182,6830,352,4.90000000
CN5400700000000,54,007,"Braxton County, WV",Mar-22,5065,4706,359,7.10000000
CN5400900000000,54,009,"Brooke County, WV",Mar-22,9805,9309,496,5.10000000
CN5401100000000,54,011,"Cabell County, WV",Mar-22,41175,39740,1435,3.50000000
CN5401300000000,54,013,"Calhoun County, WV",Mar-22,2591,2307,284,11.00000000
CN5401500000000,54,015,"Clay County, WV",Mar-22,3014,2817,197,6.50000000
CN5401700000000,54,017,"Doddridge County, WV",Mar-22,3771,3651,120,3.20000000
CN5401900000000,54,019,"Fayette County, WV",Mar-22,15786,14994,792,5.00000000
CN5402100000000,54,021,"Gilmer County, WV",Mar-22,2377,2239,138,5.80000000
CN5402300000000,54,023,"Grant County, WV",Mar-22,6004,5776,228,3.80000000
CN5402500000000,54,025,"Greenbrier County, WV",Mar-22,15279,14712,567,3.70000000
CN5402700000000,54,027,"Hampshire County, WV",Mar-22,11048,10769,279,2.50000000
CN5402900000000,54,029,"Hancock County, WV",Mar-22,12907,12249,658,5.10000000
CN5403100000000,54,031,"Hardy County, WV",Mar-22,5721,5478,243,4.20000000
CN5403300000000,54,033,"Harrison County, WV",Mar-22,33435,32190,1245,3.70000000
CN5403500000000,54,035,"Jackson County, WV",Mar-22,12042,11486,556,4.60000000
CN5403700000000,54,037,"Jefferson County, WV",Mar-22,30308,29628,680,2.20000000
CN5403900000000,54,039,"Kanawha County, WV",Mar-22,80888,77715,3173,3.90000000
CN5404100000000,54,041,"Lewis County, WV",Mar-22,6024,5685,339,5.60000000
CN5404300000000,54,043,"Lincoln County, WV",Mar-22,7040,6660,380,5.40000000
CN5404500000000,54,045,"Logan County, WV",Mar-22,11056,10530,526,4.80000000
CN5404700000000,54,047,"McDowell County, WV",Mar-22,4231,3963,268,6.30000000
CN5404900000000,54,049,"Marion County, WV",Mar-22,25263,24177,1086,4.30000000
CN5405100000000,54,051,"Marshall County, WV",Mar-22,13356,12574,782,5.90000000
CN5405300000000,54,053,"Mason County, WV",Mar-22,10071,9632,439,4.40000000
CN5405500000000,54,055,"Mercer County, WV",Mar-22,20586,19612,974,4.70000000
CN5405700000000,54,057,"Mineral County, WV",Mar-22,12132,11671,461,3.80000000
CN5405900000000,54,059,"Mingo County, WV",Mar-22,6008,5602,406,6.80000000
CN5406100000000,54,061,"Monongalia County, WV",Mar-22,56399,54599,1800,3.20000000
CN5406300000000,54,063,"Monroe County, WV",Mar-22,6067,5884,183,3.00000000
CN5406500000000,54,065,"Morgan County, WV",Mar-22,8481,8252,229,2.70000000
CN5406700000000,54,067,"Nicholas County, WV",Mar-22,9092,8637,455,5.00000000
CN5406900000000,54,069,"Ohio County, WV",Mar-22,20201,19362,839,4.20000000
CN5407100000000,54,071,"Pendleton County, WV",Mar-22,3766,3667,99,2.60000000
CN5407300000000,54,073,"Pleasants County, WV",Mar-22,2674,2513,161,6.00000000
CN5407500000000,54,075,"Pocahontas County, WV",Mar-22,4111,3968,143,3.50000000
CN5407700000000,54,077,"Preston County, WV",Mar-22,15787,15158,629,4.00000000
CN5407900000000,54,079,"Putnam County, WV",Mar-22,26798,25914,884,3.30000000
CN5408100000000,54,081,"Raleigh County, WV",Mar-22,29663,28529,1134,3.80000000
CN5408300000000,54,083,"Randolph County, WV",Mar-22,11950,11363,587,4.90000000
CN5408500000000,54,085,"Ritchie County, WV",Mar-22,4281,4089,192,4.50000000
CN5408700000000,54,087,"Roane County, WV",Mar-22,5072,4670,402,7.90000000
CN5408900000000,54,089,"Summers County, WV",Mar-22,4451,4279,172,3.90000000
CN5409100000000,54,091,"Taylor County, WV",Mar-22,7854,7538,316,4.00000000
CN5409300000000,54,093,"Tucker County, WV",Mar-22,3317,3160,157,4.70000000
CN5409500000000,54,095,"Tyler County, WV",Mar-22,3002,2799,203,6.80000000
CN5409700000000,54,097,"Upshur County, WV",Mar-22,9715,9215,500,5.10000000
CN5409900000000,54,099,"Wayne County, WV",Mar-22,15501,14865,636,4.10000000
CN5410100000000,54,101,"Webster County, WV",Mar-22,3207,3038,169,5.30000000
CN5410300000000,54,103,"Wetzel County, WV",Mar-22,6961,6548,413,5.90000000
CN5410500000000,54,105,"Wirt County, WV",Mar-22,2283,2119,164,7.20000000
CN5410700000000,54,107,"Wood County, WV",Mar-22,36581,35003,1578,4.30000000
CN5410900000000,54,109,"Wyoming County, WV",Mar-22,7272,6972,300,4.10000000
CN5500100000000,55,001,"Adams County, WI",Mar-22,7911,7409,502,6.30000000
CN5500300000000,55,003,"Ashland County, WI",Mar-22,7414,7075,339,4.60000000
CN5500500000000,55,005,"Barron County, WI",Mar-22,24597,23561,1036,4.20000000
CN5500700000000,55,007,"Bayfield County, WI",Mar-22,7442,6971,471,6.30000000
CN5500900000000,55,009,"Brown County, WI",Mar-22,142739,138610,4129,2.90000000
CN5501100000000,55,011,"Buffalo County, WI",Mar-22,6588,6279,309,4.70000000
CN5501300000000,55,013,"Burnett County, WI",Mar-22,7386,6933,453,6.10000000
CN5501500000000,55,015,"Calumet County, WI",Mar-22,28180,27491,689,2.40000000
CN5501700000000,55,017,"Chippewa County, WI",Mar-22,34375,32930,1445,4.20000000
CN5501900000000,55,019,"Clark County, WI",Mar-22,18552,17980,572,3.10000000
CN5502100000000,55,021,"Columbia County, WI",Mar-22,32361,31376,985,3.00000000
CN5502300000000,55,023,"Crawford County, WI",Mar-22,7552,7169,383,5.10000000
CN5502500000000,55,025,"Dane County, WI",Mar-22,332028,324435,7593,2.30000000
CN5502700000000,55,027,"Dodge County, WI",Mar-22,48597,47181,1416,2.90000000
CN5502900000000,55,029,"Door County, WI",Mar-22,14195,13520,675,4.80000000
CN5503100000000,55,031,"Douglas County, WI",Mar-22,23519,22437,1082,4.60000000
CN5503300000000,55,033,"Dunn County, WI",Mar-22,25138,24196,942,3.70000000
CN5503500000000,55,035,"Eau Claire County, WI",Mar-22,60109,58399,1710,2.80000000
CN5503700000000,55,037,"Florence County, WI",Mar-22,2261,2162,99,4.40000000
CN5503900000000,55,039,"Fond du Lac County, WI",Mar-22,58121,56514,1607,2.80000000
CN5504100000000,55,041,"Forest County, WI",Mar-22,4049,3792,257,6.30000000
CN5504300000000,55,043,"Grant County, WI",Mar-22,28764,27894,870,3.00000000
CN5504500000000,55,045,"Green County, WI",Mar-22,21419,20804,615,2.90000000
CN5504700000000,55,047,"Green Lake County, WI",Mar-22,9264,8865,399,4.30000000
CN5504900000000,55,049,"Iowa County, WI",Mar-22,14195,13708,487,3.40000000
CN5505100000000,55,051,"Iron County, WI",Mar-22,2610,2440,170,6.50000000
CN5505300000000,55,053,"Jackson County, WI",Mar-22,9690,9176,514,5.30000000
CN5505500000000,55,055,"Jefferson County, WI",Mar-22,46612,45173,1439,3.10000000
CN5505700000000,55,057,"Juneau County, WI",Mar-22,13432,12904,528,3.90000000
CN5505900000000,55,059,"Kenosha County, WI",Mar-22,91497,88037,3460,3.80000000
CN5506100000000,55,061,"Kewaunee County, WI",Mar-22,11265,10934,331,2.90000000
CN5506300000000,55,063,"La Crosse County, WI",Mar-22,67824,66006,1818,2.70000000
CN5506500000000,55,065,"Lafayette County, WI",Mar-22,10789,10477,312,2.90000000
CN5506700000000,55,067,"Langlade County, WI",Mar-22,9580,9190,390,4.10000000
CN5506900000000,55,069,"Lincoln County, WI",Mar-22,14819,14278,541,3.70000000
CN5507100000000,55,071,"Manitowoc County, WI",Mar-22,41374,40061,1313,3.20000000
CN5507300000000,55,073,"Marathon County, WI",Mar-22,75453,73428,2025,2.70000000
CN5507500000000,55,075,"Marinette County, WI",Mar-22,19285,18478,807,4.20000000
CN5507700000000,55,077,"Marquette County, WI",Mar-22,7860,7512,348,4.40000000
CN5507800000000,55,078,"Menominee County, WI",Mar-22,1564,1476,88,5.60000000
CN5507900000000,55,079,"Milwaukee County, WI",Mar-22,465120,444920,20200,4.30000000
CN5508100000000,55,081,"Monroe County, WI",Mar-22,23994,23269,725,3.00000000
CN5508300000000,55,083,"Oconto County, WI",Mar-22,21170,20411,759,3.60000000
CN5508500000000,55,085,"Oneida County, WI",Mar-22,17445,16643,802,4.60000000
CN5508700000000,55,087,"Outagamie County, WI",Mar-22,105558,102690,2868,2.70000000
CN5508900000000,55,089,"Ozaukee County, WI",Mar-22,49437,48207,1230,2.50000000
CN5509100000000,55,091,"Pepin County, WI",Mar-22,4179,4015,164,3.90000000
CN5509300000000,55,093,"Pierce County, WI",Mar-22,25565,24596,969,3.80000000
CN5509500000000,55,095,"Polk County, WI",Mar-22,25267,24038,1229,4.90000000
CN5509700000000,55,097,"Portage County, WI",Mar-22,38894,37627,1267,3.30000000
CN5509900000000,55,099,"Price County, WI",Mar-22,6318,6073,245,3.90000000
CN5510100000000,55,101,"Racine County, WI",Mar-22,98512,94385,4127,4.20000000
CN5510300000000,55,103,"Richland County, WI",Mar-22,9234,8912,322,3.50000000
CN5510500000000,55,105,"Rock County, WI",Mar-22,87363,83809,3554,4.10000000
CN5510700000000,55,107,"Rusk County, WI",Mar-22,6756,6440,316,4.70000000
CN5510900000000,55,109,"St. Croix County, WI",Mar-22,51510,49724,1786,3.50000000
CN5511100000000,55,111,"Sauk County, WI",Mar-22,34643,33417,1226,3.50000000
CN5511300000000,55,113,"Sawyer County, WI",Mar-22,7857,7459,398,5.10000000
CN5511500000000,55,115,"Shawano County, WI",Mar-22,21343,20613,730,3.40000000
CN5511700000000,55,117,"Sheboygan County, WI",Mar-22,62785,61163,1622,2.60000000
CN5511900000000,55,119,"Taylor County, WI",Mar-22,11461,10974,487,4.20000000
CN5512100000000,55,121,"Trempealeau County, WI",Mar-22,15875,15267,608,3.80000000
CN5512300000000,55,123,"Vernon County, WI",Mar-22,16010,15489,521,3.30000000
CN5512500000000,55,125,"Vilas County, WI",Mar-22,9929,9443,486,4.90000000
CN5512700000000,55,127,"Walworth County, WI",Mar-22,57981,56051,1930,3.30000000
CN5512900000000,55,129,"Washburn County, WI",Mar-22,7916,7517,399,5.00000000
CN5513100000000,55,131,"Washington County, WI",Mar-22,77349,75270,2079,2.70000000
CN5513300000000,55,133,"Waukesha County, WI",Mar-22,225066,219170,5896,2.60000000
CN5513500000000,55,135,"Waupaca County, WI",Mar-22,26200,25338,862,3.30000000
CN5513700000000,55,137,"Waushara County, WI",Mar-22,11508,11048,460,4.00000000
CN5513900000000,55,139,"Winnebago County, WI",Mar-22,92939,90452,2487,2.70000000
CN5514100000000,55,141,"Wood County, WI",Mar-22,34490,33145,1345,3.90000000
CN5600100000000,56,001,"Albany County, WY",Mar-22,21530,20920,610,2.80000000
CN5600300000000,56,003,"Big Horn County, WY",Mar-22,5187,4955,232,4.50000000
CN5600500000000,56,005,"Campbell County, WY",Mar-22,22195,21292,903,4.10000000
CN5600700000000,56,007,"Carbon County, WY",Mar-22,7208,6948,260,3.60000000
CN5600900000000,56,009,"Converse County, WY",Mar-22,7741,7477,264,3.40000000
CN5601100000000,56,011,"Crook County, WY",Mar-22,3819,3703,116,3.00000000
CN5601300000000,56,013,"Fremont County, WY",Mar-22,18878,18096,782,4.10000000
CN5601500000000,56,015,"Goshen County, WY",Mar-22,6575,6391,184,2.80000000
CN5601700000000,56,017,"Hot Springs County, WY",Mar-22,2227,2158,69,3.10000000
CN5601900000000,56,019,"Johnson County, WY",Mar-22,4229,4076,153,3.60000000
CN5602100000000,56,021,"Laramie County, WY",Mar-22,50061,48390,1671,3.30000000
CN5602300000000,56,023,"Lincoln County, WY",Mar-22,9435,9122,313,3.30000000
CN5602500000000,56,025,"Natrona County, WY",Mar-22,39140,37315,1825,4.70000000
CN5602700000000,56,027,"Niobrara County, WY",Mar-22,1211,1180,31,2.60000000
CN5602900000000,56,029,"Park County, WY",Mar-22,14761,14178,583,3.90000000
CN5603100000000,56,031,"Platte County, WY",Mar-22,4489,4340,149,3.30000000
CN5603300000000,56,033,"Sheridan County, WY",Mar-22,16040,15493,547,3.40000000
CN5603500000000,56,035,"Sublette County, WY",Mar-22,3821,3642,179,4.70000000
CN5603700000000,56,037,"Sweetwater County, WY",Mar-22,19294,18421,873,4.50000000
CN5603900000000,56,039,"Teton County, WY",Mar-22,15971,15621,350,2.20000000
CN5604100000000,56,041,"Uinta County, WY",Mar-22,8717,8385,332,3.80000000
CN5604300000000,56,043,"Washakie County, WY",Mar-22,3847,3688,159,4.10000000
CN5604500000000,56,045,"Weston County, WY",Mar-22,3722,3606,116,3.10000000
CN7200100000000,72,001,"Adjuntas Municipio, PR",Mar-22,4419,4003,416,9.40000000
CN7200300000000,72,003,"Aguada Municipio, PR",Mar-22,13452,12466,986,7.30000000
CN7200500000000,72,005,"Aguadilla Municipio, PR",Mar-22,16186,14974,1212,7.50000000
CN7200700000000,72,007,"Aguas Buenas Municipio, PR",Mar-22,7271,6784,487,6.70000000
CN7200900000000,72,009,"Aibonito Municipio, PR",Mar-22,6915,6476,439,6.30000000
CN7201100000000,72,011,"Anasco Municipio, PR",Mar-22,10044,9450,594,5.90000000
CN7201300000000,72,013,"Arecibo Municipio, PR",Mar-22,26307,24601,1706,6.50000000
CN7201500000000,72,015,"Arroyo Municipio, PR",Mar-22,5117,4746,371,7.30000000
CN7201700000000,72,017,"Barceloneta Municipio, PR",Mar-22,6594,6063,531,8.10000000
CN7201900000000,72,019,"Barranquitas Municipio, PR",Mar-22,8015,7476,539,6.70000000
CN7202100000000,72,021,"Bayamon Municipio, PR",Mar-22,72488,68869,3619,5.00000000
CN7202300000000,72,023,"Cabo Rojo Municipio, PR",Mar-22,15590,14590,1000,6.40000000
CN7202500000000,72,025,"Caguas Municipio, PR",Mar-22,53143,50752,2391,4.50000000
CN7202700000000,72,027,"Camuy Municipio, PR",Mar-22,10495,9912,583,5.60000000
CN7202900000000,72,029,"Canovanas Municipio, PR",Mar-22,18219,17340,879,4.80000000
CN7203100000000,72,031,"Carolina Municipio, PR",Mar-22,68660,65277,3383,4.90000000
CN7203300000000,72,033,"Catano Municipio, PR",Mar-22,8715,8223,492,5.60000000
CN7203500000000,72,035,"Cayey Municipio, PR",Mar-22,17940,17186,754,4.20000000
CN7203700000000,72,037,"Ceiba Municipio, PR",Mar-22,3992,3736,256,6.40000000
CN7203900000000,72,039,"Ciales Municipio, PR",Mar-22,4050,3689,361,8.90000000
CN7204100000000,72,041,"Cidra Municipio, PR",Mar-22,17124,16444,680,4.00000000
CN7204300000000,72,043,"Coamo Municipio, PR",Mar-22,11305,10533,772,6.80000000
CN7204500000000,72,045,"Comerio Municipio, PR",Mar-22,5418,5062,356,6.60000000
CN7204700000000,72,047,"Corozal Municipio, PR",Mar-22,9807,9090,717,7.30000000
CN7204900000000,72,049,"Culebra Municipio, PR",Mar-22,1032,998,34,3.30000000
CN7205100000000,72,051,"Dorado Municipio, PR",Mar-22,15031,14411,620,4.10000000
CN7205300000000,72,053,"Fajardo Municipio, PR",Mar-22,11773,10986,787,6.70000000
CN7205400000000,72,054,"Florida Municipio, PR",Mar-22,3623,3353,270,7.50000000
CN7205500000000,72,055,"Guanica Municipio, PR",Mar-22,4257,3792,465,10.90000000
CN7205700000000,72,057,"Guayama Municipio, PR",Mar-22,12017,11342,675,5.60000000
CN7205900000000,72,059,"Guayanilla Municipio, PR",Mar-22,5275,4762,513,9.70000000
CN7206100000000,72,061,"Guaynabo Municipio, PR",Mar-22,42462,41227,1235,2.90000000
CN7206300000000,72,063,"Gurabo Municipio, PR",Mar-22,20869,20167,702,3.40000000
CN7206500000000,72,065,"Hatillo Municipio, PR",Mar-22,14846,13765,1081,7.30000000
CN7206700000000,72,067,"Hormigueros Municipio, PR",Mar-22,6175,5748,427,6.90000000
CN7206900000000,72,069,"Humacao Municipio, PR",Mar-22,19228,18032,1196,6.20000000
CN7207100000000,72,071,"Isabela Municipio, PR",Mar-22,13177,12394,783,5.90000000
CN7207300000000,72,073,"Jayuya Municipio, PR",Mar-22,4562,4156,406,8.90000000
CN7207500000000,72,075,"Juana Diaz Municipio, PR",Mar-22,17152,16184,968,5.60000000
CN7207700000000,72,077,"Juncos Municipio, PR",Mar-22,13815,12996,819,5.90000000
CN7207900000000,72,079,"Lajas Municipio, PR",Mar-22,5739,5187,552,9.60000000
CN7208100000000,72,081,"Lares Municipio, PR",Mar-22,7321,6570,751,10.30000000
CN7208300000000,72,083,"Las Marias Municipio, PR",Mar-22,2894,2641,253,8.70000000
CN7208500000000,72,085,"Las Piedras Municipio, PR",Mar-22,12728,12022,706,5.50000000
CN7208700000000,72,087,"Loiza Municipio, PR",Mar-22,9313,8719,594,6.40000000
CN7208900000000,72,089,"Luquillo Municipio, PR",Mar-22,6844,6423,421,6.20000000
CN7209100000000,72,091,"Manati Municipio, PR",Mar-22,12456,11744,712,5.70000000
CN7209300000000,72,093,"Maricao Municipio, PR",Mar-22,2108,1893,215,10.20000000
CN7209500000000,72,095,"Maunabo Municipio, PR",Mar-22,3157,2824,333,10.50000000
CN7209700000000,72,097,"Mayaguez Municipio, PR",Mar-22,24297,22636,1661,6.80000000
CN7209900000000,72,099,"Moca Municipio, PR",Mar-22,11713,10805,908,7.80000000
CN7210100000000,72,101,"Morovis Municipio, PR",Mar-22,8966,8341,625,7.00000000
CN7210300000000,72,103,"Naguabo Municipio, PR",Mar-22,9208,8659,549,6.00000000
CN7210500000000,72,105,"Naranjito Municipio, PR",Mar-22,7916,7325,591,7.50000000
CN7210700000000,72,107,"Orocovis Municipio, PR",Mar-22,5369,4938,431,8.00000000
CN7210900000000,72,109,"Patillas Municipio, PR",Mar-22,4648,4183,465,10.00000000
CN7211100000000,72,111,"Penuelas Municipio, PR",Mar-22,6318,5769,549,8.70000000
CN7211300000000,72,113,"Ponce Municipio, PR",Mar-22,50428,46911,3517,7.00000000
CN7211500000000,72,115,"Quebradillas Municipio, PR",Mar-22,6677,6196,481,7.20000000
CN7211700000000,72,117,"Rincon Municipio, PR",Mar-22,5224,4810,414,7.90000000
CN7211900000000,72,119,"Rio Grande Municipio, PR",Mar-22,19038,17907,1131,5.90000000
CN7212100000000,72,121,"Sabana Grande Municipio, PR",Mar-22,6612,6063,549,8.30000000
CN7212300000000,72,123,"Salinas Municipio, PR",Mar-22,7567,6968,599,7.90000000
CN7212500000000,72,125,"San German Municipio, PR",Mar-22,10835,9972,863,8.00000000
CN7212700000000,72,127,"San Juan Municipio, PR",Mar-22,149409,143057,6352,4.30000000
CN7212900000000,72,129,"San Lorenzo Municipio, PR",Mar-22,12813,12101,712,5.60000000
CN7213100000000,72,131,"San Sebastian Municipio, PR",Mar-22,11054,10008,1046,9.50000000
CN7213300000000,72,133,"Santa Isabel Municipio, PR",Mar-22,9949,9266,683,6.90000000
CN7213500000000,72,135,"Toa Alta Municipio, PR",Mar-22,31151,29786,1365,4.40000000
CN7213700000000,72,137,"Toa Baja Municipio, PR",Mar-22,32403,30915,1488,4.60000000
CN7213900000000,72,139,"Trujillo Alto Municipio, PR",Mar-22,30313,29245,1068,3.50000000
CN7214100000000,72,141,"Utuado Municipio, PR",Mar-22,7275,6678,597,8.20000000
CN7214300000000,72,143,"Vega Alta Municipio, PR",Mar-22,11010,10218,792,7.20000000
CN7214500000000,72,145,"Vega Baja Municipio, PR",Mar-22,14652,13543,1109,7.60000000
CN7214700000000,72,147,"Vieques Municipio, PR",Mar-22,2941,2685,256,8.70000000
CN7214900000000,72,149,"Villalba Municipio, PR",Mar-22,7925,7218,707,8.90000000
CN7215100000000,72,151,"Yabucoa Municipio, PR",Mar-22,9504,8725,779,8.20000000
CN7215300000000,72,153,"Yauco Municipio, PR",Mar-22,10493,9499,994,9.50000000
CN0100100000000,01,001,"Autauga County, AL",Apr-22,26626,26170,456,1.70000000
CN0100300000000,01,003,"Baldwin County, AL",Apr-22,100545,98704,1841,1.80000000
CN0100500000000,01,005,"Barbour County, AL",Apr-22,8197,7929,268,3.30000000
CN0100700000000,01,007,"Bibb County, AL",Apr-22,8674,8507,167,1.90000000
CN0100900000000,01,009,"Blount County, AL",Apr-22,25537,25117,420,1.60000000
CN0101100000000,01,011,"Bullock County, AL",Apr-22,4435,4331,104,2.30000000
CN0101300000000,01,013,"Butler County, AL",Apr-22,8738,8459,279,3.20000000
CN0101500000000,01,015,"Calhoun County, AL",Apr-22,46399,45216,1183,2.50000000
CN0101700000000,01,017,"Chambers County, AL",Apr-22,15848,15531,317,2.00000000
CN0101900000000,01,019,"Cherokee County, AL",Apr-22,11522,11324,198,1.70000000
CN0102100000000,01,021,"Chilton County, AL",Apr-22,20042,19691,351,1.80000000
CN0102300000000,01,023,"Choctaw County, AL",Apr-22,4319,4188,131,3.00000000
CN0102500000000,01,025,"Clarke County, AL",Apr-22,7732,7426,306,4.00000000
CN0102700000000,01,027,"Clay County, AL",Apr-22,6032,5932,100,1.70000000
CN0102900000000,01,029,"Cleburne County, AL",Apr-22,5943,5840,103,1.70000000
CN0103100000000,01,031,"Coffee County, AL",Apr-22,21373,20975,398,1.90000000
CN0103300000000,01,033,"Colbert County, AL",Apr-22,23628,23055,573,2.40000000
CN0103500000000,01,035,"Conecuh County, AL",Apr-22,4209,4086,123,2.90000000
CN0103700000000,01,037,"Coosa County, AL",Apr-22,4369,4290,79,1.80000000
CN0103900000000,01,039,"Covington County, AL",Apr-22,15020,14734,286,1.90000000
CN0104100000000,01,041,"Crenshaw County, AL",Apr-22,5864,5746,118,2.00000000
CN0104300000000,01,043,"Cullman County, AL",Apr-22,39338,38727,611,1.60000000
CN0104500000000,01,045,"Dale County, AL",Apr-22,20807,20390,417,2.00000000
CN0104700000000,01,047,"Dallas County, AL",Apr-22,13623,12949,674,4.90000000
CN0104900000000,01,049,"DeKalb County, AL",Apr-22,31052,30514,538,1.70000000
CN0105100000000,01,051,"Elmore County, AL",Apr-22,38075,37458,617,1.60000000
CN0105300000000,01,053,"Escambia County, AL",Apr-22,14019,13690,329,2.30000000
CN0105500000000,01,055,"Etowah County, AL",Apr-22,39343,38357,986,2.50000000
CN0105700000000,01,057,"Fayette County, AL",Apr-22,6713,6565,148,2.20000000
CN0105900000000,01,059,"Franklin County, AL",Apr-22,14423,14182,241,1.70000000
CN0106100000000,01,061,"Geneva County, AL",Apr-22,10900,10701,199,1.80000000
CN0106300000000,01,063,"Greene County, AL",Apr-22,2791,2672,119,4.30000000
CN0106500000000,01,065,"Hale County, AL",Apr-22,5774,5567,207,3.60000000
CN0106700000000,01,067,"Henry County, AL",Apr-22,6896,6751,145,2.10000000
CN0106900000000,01,069,"Houston County, AL",Apr-22,47295,46330,965,2.00000000
CN0107100000000,01,071,"Jackson County, AL",Apr-22,23197,22766,431,1.90000000
CN0107300000000,01,073,"Jefferson County, AL",Apr-22,322906,316021,6885,2.10000000
CN0107500000000,01,075,"Lamar County, AL",Apr-22,5660,5546,114,2.00000000
CN0107700000000,01,077,"Lauderdale County, AL",Apr-22,42537,41681,856,2.00000000
CN0107900000000,01,079,"Lawrence County, AL",Apr-22,14454,14178,276,1.90000000
CN0108100000000,01,081,"Lee County, AL",Apr-22,78560,77189,1371,1.70000000
CN0108300000000,01,083,"Limestone County, AL",Apr-22,47460,46714,746,1.60000000
CN0108500000000,01,085,"Lowndes County, AL",Apr-22,3489,3297,192,5.50000000
CN0108700000000,01,087,"Macon County, AL",Apr-22,7827,7544,283,3.60000000
CN0108900000000,01,089,"Madison County, AL",Apr-22,196262,193069,3193,1.60000000
CN0109100000000,01,091,"Marengo County, AL",Apr-22,7588,7392,196,2.60000000
CN0109300000000,01,093,"Marion County, AL",Apr-22,13651,13411,240,1.80000000
CN0109500000000,01,095,"Marshall County, AL",Apr-22,44816,44136,680,1.50000000
CN0109700000000,01,097,"Mobile County, AL",Apr-22,191719,186334,5385,2.80000000
CN0109900000000,01,099,"Monroe County, AL",Apr-22,7272,7014,258,3.50000000
CN0110100000000,01,101,"Montgomery County, AL",Apr-22,107053,104118,2935,2.70000000
CN0110300000000,01,103,"Morgan County, AL",Apr-22,59969,58992,977,1.60000000
CN0110500000000,01,105,"Perry County, AL",Apr-22,3025,2862,163,5.40000000
CN0110700000000,01,107,"Pickens County, AL",Apr-22,7529,7337,192,2.60000000
CN0110900000000,01,109,"Pike County, AL",Apr-22,16388,16060,328,2.00000000
CN0111100000000,01,111,"Randolph County, AL",Apr-22,9524,9355,169,1.80000000
CN0111300000000,01,113,"Russell County, AL",Apr-22,23810,23363,447,1.90000000
CN0111500000000,01,115,"St. Clair County, AL",Apr-22,42054,41355,699,1.70000000
CN0111700000000,01,117,"Shelby County, AL",Apr-22,121147,119510,1637,1.40000000
CN0111900000000,01,119,"Sumter County, AL",Apr-22,4524,4403,121,2.70000000
CN0112100000000,01,121,"Talladega County, AL",Apr-22,36144,35213,931,2.60000000
CN0112300000000,01,123,"Tallapoosa County, AL",Apr-22,17746,17321,425,2.40000000
CN0112500000000,01,125,"Tuscaloosa County, AL",Apr-22,102986,100890,2096,2.00000000
CN0112700000000,01,127,"Walker County, AL",Apr-22,25436,24889,547,2.20000000
CN0112900000000,01,129,"Washington County, AL",Apr-22,6494,6293,201,3.10000000
CN0113100000000,01,131,"Wilcox County, AL",Apr-22,2529,2333,196,7.80000000
CN0113300000000,01,133,"Winston County, AL",Apr-22,10165,9981,184,1.80000000
CN0201300000000,02,013,"Aleutians East Borough, AK",Apr-22,2603,2566,37,1.40000000
CN0201600000000,02,016,"Aleutians West Census Area, AK",Apr-22,4126,4025,101,2.40000000
CN0202000000000,02,020,"Anchorage Borough/municipality, AK",Apr-22,151636,145700,5936,3.90000000
CN0205000000000,02,050,"Bethel Census Area, AK",Apr-22,6601,5808,793,12.00000000
CN0206000000000,02,060,"Bristol Bay Borough, AK",Apr-22,411,394,17,4.10000000
CN0206300000000,02,063,"Chugach Census Area, AK",Apr-22,3129,2981,148,4.70000000
CN0206600000000,02,066,"Copper River Census Area, AK",Apr-22,1323,1159,164,12.40000000
CN0206800000000,02,068,"Denali Borough, AK",Apr-22,664,589,75,11.30000000
CN0207000000000,02,070,"Dillingham Census Area, AK",Apr-22,1580,1468,112,7.10000000
CN0209000000000,02,090,"Fairbanks North Star Borough, AK",Apr-22,45868,44011,1857,4.00000000
CN0210000000000,02,100,"Haines Borough, AK",Apr-22,986,904,82,8.30000000
CN0210500000000,02,105,"Hoonah-Angoon Census Area, AK",Apr-22,1034,954,80,7.70000000
CN0211000000000,02,110,"Juneau Borough/city, AK",Apr-22,17004,16490,514,3.00000000
CN0212200000000,02,122,"Kenai Peninsula Borough, AK",Apr-22,27077,25521,1556,5.70000000
CN0213000000000,02,130,"Ketchikan Gateway Borough, AK",Apr-22,6446,6114,332,5.20000000
CN0215000000000,02,150,"Kodiak Island Borough, AK",Apr-22,5823,5576,247,4.20000000
CN0215800000000,02,158,"Kusilvak Census Area, AK",Apr-22,2308,1926,382,16.60000000
CN0216400000000,02,164,"Lake and Peninsula Borough, AK",Apr-22,558,510,48,8.60000000
CN0217000000000,02,170,"Matanuska-Susitna Borough, AK",Apr-22,50163,47432,2731,5.40000000
CN0218000000000,02,180,"Nome Census Area, AK",Apr-22,3884,3502,382,9.80000000
CN0218500000000,02,185,"North Slope Borough, AK",Apr-22,2972,2807,165,5.60000000
CN0218800000000,02,188,"Northwest Arctic Borough, AK",Apr-22,2938,2617,321,10.90000000
CN0219500000000,02,195,"Petersburg Borough, AK",Apr-22,1666,1564,102,6.10000000
CN0219800000000,02,198,"Prince of Wales-Hyder Census Area, AK",Apr-22,2823,2644,179,6.30000000
CN0222000000000,02,220,"Sitka Borough/city, AK",Apr-22,4387,4258,129,2.90000000
CN0223000000000,02,230,"Skagway Municipality, AK",Apr-22,576,519,57,9.90000000
CN0224000000000,02,240,"Southeast Fairbanks Census Area, AK",Apr-22,3292,3081,211,6.40000000
CN0227500000000,02,275,"Wrangell Borough/city, AK",Apr-22,959,906,53,5.50000000
CN0228200000000,02,282,"Yakutat Borough/city, AK",Apr-22,311,295,16,5.10000000
CN0229000000000,02,290,"Yukon-Koyukuk Census Area, AK",Apr-22,2478,2207,271,10.90000000
CN0400100000000,04,001,"Apache County, AZ",Apr-22,18296,16987,1309,7.20000000
CN0400300000000,04,003,"Cochise County, AZ",Apr-22,48611,46951,1660,3.40000000
CN0400500000000,04,005,"Coconino County, AZ",Apr-22,74593,71648,2945,3.90000000
CN0400700000000,04,007,"Gila County, AZ",Apr-22,19983,19300,683,3.40000000
CN0400900000000,04,009,"Graham County, AZ",Apr-22,15986,15574,412,2.60000000
CN0401100000000,04,011,"Greenlee County, AZ",Apr-22,4405,4298,107,2.40000000
CN0401200000000,04,012,"La Paz County, AZ",Apr-22,8355,8009,346,4.10000000
CN0401300000000,04,013,"Maricopa County, AZ",Apr-22,2337663,2275433,62230,2.70000000
CN0401500000000,04,015,"Mohave County, AZ",Apr-22,89100,85636,3464,3.90000000
CN0401700000000,04,017,"Navajo County, AZ",Apr-22,38595,36770,1825,4.70000000
CN0401900000000,04,019,"Pima County, AZ",Apr-22,487495,472269,15226,3.10000000
CN0402100000000,04,021,"Pinal County, AZ",Apr-22,193762,187796,5966,3.10000000
CN0402300000000,04,023,"Santa Cruz County, AZ",Apr-22,18825,17589,1236,6.60000000
CN0402500000000,04,025,"Yavapai County, AZ",Apr-22,106451,103681,2770,2.60000000
CN0402700000000,04,027,"Yuma County, AZ",Apr-22,94921,82480,12441,13.10000000
CN0500100000000,05,001,"Arkansas County, AR",Apr-22,9497,9183,314,3.30000000
CN0500300000000,05,003,"Ashley County, AR",Apr-22,6769,6368,401,5.90000000
CN0500500000000,05,005,"Baxter County, AR",Apr-22,16467,15956,511,3.10000000
CN0500700000000,05,007,"Benton County, AR",Apr-22,148127,144907,3220,2.20000000
CN0500900000000,05,009,"Boone County, AR",Apr-22,15816,15441,375,2.40000000
CN0501100000000,05,011,"Bradley County, AR",Apr-22,4112,3944,168,4.10000000
CN0501300000000,05,013,"Calhoun County, AR",Apr-22,2407,2342,65,2.70000000
CN0501500000000,05,015,"Carroll County, AR",Apr-22,12646,12325,321,2.50000000
CN0501700000000,05,017,"Chicot County, AR",Apr-22,3015,2790,225,7.50000000
CN0501900000000,05,019,"Clark County, AR",Apr-22,8747,8413,334,3.80000000
CN0502100000000,05,021,"Clay County, AR",Apr-22,5475,5284,191,3.50000000
CN0502300000000,05,023,"Cleburne County, AR",Apr-22,8881,8531,350,3.90000000
CN0502500000000,05,025,"Cleveland County, AR",Apr-22,3190,3078,112,3.50000000
CN0502700000000,05,027,"Columbia County, AR",Apr-22,8832,8455,377,4.30000000
CN0502900000000,05,029,"Conway County, AR",Apr-22,8408,8122,286,3.40000000
CN0503100000000,05,031,"Craighead County, AR",Apr-22,56545,55134,1411,2.50000000
CN0503300000000,05,033,"Crawford County, AR",Apr-22,26321,25534,787,3.00000000
CN0503500000000,05,035,"Crittenden County, AR",Apr-22,20819,20038,781,3.80000000
CN0503700000000,05,037,"Cross County, AR",Apr-22,7021,6786,235,3.30000000
CN0503900000000,05,039,"Dallas County, AR",Apr-22,2766,2667,99,3.60000000
CN0504100000000,05,041,"Desha County, AR",Apr-22,4929,4652,277,5.60000000
CN0504300000000,05,043,"Drew County, AR",Apr-22,7537,7218,319,4.20000000
CN0504500000000,05,045,"Faulkner County, AR",Apr-22,62217,60513,1704,2.70000000
CN0504700000000,05,047,"Franklin County, AR",Apr-22,7388,7154,234,3.20000000
CN0504900000000,05,049,"Fulton County, AR",Apr-22,5047,4905,142,2.80000000
CN0505100000000,05,051,"Garland County, AR",Apr-22,41001,39427,1574,3.80000000
CN0505300000000,05,053,"Grant County, AR",Apr-22,8363,8127,236,2.80000000
CN0505500000000,05,055,"Greene County, AR",Apr-22,19425,18881,544,2.80000000
CN0505700000000,05,057,"Hempstead County, AR",Apr-22,9075,8809,266,2.90000000
CN0505900000000,05,059,"Hot Spring County, AR",Apr-22,13830,13400,430,3.10000000
CN0506100000000,05,061,"Howard County, AR",Apr-22,5474,5325,149,2.70000000
CN0506300000000,05,063,"Independence County, AR",Apr-22,16737,16232,505,3.00000000
CN0506500000000,05,065,"Izard County, AR",Apr-22,4435,4224,211,4.80000000
CN0506700000000,05,067,"Jackson County, AR",Apr-22,5593,5343,250,4.50000000
CN0506900000000,05,069,"Jefferson County, AR",Apr-22,26540,25012,1528,5.80000000
CN0507100000000,05,071,"Johnson County, AR",Apr-22,9944,9569,375,3.80000000
CN0507300000000,05,073,"Lafayette County, AR",Apr-22,2341,2238,103,4.40000000
CN0507500000000,05,075,"Lawrence County, AR",Apr-22,6800,6569,231,3.40000000
CN0507700000000,05,077,"Lee County, AR",Apr-22,2564,2451,113,4.40000000
CN0507900000000,05,079,"Lincoln County, AR",Apr-22,3835,3673,162,4.20000000
CN0508100000000,05,081,"Little River County, AR",Apr-22,5351,5154,197,3.70000000
CN0508300000000,05,083,"Logan County, AR",Apr-22,8301,8008,293,3.50000000
CN0508500000000,05,085,"Lonoke County, AR",Apr-22,33881,32996,885,2.60000000
CN0508700000000,05,087,"Madison County, AR",Apr-22,7727,7548,179,2.30000000
CN0508900000000,05,089,"Marion County, AR",Apr-22,6274,6068,206,3.30000000
CN0509100000000,05,091,"Miller County, AR",Apr-22,19284,18563,721,3.70000000
CN0509300000000,05,093,"Mississippi County, AR",Apr-22,16324,15360,964,5.90000000
CN0509500000000,05,095,"Monroe County, AR",Apr-22,2658,2545,113,4.30000000
CN0509700000000,05,097,"Montgomery County, AR",Apr-22,2955,2828,127,4.30000000
CN0509900000000,05,099,"Nevada County, AR",Apr-22,3327,3202,125,3.80000000
CN0510100000000,05,101,"Newton County, AR",Apr-22,3210,3127,83,2.60000000
CN0510300000000,05,103,"Ouachita County, AR",Apr-22,9744,9383,361,3.70000000
CN0510500000000,05,105,"Perry County, AR",Apr-22,4189,4040,149,3.60000000
CN0510700000000,05,107,"Phillips County, AR",Apr-22,5772,5390,382,6.60000000
CN0510900000000,05,109,"Pike County, AR",Apr-22,4241,4085,156,3.70000000
CN0511100000000,05,111,"Poinsett County, AR",Apr-22,9891,9582,309,3.10000000
CN0511300000000,05,113,"Polk County, AR",Apr-22,7790,7520,270,3.50000000
CN0511500000000,05,115,"Pope County, AR",Apr-22,27429,26539,890,3.20000000
CN0511700000000,05,117,"Prairie County, AR",Apr-22,3628,3537,91,2.50000000
CN0511900000000,05,119,"Pulaski County, AR",Apr-22,187377,180475,6902,3.70000000
CN0512100000000,05,121,"Randolph County, AR",Apr-22,7264,7045,219,3.00000000
CN0512300000000,05,123,"St. Francis County, AR",Apr-22,7601,7221,380,5.00000000
CN0512500000000,05,125,"Saline County, AR",Apr-22,59062,57567,1495,2.50000000
CN0512700000000,05,127,"Scott County, AR",Apr-22,4179,4072,107,2.60000000
CN0512900000000,05,129,"Searcy County, AR",Apr-22,2947,2839,108,3.70000000
CN0513100000000,05,131,"Sebastian County, AR",Apr-22,55230,53624,1606,2.90000000
CN0513300000000,05,133,"Sevier County, AR",Apr-22,5320,5126,194,3.60000000
CN0513500000000,05,135,"Sharp County, AR",Apr-22,5780,5560,220,3.80000000
CN0513700000000,05,137,"Stone County, AR",Apr-22,4597,4425,172,3.70000000
CN0513900000000,05,139,"Union County, AR",Apr-22,14925,14171,754,5.10000000
CN0514100000000,05,141,"Van Buren County, AR",Apr-22,5937,5717,220,3.70000000
CN0514300000000,05,143,"Washington County, AR",Apr-22,131011,128128,2883,2.20000000
CN0514500000000,05,145,"White County, AR",Apr-22,34021,32882,1139,3.30000000
CN0514700000000,05,147,"Woodruff County, AR",Apr-22,2825,2724,101,3.60000000
CN0514900000000,05,149,"Yell County, AR",Apr-22,7955,7687,268,3.40000000
CN0600100000000,06,001,"Alameda County, CA",Apr-22,821878,798534,23344,2.80000000
CN0600300000000,06,003,"Alpine County, CA",Apr-22,509,485,24,4.70000000
CN0600500000000,06,005,"Amador County, CA",Apr-22,14308,13750,558,3.90000000
CN0600700000000,06,007,"Butte County, CA",Apr-22,92544,88973,3571,3.90000000
CN0600900000000,06,009,"Calaveras County, CA",Apr-22,21590,20940,650,3.00000000
CN0601100000000,06,011,"Colusa County, CA",Apr-22,11010,9884,1126,10.20000000
CN0601300000000,06,013,"Contra Costa County, CA",Apr-22,548891,532012,16879,3.10000000
CN0601500000000,06,015,"Del Norte County, CA",Apr-22,9298,8875,423,4.50000000
CN0601700000000,06,017,"El Dorado County, CA",Apr-22,92514,89919,2595,2.80000000
CN0601900000000,06,019,"Fresno County, CA",Apr-22,453633,426017,27616,6.10000000
CN0602100000000,06,021,"Glenn County, CA",Apr-22,12588,12008,580,4.60000000
CN0602300000000,06,023,"Humboldt County, CA",Apr-22,59434,57458,1976,3.30000000
CN0602500000000,06,025,"Imperial County, CA",Apr-22,67652,59653,7999,11.80000000
CN0602700000000,06,027,"Inyo County, CA",Apr-22,8227,7966,261,3.20000000
CN0602900000000,06,029,"Kern County, CA",Apr-22,383430,357308,26122,6.80000000
CN0603100000000,06,031,"Kings County, CA",Apr-22,56210,52489,3721,6.60000000
CN0603300000000,06,033,"Lake County, CA",Apr-22,28420,27145,1275,4.50000000
CN0603500000000,06,035,"Lassen County, CA",Apr-22,8884,8574,310,3.50000000
CN0603700000000,06,037,"Los Angeles County, CA",Apr-22,5000847,4761695,239152,4.80000000
CN0603900000000,06,039,"Madera County, CA",Apr-22,62490,58894,3596,5.80000000
CN0604100000000,06,041,"Marin County, CA",Apr-22,129167,126492,2675,2.10000000
CN0604300000000,06,043,"Mariposa County, CA",Apr-22,6592,6293,299,4.50000000
CN0604500000000,06,045,"Mendocino County, CA",Apr-22,37082,35776,1306,3.50000000
CN0604700000000,06,047,"Merced County, CA",Apr-22,115613,107071,8542,7.40000000
CN0604900000000,06,049,"Modoc County, CA",Apr-22,3235,3087,148,4.60000000
CN0605100000000,06,051,"Mono County, CA",Apr-22,9287,9016,271,2.90000000
CN0605300000000,06,053,"Monterey County, CA",Apr-22,215219,202662,12557,5.80000000
CN0605500000000,06,055,"Napa County, CA",Apr-22,69566,67649,1917,2.80000000
CN0605700000000,06,057,"Nevada County, CA",Apr-22,47213,45853,1360,2.90000000
CN0605900000000,06,059,"Orange County, CA",Apr-22,1579308,1535966,43342,2.70000000
CN0606100000000,06,061,"Placer County, CA",Apr-22,192015,187397,4618,2.40000000
CN0606300000000,06,063,"Plumas County, CA",Apr-22,7083,6629,454,6.40000000
CN0606500000000,06,065,"Riverside County, CA",Apr-22,1151558,1108151,43407,3.80000000
CN0606700000000,06,067,"Sacramento County, CA",Apr-22,722952,697356,25596,3.50000000
CN0606900000000,06,069,"San Benito County, CA",Apr-22,32686,31165,1521,4.70000000
CN0607100000000,06,071,"San Bernardino County, CA",Apr-22,1008458,970072,38386,3.80000000
CN0607300000000,06,073,"San Diego County, CA",Apr-22,1574833,1527146,47687,3.00000000
CN0607500000000,06,075,"San Francisco County/city, CA",Apr-22,567380,555046,12334,2.20000000
CN0607700000000,06,077,"San Joaquin County, CA",Apr-22,333721,316825,16896,5.10000000
CN0607900000000,06,079,"San Luis Obispo County, CA",Apr-22,136493,133194,3299,2.40000000
CN0608100000000,06,081,"San Mateo County, CA",Apr-22,448617,439869,8748,1.90000000
CN0608300000000,06,083,"Santa Barbara County, CA",Apr-22,223396,217030,6366,2.80000000
CN0608500000000,06,085,"Santa Clara County, CA",Apr-22,1039013,1017120,21893,2.10000000
CN0608700000000,06,087,"Santa Cruz County, CA",Apr-22,133546,127476,6070,4.50000000
CN0608900000000,06,089,"Shasta County, CA",Apr-22,73357,70441,2916,4.00000000
CN0609100000000,06,091,"Sierra County, CA",Apr-22,1296,1244,52,4.00000000
CN0609300000000,06,093,"Siskiyou County, CA",Apr-22,16056,15209,847,5.30000000
CN0609500000000,06,095,"Solano County, CA",Apr-22,199620,191614,8006,4.00000000
CN0609700000000,06,097,"Sonoma County, CA",Apr-22,245869,239485,6384,2.60000000
CN0609900000000,06,099,"Stanislaus County, CA",Apr-22,239701,227376,12325,5.10000000
CN0610100000000,06,101,"Sutter County, CA",Apr-22,45821,42932,2889,6.30000000
CN0610300000000,06,103,"Tehama County, CA",Apr-22,25121,24054,1067,4.20000000
CN0610500000000,06,105,"Trinity County, CA",Apr-22,4293,4127,166,3.90000000
CN0610700000000,06,107,"Tulare County, CA",Apr-22,205319,190032,15287,7.40000000
CN0610900000000,06,109,"Tuolumne County, CA",Apr-22,19845,19054,791,4.00000000
CN0611100000000,06,111,"Ventura County, CA",Apr-22,410154,397650,12504,3.00000000
CN0611300000000,06,113,"Yolo County, CA",Apr-22,108707,105153,3554,3.30000000
CN0611500000000,06,115,"Yuba County, CA",Apr-22,31088,29530,1558,5.00000000
CN0800100000000,08,001,"Adams County, CO",Apr-22,280069,269604,10465,3.70000000
CN0800300000000,08,003,"Alamosa County, CO",Apr-22,8549,8256,293,3.40000000
CN0800500000000,08,005,"Arapahoe County, CO",Apr-22,372863,360319,12544,3.40000000
CN0800700000000,08,007,"Archuleta County, CO",Apr-22,7069,6850,219,3.10000000
CN0800900000000,08,009,"Baca County, CO",Apr-22,2009,1978,31,1.50000000
CN0801100000000,08,011,"Bent County, CO",Apr-22,1820,1748,72,4.00000000
CN0801300000000,08,013,"Boulder County, CO",Apr-22,200159,195326,4833,2.40000000
CN0801400000000,08,014,"Broomfield County/city, CO",Apr-22,42028,40982,1046,2.50000000
CN0801500000000,08,015,"Chaffee County, CO",Apr-22,10139,9900,239,2.40000000
CN0801700000000,08,017,"Cheyenne County, CO",Apr-22,1045,1028,17,1.60000000
CN0801900000000,08,019,"Clear Creek County, CO",Apr-22,6108,5916,192,3.10000000
CN0802100000000,08,021,"Conejos County, CO",Apr-22,4070,3948,122,3.00000000
CN0802300000000,08,023,"Costilla County, CO",Apr-22,1857,1781,76,4.10000000
CN0802500000000,08,025,"Crowley County, CO",Apr-22,1444,1390,54,3.70000000
CN0802700000000,08,027,"Custer County, CO",Apr-22,2385,2324,61,2.60000000
CN0802900000000,08,029,"Delta County, CO",Apr-22,13870,13407,463,3.30000000
CN0803100000000,08,031,"Denver County/city, CO",Apr-22,433681,418828,14853,3.40000000
CN0803300000000,08,033,"Dolores County, CO",Apr-22,1122,1087,35,3.10000000
CN0803500000000,08,035,"Douglas County, CO",Apr-22,205414,200571,4843,2.40000000
CN0803700000000,08,037,"Eagle County, CO",Apr-22,39145,38234,911,2.30000000
CN0803900000000,08,039,"Elbert County, CO",Apr-22,15686,15325,361,2.30000000
CN0804100000000,08,041,"El Paso County, CO",Apr-22,353766,341923,11843,3.30000000
CN0804300000000,08,043,"Fremont County, CO",Apr-22,15589,14863,726,4.70000000
CN0804500000000,08,045,"Garfield County, CO",Apr-22,32268,31391,877,2.70000000
CN0804700000000,08,047,"Gilpin County, CO",Apr-22,3919,3786,133,3.40000000
CN0804900000000,08,049,"Grand County, CO",Apr-22,10547,10307,240,2.30000000
CN0805100000000,08,051,"Gunnison County, CO",Apr-22,11900,11625,275,2.30000000
CN0805300000000,08,053,"Hinsdale County, CO",Apr-22,400,391,9,2.30000000
CN0805500000000,08,055,"Huerfano County, CO",Apr-22,2539,2383,156,6.10000000
CN0805700000000,08,057,"Jackson County, CO",Apr-22,931,914,17,1.80000000
CN0805900000000,08,059,"Jefferson County, CO",Apr-22,339964,330283,9681,2.80000000
CN0806100000000,08,061,"Kiowa County, CO",Apr-22,867,852,15,1.70000000
CN0806300000000,08,063,"Kit Carson County, CO",Apr-22,4061,3984,77,1.90000000
CN0806500000000,08,065,"Lake County, CO",Apr-22,5349,5222,127,2.40000000
CN0806700000000,08,067,"La Plata County, CO",Apr-22,32216,31301,915,2.80000000
CN0806900000000,08,069,"Larimer County, CO",Apr-22,209434,203875,5559,2.70000000
CN0807100000000,08,071,"Las Animas County, CO",Apr-22,6372,6082,290,4.60000000
CN0807300000000,08,073,"Lincoln County, CO",Apr-22,2269,2215,54,2.40000000
CN0807500000000,08,075,"Logan County, CO",Apr-22,10637,10365,272,2.60000000
CN0807700000000,08,077,"Mesa County, CO",Apr-22,78463,75813,2650,3.40000000
CN0807900000000,08,079,"Mineral County, CO",Apr-22,486,476,10,2.10000000
CN0808100000000,08,081,"Moffat County, CO",Apr-22,7189,6971,218,3.00000000
CN0808300000000,08,083,"Montezuma County, CO",Apr-22,13307,12843,464,3.50000000
CN0808500000000,08,085,"Montrose County, CO",Apr-22,22532,21795,737,3.30000000
CN0808700000000,08,087,"Morgan County, CO",Apr-22,15772,15248,524,3.30000000
CN0808900000000,08,089,"Otero County, CO",Apr-22,8131,7801,330,4.10000000
CN0809100000000,08,091,"Ouray County, CO",Apr-22,2728,2649,79,2.90000000
CN0809300000000,08,093,"Park County, CO",Apr-22,11474,11190,284,2.50000000
CN0809500000000,08,095,"Phillips County, CO",Apr-22,2360,2317,43,1.80000000
CN0809700000000,08,097,"Pitkin County, CO",Apr-22,11088,10745,343,3.10000000
CN0809900000000,08,099,"Prowers County, CO",Apr-22,6091,5921,170,2.80000000
CN0810100000000,08,101,"Pueblo County, CO",Apr-22,78432,74417,4015,5.10000000
CN0810300000000,08,103,"Rio Blanco County, CO",Apr-22,2841,2733,108,3.80000000
CN0810500000000,08,105,"Rio Grande County, CO",Apr-22,5287,5057,230,4.40000000
CN0810700000000,08,107,"Routt County, CO",Apr-22,15971,15567,404,2.50000000
CN0810900000000,08,109,"Saguache County, CO",Apr-22,3410,3288,122,3.60000000
CN0811100000000,08,111,"San Juan County, CO",Apr-22,597,583,14,2.30000000
CN0811300000000,08,113,"San Miguel County, CO",Apr-22,6110,5852,258,4.20000000
CN0811500000000,08,115,"Sedgwick County, CO",Apr-22,1136,1112,24,2.10000000
CN0811700000000,08,117,"Summit County, CO",Apr-22,24379,23901,478,2.00000000
CN0811900000000,08,119,"Teller County, CO",Apr-22,13231,12832,399,3.00000000
CN0812100000000,08,121,"Washington County, CO",Apr-22,2623,2560,63,2.40000000
CN0812300000000,08,123,"Weld County, CO",Apr-22,166740,161032,5708,3.40000000
CN0812500000000,08,125,"Yuma County, CO",Apr-22,5390,5290,100,1.90000000
CN0900100000000,09,001,"Fairfield County, CT",Apr-22,467815,450693,17122,3.70000000
CN0900300000000,09,003,"Hartford County, CT",Apr-22,471371,452320,19051,4.00000000
CN0900500000000,09,005,"Litchfield County, CT",Apr-22,101797,98366,3431,3.40000000
CN0900700000000,09,007,"Middlesex County, CT",Apr-22,91776,89042,2734,3.00000000
CN0900900000000,09,009,"New Haven County, CT",Apr-22,455189,437525,17664,3.90000000
CN0901100000000,09,011,"New London County, CT",Apr-22,128962,123866,5096,4.00000000
CN0901300000000,09,013,"Tolland County, CT",Apr-22,84571,82107,2464,2.90000000
CN0901500000000,09,015,"Windham County, CT",Apr-22,61999,59789,2210,3.60000000
CN1000100000000,10,001,"Kent County, DE",Apr-22,81725,77570,4155,5.10000000
CN1000300000000,10,003,"New Castle County, DE",Apr-22,305721,292676,13045,4.30000000
CN1000500000000,10,005,"Sussex County, DE",Apr-22,110799,106110,4689,4.20000000
CN1100100000000,11,001,District of Columbia,Apr-22,386488,370349,16139,4.20000000
CN1200100000000,12,001,"Alachua County, FL",Apr-22,142570,139550,3020,2.10000000
CN1200300000000,12,003,"Baker County, FL",Apr-22,12431,12170,261,2.10000000
CN1200500000000,12,005,"Bay County, FL",Apr-22,87368,85570,1798,2.10000000
CN1200700000000,12,007,"Bradford County, FL",Apr-22,10949,10680,269,2.50000000
CN1200900000000,12,009,"Brevard County, FL",Apr-22,292847,286305,6542,2.20000000
CN1201100000000,12,011,"Broward County, FL",Apr-22,1045163,1018764,26399,2.50000000
CN1201300000000,12,013,"Calhoun County, FL",Apr-22,4915,4795,120,2.40000000
CN1201500000000,12,015,"Charlotte County, FL",Apr-22,75280,73453,1827,2.40000000
CN1201700000000,12,017,"Citrus County, FL",Apr-22,47484,45929,1555,3.30000000
CN1201900000000,12,019,"Clay County, FL",Apr-22,111056,108819,2237,2.00000000
CN1202100000000,12,021,"Collier County, FL",Apr-22,187514,183892,3622,1.90000000
CN1202300000000,12,023,"Columbia County, FL",Apr-22,29103,28351,752,2.60000000
CN1202700000000,12,027,"DeSoto County, FL",Apr-22,15630,15311,319,2.00000000
CN1202900000000,12,029,"Dixie County, FL",Apr-22,5892,5745,147,2.50000000
CN1203100000000,12,031,"Duval County, FL",Apr-22,504791,492259,12532,2.50000000
CN1203300000000,12,033,"Escambia County, FL",Apr-22,148992,145328,3664,2.50000000
CN1203500000000,12,035,"Flagler County, FL",Apr-22,49117,47835,1282,2.60000000
CN1203700000000,12,037,"Franklin County, FL",Apr-22,4842,4737,105,2.20000000
CN1203900000000,12,039,"Gadsden County, FL",Apr-22,20223,19614,609,3.00000000
CN1204100000000,12,041,"Gilchrist County, FL",Apr-22,7352,7189,163,2.20000000
CN1204300000000,12,043,"Glades County, FL",Apr-22,5414,5295,119,2.20000000
CN1204500000000,12,045,"Gulf County, FL",Apr-22,5370,5267,103,1.90000000
CN1204700000000,12,047,"Hamilton County, FL",Apr-22,4057,3919,138,3.40000000
CN1204900000000,12,049,"Hardee County, FL",Apr-22,9192,8949,243,2.60000000
CN1205100000000,12,051,"Hendry County, FL",Apr-22,16616,16068,548,3.30000000
CN1205300000000,12,053,"Hernando County, FL",Apr-22,75322,73157,2165,2.90000000
CN1205500000000,12,055,"Highlands County, FL",Apr-22,34570,33362,1208,3.50000000
CN1205700000000,12,057,"Hillsborough County, FL",Apr-22,791276,773390,17886,2.30000000
CN1205900000000,12,059,"Holmes County, FL",Apr-22,6965,6802,163,2.30000000
CN1206100000000,12,061,"Indian River County, FL",Apr-22,66324,64511,1813,2.70000000
CN1206300000000,12,063,"Jackson County, FL",Apr-22,17134,16687,447,2.60000000
CN1206500000000,12,065,"Jefferson County, FL",Apr-22,5708,5567,141,2.50000000
CN1206700000000,12,067,"Lafayette County, FL",Apr-22,2782,2711,71,2.60000000
CN1206900000000,12,069,"Lake County, FL",Apr-22,165644,161519,4125,2.50000000
CN1207100000000,12,071,"Lee County, FL",Apr-22,367926,359776,8150,2.20000000
CN1207300000000,12,073,"Leon County, FL",Apr-22,157444,153645,3799,2.40000000
CN1207500000000,12,075,"Levy County, FL",Apr-22,16962,16520,442,2.60000000
CN1207700000000,12,077,"Liberty County, FL",Apr-22,2581,2519,62,2.40000000
CN1207900000000,12,079,"Madison County, FL",Apr-22,7844,7628,216,2.80000000
CN1208100000000,12,081,"Manatee County, FL",Apr-22,190642,186669,3973,2.10000000
CN1208300000000,12,083,"Marion County, FL",Apr-22,142538,138568,3970,2.80000000
CN1208500000000,12,085,"Martin County, FL",Apr-22,75109,73594,1515,2.00000000
CN1208600000000,12,086,"Miami-Dade County, FL",Apr-22,1361251,1325974,35277,2.60000000
CN1208700000000,12,087,"Monroe County, FL",Apr-22,48851,48140,711,1.50000000
CN1208900000000,12,089,"Nassau County, FL",Apr-22,43971,43154,817,1.90000000
CN1209100000000,12,091,"Okaloosa County, FL",Apr-22,101013,99148,1865,1.80000000
CN1209300000000,12,093,"Okeechobee County, FL",Apr-22,17700,17273,427,2.40000000
CN1209500000000,12,095,"Orange County, FL",Apr-22,767389,747029,20360,2.70000000
CN1209700000000,12,097,"Osceola County, FL",Apr-22,191436,185130,6306,3.30000000
CN1209900000000,12,099,"Palm Beach County, FL",Apr-22,753605,736176,17429,2.30000000
CN1210100000000,12,101,"Pasco County, FL",Apr-22,253486,247378,6108,2.40000000
CN1210300000000,12,103,"Pinellas County, FL",Apr-22,500507,489986,10521,2.10000000
CN1210500000000,12,105,"Polk County, FL",Apr-22,335744,325960,9784,2.90000000
CN1210700000000,12,107,"Putnam County, FL",Apr-22,27284,26313,971,3.60000000
CN1210900000000,12,109,"St. Johns County, FL",Apr-22,146375,143865,2510,1.70000000
CN1211100000000,12,111,"St. Lucie County, FL",Apr-22,152828,148600,4228,2.80000000
CN1211300000000,12,113,"Santa Rosa County, FL",Apr-22,87180,85456,1724,2.00000000
CN1211500000000,12,115,"Sarasota County, FL",Apr-22,199460,195345,4115,2.10000000
CN1211700000000,12,117,"Seminole County, FL",Apr-22,254783,249211,5572,2.20000000
CN1211900000000,12,119,"Sumter County, FL",Apr-22,35512,34444,1068,3.00000000
CN1212100000000,12,121,"Suwannee County, FL",Apr-22,17308,16873,435,2.50000000
CN1212300000000,12,123,"Taylor County, FL",Apr-22,7858,7643,215,2.70000000
CN1212500000000,12,125,"Union County, FL",Apr-22,4567,4477,90,2.00000000
CN1212700000000,12,127,"Volusia County, FL",Apr-22,259265,252678,6587,2.50000000
CN1212900000000,12,129,"Wakulla County, FL",Apr-22,15869,15558,311,2.00000000
CN1213100000000,12,131,"Walton County, FL",Apr-22,34253,33589,664,1.90000000
CN1213300000000,12,133,"Washington County, FL",Apr-22,9573,9326,247,2.60000000
CN1300100000000,13,001,"Appling County, GA",Apr-22,9130,8878,252,2.80000000
CN1300300000000,13,003,"Atkinson County, GA",Apr-22,4587,4495,92,2.00000000
CN1300500000000,13,005,"Bacon County, GA",Apr-22,4857,4749,108,2.20000000
CN1300700000000,13,007,"Baker County, GA",Apr-22,1161,1120,41,3.50000000
CN1300900000000,13,009,"Baldwin County, GA",Apr-22,17503,16968,535,3.10000000
CN1301100000000,13,011,"Banks County, GA",Apr-22,10110,9938,172,1.70000000
CN1301300000000,13,013,"Barrow County, GA",Apr-22,43220,42427,793,1.80000000
CN1301500000000,13,015,"Bartow County, GA",Apr-22,52475,51337,1138,2.20000000
CN1301700000000,13,017,"Ben Hill County, GA",Apr-22,5479,5295,184,3.40000000
CN1301900000000,13,019,"Berrien County, GA",Apr-22,7596,7412,184,2.40000000
CN1302100000000,13,021,"Bibb County, GA",Apr-22,67739,65637,2102,3.10000000
CN1302300000000,13,023,"Bleckley County, GA",Apr-22,4602,4459,143,3.10000000
CN1302500000000,13,025,"Brantley County, GA",Apr-22,7410,7226,184,2.50000000
CN1302700000000,13,027,"Brooks County, GA",Apr-22,6837,6686,151,2.20000000
CN1302900000000,13,029,"Bryan County, GA",Apr-22,20374,19993,381,1.90000000
CN1303100000000,13,031,"Bulloch County, GA",Apr-22,37675,36709,966,2.60000000
CN1303300000000,13,033,"Burke County, GA",Apr-22,9275,8861,414,4.50000000
CN1303500000000,13,035,"Butts County, GA",Apr-22,11384,11136,248,2.20000000
CN1303700000000,13,037,"Calhoun County, GA",Apr-22,2290,2233,57,2.50000000
CN1303900000000,13,039,"Camden County, GA",Apr-22,21498,21015,483,2.20000000
CN1304300000000,13,043,"Candler County, GA",Apr-22,6106,5989,117,1.90000000
CN1304500000000,13,045,"Carroll County, GA",Apr-22,57434,56109,1325,2.30000000
CN1304700000000,13,047,"Catoosa County, GA",Apr-22,33464,32824,640,1.90000000
CN1304900000000,13,049,"Charlton County, GA",Apr-22,4943,4819,124,2.50000000
CN1305100000000,13,051,"Chatham County, GA",Apr-22,146148,142397,3751,2.60000000
CN1305300000000,13,053,"Chattahoochee County, GA",Apr-22,1935,1865,70,3.60000000
CN1305500000000,13,055,"Chattooga County, GA",Apr-22,9360,8963,397,4.20000000
CN1305700000000,13,057,"Cherokee County, GA",Apr-22,143237,140789,2448,1.70000000
CN1305900000000,13,059,"Clarke County, GA",Apr-22,60802,59419,1383,2.30000000
CN1306100000000,13,061,"Clay County, GA",Apr-22,877,808,69,7.90000000
CN1306300000000,13,063,"Clayton County, GA",Apr-22,141885,136063,5822,4.10000000
CN1306500000000,13,065,"Clinch County, GA",Apr-22,3124,3063,61,2.00000000
CN1306700000000,13,067,"Cobb County, GA",Apr-22,433332,424506,8826,2.00000000
CN1306900000000,13,069,"Coffee County, GA",Apr-22,18341,17812,529,2.90000000
CN1307100000000,13,071,"Colquitt County, GA",Apr-22,22139,21662,477,2.20000000
CN1307300000000,13,073,"Columbia County, GA",Apr-22,77742,76208,1534,2.00000000
CN1307500000000,13,075,"Cook County, GA",Apr-22,8232,8029,203,2.50000000
CN1307700000000,13,077,"Coweta County, GA",Apr-22,78064,76433,1631,2.10000000
CN1307900000000,13,079,"Crawford County, GA",Apr-22,5556,5432,124,2.20000000
CN1308100000000,13,081,"Crisp County, GA",Apr-22,9261,8868,393,4.20000000
CN1308300000000,13,083,"Dade County, GA",Apr-22,8058,7914,144,1.80000000
CN1308500000000,13,085,"Dawson County, GA",Apr-22,13485,13242,243,1.80000000
CN1308700000000,13,087,"Decatur County, GA",Apr-22,11377,11092,285,2.50000000
CN1308900000000,13,089,"DeKalb County, GA",Apr-22,407643,396352,11291,2.80000000
CN1309100000000,13,091,"Dodge County, GA",Apr-22,6971,6767,204,2.90000000
CN1309300000000,13,093,"Dooly County, GA",Apr-22,4703,4526,177,3.80000000
CN1309500000000,13,095,"Dougherty County, GA",Apr-22,37077,35608,1469,4.00000000
CN1309700000000,13,097,"Douglas County, GA",Apr-22,75444,73401,2043,2.70000000
CN1309900000000,13,099,"Early County, GA",Apr-22,4276,4136,140,3.30000000
CN1310100000000,13,101,"Echols County, GA",Apr-22,1927,1893,34,1.80000000
CN1310300000000,13,103,"Effingham County, GA",Apr-22,34088,33422,666,2.00000000
CN1310500000000,13,105,"Elbert County, GA",Apr-22,7703,7465,238,3.10000000
CN1310700000000,13,107,"Emanuel County, GA",Apr-22,8633,8344,289,3.30000000
CN1310900000000,13,109,"Evans County, GA",Apr-22,5172,5055,117,2.30000000
CN1311100000000,13,111,"Fannin County, GA",Apr-22,11771,11546,225,1.90000000
CN1311300000000,13,113,"Fayette County, GA",Apr-22,59717,58590,1127,1.90000000
CN1311500000000,13,115,"Floyd County, GA",Apr-22,43785,42736,1049,2.40000000
CN1311700000000,13,117,"Forsyth County, GA",Apr-22,130679,128515,2164,1.70000000
CN1311900000000,13,119,"Franklin County, GA",Apr-22,10050,9827,223,2.20000000
CN1312100000000,13,121,"Fulton County, GA",Apr-22,579010,562933,16077,2.80000000
CN1312300000000,13,123,"Gilmer County, GA",Apr-22,12288,12019,269,2.20000000
CN1312500000000,13,125,"Glascock County, GA",Apr-22,1277,1252,25,2.00000000
CN1312700000000,13,127,"Glynn County, GA",Apr-22,39559,38636,923,2.30000000
CN1312900000000,13,129,"Gordon County, GA",Apr-22,28996,28383,613,2.10000000
CN1313100000000,13,131,"Grady County, GA",Apr-22,11132,10878,254,2.30000000
CN1313300000000,13,133,"Greene County, GA",Apr-22,7176,7006,170,2.40000000
CN1313500000000,13,135,"Gwinnett County, GA",Apr-22,503339,492574,10765,2.10000000
CN1313700000000,13,137,"Habersham County, GA",Apr-22,18528,18114,414,2.20000000
CN1313900000000,13,139,"Hall County, GA",Apr-22,106037,104188,1849,1.70000000
CN1314100000000,13,141,"Hancock County, GA",Apr-22,2519,2410,109,4.30000000
CN1314300000000,13,143,"Haralson County, GA",Apr-22,13054,12759,295,2.30000000
CN1314500000000,13,145,"Harris County, GA",Apr-22,17038,16700,338,2.00000000
CN1314700000000,13,147,"Hart County, GA",Apr-22,11814,11531,283,2.40000000
CN1314900000000,13,149,"Heard County, GA",Apr-22,5354,5230,124,2.30000000
CN1315100000000,13,151,"Henry County, GA",Apr-22,121166,117997,3169,2.60000000
CN1315300000000,13,153,"Houston County, GA",Apr-22,71370,69742,1628,2.30000000
CN1315500000000,13,155,"Irwin County, GA",Apr-22,3546,3443,103,2.90000000
CN1315700000000,13,157,"Jackson County, GA",Apr-22,43178,42477,701,1.60000000
CN1315900000000,13,159,"Jasper County, GA",Apr-22,7252,7103,149,2.10000000
CN1316100000000,13,161,"Jeff Davis County, GA",Apr-22,6170,6015,155,2.50000000
CN1316300000000,13,163,"Jefferson County, GA",Apr-22,7009,6794,215,3.10000000
CN1316500000000,13,165,"Jenkins County, GA",Apr-22,3163,3056,107,3.40000000
CN1316700000000,13,167,"Johnson County, GA",Apr-22,4051,3956,95,2.30000000
CN1316900000000,13,169,"Jones County, GA",Apr-22,13769,13485,284,2.10000000
CN1317100000000,13,171,"Lamar County, GA",Apr-22,8410,8196,214,2.50000000
CN1317300000000,13,173,"Lanier County, GA",Apr-22,3820,3729,91,2.40000000
CN1317500000000,13,175,"Laurens County, GA",Apr-22,19252,18683,569,3.00000000
CN1317700000000,13,177,"Lee County, GA",Apr-22,15243,14921,322,2.10000000
CN1317900000000,13,179,"Liberty County, GA",Apr-22,26252,25554,698,2.70000000
CN1318100000000,13,181,"Lincoln County, GA",Apr-22,3619,3517,102,2.80000000
CN1318300000000,13,183,"Long County, GA",Apr-22,8539,8331,208,2.40000000
CN1318500000000,13,185,"Lowndes County, GA",Apr-22,51099,49837,1262,2.50000000
CN1318700000000,13,187,"Lumpkin County, GA",Apr-22,17393,17088,305,1.80000000
CN1318900000000,13,189,"McDuffie County, GA",Apr-22,8607,8307,300,3.50000000
CN1319100000000,13,191,"McIntosh County, GA",Apr-22,6225,6077,148,2.40000000
CN1319300000000,13,193,"Macon County, GA",Apr-22,4609,4453,156,3.40000000
CN1319500000000,13,195,"Madison County, GA",Apr-22,14039,13756,283,2.00000000
CN1319700000000,13,197,"Marion County, GA",Apr-22,3278,3199,79,2.40000000
CN1319900000000,13,199,"Meriwether County, GA",Apr-22,9058,8753,305,3.40000000
CN1320100000000,13,201,"Miller County, GA",Apr-22,2761,2701,60,2.20000000
CN1320500000000,13,205,"Mitchell County, GA",Apr-22,8121,7859,262,3.20000000
CN1320700000000,13,207,"Monroe County, GA",Apr-22,13223,12965,258,2.00000000
CN1320900000000,13,209,"Montgomery County, GA",Apr-22,3710,3606,104,2.80000000
CN1321100000000,13,211,"Morgan County, GA",Apr-22,9776,9576,200,2.00000000
CN1321300000000,13,213,"Murray County, GA",Apr-22,15380,14972,408,2.70000000
CN1321500000000,13,215,"Muscogee County, GA",Apr-22,76461,73766,2695,3.50000000
CN1321700000000,13,217,"Newton County, GA",Apr-22,54494,52995,1499,2.80000000
CN1321900000000,13,219,"Oconee County, GA",Apr-22,21017,20702,315,1.50000000
CN1322100000000,13,221,"Oglethorpe County, GA",Apr-22,7278,7144,134,1.80000000
CN1322300000000,13,223,"Paulding County, GA",Apr-22,91762,89939,1823,2.00000000
CN1322500000000,13,225,"Peach County, GA",Apr-22,11980,11647,333,2.80000000
CN1322700000000,13,227,"Pickens County, GA",Apr-22,15969,15663,306,1.90000000
CN1322900000000,13,229,"Pierce County, GA",Apr-22,8482,8309,173,2.00000000
CN1323100000000,13,231,"Pike County, GA",Apr-22,9228,9058,170,1.80000000
CN1323300000000,13,233,"Polk County, GA",Apr-22,18341,17933,408,2.20000000
CN1323500000000,13,235,"Pulaski County, GA",Apr-22,4050,3957,93,2.30000000
CN1323700000000,13,237,"Putnam County, GA",Apr-22,8661,8424,237,2.70000000
CN1323900000000,13,239,"Quitman County, GA",Apr-22,755,730,25,3.30000000
CN1324100000000,13,241,"Rabun County, GA",Apr-22,7320,7157,163,2.20000000
CN1324300000000,13,243,"Randolph County, GA",Apr-22,2388,2301,87,3.60000000
CN1324500000000,13,245,"Richmond County, GA",Apr-22,84833,81826,3007,3.50000000
CN1324700000000,13,247,"Rockdale County, GA",Apr-22,45451,44114,1337,2.90000000
CN1324900000000,13,249,"Schley County, GA",Apr-22,2106,2046,60,2.80000000
CN1325100000000,13,251,"Screven County, GA",Apr-22,5003,4828,175,3.50000000
CN1325300000000,13,253,"Seminole County, GA",Apr-22,3001,2920,81,2.70000000
CN1325500000000,13,255,"Spalding County, GA",Apr-22,29453,28670,783,2.70000000
CN1325700000000,13,257,"Stephens County, GA",Apr-22,10326,10057,269,2.60000000
CN1325900000000,13,259,"Stewart County, GA",Apr-22,2563,2487,76,3.00000000
CN1326100000000,13,261,"Sumter County, GA",Apr-22,12014,11590,424,3.50000000
CN1326300000000,13,263,"Talbot County, GA",Apr-22,2792,2712,80,2.90000000
CN1326500000000,13,265,"Taliaferro County, GA",Apr-22,528,513,15,2.80000000
CN1326700000000,13,267,"Tattnall County, GA",Apr-22,9800,9577,223,2.30000000
CN1326900000000,13,269,"Taylor County, GA",Apr-22,2859,2759,100,3.50000000
CN1327100000000,13,271,"Telfair County, GA",Apr-22,3655,3487,168,4.60000000
CN1327300000000,13,273,"Terrell County, GA",Apr-22,3555,3401,154,4.30000000
CN1327500000000,13,275,"Thomas County, GA",Apr-22,17428,16961,467,2.70000000
CN1327700000000,13,277,"Tift County, GA",Apr-22,21201,20757,444,2.10000000
CN1327900000000,13,279,"Toombs County, GA",Apr-22,11688,11345,343,2.90000000
CN1328100000000,13,281,"Towns County, GA",Apr-22,4083,3969,114,2.80000000
CN1328300000000,13,283,"Treutlen County, GA",Apr-22,2581,2510,71,2.80000000
CN1328500000000,13,285,"Troup County, GA",Apr-22,37041,36128,913,2.50000000
CN1328700000000,13,287,"Turner County, GA",Apr-22,3228,3106,122,3.80000000
CN1328900000000,13,289,"Twiggs County, GA",Apr-22,2818,2714,104,3.70000000
CN1329100000000,13,291,"Union County, GA",Apr-22,11173,10964,209,1.90000000
CN1329300000000,13,293,"Upson County, GA",Apr-22,11650,11380,270,2.30000000
CN1329500000000,13,295,"Walker County, GA",Apr-22,31279,30609,670,2.10000000
CN1329700000000,13,297,"Walton County, GA",Apr-22,48168,47164,1004,2.10000000
CN1329900000000,13,299,"Ware County, GA",Apr-22,15080,14735,345,2.30000000
CN1330100000000,13,301,"Warren County, GA",Apr-22,2656,2585,71,2.70000000
CN1330300000000,13,303,"Washington County, GA",Apr-22,6638,6414,224,3.40000000
CN1330500000000,13,305,"Wayne County, GA",Apr-22,11851,11568,283,2.40000000
CN1330700000000,13,307,"Webster County, GA",Apr-22,988,960,28,2.80000000
CN1330900000000,13,309,"Wheeler County, GA",Apr-22,1626,1565,61,3.80000000
CN1331100000000,13,311,"White County, GA",Apr-22,16408,16128,280,1.70000000
CN1331300000000,13,313,"Whitfield County, GA",Apr-22,43163,42054,1109,2.60000000
CN1331500000000,13,315,"Wilcox County, GA",Apr-22,2731,2652,79,2.90000000
CN1331700000000,13,317,"Wilkes County, GA",Apr-22,3652,3529,123,3.40000000
CN1331900000000,13,319,"Wilkinson County, GA",Apr-22,3600,3503,97,2.70000000
CN1332100000000,13,321,"Worth County, GA",Apr-22,8905,8694,211,2.40000000
CN1500100000000,15,001,"Hawaii County, HI",Apr-22,92734,89445,3289,3.50000000
CN1500300000000,15,003,"Honolulu County/city, HI",Apr-22,454301,439099,15202,3.30000000
CN1500700000000,15,007,"Kauai County, HI",Apr-22,36067,34465,1602,4.40000000
CN1500900000000,15,009,"Maui County, HI",Apr-22,86347,82683,3664,4.20000000
CN1600100000000,16,001,"Ada County, ID",Apr-22,273662,267782,5880,2.10000000
CN1600300000000,16,003,"Adams County, ID",Apr-22,1744,1618,126,7.20000000
CN1600500000000,16,005,"Bannock County, ID",Apr-22,44657,43527,1130,2.50000000
CN1600700000000,16,007,"Bear Lake County, ID",Apr-22,3252,3167,85,2.60000000
CN1600900000000,16,009,"Benewah County, ID",Apr-22,4085,3867,218,5.30000000
CN1601100000000,16,011,"Bingham County, ID",Apr-22,24728,24152,576,2.30000000
CN1601300000000,16,013,"Blaine County, ID",Apr-22,12748,12389,359,2.80000000
CN1601500000000,16,015,"Boise County, ID",Apr-22,3822,3657,165,4.30000000
CN1601700000000,16,017,"Bonner County, ID",Apr-22,21899,21036,863,3.90000000
CN1601900000000,16,019,"Bonneville County, ID",Apr-22,62656,61307,1349,2.20000000
CN1602100000000,16,021,"Boundary County, ID",Apr-22,5783,5549,234,4.00000000
CN1602300000000,16,023,"Butte County, ID",Apr-22,1500,1452,48,3.20000000
CN1602500000000,16,025,"Camas County, ID",Apr-22,716,692,24,3.40000000
CN1602700000000,16,027,"Canyon County, ID",Apr-22,112521,109491,3030,2.70000000
CN1602900000000,16,029,"Caribou County, ID",Apr-22,4242,4126,116,2.70000000
CN1603100000000,16,031,"Cassia County, ID",Apr-22,12864,12563,301,2.30000000
CN1603300000000,16,033,"Clark County, ID",Apr-22,385,371,14,3.60000000
CN1603500000000,16,035,"Clearwater County, ID",Apr-22,3018,2811,207,6.90000000
CN1603700000000,16,037,"Custer County, ID",Apr-22,2127,2050,77,3.60000000
CN1603900000000,16,039,"Elmore County, ID",Apr-22,12219,11895,324,2.70000000
CN1604100000000,16,041,"Franklin County, ID",Apr-22,7683,7550,133,1.70000000
CN1604300000000,16,043,"Fremont County, ID",Apr-22,8548,8326,222,2.60000000
CN1604500000000,16,045,"Gem County, ID",Apr-22,8913,8652,261,2.90000000
CN1604700000000,16,047,"Gooding County, ID",Apr-22,8534,8333,201,2.40000000
CN1604900000000,16,049,"Idaho County, ID",Apr-22,6884,6599,285,4.10000000
CN1605100000000,16,051,"Jefferson County, ID",Apr-22,15163,14868,295,1.90000000
CN1605300000000,16,053,"Jerome County, ID",Apr-22,12842,12540,302,2.40000000
CN1605500000000,16,055,"Kootenai County, ID",Apr-22,85039,82476,2563,3.00000000
CN1605700000000,16,057,"Latah County, ID",Apr-22,21129,20630,499,2.40000000
CN1605900000000,16,059,"Lemhi County, ID",Apr-22,3655,3496,159,4.40000000
CN1606100000000,16,061,"Lewis County, ID",Apr-22,1682,1611,71,4.20000000
CN1606300000000,16,063,"Lincoln County, ID",Apr-22,2698,2600,98,3.60000000
CN1606500000000,16,065,"Madison County, ID",Apr-22,24155,23800,355,1.50000000
CN1606700000000,16,067,"Minidoka County, ID",Apr-22,12169,11896,273,2.20000000
CN1606900000000,16,069,"Nez Perce County, ID",Apr-22,21354,20842,512,2.40000000
CN1607100000000,16,071,"Oneida County, ID",Apr-22,2782,2733,49,1.80000000
CN1607300000000,16,073,"Owyhee County, ID",Apr-22,5723,5548,175,3.10000000
CN1607500000000,16,075,"Payette County, ID",Apr-22,12286,11938,348,2.80000000
CN1607700000000,16,077,"Power County, ID",Apr-22,4343,4226,117,2.70000000
CN1607900000000,16,079,"Shoshone County, ID",Apr-22,5506,5193,313,5.70000000
CN1608100000000,16,081,"Teton County, ID",Apr-22,6989,6823,166,2.40000000
CN1608300000000,16,083,"Twin Falls County, ID",Apr-22,43510,42433,1077,2.50000000
CN1608500000000,16,085,"Valley County, ID",Apr-22,5546,5276,270,4.90000000
CN1608700000000,16,087,"Washington County, ID",Apr-22,4874,4719,155,3.20000000
CN1700100000000,17,001,"Adams County, IL",Apr-22,30219,29180,1039,3.40000000
CN1700300000000,17,003,"Alexander County, IL",Apr-22,1813,1670,143,7.90000000
CN1700500000000,17,005,"Bond County, IL",Apr-22,7392,7081,311,4.20000000
CN1700700000000,17,007,"Boone County, IL",Apr-22,25144,23181,1963,7.80000000
CN1700900000000,17,009,"Brown County, IL",Apr-22,3084,3019,65,2.10000000
CN1701100000000,17,011,"Bureau County, IL",Apr-22,16102,15341,761,4.70000000
CN1701300000000,17,013,"Calhoun County, IL",Apr-22,2143,2057,86,4.00000000
CN1701500000000,17,015,"Carroll County, IL",Apr-22,7372,7090,282,3.80000000
CN1701700000000,17,017,"Cass County, IL",Apr-22,5539,5291,248,4.50000000
CN1701900000000,17,019,"Champaign County, IL",Apr-22,109157,104736,4421,4.10000000
CN1702100000000,17,021,"Christian County, IL",Apr-22,13229,12566,663,5.00000000
CN1702300000000,17,023,"Clark County, IL",Apr-22,7031,6717,314,4.50000000
CN1702500000000,17,025,"Clay County, IL",Apr-22,5739,5459,280,4.90000000
CN1702700000000,17,027,"Clinton County, IL",Apr-22,19623,19049,574,2.90000000
CN1702900000000,17,029,"Coles County, IL",Apr-22,22464,21421,1043,4.60000000
CN1703100000000,17,031,"Cook County, IL",Apr-22,2646595,2528036,118559,4.50000000
CN1703300000000,17,033,"Crawford County, IL",Apr-22,8524,8137,387,4.50000000
CN1703500000000,17,035,"Cumberland County, IL",Apr-22,5947,5741,206,3.50000000
CN1703700000000,17,037,"DeKalb County, IL",Apr-22,53163,50573,2590,4.90000000
CN1703900000000,17,039,"De Witt County, IL",Apr-22,7200,6903,297,4.10000000
CN1704100000000,17,041,"Douglas County, IL",Apr-22,9992,9651,341,3.40000000
CN1704300000000,17,043,"DuPage County, IL",Apr-22,514200,500219,13981,2.70000000
CN1704500000000,17,045,"Edgar County, IL",Apr-22,8893,8578,315,3.50000000
CN1704700000000,17,047,"Edwards County, IL",Apr-22,2486,2377,109,4.40000000
CN1704900000000,17,049,"Effingham County, IL",Apr-22,19429,18826,603,3.10000000
CN1705100000000,17,051,"Fayette County, IL",Apr-22,9746,9293,453,4.60000000
CN1705300000000,17,053,"Ford County, IL",Apr-22,6245,5997,248,4.00000000
CN1705500000000,17,055,"Franklin County, IL",Apr-22,15608,14686,922,5.90000000
CN1705700000000,17,057,"Fulton County, IL",Apr-22,14253,13503,750,5.30000000
CN1705900000000,17,059,"Gallatin County, IL",Apr-22,1987,1875,112,5.60000000
CN1706100000000,17,061,"Greene County, IL",Apr-22,5801,5562,239,4.10000000
CN1706300000000,17,063,"Grundy County, IL",Apr-22,25851,24951,900,3.50000000
CN1706500000000,17,065,"Hamilton County, IL",Apr-22,4230,4078,152,3.60000000
CN1706700000000,17,067,"Hancock County, IL",Apr-22,8073,7741,332,4.10000000
CN1706900000000,17,069,"Hardin County, IL",Apr-22,1293,1215,78,6.00000000
CN1707100000000,17,071,"Henderson County, IL",Apr-22,3550,3410,140,3.90000000
CN1707300000000,17,073,"Henry County, IL",Apr-22,23816,22744,1072,4.50000000
CN1707500000000,17,075,"Iroquois County, IL",Apr-22,12643,12051,592,4.70000000
CN1707700000000,17,077,"Jackson County, IL",Apr-22,27424,26181,1243,4.50000000
CN1707900000000,17,079,"Jasper County, IL",Apr-22,4777,4598,179,3.70000000
CN1708100000000,17,081,"Jefferson County, IL",Apr-22,16232,15330,902,5.60000000
CN1708300000000,17,083,"Jersey County, IL",Apr-22,10455,10068,387,3.70000000
CN1708500000000,17,085,"Jo Daviess County, IL",Apr-22,10301,9911,390,3.80000000
CN1708700000000,17,087,"Johnson County, IL",Apr-22,4177,3938,239,5.70000000
CN1708900000000,17,089,"Kane County, IL",Apr-22,261196,247471,13725,5.30000000
CN1709100000000,17,091,"Kankakee County, IL",Apr-22,51985,48812,3173,6.10000000
CN1709300000000,17,093,"Kendall County, IL",Apr-22,71704,69603,2101,2.90000000
CN1709500000000,17,095,"Knox County, IL",Apr-22,20146,18936,1210,6.00000000
CN1709700000000,17,097,"Lake County, IL",Apr-22,363776,346855,16921,4.70000000
CN1709900000000,17,099,"LaSalle County, IL",Apr-22,51980,49124,2856,5.50000000
CN1710100000000,17,101,"Lawrence County, IL",Apr-22,5479,5164,315,5.70000000
CN1710300000000,17,103,"Lee County, IL",Apr-22,16565,15867,698,4.20000000
CN1710500000000,17,105,"Livingston County, IL",Apr-22,15326,14664,662,4.30000000
CN1710700000000,17,107,"Logan County, IL",Apr-22,11741,11242,499,4.30000000
CN1710900000000,17,109,"McDonough County, IL",Apr-22,12858,12322,536,4.20000000
CN1711100000000,17,111,"McHenry County, IL",Apr-22,167933,162888,5045,3.00000000
CN1711300000000,17,113,"McLean County, IL",Apr-22,87162,83872,3290,3.80000000
CN1711500000000,17,115,"Macon County, IL",Apr-22,46468,43225,3243,7.00000000
CN1711700000000,17,117,"Macoupin County, IL",Apr-22,21834,20965,869,4.00000000
CN1711900000000,17,119,"Madison County, IL",Apr-22,129735,124398,5337,4.10000000
CN1712100000000,17,121,"Marion County, IL",Apr-22,16450,15580,870,5.30000000
CN1712300000000,17,123,"Marshall County, IL",Apr-22,5046,4781,265,5.30000000
CN1712500000000,17,125,"Mason County, IL",Apr-22,5763,5486,277,4.80000000
CN1712700000000,17,127,"Massac County, IL",Apr-22,5229,4957,272,5.20000000
CN1712900000000,17,129,"Menard County, IL",Apr-22,6179,5946,233,3.80000000
CN1713100000000,17,131,"Mercer County, IL",Apr-22,7567,7258,309,4.10000000
CN1713300000000,17,133,"Monroe County, IL",Apr-22,18408,17885,523,2.80000000
CN1713500000000,17,135,"Montgomery County, IL",Apr-22,11137,10605,532,4.80000000
CN1713700000000,17,137,"Morgan County, IL",Apr-22,15653,14974,679,4.30000000
CN1713900000000,17,139,"Moultrie County, IL",Apr-22,7303,7062,241,3.30000000
CN1714100000000,17,141,"Ogle County, IL",Apr-22,23693,22411,1282,5.40000000
CN1714300000000,17,143,"Peoria County, IL",Apr-22,81887,76560,5327,6.50000000
CN1714500000000,17,145,"Perry County, IL",Apr-22,7931,7528,403,5.10000000
CN1714700000000,17,147,"Piatt County, IL",Apr-22,8563,8258,305,3.60000000
CN1714900000000,17,149,"Pike County, IL",Apr-22,6707,6410,297,4.40000000
CN1715100000000,17,151,"Pope County, IL",Apr-22,1687,1605,82,4.90000000
CN1715300000000,17,153,"Pulaski County, IL",Apr-22,1680,1542,138,8.20000000
CN1715500000000,17,155,"Putnam County, IL",Apr-22,2902,2752,150,5.20000000
CN1715700000000,17,157,"Randolph County, IL",Apr-22,13585,13088,497,3.70000000
CN1715900000000,17,159,"Richland County, IL",Apr-22,7093,6805,288,4.10000000
CN1716100000000,17,161,"Rock Island County, IL",Apr-22,67837,64684,3153,4.60000000
CN1716300000000,17,163,"St. Clair County, IL",Apr-22,122503,116178,6325,5.20000000
CN1716500000000,17,165,"Saline County, IL",Apr-22,9155,8611,544,5.90000000
CN1716700000000,17,167,"Sangamon County, IL",Apr-22,97885,93331,4554,4.70000000
CN1716900000000,17,169,"Schuyler County, IL",Apr-22,3224,3115,109,3.40000000
CN1717100000000,17,171,"Scott County, IL",Apr-22,2281,2165,116,5.10000000
CN1717300000000,17,173,"Shelby County, IL",Apr-22,10235,9819,416,4.10000000
CN1717500000000,17,175,"Stark County, IL",Apr-22,2362,2223,139,5.90000000
CN1717700000000,17,177,"Stephenson County, IL",Apr-22,20326,19290,1036,5.10000000
CN1717900000000,17,179,"Tazewell County, IL",Apr-22,60838,58150,2688,4.40000000
CN1718100000000,17,181,"Union County, IL",Apr-22,7331,6917,414,5.60000000
CN1718300000000,17,183,"Vermilion County, IL",Apr-22,31283,29454,1829,5.80000000
CN1718500000000,17,185,"Wabash County, IL",Apr-22,5394,5177,217,4.00000000
CN1718700000000,17,187,"Warren County, IL",Apr-22,7515,7195,320,4.30000000
CN1718900000000,17,189,"Washington County, IL",Apr-22,9555,9334,221,2.30000000
CN1719100000000,17,191,"Wayne County, IL",Apr-22,6853,6577,276,4.00000000
CN1719300000000,17,193,"White County, IL",Apr-22,5925,5660,265,4.50000000
CN1719500000000,17,195,"Whiteside County, IL",Apr-22,27314,26164,1150,4.20000000
CN1719700000000,17,197,"Will County, IL",Apr-22,364426,351111,13315,3.70000000
CN1719900000000,17,199,"Williamson County, IL",Apr-22,31423,29948,1475,4.70000000
CN1720100000000,17,201,"Winnebago County, IL",Apr-22,134326,123951,10375,7.70000000
CN1720300000000,17,203,"Woodford County, IL",Apr-22,17845,17235,610,3.40000000
CN1800100000000,18,001,"Adams County, IN",Apr-22,16487,16234,253,1.50000000
CN1800300000000,18,003,"Allen County, IN",Apr-22,187547,183196,4351,2.30000000
CN1800500000000,18,005,"Bartholomew County, IN",Apr-22,43382,42661,721,1.70000000
CN1800700000000,18,007,"Benton County, IN",Apr-22,4313,4239,74,1.70000000
CN1800900000000,18,009,"Blackford County, IN",Apr-22,4606,4491,115,2.50000000
CN1801100000000,18,011,"Boone County, IN",Apr-22,37692,37192,500,1.30000000
CN1801300000000,18,013,"Brown County, IN",Apr-22,7698,7532,166,2.20000000
CN1801500000000,18,015,"Carroll County, IN",Apr-22,9749,9561,188,1.90000000
CN1801700000000,18,017,"Cass County, IN",Apr-22,16958,16585,373,2.20000000
CN1801900000000,18,019,"Clark County, IN",Apr-22,62745,61552,1193,1.90000000
CN1802100000000,18,021,"Clay County, IN",Apr-22,11708,11444,264,2.30000000
CN1802300000000,18,023,"Clinton County, IN",Apr-22,16653,16367,286,1.70000000
CN1802500000000,18,025,"Crawford County, IN",Apr-22,4738,4623,115,2.40000000
CN1802700000000,18,027,"Daviess County, IN",Apr-22,16122,15882,240,1.50000000
CN1802900000000,18,029,"Dearborn County, IN",Apr-22,25294,24814,480,1.90000000
CN1803100000000,18,031,"Decatur County, IN",Apr-22,14299,14037,262,1.80000000
CN1803300000000,18,033,"DeKalb County, IN",Apr-22,21831,21478,353,1.60000000
CN1803500000000,18,035,"Delaware County, IN",Apr-22,52923,51607,1316,2.50000000
CN1803700000000,18,037,"Dubois County, IN",Apr-22,21521,21212,309,1.40000000
CN1803900000000,18,039,"Elkhart County, IN",Apr-22,120667,119000,1667,1.40000000
CN1804100000000,18,041,"Fayette County, IN",Apr-22,7983,7733,250,3.10000000
CN1804300000000,18,043,"Floyd County, IN",Apr-22,42285,41557,728,1.70000000
CN1804500000000,18,045,"Fountain County, IN",Apr-22,7640,7504,136,1.80000000
CN1804700000000,18,047,"Franklin County, IN",Apr-22,10828,10631,197,1.80000000
CN1804900000000,18,049,"Fulton County, IN",Apr-22,9178,8979,199,2.20000000
CN1805100000000,18,051,"Gibson County, IN",Apr-22,19000,18704,296,1.60000000
CN1805300000000,18,053,"Grant County, IN",Apr-22,31269,30549,720,2.30000000
CN1805500000000,18,055,"Greene County, IN",Apr-22,13433,13133,300,2.20000000
CN1805700000000,18,057,"Hamilton County, IN",Apr-22,193317,190621,2696,1.40000000
CN1805900000000,18,059,"Hancock County, IN",Apr-22,42226,41492,734,1.70000000
CN1806100000000,18,061,"Harrison County, IN",Apr-22,20438,20092,346,1.70000000
CN1806300000000,18,063,"Hendricks County, IN",Apr-22,94243,92735,1508,1.60000000
CN1806500000000,18,065,"Henry County, IN",Apr-22,21749,21287,462,2.10000000
CN1806700000000,18,067,"Howard County, IN",Apr-22,33508,32210,1298,3.90000000
CN1806900000000,18,069,"Huntington County, IN",Apr-22,17956,17557,399,2.20000000
CN1807100000000,18,071,"Jackson County, IN",Apr-22,22754,22339,415,1.80000000
CN1807300000000,18,073,"Jasper County, IN",Apr-22,15602,15253,349,2.20000000
CN1807500000000,18,075,"Jay County, IN",Apr-22,8427,8264,163,1.90000000
CN1807700000000,18,077,"Jefferson County, IN",Apr-22,14633,14360,273,1.90000000
CN1807900000000,18,079,"Jennings County, IN",Apr-22,13262,12960,302,2.30000000
CN1808100000000,18,081,"Johnson County, IN",Apr-22,85952,84598,1354,1.60000000
CN1808300000000,18,083,"Knox County, IN",Apr-22,17556,17242,314,1.80000000
CN1808500000000,18,085,"Kosciusko County, IN",Apr-22,39661,38997,664,1.70000000
CN1808700000000,18,087,"LaGrange County, IN",Apr-22,20353,20094,259,1.30000000
CN1808900000000,18,089,"Lake County, IN",Apr-22,224877,216164,8713,3.90000000
CN1809100000000,18,091,"LaPorte County, IN",Apr-22,46285,44899,1386,3.00000000
CN1809300000000,18,093,"Lawrence County, IN",Apr-22,20601,20144,457,2.20000000
CN1809500000000,18,095,"Madison County, IN",Apr-22,59461,58030,1431,2.40000000
CN1809700000000,18,097,"Marion County, IN",Apr-22,503130,490544,12586,2.50000000
CN1809900000000,18,099,"Marshall County, IN",Apr-22,22213,21849,364,1.60000000
CN1810100000000,18,101,"Martin County, IN",Apr-22,5373,5281,92,1.70000000
CN1810300000000,18,103,"Miami County, IN",Apr-22,14236,13831,405,2.80000000
CN1810500000000,18,105,"Monroe County, IN",Apr-22,72344,71097,1247,1.70000000
CN1810700000000,18,107,"Montgomery County, IN",Apr-22,18384,18066,318,1.70000000
CN1810900000000,18,109,"Morgan County, IN",Apr-22,36848,36147,701,1.90000000
CN1811100000000,18,111,"Newton County, IN",Apr-22,6581,6419,162,2.50000000
CN1811300000000,18,113,"Noble County, IN",Apr-22,20991,20557,434,2.10000000
CN1811500000000,18,115,"Ohio County, IN",Apr-22,3126,3081,45,1.40000000
CN1811700000000,18,117,"Orange County, IN",Apr-22,7964,7763,201,2.50000000
CN1811900000000,18,119,"Owen County, IN",Apr-22,9505,9288,217,2.30000000
CN1812100000000,18,121,"Parke County, IN",Apr-22,6881,6742,139,2.00000000
CN1812300000000,18,123,"Perry County, IN",Apr-22,8623,8457,166,1.90000000
CN1812500000000,18,125,"Pike County, IN",Apr-22,5660,5536,124,2.20000000
CN1812700000000,18,127,"Porter County, IN",Apr-22,84487,82523,1964,2.30000000
CN1812900000000,18,129,"Posey County, IN",Apr-22,13025,12799,226,1.70000000
CN1813100000000,18,131,"Pulaski County, IN",Apr-22,6354,6226,128,2.00000000
CN1813300000000,18,133,"Putnam County, IN",Apr-22,16636,16311,325,2.00000000
CN1813500000000,18,135,"Randolph County, IN",Apr-22,12065,11827,238,2.00000000
CN1813700000000,18,137,"Ripley County, IN",Apr-22,13218,12972,246,1.90000000
CN1813900000000,18,139,"Rush County, IN",Apr-22,8735,8579,156,1.80000000
CN1814100000000,18,141,"St. Joseph County, IN",Apr-22,132119,129021,3098,2.30000000
CN1814300000000,18,143,"Scott County, IN",Apr-22,10557,10299,258,2.40000000
CN1814500000000,18,145,"Shelby County, IN",Apr-22,23442,23013,429,1.80000000
CN1814700000000,18,147,"Spencer County, IN",Apr-22,10411,10220,191,1.80000000
CN1814900000000,18,149,"Starke County, IN",Apr-22,9297,9049,248,2.70000000
CN1815100000000,18,151,"Steuben County, IN",Apr-22,19890,19605,285,1.40000000
CN1815300000000,18,153,"Sullivan County, IN",Apr-22,8024,7813,211,2.60000000
CN1815500000000,18,155,"Switzerland County, IN",Apr-22,4557,4455,102,2.20000000
CN1815700000000,18,157,"Tippecanoe County, IN",Apr-22,96525,94716,1809,1.90000000
CN1815900000000,18,159,"Tipton County, IN",Apr-22,8805,8641,164,1.90000000
CN1816100000000,18,161,"Union County, IN",Apr-22,3491,3431,60,1.70000000
CN1816300000000,18,163,"Vanderburgh County, IN",Apr-22,92837,90842,1995,2.10000000
CN1816500000000,18,165,"Vermillion County, IN",Apr-22,6604,6425,179,2.70000000
CN1816700000000,18,167,"Vigo County, IN",Apr-22,46339,45153,1186,2.60000000
CN1816900000000,18,169,"Wabash County, IN",Apr-22,14343,14067,276,1.90000000
CN1817100000000,18,171,"Warren County, IN",Apr-22,4033,3960,73,1.80000000
CN1817300000000,18,173,"Warrick County, IN",Apr-22,32452,31884,568,1.80000000
CN1817500000000,18,175,"Washington County, IN",Apr-22,13650,13402,248,1.80000000
CN1817700000000,18,177,"Wayne County, IN",Apr-22,28893,28238,655,2.30000000
CN1817900000000,18,179,"Wells County, IN",Apr-22,14129,13892,237,1.70000000
CN1818100000000,18,181,"White County, IN",Apr-22,12872,12656,216,1.70000000
CN1818300000000,18,183,"Whitley County, IN",Apr-22,17667,17356,311,1.80000000
CN1900100000000,19,001,"Adair County, IA",Apr-22,4418,4352,66,1.50000000
CN1900300000000,19,003,"Adams County, IA",Apr-22,2043,2012,31,1.50000000
CN1900500000000,19,005,"Allamakee County, IA",Apr-22,7109,6880,229,3.20000000
CN1900700000000,19,007,"Appanoose County, IA",Apr-22,6088,5956,132,2.20000000
CN1900900000000,19,009,"Audubon County, IA",Apr-22,3075,3021,54,1.80000000
CN1901100000000,19,011,"Benton County, IA",Apr-22,12769,12474,295,2.30000000
CN1901300000000,19,013,"Black Hawk County, IA",Apr-22,68362,66702,1660,2.40000000
CN1901500000000,19,015,"Boone County, IA",Apr-22,14787,14509,278,1.90000000
CN1901700000000,19,017,"Bremer County, IA",Apr-22,14104,13855,249,1.80000000
CN1901900000000,19,019,"Buchanan County, IA",Apr-22,11295,11053,242,2.10000000
CN1902100000000,19,021,"Buena Vista County, IA",Apr-22,12001,11804,197,1.60000000
CN1902300000000,19,023,"Butler County, IA",Apr-22,8039,7852,187,2.30000000
CN1902500000000,19,025,"Calhoun County, IA",Apr-22,4068,3988,80,2.00000000
CN1902700000000,19,027,"Carroll County, IA",Apr-22,10767,10601,166,1.50000000
CN1902900000000,19,029,"Cass County, IA",Apr-22,6825,6695,130,1.90000000
CN1903100000000,19,031,"Cedar County, IA",Apr-22,10529,10310,219,2.10000000
CN1903300000000,19,033,"Cerro Gordo County, IA",Apr-22,22149,21640,509,2.30000000
CN1903500000000,19,035,"Cherokee County, IA",Apr-22,6096,5990,106,1.70000000
CN1903700000000,19,037,"Chickasaw County, IA",Apr-22,6470,6332,138,2.10000000
CN1903900000000,19,039,"Clarke County, IA",Apr-22,4855,4737,118,2.40000000
CN1904100000000,19,041,"Clay County, IA",Apr-22,8505,8326,179,2.10000000
CN1904300000000,19,043,"Clayton County, IA",Apr-22,9577,9307,270,2.80000000
CN1904500000000,19,045,"Clinton County, IA",Apr-22,22027,21394,633,2.90000000
CN1904700000000,19,047,"Crawford County, IA",Apr-22,7952,7695,257,3.20000000
CN1904900000000,19,049,"Dallas County, IA",Apr-22,53015,52228,787,1.50000000
CN1905100000000,19,051,"Davis County, IA",Apr-22,4272,4196,76,1.80000000
CN1905300000000,19,053,"Decatur County, IA",Apr-22,4447,4361,86,1.90000000
CN1905500000000,19,055,"Delaware County, IA",Apr-22,10628,10431,197,1.90000000
CN1905700000000,19,057,"Des Moines County, IA",Apr-22,18110,17405,705,3.90000000
CN1905900000000,19,059,"Dickinson County, IA",Apr-22,10085,9838,247,2.40000000
CN1906100000000,19,061,"Dubuque County, IA",Apr-22,55039,53733,1306,2.40000000
CN1906300000000,19,063,"Emmet County, IA",Apr-22,4914,4807,107,2.20000000
CN1906500000000,19,065,"Fayette County, IA",Apr-22,10285,10007,278,2.70000000
CN1906700000000,19,067,"Floyd County, IA",Apr-22,8201,7998,203,2.50000000
CN1906900000000,19,069,"Franklin County, IA",Apr-22,5620,5502,118,2.10000000
CN1907100000000,19,071,"Fremont County, IA",Apr-22,3703,3636,67,1.80000000
CN1907300000000,19,073,"Greene County, IA",Apr-22,5341,5249,92,1.70000000
CN1907500000000,19,075,"Grundy County, IA",Apr-22,6452,6335,117,1.80000000
CN1907700000000,19,077,"Guthrie County, IA",Apr-22,5574,5457,117,2.10000000
CN1907900000000,19,079,"Hamilton County, IA",Apr-22,6958,6791,167,2.40000000
CN1908100000000,19,081,"Hancock County, IA",Apr-22,5670,5565,105,1.90000000
CN1908300000000,19,083,"Hardin County, IA",Apr-22,7898,7726,172,2.20000000
CN1908500000000,19,085,"Harrison County, IA",Apr-22,7137,6999,138,1.90000000
CN1908700000000,19,087,"Henry County, IA",Apr-22,9620,9402,218,2.30000000
CN1908900000000,19,089,"Howard County, IA",Apr-22,5199,5068,131,2.50000000
CN1909100000000,19,091,"Humboldt County, IA",Apr-22,4934,4833,101,2.00000000
CN1909300000000,19,093,"Ida County, IA",Apr-22,3974,3908,66,1.70000000
CN1909500000000,19,095,"Iowa County, IA",Apr-22,9971,9780,191,1.90000000
CN1909700000000,19,097,"Jackson County, IA",Apr-22,10718,10422,296,2.80000000
CN1909900000000,19,099,"Jasper County, IA",Apr-22,18667,18226,441,2.40000000
CN1910100000000,19,101,"Jefferson County, IA",Apr-22,10187,9980,207,2.00000000
CN1910300000000,19,103,"Johnson County, IA",Apr-22,86401,84846,1555,1.80000000
CN1910500000000,19,105,"Jones County, IA",Apr-22,10176,9906,270,2.70000000
CN1910700000000,19,107,"Keokuk County, IA",Apr-22,5214,5082,132,2.50000000
CN1910900000000,19,109,"Kossuth County, IA",Apr-22,8129,7972,157,1.90000000
CN1911100000000,19,111,"Lee County, IA",Apr-22,15239,14613,626,4.10000000
CN1911300000000,19,113,"Linn County, IA",Apr-22,117818,114784,3034,2.60000000
CN1911500000000,19,115,"Louisa County, IA",Apr-22,5846,5702,144,2.50000000
CN1911700000000,19,117,"Lucas County, IA",Apr-22,4715,4648,67,1.40000000
CN1911900000000,19,119,"Lyon County, IA",Apr-22,7065,6968,97,1.40000000
CN1912100000000,19,121,"Madison County, IA",Apr-22,8624,8410,214,2.50000000
CN1912300000000,19,123,"Mahaska County, IA",Apr-22,12082,11849,233,1.90000000
CN1912500000000,19,125,"Marion County, IA",Apr-22,18951,18650,301,1.60000000
CN1912700000000,19,127,"Marshall County, IA",Apr-22,17182,16324,858,5.00000000
CN1912900000000,19,129,"Mills County, IA",Apr-22,7111,6989,122,1.70000000
CN1913100000000,19,131,"Mitchell County, IA",Apr-22,5760,5664,96,1.70000000
CN1913300000000,19,133,"Monona County, IA",Apr-22,4440,4335,105,2.40000000
CN1913500000000,19,135,"Monroe County, IA",Apr-22,3918,3838,80,2.00000000
CN1913700000000,19,137,"Montgomery County, IA",Apr-22,4945,4849,96,1.90000000
CN1913900000000,19,139,"Muscatine County, IA",Apr-22,20541,20040,501,2.40000000
CN1914100000000,19,141,"O'Brien County, IA",Apr-22,8212,8079,133,1.60000000
CN1914300000000,19,143,"Osceola County, IA",Apr-22,3641,3592,49,1.30000000
CN1914500000000,19,145,"Page County, IA",Apr-22,6358,6240,118,1.90000000
CN1914700000000,19,147,"Palo Alto County, IA",Apr-22,4511,4418,93,2.10000000
CN1914900000000,19,149,"Plymouth County, IA",Apr-22,14615,14408,207,1.40000000
CN1915100000000,19,151,"Pocahontas County, IA",Apr-22,4324,4253,71,1.60000000
CN1915300000000,19,153,"Polk County, IA",Apr-22,271572,265396,6176,2.30000000
CN1915500000000,19,155,"Pottawattamie County, IA",Apr-22,47662,46703,959,2.00000000
CN1915700000000,19,157,"Poweshiek County, IA",Apr-22,10663,10415,248,2.30000000
CN1915900000000,19,159,"Ringgold County, IA",Apr-22,2399,2358,41,1.70000000
CN1916100000000,19,161,"Sac County, IA",Apr-22,5296,5201,95,1.80000000
CN1916300000000,19,163,"Scott County, IA",Apr-22,88725,86290,2435,2.70000000
CN1916500000000,19,165,"Shelby County, IA",Apr-22,6288,6177,111,1.80000000
CN1916700000000,19,167,"Sioux County, IA",Apr-22,22536,22215,321,1.40000000
CN1916900000000,19,169,"Story County, IA",Apr-22,59788,58863,925,1.50000000
CN1917100000000,19,171,"Tama County, IA",Apr-22,9215,8971,244,2.60000000
CN1917300000000,19,173,"Taylor County, IA",Apr-22,3142,3097,45,1.40000000
CN1917500000000,19,175,"Union County, IA",Apr-22,6145,6015,130,2.10000000
CN1917700000000,19,177,"Van Buren County, IA",Apr-22,3692,3614,78,2.10000000
CN1917900000000,19,179,"Wapello County, IA",Apr-22,16928,16495,433,2.60000000
CN1918100000000,19,181,"Warren County, IA",Apr-22,28825,28288,537,1.90000000
CN1918300000000,19,183,"Washington County, IA",Apr-22,11733,11519,214,1.80000000
CN1918500000000,19,185,"Wayne County, IA",Apr-22,2872,2817,55,1.90000000
CN1918700000000,19,187,"Webster County, IA",Apr-22,18407,17957,450,2.40000000
CN1918900000000,19,189,"Winnebago County, IA",Apr-22,4885,4770,115,2.40000000
CN1919100000000,19,191,"Winneshiek County, IA",Apr-22,11991,11656,335,2.80000000
CN1919300000000,19,193,"Woodbury County, IA",Apr-22,55060,53835,1225,2.20000000
CN1919500000000,19,195,"Worth County, IA",Apr-22,4003,3907,96,2.40000000
CN1919700000000,19,197,"Wright County, IA",Apr-22,6706,6549,157,2.30000000
CN2000100000000,20,001,"Allen County, KS",Apr-22,6591,6447,144,2.20000000
CN2000300000000,20,003,"Anderson County, KS",Apr-22,4723,4649,74,1.60000000
CN2000500000000,20,005,"Atchison County, KS",Apr-22,6565,6390,175,2.70000000
CN2000700000000,20,007,"Barber County, KS",Apr-22,2143,2114,29,1.40000000
CN2000900000000,20,009,"Barton County, KS",Apr-22,12997,12744,253,1.90000000
CN2001100000000,20,011,"Bourbon County, KS",Apr-22,6373,6208,165,2.60000000
CN2001300000000,20,013,"Brown County, KS",Apr-22,4877,4786,91,1.90000000
CN2001500000000,20,015,"Butler County, KS",Apr-22,32882,32178,704,2.10000000
CN2001700000000,20,017,"Chase County, KS",Apr-22,1321,1301,20,1.50000000
CN2001900000000,20,019,"Chautauqua County, KS",Apr-22,1363,1332,31,2.30000000
CN2002100000000,20,021,"Cherokee County, KS",Apr-22,9783,9596,187,1.90000000
CN2002300000000,20,023,"Cheyenne County, KS",Apr-22,1183,1162,21,1.80000000
CN2002500000000,20,025,"Clark County, KS",Apr-22,1068,1055,13,1.20000000
CN2002700000000,20,027,"Clay County, KS",Apr-22,3561,3492,69,1.90000000
CN2002900000000,20,029,"Cloud County, KS",Apr-22,3808,3734,74,1.90000000
CN2003100000000,20,031,"Coffey County, KS",Apr-22,3834,3731,103,2.70000000
CN2003300000000,20,033,"Comanche County, KS",Apr-22,853,841,12,1.40000000
CN2003500000000,20,035,"Cowley County, KS",Apr-22,16422,16050,372,2.30000000
CN2003700000000,20,037,"Crawford County, KS",Apr-22,18857,18448,409,2.20000000
CN2003900000000,20,039,"Decatur County, KS",Apr-22,1075,1055,20,1.90000000
CN2004100000000,20,041,"Dickinson County, KS",Apr-22,8851,8659,192,2.20000000
CN2004300000000,20,043,"Doniphan County, KS",Apr-22,4112,4047,65,1.60000000
CN2004500000000,20,045,"Douglas County, KS",Apr-22,67380,66122,1258,1.90000000
CN2004700000000,20,047,"Edwards County, KS",Apr-22,1379,1358,21,1.50000000
CN2004900000000,20,049,"Elk County, KS",Apr-22,1132,1110,22,1.90000000
CN2005100000000,20,051,"Ellis County, KS",Apr-22,16659,16436,223,1.30000000
CN2005300000000,20,053,"Ellsworth County, KS",Apr-22,2637,2593,44,1.70000000
CN2005500000000,20,055,"Finney County, KS",Apr-22,19649,19333,316,1.60000000
CN2005700000000,20,057,"Ford County, KS",Apr-22,17420,17148,272,1.60000000
CN2005900000000,20,059,"Franklin County, KS",Apr-22,14486,14213,273,1.90000000
CN2006100000000,20,061,"Geary County, KS",Apr-22,11357,11028,329,2.90000000
CN2006300000000,20,063,"Gove County, KS",Apr-22,1376,1358,18,1.30000000
CN2006500000000,20,065,"Graham County, KS",Apr-22,1067,1049,18,1.70000000
CN2006700000000,20,067,"Grant County, KS",Apr-22,2668,2611,57,2.10000000
CN2006900000000,20,069,"Gray County, KS",Apr-22,2973,2929,44,1.50000000
CN2007100000000,20,071,"Greeley County, KS",Apr-22,753,745,8,1.10000000
CN2007300000000,20,073,"Greenwood County, KS",Apr-22,2916,2861,55,1.90000000
CN2007500000000,20,075,"Hamilton County, KS",Apr-22,1459,1442,17,1.20000000
CN2007700000000,20,077,"Harper County, KS",Apr-22,2811,2767,44,1.60000000
CN2007900000000,20,079,"Harvey County, KS",Apr-22,17152,16822,330,1.90000000
CN2008100000000,20,081,"Haskell County, KS",Apr-22,2069,2040,29,1.40000000
CN2008300000000,20,083,"Hodgeman County, KS",Apr-22,955,943,12,1.30000000
CN2008500000000,20,085,"Jackson County, KS",Apr-22,7252,7129,123,1.70000000
CN2008700000000,20,087,"Jefferson County, KS",Apr-22,10317,10107,210,2.00000000
CN2008900000000,20,089,"Jewell County, KS",Apr-22,1143,1123,20,1.70000000
CN2009100000000,20,091,"Johnson County, KS",Apr-22,349563,343637,5926,1.70000000
CN2009300000000,20,093,"Kearny County, KS",Apr-22,1944,1919,25,1.30000000
CN2009500000000,20,095,"Kingman County, KS",Apr-22,3211,3151,60,1.90000000
CN2009700000000,20,097,"Kiowa County, KS",Apr-22,1146,1128,18,1.60000000
CN2009900000000,20,099,"Labette County, KS",Apr-22,9097,8862,235,2.60000000
CN2010100000000,20,101,"Lane County, KS",Apr-22,687,674,13,1.90000000
CN2010300000000,20,103,"Leavenworth County, KS",Apr-22,37380,36561,819,2.20000000
CN2010500000000,20,105,"Lincoln County, KS",Apr-22,1578,1543,35,2.20000000
CN2010700000000,20,107,"Linn County, KS",Apr-22,4317,4184,133,3.10000000
CN2010900000000,20,109,"Logan County, KS",Apr-22,1529,1507,22,1.40000000
CN2011100000000,20,111,"Lyon County, KS",Apr-22,16840,16530,310,1.80000000
CN2011300000000,20,113,"McPherson County, KS",Apr-22,17034,16798,236,1.40000000
CN2011500000000,20,115,"Marion County, KS",Apr-22,5750,5647,103,1.80000000
CN2011700000000,20,117,"Marshall County, KS",Apr-22,5192,5120,72,1.40000000
CN2011900000000,20,119,"Meade County, KS",Apr-22,2016,1989,27,1.30000000
CN2012100000000,20,121,"Miami County, KS",Apr-22,18007,17664,343,1.90000000
CN2012300000000,20,123,"Mitchell County, KS",Apr-22,3314,3270,44,1.30000000
CN2012500000000,20,125,"Montgomery County, KS",Apr-22,14447,14096,351,2.40000000
CN2012700000000,20,127,"Morris County, KS",Apr-22,2897,2842,55,1.90000000
CN2012900000000,20,129,"Morton County, KS",Apr-22,1061,1037,24,2.30000000
CN2013100000000,20,131,"Nemaha County, KS",Apr-22,5319,5251,68,1.30000000
CN2013300000000,20,133,"Neosho County, KS",Apr-22,5965,5795,170,2.80000000
CN2013500000000,20,135,"Ness County, KS",Apr-22,1253,1233,20,1.60000000
CN2013700000000,20,137,"Norton County, KS",Apr-22,2530,2495,35,1.40000000
CN2013900000000,20,139,"Osage County, KS",Apr-22,7966,7804,162,2.00000000
CN2014100000000,20,141,"Osborne County, KS",Apr-22,1853,1824,29,1.60000000
CN2014300000000,20,143,"Ottawa County, KS",Apr-22,2838,2782,56,2.00000000
CN2014500000000,20,145,"Pawnee County, KS",Apr-22,2603,2560,43,1.70000000
CN2014700000000,20,147,"Phillips County, KS",Apr-22,2526,2484,42,1.70000000
CN2014900000000,20,149,"Pottawatomie County, KS",Apr-22,12508,12294,214,1.70000000
CN2015100000000,20,151,"Pratt County, KS",Apr-22,4840,4771,69,1.40000000
CN2015300000000,20,153,"Rawlins County, KS",Apr-22,1552,1532,20,1.30000000
CN2015500000000,20,155,"Reno County, KS",Apr-22,29265,28647,618,2.10000000
CN2015700000000,20,157,"Republic County, KS",Apr-22,2199,2160,39,1.80000000
CN2015900000000,20,159,"Rice County, KS",Apr-22,5344,5260,84,1.60000000
CN2016100000000,20,161,"Riley County, KS",Apr-22,34741,34098,643,1.90000000
CN2016300000000,20,163,"Rooks County, KS",Apr-22,2267,2224,43,1.90000000
CN2016500000000,20,165,"Rush County, KS",Apr-22,1508,1483,25,1.70000000
CN2016700000000,20,167,"Russell County, KS",Apr-22,3222,3170,52,1.60000000
CN2016900000000,20,169,"Saline County, KS",Apr-22,28654,28100,554,1.90000000
CN2017100000000,20,171,"Scott County, KS",Apr-22,2625,2595,30,1.10000000
CN2017300000000,20,173,"Sedgwick County, KS",Apr-22,258107,251102,7005,2.70000000
CN2017500000000,20,175,"Seward County, KS",Apr-22,9602,9420,182,1.90000000
CN2017700000000,20,177,"Shawnee County, KS",Apr-22,91972,90055,1917,2.10000000
CN2017900000000,20,179,"Sheridan County, KS",Apr-22,1340,1322,18,1.30000000
CN2018100000000,20,181,"Sherman County, KS",Apr-22,2720,2674,46,1.70000000
CN2018300000000,20,183,"Smith County, KS",Apr-22,1872,1846,26,1.40000000
CN2018500000000,20,185,"Stafford County, KS",Apr-22,1873,1844,29,1.50000000
CN2018700000000,20,187,"Stanton County, KS",Apr-22,1076,1063,13,1.20000000
CN2018900000000,20,189,"Stevens County, KS",Apr-22,2787,2747,40,1.40000000
CN2019100000000,20,191,"Sumner County, KS",Apr-22,10751,10483,268,2.50000000
CN2019300000000,20,193,"Thomas County, KS",Apr-22,4088,4038,50,1.20000000
CN2019500000000,20,195,"Trego County, KS",Apr-22,1364,1343,21,1.50000000
CN2019700000000,20,197,"Wabaunsee County, KS",Apr-22,3660,3596,64,1.70000000
CN2019900000000,20,199,"Wallace County, KS",Apr-22,819,809,10,1.20000000
CN2020100000000,20,201,"Washington County, KS",Apr-22,2865,2828,37,1.30000000
CN2020300000000,20,203,"Wichita County, KS",Apr-22,1061,1047,14,1.30000000
CN2020500000000,20,205,"Wilson County, KS",Apr-22,3593,3492,101,2.80000000
CN2020700000000,20,207,"Woodson County, KS",Apr-22,1522,1480,42,2.80000000
CN2020900000000,20,209,"Wyandotte County, KS",Apr-22,78179,75947,2232,2.90000000
CN2100100000000,21,001,"Adair County, KY",Apr-22,7310,7021,289,4.00000000
CN2100300000000,21,003,"Allen County, KY",Apr-22,8826,8544,282,3.20000000
CN2100500000000,21,005,"Anderson County, KY",Apr-22,11952,11616,336,2.80000000
CN2100700000000,21,007,"Ballard County, KY",Apr-22,3429,3262,167,4.90000000
CN2100900000000,21,009,"Barren County, KY",Apr-22,17821,17157,664,3.70000000
CN2101100000000,21,011,"Bath County, KY",Apr-22,4634,4405,229,4.90000000
CN2101300000000,21,013,"Bell County, KY",Apr-22,8327,7974,353,4.20000000
CN2101500000000,21,015,"Boone County, KY",Apr-22,72002,69954,2048,2.80000000
CN2101700000000,21,017,"Bourbon County, KY",Apr-22,9250,8959,291,3.10000000
CN2101900000000,21,019,"Boyd County, KY",Apr-22,17507,16691,816,4.70000000
CN2102100000000,21,021,"Boyle County, KY",Apr-22,12741,12285,456,3.60000000
CN2102300000000,21,023,"Bracken County, KY",Apr-22,3758,3622,136,3.60000000
CN2102500000000,21,025,"Breathitt County, KY",Apr-22,3267,3019,248,7.60000000
CN2102700000000,21,027,"Breckinridge County, KY",Apr-22,7902,7589,313,4.00000000
CN2102900000000,21,029,"Bullitt County, KY",Apr-22,43440,42197,1243,2.90000000
CN2103100000000,21,031,"Butler County, KY",Apr-22,5024,4855,169,3.40000000
CN2103300000000,21,033,"Caldwell County, KY",Apr-22,5998,5822,176,2.90000000
CN2103500000000,21,035,"Calloway County, KY",Apr-22,17184,16549,635,3.70000000
CN2103700000000,21,037,"Campbell County, KY",Apr-22,50752,49164,1588,3.10000000
CN2103900000000,21,039,"Carlisle County, KY",Apr-22,2187,2111,76,3.50000000
CN2104100000000,21,041,"Carroll County, KY",Apr-22,5429,5271,158,2.90000000
CN2104300000000,21,043,"Carter County, KY",Apr-22,9774,9139,635,6.50000000
CN2104500000000,21,045,"Casey County, KY",Apr-22,6653,6419,234,3.50000000
CN2104700000000,21,047,"Christian County, KY",Apr-22,25056,23881,1175,4.70000000
CN2104900000000,21,049,"Clark County, KY",Apr-22,17217,16659,558,3.20000000
CN2105100000000,21,051,"Clay County, KY",Apr-22,5187,4927,260,5.00000000
CN2105300000000,21,053,"Clinton County, KY",Apr-22,3843,3698,145,3.80000000
CN2105500000000,21,055,"Crittenden County, KY",Apr-22,3799,3661,138,3.60000000
CN2105700000000,21,057,"Cumberland County, KY",Apr-22,3320,3236,84,2.50000000
CN2105900000000,21,059,"Daviess County, KY",Apr-22,46764,45265,1499,3.20000000
CN2106100000000,21,061,"Edmonson County, KY",Apr-22,4726,4538,188,4.00000000
CN2106300000000,21,063,"Elliott County, KY",Apr-22,1845,1704,141,7.60000000
CN2106500000000,21,065,"Estill County, KY",Apr-22,5235,5015,220,4.20000000
CN2106700000000,21,067,"Fayette County, KY",Apr-22,175100,170142,4958,2.80000000
CN2106900000000,21,069,"Fleming County, KY",Apr-22,5935,5691,244,4.10000000
CN2107100000000,21,071,"Floyd County, KY",Apr-22,11108,10475,633,5.70000000
CN2107300000000,21,073,"Franklin County, KY",Apr-22,25101,24328,773,3.10000000
CN2107500000000,21,075,"Fulton County, KY",Apr-22,2058,1970,88,4.30000000
CN2107700000000,21,077,"Gallatin County, KY",Apr-22,3966,3839,127,3.20000000
CN2107900000000,21,079,"Garrard County, KY",Apr-22,7753,7479,274,3.50000000
CN2108100000000,21,081,"Grant County, KY",Apr-22,11655,11259,396,3.40000000
CN2108300000000,21,083,"Graves County, KY",Apr-22,15564,14924,640,4.10000000
CN2108500000000,21,085,"Grayson County, KY",Apr-22,10527,10081,446,4.20000000
CN2108700000000,21,087,"Green County, KY",Apr-22,5281,5119,162,3.10000000
CN2108900000000,21,089,"Greenup County, KY",Apr-22,13142,12440,702,5.30000000
CN2109100000000,21,091,"Hancock County, KY",Apr-22,3882,3755,127,3.30000000
CN2109300000000,21,093,"Hardin County, KY",Apr-22,47408,45723,1685,3.60000000
CN2109500000000,21,095,"Harlan County, KY",Apr-22,6714,6298,416,6.20000000
CN2109700000000,21,097,"Harrison County, KY",Apr-22,8821,8577,244,2.80000000
CN2109900000000,21,099,"Hart County, KY",Apr-22,7547,7294,253,3.40000000
CN2110100000000,21,101,"Henderson County, KY",Apr-22,21030,20343,687,3.30000000
CN2110300000000,21,103,"Henry County, KY",Apr-22,8159,7937,222,2.70000000
CN2110500000000,21,105,"Hickman County, KY",Apr-22,1627,1567,60,3.70000000
CN2110700000000,21,107,"Hopkins County, KY",Apr-22,18170,17427,743,4.10000000
CN2110900000000,21,109,"Jackson County, KY",Apr-22,4226,4007,219,5.20000000
CN2111100000000,21,111,"Jefferson County, KY",Apr-22,401220,388791,12429,3.10000000
CN2111300000000,21,113,"Jessamine County, KY",Apr-22,26581,25815,766,2.90000000
CN2111500000000,21,115,"Johnson County, KY",Apr-22,6687,6302,385,5.80000000
CN2111700000000,21,117,"Kenton County, KY",Apr-22,87659,84979,2680,3.10000000
CN2111900000000,21,119,"Knott County, KY",Apr-22,4280,4041,239,5.60000000
CN2112100000000,21,121,"Knox County, KY",Apr-22,10341,9849,492,4.80000000
CN2112300000000,21,123,"Larue County, KY",Apr-22,5812,5592,220,3.80000000
CN2112500000000,21,125,"Laurel County, KY",Apr-22,26107,25212,895,3.40000000
CN2112700000000,21,127,"Lawrence County, KY",Apr-22,5489,5219,270,4.90000000
CN2112900000000,21,129,"Lee County, KY",Apr-22,2051,1953,98,4.80000000
CN2113100000000,21,131,"Leslie County, KY",Apr-22,2541,2376,165,6.50000000
CN2113300000000,21,133,"Letcher County, KY",Apr-22,6128,5787,341,5.60000000
CN2113500000000,21,135,"Lewis County, KY",Apr-22,4701,4402,299,6.40000000
CN2113700000000,21,137,"Lincoln County, KY",Apr-22,9310,8916,394,4.20000000
CN2113900000000,21,139,"Livingston County, KY",Apr-22,3586,3414,172,4.80000000
CN2114100000000,21,141,"Logan County, KY",Apr-22,12391,12040,351,2.80000000
CN2114300000000,21,143,"Lyon County, KY",Apr-22,3075,2967,108,3.50000000
CN2114500000000,21,145,"McCracken County, KY",Apr-22,29501,28388,1113,3.80000000
CN2114700000000,21,147,"McCreary County, KY",Apr-22,4792,4572,220,4.60000000
CN2114900000000,21,149,"McLean County, KY",Apr-22,3993,3848,145,3.60000000
CN2115100000000,21,151,"Madison County, KY",Apr-22,48846,47295,1551,3.20000000
CN2115300000000,21,153,"Magoffin County, KY",Apr-22,3349,2991,358,10.70000000
CN2115500000000,21,155,"Marion County, KY",Apr-22,9080,8794,286,3.10000000
CN2115700000000,21,157,"Marshall County, KY",Apr-22,14318,13786,532,3.70000000
CN2115900000000,21,159,"Martin County, KY",Apr-22,2305,2138,167,7.20000000
CN2116100000000,21,161,"Mason County, KY",Apr-22,6654,6367,287,4.30000000
CN2116300000000,21,163,"Meade County, KY",Apr-22,11653,11212,441,3.80000000
CN2116500000000,21,165,"Menifee County, KY",Apr-22,2349,2215,134,5.70000000
CN2116700000000,21,167,"Mercer County, KY",Apr-22,9998,9668,330,3.30000000
CN2116900000000,21,169,"Metcalfe County, KY",Apr-22,3887,3715,172,4.40000000
CN2117100000000,21,171,"Monroe County, KY",Apr-22,4530,4404,126,2.80000000
CN2117300000000,21,173,"Montgomery County, KY",Apr-22,11768,11274,494,4.20000000
CN2117500000000,21,175,"Morgan County, KY",Apr-22,4310,4121,189,4.40000000
CN2117700000000,21,177,"Muhlenberg County, KY",Apr-22,9782,9271,511,5.20000000
CN2117900000000,21,179,"Nelson County, KY",Apr-22,23750,23043,707,3.00000000
CN2118100000000,21,181,"Nicholas County, KY",Apr-22,3267,3145,122,3.70000000
CN2118300000000,21,183,"Ohio County, KY",Apr-22,8915,8528,387,4.30000000
CN2118500000000,21,185,"Oldham County, KY",Apr-22,33790,32923,867,2.60000000
CN2118700000000,21,187,"Owen County, KY",Apr-22,5045,4899,146,2.90000000
CN2118900000000,21,189,"Owsley County, KY",Apr-22,1046,977,69,6.60000000
CN2119100000000,21,191,"Pendleton County, KY",Apr-22,6909,6701,208,3.00000000
CN2119300000000,21,193,"Perry County, KY",Apr-22,8061,7691,370,4.60000000
CN2119500000000,21,195,"Pike County, KY",Apr-22,19216,18288,928,4.80000000
CN2119700000000,21,197,"Powell County, KY",Apr-22,5145,4963,182,3.50000000
CN2119900000000,21,199,"Pulaski County, KY",Apr-22,25697,24692,1005,3.90000000
CN2120100000000,21,201,"Robertson County, KY",Apr-22,787,754,33,4.20000000
CN2120300000000,21,203,"Rockcastle County, KY",Apr-22,6735,6477,258,3.80000000
CN2120500000000,21,205,"Rowan County, KY",Apr-22,10014,9565,449,4.50000000
CN2120700000000,21,207,"Russell County, KY",Apr-22,6065,5814,251,4.10000000
CN2120900000000,21,209,"Scott County, KY",Apr-22,30195,29378,817,2.70000000
CN2121100000000,21,211,"Shelby County, KY",Apr-22,26069,25374,695,2.70000000
CN2121300000000,21,213,"Simpson County, KY",Apr-22,8937,8684,253,2.80000000
CN2121500000000,21,215,"Spencer County, KY",Apr-22,10705,10416,289,2.70000000
CN2121700000000,21,217,"Taylor County, KY",Apr-22,12808,12405,403,3.10000000
CN2121900000000,21,219,"Todd County, KY",Apr-22,5424,5267,157,2.90000000
CN2122100000000,21,221,"Trigg County, KY",Apr-22,6016,5785,231,3.80000000
CN2122300000000,21,223,"Trimble County, KY",Apr-22,3843,3721,122,3.20000000
CN2122500000000,21,225,"Union County, KY",Apr-22,5914,5687,227,3.80000000
CN2122700000000,21,227,"Warren County, KY",Apr-22,65833,63732,2101,3.20000000
CN2122900000000,21,229,"Washington County, KY",Apr-22,6100,5926,174,2.90000000
CN2123100000000,21,231,"Wayne County, KY",Apr-22,6977,6683,294,4.20000000
CN2123300000000,21,233,"Webster County, KY",Apr-22,5277,5100,177,3.40000000
CN2123500000000,21,235,"Whitley County, KY",Apr-22,14464,13918,546,3.80000000
CN2123700000000,21,237,"Wolfe County, KY",Apr-22,2260,2157,103,4.60000000
CN2123900000000,21,239,"Woodford County, KY",Apr-22,14553,14180,373,2.60000000
CN2200100000000,22,001,"Acadia Parish, LA",Apr-22,24264,23526,738,3.00000000
CN2200300000000,22,003,"Allen Parish, LA",Apr-22,8306,8005,301,3.60000000
CN2200500000000,22,005,"Ascension Parish, LA",Apr-22,66051,64346,1705,2.60000000
CN2200700000000,22,007,"Assumption Parish, LA",Apr-22,8699,8262,437,5.00000000
CN2200900000000,22,009,"Avoyelles Parish, LA",Apr-22,14692,14179,513,3.50000000
CN2201100000000,22,011,"Beauregard Parish, LA",Apr-22,15127,14726,401,2.70000000
CN2201300000000,22,013,"Bienville Parish, LA",Apr-22,5307,5104,203,3.80000000
CN2201500000000,22,015,"Bossier Parish, LA",Apr-22,58669,57265,1404,2.40000000
CN2201700000000,22,017,"Caddo Parish, LA",Apr-22,103555,99267,4288,4.10000000
CN2201900000000,22,019,"Calcasieu Parish, LA",Apr-22,99573,96181,3392,3.40000000
CN2202100000000,22,021,"Caldwell Parish, LA",Apr-22,3704,3589,115,3.10000000
CN2202300000000,22,023,"Cameron Parish, LA",Apr-22,3678,3599,79,2.10000000
CN2202500000000,22,025,"Catahoula Parish, LA",Apr-22,3524,3404,120,3.40000000
CN2202700000000,22,027,"Claiborne Parish, LA",Apr-22,5400,5231,169,3.10000000
CN2202900000000,22,029,"Concordia Parish, LA",Apr-22,7025,6734,291,4.10000000
CN2203100000000,22,031,"De Soto Parish, LA",Apr-22,11039,10689,350,3.20000000
CN2203300000000,22,033,"East Baton Rouge Parish, LA",Apr-22,231102,223387,7715,3.30000000
CN2203500000000,22,035,"East Carroll Parish, LA",Apr-22,1716,1590,126,7.30000000
CN2203700000000,22,037,"East Feliciana Parish, LA",Apr-22,7812,7593,219,2.80000000
CN2203900000000,22,039,"Evangeline Parish, LA",Apr-22,12095,11652,443,3.70000000
CN2204100000000,22,041,"Franklin Parish, LA",Apr-22,7552,7243,309,4.10000000
CN2204300000000,22,043,"Grant Parish, LA",Apr-22,8410,8197,213,2.50000000
CN2204500000000,22,045,"Iberia Parish, LA",Apr-22,28325,27049,1276,4.50000000
CN2204700000000,22,047,"Iberville Parish, LA",Apr-22,13899,13205,694,5.00000000
CN2204900000000,22,049,"Jackson Parish, LA",Apr-22,6914,6744,170,2.50000000
CN2205100000000,22,051,"Jefferson Parish, LA",Apr-22,211428,203326,8102,3.80000000
CN2205300000000,22,053,"Jefferson Davis Parish, LA",Apr-22,12888,12506,382,3.00000000
CN2205500000000,22,055,"Lafayette Parish, LA",Apr-22,118049,114841,3208,2.70000000
CN2205700000000,22,057,"Lafourche Parish, LA",Apr-22,40619,39468,1151,2.80000000
CN2205900000000,22,059,"LaSalle Parish, LA",Apr-22,6643,6505,138,2.10000000
CN2206100000000,22,061,"Lincoln Parish, LA",Apr-22,21686,21115,571,2.60000000
CN2206300000000,22,063,"Livingston Parish, LA",Apr-22,70826,69157,1669,2.40000000
CN2206500000000,22,065,"Madison Parish, LA",Apr-22,3497,3331,166,4.70000000
CN2206700000000,22,067,"Morehouse Parish, LA",Apr-22,10121,9566,555,5.50000000
CN2206900000000,22,069,"Natchitoches Parish, LA",Apr-22,16792,16292,500,3.00000000
CN2207100000000,22,071,"Orleans Parish, LA",Apr-22,178851,169074,9777,5.50000000
CN2207300000000,22,073,"Ouachita Parish, LA",Apr-22,69620,67338,2282,3.30000000
CN2207500000000,22,075,"Plaquemines Parish, LA",Apr-22,9808,9555,253,2.60000000
CN2207700000000,22,077,"Pointe Coupee Parish, LA",Apr-22,9781,9416,365,3.70000000
CN2207900000000,22,079,"Rapides Parish, LA",Apr-22,56736,55288,1448,2.60000000
CN2208100000000,22,081,"Red River Parish, LA",Apr-22,3828,3727,101,2.60000000
CN2208300000000,22,083,"Richland Parish, LA",Apr-22,8339,8056,283,3.40000000
CN2208500000000,22,085,"Sabine Parish, LA",Apr-22,9453,9221,232,2.50000000
CN2208700000000,22,087,"St. Bernard Parish, LA",Apr-22,20198,19298,900,4.50000000
CN2208900000000,22,089,"St. Charles Parish, LA",Apr-22,24772,24020,752,3.00000000
CN2209100000000,22,091,"St. Helena Parish, LA",Apr-22,4280,4024,256,6.00000000
CN2209300000000,22,093,"St. James Parish, LA",Apr-22,8962,8519,443,4.90000000
CN2209500000000,22,095,"St. John the Baptist Parish, LA",Apr-22,19307,18166,1141,5.90000000
CN2209700000000,22,097,"St. Landry Parish, LA",Apr-22,32330,30923,1407,4.40000000
CN2209900000000,22,099,"St. Martin Parish, LA",Apr-22,22435,21660,775,3.50000000
CN2210100000000,22,101,"St. Mary Parish, LA",Apr-22,19251,18356,895,4.60000000
CN2210300000000,22,103,"St. Tammany Parish, LA",Apr-22,119371,116572,2799,2.30000000
CN2210500000000,22,105,"Tangipahoa Parish, LA",Apr-22,56774,54340,2434,4.30000000
CN2210700000000,22,107,"Tensas Parish, LA",Apr-22,1362,1302,60,4.40000000
CN2210900000000,22,109,"Terrebonne Parish, LA",Apr-22,44886,43221,1665,3.70000000
CN2211100000000,22,111,"Union Parish, LA",Apr-22,9108,8826,282,3.10000000
CN2211300000000,22,113,"Vermilion Parish, LA",Apr-22,24512,23748,764,3.10000000
CN2211500000000,22,115,"Vernon Parish, LA",Apr-22,15853,15374,479,3.00000000
CN2211700000000,22,117,"Washington Parish, LA",Apr-22,16891,16241,650,3.80000000
CN2211900000000,22,119,"Webster Parish, LA",Apr-22,14318,13817,501,3.50000000
CN2212100000000,22,121,"West Baton Rouge Parish, LA",Apr-22,13825,13419,406,2.90000000
CN2212300000000,22,123,"West Carroll Parish, LA",Apr-22,3604,3440,164,4.60000000
CN2212500000000,22,125,"West Feliciana Parish, LA",Apr-22,5388,5273,115,2.10000000
CN2212700000000,22,127,"Winn Parish, LA",Apr-22,4642,4494,148,3.20000000
CN2300100000000,23,001,"Androscoggin County, ME",Apr-22,53232,51652,1580,3.00000000
CN2300300000000,23,003,"Aroostook County, ME",Apr-22,28333,26814,1519,5.40000000
CN2300500000000,23,005,"Cumberland County, ME",Apr-22,159206,155517,3689,2.30000000
CN2300700000000,23,007,"Franklin County, ME",Apr-22,13613,13078,535,3.90000000
CN2300900000000,23,009,"Hancock County, ME",Apr-22,27575,26486,1089,3.90000000
CN2301100000000,23,011,"Kennebec County, ME",Apr-22,60114,58434,1680,2.80000000
CN2301300000000,23,013,"Knox County, ME",Apr-22,19277,18687,590,3.10000000
CN2301500000000,23,015,"Lincoln County, ME",Apr-22,16071,15565,506,3.10000000
CN2301700000000,23,017,"Oxford County, ME",Apr-22,25349,24458,891,3.50000000
CN2301900000000,23,019,"Penobscot County, ME",Apr-22,74832,72424,2408,3.20000000
CN2302100000000,23,021,"Piscataquis County, ME",Apr-22,7223,6888,335,4.60000000
CN2302300000000,23,023,"Sagadahoc County, ME",Apr-22,18902,18433,469,2.50000000
CN2302500000000,23,025,"Somerset County, ME",Apr-22,21775,20780,995,4.60000000
CN2302700000000,23,027,"Waldo County, ME",Apr-22,20046,19366,680,3.40000000
CN2302900000000,23,029,"Washington County, ME",Apr-22,13114,12406,708,5.40000000
CN2303100000000,23,031,"York County, ME",Apr-22,109761,106762,2999,2.70000000
CN2400100000000,24,001,"Allegany County, MD",Apr-22,30337,29048,1289,4.20000000
CN2400300000000,24,003,"Anne Arundel County, MD",Apr-22,316398,307641,8757,2.80000000
CN2400500000000,24,005,"Baltimore County, MD",Apr-22,449069,433688,15381,3.40000000
CN2400900000000,24,009,"Calvert County, MD",Apr-22,48873,47422,1451,3.00000000
CN2401100000000,24,011,"Caroline County, MD",Apr-22,17322,16831,491,2.80000000
CN2401300000000,24,013,"Carroll County, MD",Apr-22,94838,92552,2286,2.40000000
CN2401500000000,24,015,"Cecil County, MD",Apr-22,52153,50467,1686,3.20000000
CN2401700000000,24,017,"Charles County, MD",Apr-22,85682,82688,2994,3.50000000
CN2401900000000,24,019,"Dorchester County, MD",Apr-22,15711,15158,553,3.50000000
CN2402100000000,24,021,"Frederick County, MD",Apr-22,135527,131717,3810,2.80000000
CN2402300000000,24,023,"Garrett County, MD",Apr-22,14867,14408,459,3.10000000
CN2402500000000,24,025,"Harford County, MD",Apr-22,140731,136796,3935,2.80000000
CN2402700000000,24,027,"Howard County, MD",Apr-22,189266,184483,4783,2.50000000
CN2402900000000,24,029,"Kent County, MD",Apr-22,9344,9019,325,3.50000000
CN2403100000000,24,031,"Montgomery County, MD",Apr-22,550452,534077,16375,3.00000000
CN2403300000000,24,033,"Prince George's County, MD",Apr-22,496136,474037,22099,4.50000000
CN2403500000000,24,035,"Queen Anne's County, MD",Apr-22,27894,27196,698,2.50000000
CN2403700000000,24,037,"St. Mary's County, MD",Apr-22,57084,55403,1681,2.90000000
CN2403900000000,24,039,"Somerset County, MD",Apr-22,8479,8025,454,5.40000000
CN2404100000000,24,041,"Talbot County, MD",Apr-22,17128,16611,517,3.00000000
CN2404300000000,24,043,"Washington County, MD",Apr-22,71443,69165,2278,3.20000000
CN2404500000000,24,045,"Wicomico County, MD",Apr-22,49004,47016,1988,4.10000000
CN2404700000000,24,047,"Worcester County, MD",Apr-22,24329,22900,1429,5.90000000
CN2451000000000,24,510,"Baltimore city, MD",Apr-22,278274,264727,13547,4.90000000
CN2500100000000,25,001,"Barnstable County, MA",Apr-22,107614,102676,4938,4.60000000
CN2500300000000,25,003,"Berkshire County, MA",Apr-22,59786,57262,2524,4.20000000
CN2500500000000,25,005,"Bristol County, MA",Apr-22,295719,283396,12323,4.20000000
CN2500700000000,25,007,"Dukes County, MA",Apr-22,8799,8322,477,5.40000000
CN2500900000000,25,009,"Essex County, MA",Apr-22,418364,403026,15338,3.70000000
CN2501100000000,25,011,"Franklin County, MA",Apr-22,40593,39405,1188,2.90000000
CN2501300000000,25,013,"Hampden County, MA",Apr-22,224755,214511,10244,4.60000000
CN2501500000000,25,015,"Hampshire County, MA",Apr-22,89521,87073,2448,2.70000000
CN2501700000000,25,017,"Middlesex County, MA",Apr-22,909240,886083,23157,2.50000000
CN2501900000000,25,019,"Nantucket County/town, MA",Apr-22,6675,6236,439,6.60000000
CN2502100000000,25,021,"Norfolk County, MA",Apr-22,391586,380151,11435,2.90000000
CN2502300000000,25,023,"Plymouth County, MA",Apr-22,281352,270919,10433,3.70000000
CN2502500000000,25,025,"Suffolk County, MA",Apr-22,451417,437579,13838,3.10000000
CN2502700000000,25,027,"Worcester County, MA",Apr-22,435977,420786,15191,3.50000000
CN2600100000000,26,001,"Alcona County, MI",Apr-22,3707,3459,248,6.70000000
CN2600300000000,26,003,"Alger County, MI",Apr-22,3003,2732,271,9.00000000
CN2600500000000,26,005,"Allegan County, MI",Apr-22,61310,59327,1983,3.20000000
CN2600700000000,26,007,"Alpena County, MI",Apr-22,13476,12862,614,4.60000000
CN2600900000000,26,009,"Antrim County, MI",Apr-22,9422,8799,623,6.60000000
CN2601100000000,26,011,"Arenac County, MI",Apr-22,5729,5279,450,7.90000000
CN2601300000000,26,013,"Baraga County, MI",Apr-22,3098,2829,269,8.70000000
CN2601500000000,26,015,"Barry County, MI",Apr-22,31308,30257,1051,3.40000000
CN2601700000000,26,017,"Bay County, MI",Apr-22,48677,46247,2430,5.00000000
CN2601900000000,26,019,"Benzie County, MI",Apr-22,8456,7994,462,5.50000000
CN2602100000000,26,021,"Berrien County, MI",Apr-22,70401,67433,2968,4.20000000
CN2602300000000,26,023,"Branch County, MI",Apr-22,19106,18427,679,3.60000000
CN2602500000000,26,025,"Calhoun County, MI",Apr-22,60031,57255,2776,4.60000000
CN2602700000000,26,027,"Cass County, MI",Apr-22,23489,22628,861,3.70000000
CN2602900000000,26,029,"Charlevoix County, MI",Apr-22,11716,11102,614,5.20000000
CN2603100000000,26,031,"Cheboygan County, MI",Apr-22,9602,8613,989,10.30000000
CN2603300000000,26,033,"Chippewa County, MI",Apr-22,16151,15071,1080,6.70000000
CN2603500000000,26,035,"Clare County, MI",Apr-22,11327,10512,815,7.20000000
CN2603700000000,26,037,"Clinton County, MI",Apr-22,40040,38677,1363,3.40000000
CN2603900000000,26,039,"Crawford County, MI",Apr-22,5313,4945,368,6.90000000
CN2604100000000,26,041,"Delta County, MI",Apr-22,16295,15354,941,5.80000000
CN2604300000000,26,043,"Dickinson County, MI",Apr-22,12093,11579,514,4.30000000
CN2604500000000,26,045,"Eaton County, MI",Apr-22,55717,53479,2238,4.00000000
CN2604700000000,26,047,"Emmet County, MI",Apr-22,15746,14739,1007,6.40000000
CN2604900000000,26,049,"Genesee County, MI",Apr-22,175763,165681,10082,5.70000000
CN2605100000000,26,051,"Gladwin County, MI",Apr-22,9605,9000,605,6.30000000
CN2605300000000,26,053,"Gogebic County, MI",Apr-22,5591,5275,316,5.70000000
CN2605500000000,26,055,"Grand Traverse County, MI",Apr-22,47593,45843,1750,3.70000000
CN2605700000000,26,057,"Gratiot County, MI",Apr-22,17341,16600,741,4.30000000
CN2605900000000,26,059,"Hillsdale County, MI",Apr-22,19791,19003,788,4.00000000
CN2606100000000,26,061,"Houghton County, MI",Apr-22,16019,15240,779,4.90000000
CN2606300000000,26,063,"Huron County, MI",Apr-22,14490,13853,637,4.40000000
CN2606500000000,26,065,"Ingham County, MI",Apr-22,145707,139697,6010,4.10000000
CN2606700000000,26,067,"Ionia County, MI",Apr-22,29790,28769,1021,3.40000000
CN2606900000000,26,069,"Iosco County, MI",Apr-22,9917,9235,682,6.90000000
CN2607100000000,26,071,"Iron County, MI",Apr-22,4793,4506,287,6.00000000
CN2607300000000,26,073,"Isabella County, MI",Apr-22,32556,31184,1372,4.20000000
CN2607500000000,26,075,"Jackson County, MI",Apr-22,73293,70186,3107,4.20000000
CN2607700000000,26,077,"Kalamazoo County, MI",Apr-22,131282,126705,4577,3.50000000
CN2607900000000,26,079,"Kalkaska County, MI",Apr-22,7599,7126,473,6.20000000
CN2608100000000,26,081,"Kent County, MI",Apr-22,353998,342820,11178,3.20000000
CN2608300000000,26,083,"Keweenaw County, MI",Apr-22,905,841,64,7.10000000
CN2608500000000,26,085,"Lake County, MI",Apr-22,3897,3623,274,7.00000000
CN2608700000000,26,087,"Lapeer County, MI",Apr-22,40093,38284,1809,4.50000000
CN2608900000000,26,089,"Leelanau County, MI",Apr-22,9986,9555,431,4.30000000
CN2609100000000,26,091,"Lenawee County, MI",Apr-22,44629,42717,1912,4.30000000
CN2609300000000,26,093,"Livingston County, MI",Apr-22,102070,99301,2769,2.70000000
CN2609500000000,26,095,"Luce County, MI",Apr-22,2074,1921,153,7.40000000
CN2609700000000,26,097,"Mackinac County, MI",Apr-22,4320,3727,593,13.70000000
CN2609900000000,26,099,"Macomb County, MI",Apr-22,439314,421376,17938,4.10000000
CN2610100000000,26,101,"Manistee County, MI",Apr-22,9975,9363,612,6.10000000
CN2610300000000,26,103,"Marquette County, MI",Apr-22,31601,30095,1506,4.80000000
CN2610500000000,26,105,"Mason County, MI",Apr-22,12914,12257,657,5.10000000
CN2610700000000,26,107,"Mecosta County, MI",Apr-22,18334,17436,898,4.90000000
CN2610900000000,26,109,"Menominee County, MI",Apr-22,10428,9999,429,4.10000000
CN2611100000000,26,111,"Midland County, MI",Apr-22,38846,37277,1569,4.00000000
CN2611300000000,26,113,"Missaukee County, MI",Apr-22,6782,6439,343,5.10000000
CN2611500000000,26,115,"Monroe County, MI",Apr-22,73724,70601,3123,4.20000000
CN2611700000000,26,117,"Montcalm County, MI",Apr-22,27322,26236,1086,4.00000000
CN2611900000000,26,119,"Montmorency County, MI",Apr-22,3001,2739,262,8.70000000
CN2612100000000,26,121,"Muskegon County, MI",Apr-22,76181,72121,4060,5.30000000
CN2612300000000,26,123,"Newaygo County, MI",Apr-22,23439,22448,991,4.20000000
CN2612500000000,26,125,"Oakland County, MI",Apr-22,661143,640962,20181,3.10000000
CN2612700000000,26,127,"Oceana County, MI",Apr-22,11510,10704,806,7.00000000
CN2612900000000,26,129,"Ogemaw County, MI",Apr-22,7962,7368,594,7.50000000
CN2613100000000,26,131,"Ontonagon County, MI",Apr-22,2017,1846,171,8.50000000
CN2613300000000,26,133,"Osceola County, MI",Apr-22,11489,10983,506,4.40000000
CN2613500000000,26,135,"Oscoda County, MI",Apr-22,2540,2308,232,9.10000000
CN2613700000000,26,137,"Otsego County, MI",Apr-22,11261,10591,670,5.90000000
CN2613900000000,26,139,"Ottawa County, MI",Apr-22,159014,154589,4425,2.80000000
CN2614100000000,26,141,"Presque Isle County, MI",Apr-22,4835,4468,367,7.60000000
CN2614300000000,26,143,"Roscommon County, MI",Apr-22,7163,6384,779,10.90000000
CN2614500000000,26,145,"Saginaw County, MI",Apr-22,81728,77086,4642,5.70000000
CN2614700000000,26,147,"St. Clair County, MI",Apr-22,74024,71052,2972,4.00000000
CN2614900000000,26,149,"St. Joseph County, MI",Apr-22,27947,26991,956,3.40000000
CN2615100000000,26,151,"Sanilac County, MI",Apr-22,18934,18006,928,4.90000000
CN2615300000000,26,153,"Schoolcraft County, MI",Apr-22,3133,2867,266,8.50000000
CN2615500000000,26,155,"Shiawassee County, MI",Apr-22,32338,30914,1424,4.40000000
CN2615700000000,26,157,"Tuscola County, MI",Apr-22,22827,21671,1156,5.10000000
CN2615900000000,26,159,"Van Buren County, MI",Apr-22,34275,32673,1602,4.70000000
CN2616100000000,26,161,"Washtenaw County, MI",Apr-22,197934,192018,5916,3.00000000
CN2616300000000,26,163,"Wayne County, MI",Apr-22,794746,751347,43399,5.50000000
CN2616500000000,26,165,"Wexford County, MI",Apr-22,14584,13909,675,4.60000000
CN2700100000000,27,001,"Aitkin County, MN",Apr-22,7171,6937,234,3.30000000
CN2700300000000,27,003,"Anoka County, MN",Apr-22,200640,197543,3097,1.50000000
CN2700500000000,27,005,"Becker County, MN",Apr-22,17754,17375,379,2.10000000
CN2700700000000,27,007,"Beltrami County, MN",Apr-22,23836,23243,593,2.50000000
CN2700900000000,27,009,"Benton County, MN",Apr-22,21787,21302,485,2.20000000
CN2701100000000,27,011,"Big Stone County, MN",Apr-22,2266,2212,54,2.40000000
CN2701300000000,27,013,"Blue Earth County, MN",Apr-22,40447,39914,533,1.30000000
CN2701500000000,27,015,"Brown County, MN",Apr-22,13134,12908,226,1.70000000
CN2701700000000,27,017,"Carlton County, MN",Apr-22,17604,17168,436,2.50000000
CN2701900000000,27,019,"Carver County, MN",Apr-22,59858,59122,736,1.20000000
CN2702100000000,27,021,"Cass County, MN",Apr-22,15281,14850,431,2.80000000
CN2702300000000,27,023,"Chippewa County, MN",Apr-22,6267,6173,94,1.50000000
CN2702500000000,27,025,"Chisago County, MN",Apr-22,30143,29561,582,1.90000000
CN2702700000000,27,027,"Clay County, MN",Apr-22,36806,36287,519,1.40000000
CN2702900000000,27,029,"Clearwater County, MN",Apr-22,4345,4084,261,6.00000000
CN2703100000000,27,031,"Cook County, MN",Apr-22,2531,2454,77,3.00000000
CN2703300000000,27,033,"Cottonwood County, MN",Apr-22,6538,6446,92,1.40000000
CN2703500000000,27,035,"Crow Wing County, MN",Apr-22,30935,30253,682,2.20000000
CN2703700000000,27,037,"Dakota County, MN",Apr-22,244870,241516,3354,1.40000000
CN2703900000000,27,039,"Dodge County, MN",Apr-22,11909,11707,202,1.70000000
CN2704100000000,27,041,"Douglas County, MN",Apr-22,20502,20191,311,1.50000000
CN2704300000000,27,043,"Faribault County, MN",Apr-22,6531,6389,142,2.20000000
CN2704500000000,27,045,"Fillmore County, MN",Apr-22,11318,11149,169,1.50000000
CN2704700000000,27,047,"Freeborn County, MN",Apr-22,14902,14652,250,1.70000000
CN2704900000000,27,049,"Goodhue County, MN",Apr-22,25693,25271,422,1.60000000
CN2705100000000,27,051,"Grant County, MN",Apr-22,3142,3072,70,2.20000000
CN2705300000000,27,053,"Hennepin County, MN",Apr-22,711038,701040,9998,1.40000000
CN2705500000000,27,055,"Houston County, MN",Apr-22,10296,10159,137,1.30000000
CN2705700000000,27,057,"Hubbard County, MN",Apr-22,9644,9337,307,3.20000000
CN2705900000000,27,059,"Isanti County, MN",Apr-22,21891,21416,475,2.20000000
CN2706100000000,27,061,"Itasca County, MN",Apr-22,20244,19551,693,3.40000000
CN2706300000000,27,063,"Jackson County, MN",Apr-22,5233,5158,75,1.40000000
CN2706500000000,27,065,"Kanabec County, MN",Apr-22,8972,8651,321,3.60000000
CN2706700000000,27,067,"Kandiyohi County, MN",Apr-22,22099,21660,439,2.00000000
CN2706900000000,27,069,"Kittson County, MN",Apr-22,2159,2119,40,1.90000000
CN2707100000000,27,071,"Koochiching County, MN",Apr-22,5368,5158,210,3.90000000
CN2707300000000,27,073,"Lac qui Parle County, MN",Apr-22,3226,3169,57,1.80000000
CN2707500000000,27,075,"Lake County, MN",Apr-22,5054,4955,99,2.00000000
CN2707700000000,27,077,"Lake of the Woods County, MN",Apr-22,2211,2164,47,2.10000000
CN2707900000000,27,079,"Le Sueur County, MN",Apr-22,15960,15563,397,2.50000000
CN2708100000000,27,081,"Lincoln County, MN",Apr-22,2819,2756,63,2.20000000
CN2708300000000,27,083,"Lyon County, MN",Apr-22,13787,13562,225,1.60000000
CN2708500000000,27,085,"McLeod County, MN",Apr-22,18624,18276,348,1.90000000
CN2708700000000,27,087,"Mahnomen County, MN",Apr-22,2089,2014,75,3.60000000
CN2708900000000,27,089,"Marshall County, MN",Apr-22,5055,4896,159,3.10000000
CN2709100000000,27,091,"Martin County, MN",Apr-22,9100,8956,144,1.60000000
CN2709300000000,27,093,"Meeker County, MN",Apr-22,12889,12630,259,2.00000000
CN2709500000000,27,095,"Mille Lacs County, MN",Apr-22,12701,12321,380,3.00000000
CN2709700000000,27,097,"Morrison County, MN",Apr-22,17141,16609,532,3.10000000
CN2709900000000,27,099,"Mower County, MN",Apr-22,20258,19956,302,1.50000000
CN2710100000000,27,101,"Murray County, MN",Apr-22,4422,4311,111,2.50000000
CN2710300000000,27,103,"Nicollet County, MN",Apr-22,20692,20458,234,1.10000000
CN2710500000000,27,105,"Nobles County, MN",Apr-22,10961,10824,137,1.20000000
CN2710700000000,27,107,"Norman County, MN",Apr-22,3108,3033,75,2.40000000
CN2710900000000,27,109,"Olmsted County, MN",Apr-22,91797,90650,1147,1.20000000
CN2711100000000,27,111,"Otter Tail County, MN",Apr-22,29976,29330,646,2.20000000
CN2711300000000,27,113,"Pennington County, MN",Apr-22,8389,8164,225,2.70000000
CN2711500000000,27,115,"Pine County, MN",Apr-22,13799,13354,445,3.20000000
CN2711700000000,27,117,"Pipestone County, MN",Apr-22,4267,4189,78,1.80000000
CN2711900000000,27,119,"Polk County, MN",Apr-22,15843,15516,327,2.10000000
CN2712100000000,27,121,"Pope County, MN",Apr-22,6150,6051,99,1.60000000
CN2712300000000,27,123,"Ramsey County, MN",Apr-22,288007,283499,4508,1.60000000
CN2712500000000,27,125,"Red Lake County, MN",Apr-22,2120,2058,62,2.90000000
CN2712700000000,27,127,"Redwood County, MN",Apr-22,7178,7053,125,1.70000000
CN2712900000000,27,129,"Renville County, MN",Apr-22,7717,7525,192,2.50000000
CN2713100000000,27,131,"Rice County, MN",Apr-22,36485,35902,583,1.60000000
CN2713300000000,27,133,"Rock County, MN",Apr-22,5831,5779,52,0.90000000
CN2713500000000,27,135,"Roseau County, MN",Apr-22,7755,7629,126,1.60000000
CN2713700000000,27,137,"St. Louis County, MN",Apr-22,100431,98446,1985,2.00000000
CN2713900000000,27,139,"Scott County, MN",Apr-22,85280,84164,1116,1.30000000
CN2714100000000,27,141,"Sherburne County, MN",Apr-22,53619,52689,930,1.70000000
CN2714300000000,27,143,"Sibley County, MN",Apr-22,8009,7841,168,2.10000000
CN2714500000000,27,145,"Stearns County, MN",Apr-22,90269,88777,1492,1.70000000
CN2714700000000,27,147,"Steele County, MN",Apr-22,18837,18514,323,1.70000000
CN2714900000000,27,149,"Stevens County, MN",Apr-22,5055,4987,68,1.30000000
CN2715100000000,27,151,"Swift County, MN",Apr-22,4474,4380,94,2.10000000
CN2715300000000,27,153,"Todd County, MN",Apr-22,12971,12692,279,2.20000000
CN2715500000000,27,155,"Traverse County, MN",Apr-22,1589,1559,30,1.90000000
CN2715700000000,27,157,"Wabasha County, MN",Apr-22,12073,11890,183,1.50000000
CN2715900000000,27,159,"Wadena County, MN",Apr-22,5807,5637,170,2.90000000
CN2716100000000,27,161,"Waseca County, MN",Apr-22,8381,8189,192,2.30000000
CN2716300000000,27,163,"Washington County, MN",Apr-22,146406,144544,1862,1.30000000
CN2716500000000,27,165,"Watonwan County, MN",Apr-22,6337,6227,110,1.70000000
CN2716700000000,27,167,"Wilkin County, MN",Apr-22,3211,3165,46,1.40000000
CN2716900000000,27,169,"Winona County, MN",Apr-22,27129,26799,330,1.20000000
CN2717100000000,27,171,"Wright County, MN",Apr-22,77197,76015,1182,1.50000000
CN2717300000000,27,173,"Yellow Medicine County, MN",Apr-22,4767,4681,86,1.80000000
CN2800100000000,28,001,"Adams County, MS",Apr-22,10503,9939,564,5.40000000
CN2800300000000,28,003,"Alcorn County, MS",Apr-22,15419,14942,477,3.10000000
CN2800500000000,28,005,"Amite County, MS",Apr-22,4458,4248,210,4.70000000
CN2800700000000,28,007,"Attala County, MS",Apr-22,7150,6877,273,3.80000000
CN2800900000000,28,009,"Benton County, MS",Apr-22,3097,2965,132,4.30000000
CN2801100000000,28,011,"Bolivar County, MS",Apr-22,11489,10994,495,4.30000000
CN2801300000000,28,013,"Calhoun County, MS",Apr-22,5542,5360,182,3.30000000
CN2801500000000,28,015,"Carroll County, MS",Apr-22,3614,3472,142,3.90000000
CN2801700000000,28,017,"Chickasaw County, MS",Apr-22,6960,6697,263,3.80000000
CN2801900000000,28,019,"Choctaw County, MS",Apr-22,3651,3528,123,3.40000000
CN2802100000000,28,021,"Claiborne County, MS",Apr-22,2940,2712,228,7.80000000
CN2802300000000,28,023,"Clarke County, MS",Apr-22,5687,5428,259,4.60000000
CN2802500000000,28,025,"Clay County, MS",Apr-22,8410,8036,374,4.40000000
CN2802700000000,28,027,"Coahoma County, MS",Apr-22,7960,7522,438,5.50000000
CN2802900000000,28,029,"Copiah County, MS",Apr-22,10698,10250,448,4.20000000
CN2803100000000,28,031,"Covington County, MS",Apr-22,8190,7920,270,3.30000000
CN2803300000000,28,033,"DeSoto County, MS",Apr-22,95106,92418,2688,2.80000000
CN2803500000000,28,035,"Forrest County, MS",Apr-22,33383,32193,1190,3.60000000
CN2803700000000,28,037,"Franklin County, MS",Apr-22,2674,2551,123,4.60000000
CN2803900000000,28,039,"George County, MS",Apr-22,8789,8363,426,4.80000000
CN2804100000000,28,041,"Greene County, MS",Apr-22,4255,4023,232,5.50000000
CN2804300000000,28,043,"Grenada County, MS",Apr-22,9178,8886,292,3.20000000
CN2804500000000,28,045,"Hancock County, MS",Apr-22,19253,18548,705,3.70000000
CN2804700000000,28,047,"Harrison County, MS",Apr-22,88397,85361,3036,3.40000000
CN2804900000000,28,049,"Hinds County, MS",Apr-22,100547,96635,3912,3.90000000
CN2805100000000,28,051,"Holmes County, MS",Apr-22,5098,4752,346,6.80000000
CN2805300000000,28,053,"Humphreys County, MS",Apr-22,2008,1848,160,8.00000000
CN2805500000000,28,055,"Issaquena County, MS",Apr-22,343,317,26,7.60000000
CN2805700000000,28,057,"Itawamba County, MS",Apr-22,10394,10105,289,2.80000000
CN2805900000000,28,059,"Jackson County, MS",Apr-22,59259,56868,2391,4.00000000
CN2806100000000,28,061,"Jasper County, MS",Apr-22,5822,5541,281,4.80000000
CN2806300000000,28,063,"Jefferson County, MS",Apr-22,1906,1675,231,12.10000000
CN2806500000000,28,065,"Jefferson Davis County, MS",Apr-22,3914,3716,198,5.10000000
CN2806700000000,28,067,"Jones County, MS",Apr-22,24657,23741,916,3.70000000
CN2806900000000,28,069,"Kemper County, MS",Apr-22,3295,3127,168,5.10000000
CN2807100000000,28,071,"Lafayette County, MS",Apr-22,28753,27985,768,2.70000000
CN2807300000000,28,073,"Lamar County, MS",Apr-22,31664,30796,868,2.70000000
CN2807500000000,28,075,"Lauderdale County, MS",Apr-22,28968,27907,1061,3.70000000
CN2807700000000,28,077,"Lawrence County, MS",Apr-22,4701,4488,213,4.50000000
CN2807900000000,28,079,"Leake County, MS",Apr-22,8140,7838,302,3.70000000
CN2808100000000,28,081,"Lee County, MS",Apr-22,41195,40009,1186,2.90000000
CN2808300000000,28,083,"Leflore County, MS",Apr-22,10188,9667,521,5.10000000
CN2808500000000,28,085,"Lincoln County, MS",Apr-22,14896,14421,475,3.20000000
CN2808700000000,28,087,"Lowndes County, MS",Apr-22,25849,24882,967,3.70000000
CN2808900000000,28,089,"Madison County, MS",Apr-22,52622,51131,1491,2.80000000
CN2809100000000,28,091,"Marion County, MS",Apr-22,10520,10173,347,3.30000000
CN2809300000000,28,093,"Marshall County, MS",Apr-22,14486,13960,526,3.60000000
CN2809500000000,28,095,"Monroe County, MS",Apr-22,16070,15542,528,3.30000000
CN2809700000000,28,097,"Montgomery County, MS",Apr-22,3986,3826,160,4.00000000
CN2809900000000,28,099,"Neshoba County, MS",Apr-22,10115,9732,383,3.80000000
CN2810100000000,28,101,"Newton County, MS",Apr-22,8341,8036,305,3.70000000
CN2810300000000,28,103,"Noxubee County, MS",Apr-22,3611,3397,214,5.90000000
CN2810500000000,28,105,"Oktibbeha County, MS",Apr-22,22897,22105,792,3.50000000
CN2810700000000,28,107,"Panola County, MS",Apr-22,12635,12050,585,4.60000000
CN2810900000000,28,109,"Pearl River County, MS",Apr-22,23770,22926,844,3.60000000
CN2811100000000,28,111,"Perry County, MS",Apr-22,4260,4081,179,4.20000000
CN2811300000000,28,113,"Pike County, MS",Apr-22,14470,13818,652,4.50000000
CN2811500000000,28,115,"Pontotoc County, MS",Apr-22,15073,14654,419,2.80000000
CN2811700000000,28,117,"Prentiss County, MS",Apr-22,11568,11247,321,2.80000000
CN2811900000000,28,119,"Quitman County, MS",Apr-22,2386,2269,117,4.90000000
CN2812100000000,28,121,"Rankin County, MS",Apr-22,75362,73471,1891,2.50000000
CN2812300000000,28,123,"Scott County, MS",Apr-22,12452,12086,366,2.90000000
CN2812500000000,28,125,"Sharkey County, MS",Apr-22,1487,1403,84,5.60000000
CN2812700000000,28,127,"Simpson County, MS",Apr-22,10490,10136,354,3.40000000
CN2812900000000,28,129,"Smith County, MS",Apr-22,6757,6540,217,3.20000000
CN2813100000000,28,131,"Stone County, MS",Apr-22,7081,6825,256,3.60000000
CN2813300000000,28,133,"Sunflower County, MS",Apr-22,7641,7204,437,5.70000000
CN2813500000000,28,135,"Tallahatchie County, MS",Apr-22,4809,4622,187,3.90000000
CN2813700000000,28,137,"Tate County, MS",Apr-22,12393,11952,441,3.60000000
CN2813900000000,28,139,"Tippah County, MS",Apr-22,9889,9608,281,2.80000000
CN2814100000000,28,141,"Tishomingo County, MS",Apr-22,8449,8186,263,3.10000000
CN2814300000000,28,143,"Tunica County, MS",Apr-22,4313,4096,217,5.00000000
CN2814500000000,28,145,"Union County, MS",Apr-22,14514,14159,355,2.40000000
CN2814700000000,28,147,"Walthall County, MS",Apr-22,5003,4782,221,4.40000000
CN2814900000000,28,149,"Warren County, MS",Apr-22,19465,18688,777,4.00000000
CN2815100000000,28,151,"Washington County, MS",Apr-22,15738,14875,863,5.50000000
CN2815300000000,28,153,"Wayne County, MS",Apr-22,7584,7234,350,4.60000000
CN2815500000000,28,155,"Webster County, MS",Apr-22,4009,3872,137,3.40000000
CN2815700000000,28,157,"Wilkinson County, MS",Apr-22,2623,2443,180,6.90000000
CN2815900000000,28,159,"Winston County, MS",Apr-22,7179,6878,301,4.20000000
CN2816100000000,28,161,"Yalobusha County, MS",Apr-22,4920,4753,167,3.40000000
CN2816300000000,28,163,"Yazoo County, MS",Apr-22,8926,8508,418,4.70000000
CN2900100000000,29,001,"Adair County, MO",Apr-22,9813,9567,246,2.50000000
CN2900300000000,29,003,"Andrew County, MO",Apr-22,9751,9589,162,1.70000000
CN2900500000000,29,005,"Atchison County, MO",Apr-22,2713,2663,50,1.80000000
CN2900700000000,29,007,"Audrain County, MO",Apr-22,10204,9878,326,3.20000000
CN2900900000000,29,009,"Barry County, MO",Apr-22,14895,14540,355,2.40000000
CN2901100000000,29,011,"Barton County, MO",Apr-22,5328,5222,106,2.00000000
CN2901300000000,29,013,"Bates County, MO",Apr-22,7646,7463,183,2.40000000
CN2901500000000,29,015,"Benton County, MO",Apr-22,7311,7062,249,3.40000000
CN2901700000000,29,017,"Bollinger County, MO",Apr-22,5353,5234,119,2.20000000
CN2901900000000,29,019,"Boone County, MO",Apr-22,100638,98933,1705,1.70000000
CN2902100000000,29,021,"Buchanan County, MO",Apr-22,43686,42740,946,2.20000000
CN2902300000000,29,023,"Butler County, MO",Apr-22,18029,17555,474,2.60000000
CN2902500000000,29,025,"Caldwell County, MO",Apr-22,4251,4159,92,2.20000000
CN2902700000000,29,027,"Callaway County, MO",Apr-22,21313,20869,444,2.10000000
CN2902900000000,29,029,"Camden County, MO",Apr-22,18857,18321,536,2.80000000
CN2903100000000,29,031,"Cape Girardeau County, MO",Apr-22,40596,39790,806,2.00000000
CN2903300000000,29,033,"Carroll County, MO",Apr-22,4559,4439,120,2.60000000
CN2903500000000,29,035,"Carter County, MO",Apr-22,2533,2448,85,3.40000000
CN2903700000000,29,037,"Cass County, MO",Apr-22,54434,53225,1209,2.20000000
CN2903900000000,29,039,"Cedar County, MO",Apr-22,5744,5624,120,2.10000000
CN2904100000000,29,041,"Chariton County, MO",Apr-22,3747,3680,67,1.80000000
CN2904300000000,29,043,"Christian County, MO",Apr-22,47077,46228,849,1.80000000
CN2904500000000,29,045,"Clark County, MO",Apr-22,3136,3037,99,3.20000000
CN2904700000000,29,047,"Clay County, MO",Apr-22,137203,133998,3205,2.30000000
CN2904900000000,29,049,"Clinton County, MO",Apr-22,10558,10300,258,2.40000000
CN2905100000000,29,051,"Cole County, MO",Apr-22,38563,37900,663,1.70000000
CN2905300000000,29,053,"Cooper County, MO",Apr-22,7141,7000,141,2.00000000
CN2905500000000,29,055,"Crawford County, MO",Apr-22,10901,10617,284,2.60000000
CN2905700000000,29,057,"Dade County, MO",Apr-22,3568,3504,64,1.80000000
CN2905900000000,29,059,"Dallas County, MO",Apr-22,7247,7061,186,2.60000000
CN2906100000000,29,061,"Daviess County, MO",Apr-22,4191,4109,82,2.00000000
CN2906300000000,29,063,"DeKalb County, MO",Apr-22,4207,4121,86,2.00000000
CN2906500000000,29,065,"Dent County, MO",Apr-22,6424,6242,182,2.80000000
CN2906700000000,29,067,"Douglas County, MO",Apr-22,5230,5102,128,2.40000000
CN2906900000000,29,069,"Dunklin County, MO",Apr-22,11327,10849,478,4.20000000
CN2907100000000,29,071,"Franklin County, MO",Apr-22,53145,51990,1155,2.20000000
CN2907300000000,29,073,"Gasconade County, MO",Apr-22,7574,7422,152,2.00000000
CN2907500000000,29,075,"Gentry County, MO",Apr-22,3393,3339,54,1.60000000
CN2907700000000,29,077,"Greene County, MO",Apr-22,153999,151091,2908,1.90000000
CN2907900000000,29,079,"Grundy County, MO",Apr-22,4239,4141,98,2.30000000
CN2908100000000,29,081,"Harrison County, MO",Apr-22,3801,3729,72,1.90000000
CN2908300000000,29,083,"Henry County, MO",Apr-22,10067,9826,241,2.40000000
CN2908500000000,29,085,"Hickory County, MO",Apr-22,3957,3860,97,2.50000000
CN2908700000000,29,087,"Holt County, MO",Apr-22,2550,2513,37,1.50000000
CN2908900000000,29,089,"Howard County, MO",Apr-22,4848,4747,101,2.10000000
CN2909100000000,29,091,"Howell County, MO",Apr-22,15906,15476,430,2.70000000
CN2909300000000,29,093,"Iron County, MO",Apr-22,3484,3341,143,4.10000000
CN2909500000000,29,095,"Jackson County, MO",Apr-22,356913,346154,10759,3.00000000
CN2909700000000,29,097,"Jasper County, MO",Apr-22,57468,56229,1239,2.20000000
CN2909900000000,29,099,"Jefferson County, MO",Apr-22,118383,115686,2697,2.30000000
CN2910100000000,29,101,"Johnson County, MO",Apr-22,22772,22247,525,2.30000000
CN2910300000000,29,103,"Knox County, MO",Apr-22,1737,1706,31,1.80000000
CN2910500000000,29,105,"Laclede County, MO",Apr-22,16474,16085,389,2.40000000
CN2910700000000,29,107,"Lafayette County, MO",Apr-22,16692,16296,396,2.40000000
CN2910900000000,29,109,"Lawrence County, MO",Apr-22,17221,16852,369,2.10000000
CN2911100000000,29,111,"Lewis County, MO",Apr-22,4822,4724,98,2.00000000
CN2911300000000,29,113,"Lincoln County, MO",Apr-22,29445,28720,725,2.50000000
CN2911500000000,29,115,"Linn County, MO",Apr-22,5032,4901,131,2.60000000
CN2911700000000,29,117,"Livingston County, MO",Apr-22,7290,7158,132,1.80000000
CN2911900000000,29,119,"McDonald County, MO",Apr-22,10963,10701,262,2.40000000
CN2912100000000,29,121,"Macon County, MO",Apr-22,7306,7144,162,2.20000000
CN2912300000000,29,123,"Madison County, MO",Apr-22,5454,5310,144,2.60000000
CN2912500000000,29,125,"Maries County, MO",Apr-22,3923,3837,86,2.20000000
CN2912700000000,29,127,"Marion County, MO",Apr-22,13968,13680,288,2.10000000
CN2912900000000,29,129,"Mercer County, MO",Apr-22,1839,1804,35,1.90000000
CN2913100000000,29,131,"Miller County, MO",Apr-22,12562,12273,289,2.30000000
CN2913300000000,29,133,"Mississippi County, MO",Apr-22,5332,5163,169,3.20000000
CN2913500000000,29,135,"Moniteau County, MO",Apr-22,7074,6926,148,2.10000000
CN2913700000000,29,137,"Monroe County, MO",Apr-22,3808,3711,97,2.50000000
CN2913900000000,29,139,"Montgomery County, MO",Apr-22,5921,5786,135,2.30000000
CN2914100000000,29,141,"Morgan County, MO",Apr-22,8297,8077,220,2.70000000
CN2914300000000,29,143,"New Madrid County, MO",Apr-22,8523,8267,256,3.00000000
CN2914500000000,29,145,"Newton County, MO",Apr-22,27287,26698,589,2.20000000
CN2914700000000,29,147,"Nodaway County, MO",Apr-22,10889,10702,187,1.70000000
CN2914900000000,29,149,"Oregon County, MO",Apr-22,3784,3681,103,2.70000000
CN2915100000000,29,151,"Osage County, MO",Apr-22,7011,6896,115,1.60000000
CN2915300000000,29,153,"Ozark County, MO",Apr-22,3467,3356,111,3.20000000
CN2915500000000,29,155,"Pemiscot County, MO",Apr-22,5885,5614,271,4.60000000
CN2915700000000,29,157,"Perry County, MO",Apr-22,9536,9359,177,1.90000000
CN2915900000000,29,159,"Pettis County, MO",Apr-22,19859,19401,458,2.30000000
CN2916100000000,29,161,"Phelps County, MO",Apr-22,20045,19624,421,2.10000000
CN2916300000000,29,163,"Pike County, MO",Apr-22,7333,7151,182,2.50000000
CN2916500000000,29,165,"Platte County, MO",Apr-22,59374,58125,1249,2.10000000
CN2916700000000,29,167,"Polk County, MO",Apr-22,14717,14412,305,2.10000000
CN2916900000000,29,169,"Pulaski County, MO",Apr-22,14556,14182,374,2.60000000
CN2917100000000,29,171,"Putnam County, MO",Apr-22,2228,2181,47,2.10000000
CN2917300000000,29,173,"Ralls County, MO",Apr-22,5522,5412,110,2.00000000
CN2917500000000,29,175,"Randolph County, MO",Apr-22,10383,10145,238,2.30000000
CN2917700000000,29,177,"Ray County, MO",Apr-22,10756,10467,289,2.70000000
CN2917900000000,29,179,"Reynolds County, MO",Apr-22,2904,2829,75,2.60000000
CN2918100000000,29,181,"Ripley County, MO",Apr-22,5082,4932,150,3.00000000
CN2918300000000,29,183,"St. Charles County, MO",Apr-22,230028,225525,4503,2.00000000
CN2918500000000,29,185,"St. Clair County, MO",Apr-22,3824,3727,97,2.50000000
CN2918600000000,29,186,"Ste. Genevieve County, MO",Apr-22,9288,9100,188,2.00000000
CN2918700000000,29,187,"St. Francois County, MO",Apr-22,25747,24941,806,3.10000000
CN2918900000000,29,189,"St. Louis County, MO",Apr-22,528896,515650,13246,2.50000000
CN2919500000000,29,195,"Saline County, MO",Apr-22,10492,10292,200,1.90000000
CN2919700000000,29,197,"Schuyler County, MO",Apr-22,1832,1789,43,2.30000000
CN2919900000000,29,199,"Scotland County, MO",Apr-22,2306,2256,50,2.20000000
CN2920100000000,29,201,"Scott County, MO",Apr-22,20448,19995,453,2.20000000
CN2920300000000,29,203,"Shannon County, MO",Apr-22,3297,3182,115,3.50000000
CN2920500000000,29,205,"Shelby County, MO",Apr-22,3051,2996,55,1.80000000
CN2920700000000,29,207,"Stoddard County, MO",Apr-22,13304,12957,347,2.60000000
CN2920900000000,29,209,"Stone County, MO",Apr-22,12636,12161,475,3.80000000
CN2921100000000,29,211,"Sullivan County, MO",Apr-22,2655,2580,75,2.80000000
CN2921300000000,29,213,"Taney County, MO",Apr-22,24268,23229,1039,4.30000000
CN2921500000000,29,215,"Texas County, MO",Apr-22,9134,8893,241,2.60000000
CN2921700000000,29,217,"Vernon County, MO",Apr-22,9354,9159,195,2.10000000
CN2921900000000,29,219,"Warren County, MO",Apr-22,18861,18428,433,2.30000000
CN2922100000000,29,221,"Washington County, MO",Apr-22,10129,9812,317,3.10000000
CN2922300000000,29,223,"Wayne County, MO",Apr-22,4791,4635,156,3.30000000
CN2922500000000,29,225,"Webster County, MO",Apr-22,17615,17276,339,1.90000000
CN2922700000000,29,227,"Worth County, MO",Apr-22,1205,1188,17,1.40000000
CN2922900000000,29,229,"Wright County, MO",Apr-22,7884,7696,188,2.40000000
CN2951000000000,29,510,"St. Louis city, MO",Apr-22,150142,144719,5423,3.60000000
CN3000100000000,30,001,"Beaverhead County, MT",Apr-22,5199,5070,129,2.50000000
CN3000300000000,30,003,"Big Horn County, MT",Apr-22,4757,4488,269,5.70000000
CN3000500000000,30,005,"Blaine County, MT",Apr-22,2329,2259,70,3.00000000
CN3000700000000,30,007,"Broadwater County, MT",Apr-22,2701,2615,86,3.20000000
CN3000900000000,30,009,"Carbon County, MT",Apr-22,5829,5667,162,2.80000000
CN3001100000000,30,011,"Carter County, MT",Apr-22,669,654,15,2.20000000
CN3001300000000,30,013,"Cascade County, MT",Apr-22,38510,37480,1030,2.70000000
CN3001500000000,30,015,"Chouteau County, MT",Apr-22,2498,2447,51,2.00000000
CN3001700000000,30,017,"Custer County, MT",Apr-22,6480,6329,151,2.30000000
CN3001900000000,30,019,"Daniels County, MT",Apr-22,898,882,16,1.80000000
CN3002100000000,30,021,"Dawson County, MT",Apr-22,4597,4488,109,2.40000000
CN3002300000000,30,023,"Deer Lodge County, MT",Apr-22,5322,5191,131,2.50000000
CN3002500000000,30,025,"Fallon County, MT",Apr-22,1637,1607,30,1.80000000
CN3002700000000,30,027,"Fergus County, MT",Apr-22,6102,5925,177,2.90000000
CN3002900000000,30,029,"Flathead County, MT",Apr-22,51297,49627,1670,3.30000000
CN3003100000000,30,031,"Gallatin County, MT",Apr-22,75843,74441,1402,1.80000000
CN3003300000000,30,033,"Garfield County, MT",Apr-22,766,749,17,2.20000000
CN3003500000000,30,035,"Glacier County, MT",Apr-22,5532,5183,349,6.30000000
CN3003700000000,30,037,"Golden Valley County, MT",Apr-22,382,370,12,3.10000000
CN3003900000000,30,039,"Granite County, MT",Apr-22,1646,1571,75,4.60000000
CN3004100000000,30,041,"Hill County, MT",Apr-22,7549,7368,181,2.40000000
CN3004300000000,30,043,"Jefferson County, MT",Apr-22,6025,5866,159,2.60000000
CN3004500000000,30,045,"Judith Basin County, MT",Apr-22,954,932,22,2.30000000
CN3004700000000,30,047,"Lake County, MT",Apr-22,14328,13913,415,2.90000000
CN3004900000000,30,049,"Lewis and Clark County, MT",Apr-22,37957,37049,908,2.40000000
CN3005100000000,30,051,"Liberty County, MT",Apr-22,1026,1005,21,2.00000000
CN3005300000000,30,053,"Lincoln County, MT",Apr-22,8392,7915,477,5.70000000
CN3005500000000,30,055,"McCone County, MT",Apr-22,1014,1000,14,1.40000000
CN3005700000000,30,057,"Madison County, MT",Apr-22,5449,5340,109,2.00000000
CN3005900000000,30,059,"Meagher County, MT",Apr-22,979,957,22,2.20000000
CN3006100000000,30,061,"Mineral County, MT",Apr-22,1887,1793,94,5.00000000
CN3006300000000,30,063,"Missoula County, MT",Apr-22,67058,65294,1764,2.60000000
CN3006500000000,30,065,"Musselshell County, MT",Apr-22,2416,2351,65,2.70000000
CN3006700000000,30,067,"Park County, MT",Apr-22,9197,8925,272,3.00000000
CN3006900000000,30,069,"Petroleum County, MT",Apr-22,285,278,7,2.50000000
CN3007100000000,30,071,"Phillips County, MT",Apr-22,1875,1810,65,3.50000000
CN3007300000000,30,073,"Pondera County, MT",Apr-22,2700,2635,65,2.40000000
CN3007500000000,30,075,"Powder River County, MT",Apr-22,1026,1000,26,2.50000000
CN3007700000000,30,077,"Powell County, MT",Apr-22,2963,2888,75,2.50000000
CN3007900000000,30,079,"Prairie County, MT",Apr-22,495,482,13,2.60000000
CN3008100000000,30,081,"Ravalli County, MT",Apr-22,21944,21362,582,2.70000000
CN3008300000000,30,083,"Richland County, MT",Apr-22,5748,5571,177,3.10000000
CN3008500000000,30,085,"Roosevelt County, MT",Apr-22,4407,4241,166,3.80000000
CN3008700000000,30,087,"Rosebud County, MT",Apr-22,3697,3571,126,3.40000000
CN3008900000000,30,089,"Sanders County, MT",Apr-22,5382,5147,235,4.40000000
CN3009100000000,30,091,"Sheridan County, MT",Apr-22,1797,1758,39,2.20000000
CN3009300000000,30,093,"Silver Bow County, MT",Apr-22,17967,17446,521,2.90000000
CN3009500000000,30,095,"Stillwater County, MT",Apr-22,5655,5525,130,2.30000000
CN3009700000000,30,097,"Sweet Grass County, MT",Apr-22,1958,1922,36,1.80000000
CN3009900000000,30,099,"Teton County, MT",Apr-22,2875,2807,68,2.40000000
CN3010100000000,30,101,"Toole County, MT",Apr-22,2071,2030,41,2.00000000
CN3010300000000,30,103,"Treasure County, MT",Apr-22,369,363,6,1.60000000
CN3010500000000,30,105,"Valley County, MT",Apr-22,4033,3929,104,2.60000000
CN3010700000000,30,107,"Wheatland County, MT",Apr-22,773,744,29,3.80000000
CN3010900000000,30,109,"Wibaux County, MT",Apr-22,427,414,13,3.00000000
CN3011100000000,30,111,"Yellowstone County, MT",Apr-22,86621,84570,2051,2.40000000
CN3100100000000,31,001,"Adams County, NE",Apr-22,16913,16621,292,1.70000000
CN3100300000000,31,003,"Antelope County, NE",Apr-22,3762,3707,55,1.50000000
CN3100500000000,31,005,"Arthur County, NE",Apr-22,238,234,4,1.70000000
CN3100700000000,31,007,"Banner County, NE",Apr-22,399,390,9,2.30000000
CN3100900000000,31,009,"Blaine County, NE",Apr-22,258,251,7,2.70000000
CN3101100000000,31,011,"Boone County, NE",Apr-22,3034,2992,42,1.40000000
CN3101300000000,31,013,"Box Butte County, NE",Apr-22,5432,5323,109,2.00000000
CN3101500000000,31,015,"Boyd County, NE",Apr-22,1059,1040,19,1.80000000
CN3101700000000,31,017,"Brown County, NE",Apr-22,1432,1403,29,2.00000000
CN3101900000000,31,019,"Buffalo County, NE",Apr-22,28056,27603,453,1.60000000
CN3102100000000,31,021,"Burt County, NE",Apr-22,3966,3888,78,2.00000000
CN3102300000000,31,023,"Butler County, NE",Apr-22,4699,4634,65,1.40000000
CN3102500000000,31,025,"Cass County, NE",Apr-22,13814,13556,258,1.90000000
CN3102700000000,31,027,"Cedar County, NE",Apr-22,4684,4618,66,1.40000000
CN3102900000000,31,029,"Chase County, NE",Apr-22,2309,2274,35,1.50000000
CN3103100000000,31,031,"Cherry County, NE",Apr-22,3465,3419,46,1.30000000
CN3103300000000,31,033,"Cheyenne County, NE",Apr-22,4182,4087,95,2.30000000
CN3103500000000,31,035,"Clay County, NE",Apr-22,3264,3206,58,1.80000000
CN3103700000000,31,037,"Colfax County, NE",Apr-22,5804,5713,91,1.60000000
CN3103900000000,31,039,"Cuming County, NE",Apr-22,4999,4934,65,1.30000000
CN3104100000000,31,041,"Custer County, NE",Apr-22,6388,6299,89,1.40000000
CN3104300000000,31,043,"Dakota County, NE",Apr-22,10945,10712,233,2.10000000
CN3104500000000,31,045,"Dawes County, NE",Apr-22,5042,4963,79,1.60000000
CN3104700000000,31,047,"Dawson County, NE",Apr-22,13721,13449,272,2.00000000
CN3104900000000,31,049,"Deuel County, NE",Apr-22,978,959,19,1.90000000
CN3105100000000,31,051,"Dixon County, NE",Apr-22,3045,2996,49,1.60000000
CN3105300000000,31,053,"Dodge County, NE",Apr-22,20473,20109,364,1.80000000
CN3105500000000,31,055,"Douglas County, NE",Apr-22,309556,302628,6928,2.20000000
CN3105700000000,31,057,"Dundy County, NE",Apr-22,1181,1167,14,1.20000000
CN3105900000000,31,059,"Fillmore County, NE",Apr-22,3313,3264,49,1.50000000
CN3106100000000,31,061,"Franklin County, NE",Apr-22,1525,1495,30,2.00000000
CN3106300000000,31,063,"Frontier County, NE",Apr-22,1601,1577,24,1.50000000
CN3106500000000,31,065,"Furnas County, NE",Apr-22,2619,2579,40,1.50000000
CN3106700000000,31,067,"Gage County, NE",Apr-22,11075,10871,204,1.80000000
CN3106900000000,31,069,"Garden County, NE",Apr-22,1154,1134,20,1.70000000
CN3107100000000,31,071,"Garfield County, NE",Apr-22,1148,1129,19,1.70000000
CN3107300000000,31,073,"Gosper County, NE",Apr-22,1181,1167,14,1.20000000
CN3107500000000,31,075,"Grant County, NE",Apr-22,439,433,6,1.40000000
CN3107700000000,31,077,"Greeley County, NE",Apr-22,1274,1254,20,1.60000000
CN3107900000000,31,079,"Hall County, NE",Apr-22,32427,31778,649,2.00000000
CN3108100000000,31,081,"Hamilton County, NE",Apr-22,4892,4806,86,1.80000000
CN3108300000000,31,083,"Harlan County, NE",Apr-22,1800,1771,29,1.60000000
CN3108500000000,31,085,"Hayes County, NE",Apr-22,647,640,7,1.10000000
CN3108700000000,31,087,"Hitchcock County, NE",Apr-22,1335,1308,27,2.00000000
CN3108900000000,31,089,"Holt County, NE",Apr-22,5770,5689,81,1.40000000
CN3109100000000,31,091,"Hooker County, NE",Apr-22,386,379,7,1.80000000
CN3109300000000,31,093,"Howard County, NE",Apr-22,3461,3408,53,1.50000000
CN3109500000000,31,095,"Jefferson County, NE",Apr-22,4307,4248,59,1.40000000
CN3109700000000,31,097,"Johnson County, NE",Apr-22,2021,1975,46,2.30000000
CN3109900000000,31,099,"Kearney County, NE",Apr-22,3866,3811,55,1.40000000
CN3110100000000,31,101,"Keith County, NE",Apr-22,4563,4485,78,1.70000000
CN3110300000000,31,103,"Keya Paha County, NE",Apr-22,621,611,10,1.60000000
CN3110500000000,31,105,"Kimball County, NE",Apr-22,1960,1933,27,1.40000000
CN3110700000000,31,107,"Knox County, NE",Apr-22,4758,4685,73,1.50000000
CN3110900000000,31,109,"Lancaster County, NE",Apr-22,182072,178800,3272,1.80000000
CN3111100000000,31,111,"Lincoln County, NE",Apr-22,18421,18102,319,1.70000000
CN3111300000000,31,113,"Logan County, NE",Apr-22,479,470,9,1.90000000
CN3111500000000,31,115,"Loup County, NE",Apr-22,416,407,9,2.20000000
CN3111700000000,31,117,"McPherson County, NE",Apr-22,438,432,6,1.40000000
CN3111900000000,31,119,"Madison County, NE",Apr-22,20136,19794,342,1.70000000
CN3112100000000,31,121,"Merrick County, NE",Apr-22,4166,4101,65,1.60000000
CN3112300000000,31,123,"Morrill County, NE",Apr-22,2643,2597,46,1.70000000
CN3112500000000,31,125,"Nance County, NE",Apr-22,1990,1963,27,1.40000000
CN3112700000000,31,127,"Nemaha County, NE",Apr-22,3673,3614,59,1.60000000
CN3112900000000,31,129,"Nuckolls County, NE",Apr-22,2541,2504,37,1.50000000
CN3113100000000,31,131,"Otoe County, NE",Apr-22,8655,8500,155,1.80000000
CN3113300000000,31,133,"Pawnee County, NE",Apr-22,1541,1517,24,1.60000000
CN3113500000000,31,135,"Perkins County, NE",Apr-22,1888,1865,23,1.20000000
CN3113700000000,31,137,"Phelps County, NE",Apr-22,5009,4934,75,1.50000000
CN3113900000000,31,139,"Pierce County, NE",Apr-22,4206,4146,60,1.40000000
CN3114100000000,31,141,"Platte County, NE",Apr-22,18562,18260,302,1.60000000
CN3114300000000,31,143,"Polk County, NE",Apr-22,3004,2958,46,1.50000000
CN3114500000000,31,145,"Red Willow County, NE",Apr-22,5862,5773,89,1.50000000
CN3114700000000,31,147,"Richardson County, NE",Apr-22,4339,4271,68,1.60000000
CN3114900000000,31,149,"Rock County, NE",Apr-22,914,904,10,1.10000000
CN3115100000000,31,151,"Saline County, NE",Apr-22,7388,7247,141,1.90000000
CN3115300000000,31,153,"Sarpy County, NE",Apr-22,100884,99058,1826,1.80000000
CN3115500000000,31,155,"Saunders County, NE",Apr-22,11672,11485,187,1.60000000
CN3115700000000,31,157,"Scotts Bluff County, NE",Apr-22,17577,17196,381,2.20000000
CN3115900000000,31,159,"Seward County, NE",Apr-22,8994,8841,153,1.70000000
CN3116100000000,31,161,"Sheridan County, NE",Apr-22,2760,2713,47,1.70000000
CN3116300000000,31,163,"Sherman County, NE",Apr-22,1715,1685,30,1.70000000
CN3116500000000,31,165,"Sioux County, NE",Apr-22,774,761,13,1.70000000
CN3116700000000,31,167,"Stanton County, NE",Apr-22,3636,3586,50,1.40000000
CN3116900000000,31,169,"Thayer County, NE",Apr-22,2740,2701,39,1.40000000
CN3117100000000,31,171,"Thomas County, NE",Apr-22,432,420,12,2.80000000
CN3117300000000,31,173,"Thurston County, NE",Apr-22,3206,3107,99,3.10000000
CN3117500000000,31,175,"Valley County, NE",Apr-22,2127,2097,30,1.40000000
CN3117700000000,31,177,"Washington County, NE",Apr-22,11639,11442,197,1.70000000
CN3117900000000,31,179,"Wayne County, NE",Apr-22,5774,5685,89,1.50000000
CN3118100000000,31,181,"Webster County, NE",Apr-22,1684,1657,27,1.60000000
CN3118300000000,31,183,"Wheeler County, NE",Apr-22,602,596,6,1.00000000
CN3118500000000,31,185,"York County, NE",Apr-22,7344,7219,125,1.70000000
CN3200100000000,32,001,"Churchill County, NV",Apr-22,11480,11180,300,2.60000000
CN3200300000000,32,003,"Clark County, NV",Apr-22,1109224,1053295,55929,5.00000000
CN3200500000000,32,005,"Douglas County, NV",Apr-22,21466,20787,679,3.20000000
CN3200700000000,32,007,"Elko County, NV",Apr-22,25565,24929,636,2.50000000
CN3200900000000,32,009,"Esmeralda County, NV",Apr-22,476,466,10,2.10000000
CN3201100000000,32,011,"Eureka County, NV",Apr-22,1190,1168,22,1.80000000
CN3201300000000,32,013,"Humboldt County, NV",Apr-22,8278,8080,198,2.40000000
CN3201500000000,32,015,"Lander County, NV",Apr-22,3144,3057,87,2.80000000
CN3201700000000,32,017,"Lincoln County, NV",Apr-22,2245,2183,62,2.80000000
CN3201900000000,32,019,"Lyon County, NV",Apr-22,23625,22741,884,3.70000000
CN3202100000000,32,021,"Mineral County, NV",Apr-22,2035,1972,63,3.10000000
CN3202300000000,32,023,"Nye County, NV",Apr-22,17294,16526,768,4.40000000
CN3202700000000,32,027,"Pershing County, NV",Apr-22,2644,2575,69,2.60000000
CN3202900000000,32,029,"Storey County, NV",Apr-22,2043,1976,67,3.30000000
CN3203100000000,32,031,"Washoe County, NV",Apr-22,251931,245024,6907,2.70000000
CN3203300000000,32,033,"White Pine County, NV",Apr-22,4544,4430,114,2.50000000
CN3251000000000,32,510,"Carson City, NV",Apr-22,25389,24607,782,3.10000000
CN3300100000000,33,001,"Belknap County, NH",Apr-22,30242,29577,665,2.20000000
CN3300300000000,33,003,"Carroll County, NH",Apr-22,21960,21441,519,2.40000000
CN3300500000000,33,005,"Cheshire County, NH",Apr-22,39233,38284,949,2.40000000
CN3300700000000,33,007,"Coos County, NH",Apr-22,13932,13480,452,3.20000000
CN3300900000000,33,009,"Grafton County, NH",Apr-22,47445,46505,940,2.00000000
CN3301100000000,33,011,"Hillsborough County, NH",Apr-22,239175,233837,5338,2.20000000
CN3301300000000,33,013,"Merrimack County, NH",Apr-22,81876,80339,1537,1.90000000
CN3301500000000,33,015,"Rockingham County, NH",Apr-22,185012,180812,4200,2.30000000
CN3301700000000,33,017,"Strafford County, NH",Apr-22,72320,70908,1412,2.00000000
CN3301900000000,33,019,"Sullivan County, NH",Apr-22,22638,22168,470,2.10000000
CN3400100000000,34,001,"Atlantic County, NJ",Apr-22,126397,119967,6430,5.10000000
CN3400300000000,34,003,"Bergen County, NJ",Apr-22,491077,474746,16331,3.30000000
CN3400500000000,34,005,"Burlington County, NJ",Apr-22,244458,237384,7074,2.90000000
CN3400700000000,34,007,"Camden County, NJ",Apr-22,267941,257835,10106,3.80000000
CN3400900000000,34,009,"Cape May County, NJ",Apr-22,43023,40060,2963,6.90000000
CN3401100000000,34,011,"Cumberland County, NJ",Apr-22,66951,63704,3247,4.80000000
CN3401300000000,34,013,"Essex County, NJ",Apr-22,381278,363892,17386,4.60000000
CN3401500000000,34,015,"Gloucester County, NJ",Apr-22,159499,154174,5325,3.30000000
CN3401700000000,34,017,"Hudson County, NJ",Apr-22,368287,354664,13623,3.70000000
CN3401900000000,34,019,"Hunterdon County, NJ",Apr-22,66261,64599,1662,2.50000000
CN3402100000000,34,021,"Mercer County, NJ",Apr-22,209467,203414,6053,2.90000000
CN3402300000000,34,023,"Middlesex County, NJ",Apr-22,448236,434169,14067,3.10000000
CN3402500000000,34,025,"Monmouth County, NJ",Apr-22,335819,325513,10306,3.10000000
CN3402700000000,34,027,"Morris County, NJ",Apr-22,262855,255707,7148,2.70000000
CN3402900000000,34,029,"Ocean County, NJ",Apr-22,287988,278014,9974,3.50000000
CN3403100000000,34,031,"Passaic County, NJ",Apr-22,247178,235394,11784,4.80000000
CN3403300000000,34,033,"Salem County, NJ",Apr-22,29370,28094,1276,4.30000000
CN3403500000000,34,035,"Somerset County, NJ",Apr-22,175459,170543,4916,2.80000000
CN3403700000000,34,037,"Sussex County, NJ",Apr-22,75757,73148,2609,3.40000000
CN3403900000000,34,039,"Union County, NJ",Apr-22,284133,273437,10696,3.80000000
CN3404100000000,34,041,"Warren County, NJ",Apr-22,57777,55972,1805,3.10000000
CN3500100000000,35,001,"Bernalillo County, NM",Apr-22,336549,323519,13030,3.90000000
CN3500300000000,35,003,"Catron County, NM",Apr-22,1116,1064,52,4.70000000
CN3500500000000,35,005,"Chaves County, NM",Apr-22,26319,25029,1290,4.90000000
CN3500600000000,35,006,"Cibola County, NM",Apr-22,8698,8179,519,6.00000000
CN3500700000000,35,007,"Colfax County, NM",Apr-22,5552,5333,219,3.90000000
CN3500900000000,35,009,"Curry County, NM",Apr-22,21003,20310,693,3.30000000
CN3501100000000,35,011,"De Baca County, NM",Apr-22,656,633,23,3.50000000
CN3501300000000,35,013,"Dona Ana County, NM",Apr-22,98667,93919,4748,4.80000000
CN3501500000000,35,015,"Eddy County, NM",Apr-22,30901,29684,1217,3.90000000
CN3501700000000,35,017,"Grant County, NM",Apr-22,11191,10661,530,4.70000000
CN3501900000000,35,019,"Guadalupe County, NM",Apr-22,1634,1537,97,5.90000000
CN3502100000000,35,021,"Harding County, NM",Apr-22,271,262,9,3.30000000
CN3502300000000,35,023,"Hidalgo County, NM",Apr-22,1780,1715,65,3.70000000
CN3502500000000,35,025,"Lea County, NM",Apr-22,27015,25396,1619,6.00000000
CN3502700000000,35,027,"Lincoln County, NM",Apr-22,8414,8006,408,4.80000000
CN3502800000000,35,028,"Los Alamos County, NM",Apr-22,9978,9778,200,2.00000000
CN3502900000000,35,029,"Luna County, NM",Apr-22,9335,8092,1243,13.30000000
CN3503100000000,35,031,"McKinley County, NM",Apr-22,23513,22058,1455,6.20000000
CN3503300000000,35,033,"Mora County, NM",Apr-22,1948,1853,95,4.90000000
CN3503500000000,35,035,"Otero County, NM",Apr-22,24622,23547,1075,4.40000000
CN3503700000000,35,037,"Quay County, NM",Apr-22,2892,2756,136,4.70000000
CN3503900000000,35,039,"Rio Arriba County, NM",Apr-22,16495,15695,800,4.80000000
CN3504100000000,35,041,"Roosevelt County, NM",Apr-22,7876,7591,285,3.60000000
CN3504300000000,35,043,"Sandoval County, NM",Apr-22,67977,65176,2801,4.10000000
CN3504500000000,35,045,"San Juan County, NM",Apr-22,49997,47457,2540,5.10000000
CN3504700000000,35,047,"San Miguel County, NM",Apr-22,10035,9524,511,5.10000000
CN3504900000000,35,049,"Santa Fe County, NM",Apr-22,73652,70902,2750,3.70000000
CN3505100000000,35,051,"Sierra County, NM",Apr-22,3994,3715,279,7.00000000
CN3505300000000,35,053,"Socorro County, NM",Apr-22,5969,5715,254,4.30000000
CN3505500000000,35,055,"Taos County, NM",Apr-22,13835,12974,861,6.20000000
CN3505700000000,35,057,"Torrance County, NM",Apr-22,5397,5085,312,5.80000000
CN3505900000000,35,059,"Union County, NM",Apr-22,1503,1462,41,2.70000000
CN3506100000000,35,061,"Valencia County, NM",Apr-22,31069,29660,1409,4.50000000
CN3600100000000,36,001,"Albany County, NY",Apr-22,158435,154166,4269,2.70000000
CN3600300000000,36,003,"Allegany County, NY",Apr-22,19740,19067,673,3.40000000
CN3600500000000,36,005,"Bronx County, NY",Apr-22,583220,535273,47947,8.20000000
CN3600700000000,36,007,"Broome County, NY",Apr-22,82101,79264,2837,3.50000000
CN3600900000000,36,009,"Cattaraugus County, NY",Apr-22,33200,31977,1223,3.70000000
CN3601100000000,36,011,"Cayuga County, NY",Apr-22,34782,33656,1126,3.20000000
CN3601300000000,36,013,"Chautauqua County, NY",Apr-22,52047,50150,1897,3.60000000
CN3601500000000,36,015,"Chemung County, NY",Apr-22,34475,33292,1183,3.40000000
CN3601700000000,36,017,"Chenango County, NY",Apr-22,21710,21078,632,2.90000000
CN3601900000000,36,019,"Clinton County, NY",Apr-22,34978,33939,1039,3.00000000
CN3602100000000,36,021,"Columbia County, NY",Apr-22,29610,28883,727,2.50000000
CN3602300000000,36,023,"Cortland County, NY",Apr-22,22509,21732,777,3.50000000
CN3602500000000,36,025,"Delaware County, NY",Apr-22,18479,17887,592,3.20000000
CN3602700000000,36,027,"Dutchess County, NY",Apr-22,143297,139333,3964,2.80000000
CN3602900000000,36,029,"Erie County, NY",Apr-22,440800,425434,15366,3.50000000
CN3603100000000,36,031,"Essex County, NY",Apr-22,15886,15305,581,3.70000000
CN3603300000000,36,033,"Franklin County, NY",Apr-22,18914,18297,617,3.30000000
CN3603500000000,36,035,"Fulton County, NY",Apr-22,22339,21512,827,3.70000000
CN3603700000000,36,037,"Genesee County, NY",Apr-22,29511,28686,825,2.80000000
CN3603900000000,36,039,"Greene County, NY",Apr-22,19744,19085,659,3.30000000
CN3604100000000,36,041,"Hamilton County, NY",Apr-22,2053,1949,104,5.10000000
CN3604300000000,36,043,"Herkimer County, NY",Apr-22,27365,26292,1073,3.90000000
CN3604500000000,36,045,"Jefferson County, NY",Apr-22,43403,41740,1663,3.80000000
CN3604700000000,36,047,"Kings County, NY",Apr-22,1162874,1093908,68966,5.90000000
CN3604900000000,36,049,"Lewis County, NY",Apr-22,11439,10978,461,4.00000000
CN3605100000000,36,051,"Livingston County, NY",Apr-22,30200,29312,888,2.90000000
CN3605300000000,36,053,"Madison County, NY",Apr-22,32224,31270,954,3.00000000
CN3605500000000,36,055,"Monroe County, NY",Apr-22,365312,353383,11929,3.30000000
CN3605700000000,36,057,"Montgomery County, NY",Apr-22,21847,21002,845,3.90000000
CN3605900000000,36,059,"Nassau County, NY",Apr-22,720366,701465,18901,2.60000000
CN3606100000000,36,061,"New York County, NY",Apr-22,881976,843024,38952,4.40000000
CN3606300000000,36,063,"Niagara County, NY",Apr-22,97333,93653,3680,3.80000000
CN3606500000000,36,065,"Oneida County, NY",Apr-22,100007,96710,3297,3.30000000
CN3606700000000,36,067,"Onondaga County, NY",Apr-22,220621,213678,6943,3.10000000
CN3606900000000,36,069,"Ontario County, NY",Apr-22,55762,54222,1540,2.80000000
CN3607100000000,36,071,"Orange County, NY",Apr-22,185841,180246,5595,3.00000000
CN3607300000000,36,073,"Orleans County, NY",Apr-22,17095,16516,579,3.40000000
CN3607500000000,36,075,"Oswego County, NY",Apr-22,52014,49996,2018,3.90000000
CN3607700000000,36,077,"Otsego County, NY",Apr-22,27078,26308,770,2.80000000
CN3607900000000,36,079,"Putnam County, NY",Apr-22,50878,49533,1345,2.60000000
CN3608100000000,36,081,"Queens County, NY",Apr-22,1099578,1039768,59810,5.40000000
CN3608300000000,36,083,"Rensselaer County, NY",Apr-22,81677,79471,2206,2.70000000
CN3608500000000,36,085,"Richmond County, NY",Apr-22,217858,206466,11392,5.20000000
CN3608700000000,36,087,"Rockland County, NY",Apr-22,155386,151318,4068,2.60000000
CN3608900000000,36,089,"St. Lawrence County, NY",Apr-22,43473,41920,1553,3.60000000
CN3609100000000,36,091,"Saratoga County, NY",Apr-22,120790,118017,2773,2.30000000
CN3609300000000,36,093,"Schenectady County, NY",Apr-22,77575,75141,2434,3.10000000
CN3609500000000,36,095,"Schoharie County, NY",Apr-22,14600,14164,436,3.00000000
CN3609700000000,36,097,"Schuyler County, NY",Apr-22,8006,7717,289,3.60000000
CN3609900000000,36,099,"Seneca County, NY",Apr-22,15175,14741,434,2.90000000
CN3610100000000,36,101,"Steuben County, NY",Apr-22,41153,39762,1391,3.40000000
CN3610300000000,36,103,"Suffolk County, NY",Apr-22,790529,768228,22301,2.80000000
CN3610500000000,36,105,"Sullivan County, NY",Apr-22,36476,35335,1141,3.10000000
CN3610700000000,36,107,"Tioga County, NY",Apr-22,22184,21562,622,2.80000000
CN3610900000000,36,109,"Tompkins County, NY",Apr-22,49273,48154,1119,2.30000000
CN3611100000000,36,111,"Ulster County, NY",Apr-22,87325,84825,2500,2.90000000
CN3611300000000,36,113,"Warren County, NY",Apr-22,30802,29785,1017,3.30000000
CN3611500000000,36,115,"Washington County, NY",Apr-22,27057,26235,822,3.00000000
CN3611700000000,36,117,"Wayne County, NY",Apr-22,43355,42101,1254,2.90000000
CN3611900000000,36,119,"Westchester County, NY",Apr-22,484262,469919,14343,3.00000000
CN3612100000000,36,121,"Wyoming County, NY",Apr-22,17901,17348,553,3.10000000
CN3612300000000,36,123,"Yates County, NY",Apr-22,11552,11261,291,2.50000000
CN3700100000000,37,001,"Alamance County, NC",Apr-22,83040,80216,2824,3.40000000
CN3700300000000,37,003,"Alexander County, NC",Apr-22,17886,17367,519,2.90000000
CN3700500000000,37,005,"Alleghany County, NC",Apr-22,4239,4095,144,3.40000000
CN3700700000000,37,007,"Anson County, NC",Apr-22,10259,9785,474,4.60000000
CN3700900000000,37,009,"Ashe County, NC",Apr-22,12753,12388,365,2.90000000
CN3701100000000,37,011,"Avery County, NC",Apr-22,7330,7107,223,3.00000000
CN3701300000000,37,013,"Beaufort County, NC",Apr-22,20027,19321,706,3.50000000
CN3701500000000,37,015,"Bertie County, NC",Apr-22,7269,6930,339,4.70000000
CN3701700000000,37,017,"Bladen County, NC",Apr-22,14014,13413,601,4.30000000
CN3701900000000,37,019,"Brunswick County, NC",Apr-22,56561,54082,2479,4.40000000
CN3702100000000,37,021,"Buncombe County, NC",Apr-22,141384,137478,3906,2.80000000
CN3702300000000,37,023,"Burke County, NC",Apr-22,40502,39272,1230,3.00000000
CN3702500000000,37,025,"Cabarrus County, NC",Apr-22,113568,110045,3523,3.10000000
CN3702700000000,37,027,"Caldwell County, NC",Apr-22,36122,34921,1201,3.30000000
CN3702900000000,37,029,"Camden County, NC",Apr-22,4604,4465,139,3.00000000
CN3703100000000,37,031,"Carteret County, NC",Apr-22,31203,30241,962,3.10000000
CN3703300000000,37,033,"Caswell County, NC",Apr-22,9755,9402,353,3.60000000
CN3703500000000,37,035,"Catawba County, NC",Apr-22,78802,76318,2484,3.20000000
CN3703700000000,37,037,"Chatham County, NC",Apr-22,37888,36902,986,2.60000000
CN3703900000000,37,039,"Cherokee County, NC",Apr-22,10795,10421,374,3.50000000
CN3704100000000,37,041,"Chowan County, NC",Apr-22,5656,5452,204,3.60000000
CN3704300000000,37,043,"Clay County, NC",Apr-22,4042,3902,140,3.50000000
CN3704500000000,37,045,"Cleveland County, NC",Apr-22,48680,46834,1846,3.80000000
CN3704700000000,37,047,"Columbus County, NC",Apr-22,23108,22053,1055,4.60000000
CN3704900000000,37,049,"Craven County, NC",Apr-22,41097,39752,1345,3.30000000
CN3705100000000,37,051,"Cumberland County, NC",Apr-22,128654,122013,6641,5.20000000
CN3705300000000,37,053,"Currituck County, NC",Apr-22,14470,14040,430,3.00000000
CN3705500000000,37,055,"Dare County, NC",Apr-22,18783,17963,820,4.40000000
CN3705700000000,37,057,"Davidson County, NC",Apr-22,80634,78045,2589,3.20000000
CN3705900000000,37,059,"Davie County, NC",Apr-22,20572,19936,636,3.10000000
CN3706100000000,37,061,"Duplin County, NC",Apr-22,24783,23986,797,3.20000000
CN3706300000000,37,063,"Durham County, NC",Apr-22,181383,176229,5154,2.80000000
CN3706500000000,37,065,"Edgecombe County, NC",Apr-22,20236,18730,1506,7.40000000
CN3706700000000,37,067,"Forsyth County, NC",Apr-22,186765,180314,6451,3.50000000
CN3706900000000,37,069,"Franklin County, NC",Apr-22,33447,32306,1141,3.40000000
CN3707100000000,37,071,"Gaston County, NC",Apr-22,112411,108354,4057,3.60000000
CN3707300000000,37,073,"Gates County, NC",Apr-22,5059,4907,152,3.00000000
CN3707500000000,37,075,"Graham County, NC",Apr-22,2971,2812,159,5.40000000
CN3707700000000,37,077,"Granville County, NC",Apr-22,30562,29688,874,2.90000000
CN3707900000000,37,079,"Greene County, NC",Apr-22,9567,9285,282,2.90000000
CN3708100000000,37,081,"Guilford County, NC",Apr-22,261599,251236,10363,4.00000000
CN3708300000000,37,083,"Halifax County, NC",Apr-22,19172,18067,1105,5.80000000
CN3708500000000,37,085,"Harnett County, NC",Apr-22,54623,52558,2065,3.80000000
CN3708700000000,37,087,"Haywood County, NC",Apr-22,30039,29175,864,2.90000000
CN3708900000000,37,089,"Henderson County, NC",Apr-22,55240,53684,1556,2.80000000
CN3709100000000,37,091,"Hertford County, NC",Apr-22,8558,8139,419,4.90000000
CN3709300000000,37,093,"Hoke County, NC",Apr-22,20394,19434,960,4.70000000
CN3709500000000,37,095,"Hyde County, NC",Apr-22,1774,1673,101,5.70000000
CN3709700000000,37,097,"Iredell County, NC",Apr-22,92597,89719,2878,3.10000000
CN3709900000000,37,099,"Jackson County, NC",Apr-22,19909,19261,648,3.30000000
CN3710100000000,37,101,"Johnston County, NC",Apr-22,106289,103105,3184,3.00000000
CN3710300000000,37,103,"Jones County, NC",Apr-22,4243,4116,127,3.00000000
CN3710500000000,37,105,"Lee County, NC",Apr-22,26036,25013,1023,3.90000000
CN3710700000000,37,107,"Lenoir County, NC",Apr-22,27265,26281,984,3.60000000
CN3710900000000,37,109,"Lincoln County, NC",Apr-22,45433,44117,1316,2.90000000
CN3711100000000,37,111,"McDowell County, NC",Apr-22,20095,19479,616,3.10000000
CN3711300000000,37,113,"Macon County, NC",Apr-22,15245,14756,489,3.20000000
CN3711500000000,37,115,"Madison County, NC",Apr-22,10023,9719,304,3.00000000
CN3711700000000,37,117,"Martin County, NC",Apr-22,8734,8362,372,4.30000000
CN3711900000000,37,119,"Mecklenburg County, NC",Apr-22,639195,617355,21840,3.40000000
CN3712100000000,37,121,"Mitchell County, NC",Apr-22,5909,5683,226,3.80000000
CN3712300000000,37,123,"Montgomery County, NC",Apr-22,11303,10935,368,3.30000000
CN3712500000000,37,125,"Moore County, NC",Apr-22,40113,38749,1364,3.40000000
CN3712700000000,37,127,"Nash County, NC",Apr-22,41854,39748,2106,5.00000000
CN3712900000000,37,129,"New Hanover County, NC",Apr-22,126681,122855,3826,3.00000000
CN3713100000000,37,131,"Northampton County, NC",Apr-22,7186,6872,314,4.40000000
CN3713300000000,37,133,"Onslow County, NC",Apr-22,67170,64593,2577,3.80000000
CN3713500000000,37,135,"Orange County, NC",Apr-22,82473,80367,2106,2.60000000
CN3713700000000,37,137,"Pamlico County, NC",Apr-22,5387,5210,177,3.30000000
CN3713900000000,37,139,"Pasquotank County, NC",Apr-22,16455,15806,649,3.90000000
CN3714100000000,37,141,"Pender County, NC",Apr-22,30092,29171,921,3.10000000
CN3714300000000,37,143,"Perquimans County, NC",Apr-22,4915,4717,198,4.00000000
CN3714500000000,37,145,"Person County, NC",Apr-22,19091,18430,661,3.50000000
CN3714700000000,37,147,"Pitt County, NC",Apr-22,89621,86287,3334,3.70000000
CN3714900000000,37,149,"Polk County, NC",Apr-22,9201,8874,327,3.60000000
CN3715100000000,37,151,"Randolph County, NC",Apr-22,65526,63441,2085,3.20000000
CN3715300000000,37,153,"Richmond County, NC",Apr-22,16414,15499,915,5.60000000
CN3715500000000,37,155,"Robeson County, NC",Apr-22,48290,45466,2824,5.80000000
CN3715700000000,37,157,"Rockingham County, NC",Apr-22,39646,38118,1528,3.90000000
CN3715900000000,37,159,"Rowan County, NC",Apr-22,66391,64099,2292,3.50000000
CN3716100000000,37,161,"Rutherford County, NC",Apr-22,24239,23089,1150,4.70000000
CN3716300000000,37,163,"Sampson County, NC",Apr-22,28534,27586,948,3.30000000
CN3716500000000,37,165,"Scotland County, NC",Apr-22,11051,10246,805,7.30000000
CN3716700000000,37,167,"Stanly County, NC",Apr-22,30156,29238,918,3.00000000
CN3716900000000,37,169,"Stokes County, NC",Apr-22,21416,20794,622,2.90000000
CN3717100000000,37,171,"Surry County, NC",Apr-22,32270,31289,981,3.00000000
CN3717300000000,37,173,"Swain County, NC",Apr-22,6791,6574,217,3.20000000
CN3717500000000,37,175,"Transylvania County, NC",Apr-22,14312,13884,428,3.00000000
CN3717700000000,37,177,"Tyrrell County, NC",Apr-22,1253,1183,70,5.60000000
CN3717900000000,37,179,"Union County, NC",Apr-22,127633,123956,3677,2.90000000
CN3718100000000,37,181,"Vance County, NC",Apr-22,16889,15862,1027,6.10000000
CN3718300000000,37,183,"Wake County, NC",Apr-22,620330,602964,17366,2.80000000
CN3718500000000,37,185,"Warren County, NC",Apr-22,6469,6072,397,6.10000000
CN3718700000000,37,187,"Washington County, NC",Apr-22,4251,4031,220,5.20000000
CN3718900000000,37,189,"Watauga County, NC",Apr-22,28338,27511,827,2.90000000
CN3719100000000,37,191,"Wayne County, NC",Apr-22,51512,49600,1912,3.70000000
CN3719300000000,37,193,"Wilkes County, NC",Apr-22,26915,25984,931,3.50000000
CN3719500000000,37,195,"Wilson County, NC",Apr-22,32546,30732,1814,5.60000000
CN3719700000000,37,197,"Yadkin County, NC",Apr-22,17493,16956,537,3.10000000
CN3719900000000,37,199,"Yancey County, NC",Apr-22,8215,7954,261,3.20000000
CN3800100000000,38,001,"Adams County, ND",Apr-22,921,899,22,2.40000000
CN3800300000000,38,003,"Barnes County, ND",Apr-22,5241,5114,127,2.40000000
CN3800500000000,38,005,"Benson County, ND",Apr-22,2304,2224,80,3.50000000
CN3800700000000,38,007,"Billings County, ND",Apr-22,390,381,9,2.30000000
CN3800900000000,38,009,"Bottineau County, ND",Apr-22,2938,2831,107,3.60000000
CN3801100000000,38,011,"Bowman County, ND",Apr-22,1567,1541,26,1.70000000
CN3801300000000,38,013,"Burke County, ND",Apr-22,1043,1014,29,2.80000000
CN3801500000000,38,015,"Burleigh County, ND",Apr-22,52164,51051,1113,2.10000000
CN3801700000000,38,017,"Cass County, ND",Apr-22,108828,106588,2240,2.10000000
CN3801900000000,38,019,"Cavalier County, ND",Apr-22,1888,1827,61,3.20000000
CN3802100000000,38,021,"Dickey County, ND",Apr-22,2249,2204,45,2.00000000
CN3802300000000,38,023,"Divide County, ND",Apr-22,1365,1346,19,1.40000000
CN3802500000000,38,025,"Dunn County, ND",Apr-22,3007,2953,54,1.80000000
CN3802700000000,38,027,"Eddy County, ND",Apr-22,1173,1133,40,3.40000000
CN3802900000000,38,029,"Emmons County, ND",Apr-22,1433,1356,77,5.40000000
CN3803100000000,38,031,"Foster County, ND",Apr-22,1490,1450,40,2.70000000
CN3803300000000,38,033,"Golden Valley County, ND",Apr-22,851,839,12,1.40000000
CN3803500000000,38,035,"Grand Forks County, ND",Apr-22,37883,37088,795,2.10000000
CN3803700000000,38,037,"Grant County, ND",Apr-22,1228,1208,20,1.60000000
CN3803900000000,38,039,"Griggs County, ND",Apr-22,1042,1017,25,2.40000000
CN3804100000000,38,041,"Hettinger County, ND",Apr-22,1377,1352,25,1.80000000
CN3804300000000,38,043,"Kidder County, ND",Apr-22,1327,1266,61,4.60000000
CN3804500000000,38,045,"LaMoure County, ND",Apr-22,2041,1996,45,2.20000000
CN3804700000000,38,047,"Logan County, ND",Apr-22,857,838,19,2.20000000
CN3804900000000,38,049,"McHenry County, ND",Apr-22,3154,3024,130,4.10000000
CN3805100000000,38,051,"McIntosh County, ND",Apr-22,1073,1048,25,2.30000000
CN3805300000000,38,053,"McKenzie County, ND",Apr-22,8781,8536,245,2.80000000
CN3805500000000,38,055,"McLean County, ND",Apr-22,4697,4537,160,3.40000000
CN3805700000000,38,057,"Mercer County, ND",Apr-22,3733,3607,126,3.40000000
CN3805900000000,38,059,"Morton County, ND",Apr-22,17181,16702,479,2.80000000
CN3806100000000,38,061,"Mountrail County, ND",Apr-22,6269,6152,117,1.90000000
CN3806300000000,38,063,"Nelson County, ND",Apr-22,1422,1369,53,3.70000000
CN3806500000000,38,065,"Oliver County, ND",Apr-22,881,850,31,3.50000000
CN3806700000000,38,067,"Pembina County, ND",Apr-22,3211,3080,131,4.10000000
CN3806900000000,38,069,"Pierce County, ND",Apr-22,1642,1585,57,3.50000000
CN3807100000000,38,071,"Ramsey County, ND",Apr-22,5644,5492,152,2.70000000
CN3807300000000,38,073,"Ransom County, ND",Apr-22,2657,2600,57,2.10000000
CN3807500000000,38,075,"Renville County, ND",Apr-22,1200,1172,28,2.30000000
CN3807700000000,38,077,"Richland County, ND",Apr-22,8547,8360,187,2.20000000
CN3807900000000,38,079,"Rolette County, ND",Apr-22,4799,4430,369,7.70000000
CN3808100000000,38,081,"Sargent County, ND",Apr-22,2205,2156,49,2.20000000
CN3808300000000,38,083,"Sheridan County, ND",Apr-22,653,631,22,3.40000000
CN3808500000000,38,085,"Sioux County, ND",Apr-22,1212,1187,25,2.10000000
CN3808700000000,38,087,"Slope County, ND",Apr-22,348,340,8,2.30000000
CN3808900000000,38,089,"Stark County, ND",Apr-22,17426,16995,431,2.50000000
CN3809100000000,38,091,"Steele County, ND",Apr-22,901,877,24,2.70000000
CN3809300000000,38,093,"Stutsman County, ND",Apr-22,10330,10100,230,2.20000000
CN3809500000000,38,095,"Towner County, ND",Apr-22,1112,1083,29,2.60000000
CN3809700000000,38,097,"Traill County, ND",Apr-22,4413,4308,105,2.40000000
CN3809900000000,38,099,"Walsh County, ND",Apr-22,5247,5062,185,3.50000000
CN3810100000000,38,101,"Ward County, ND",Apr-22,31810,30909,901,2.80000000
CN3810300000000,38,103,"Wells County, ND",Apr-22,1894,1822,72,3.80000000
CN3810500000000,38,105,"Williams County, ND",Apr-22,20282,19541,741,3.70000000
CN3900100000000,39,001,"Adams County, OH",Apr-22,10968,10540,428,3.90000000
CN3900300000000,39,003,"Allen County, OH",Apr-22,46974,45307,1667,3.50000000
CN3900500000000,39,005,"Ashland County, OH",Apr-22,26635,25758,877,3.30000000
CN3900700000000,39,007,"Ashtabula County, OH",Apr-22,43236,41582,1654,3.80000000
CN3900900000000,39,009,"Athens County, OH",Apr-22,27458,26482,976,3.60000000
CN3901100000000,39,011,"Auglaize County, OH",Apr-22,24411,23848,563,2.30000000
CN3901300000000,39,013,"Belmont County, OH",Apr-22,28083,26821,1262,4.50000000
CN3901500000000,39,015,"Brown County, OH",Apr-22,19268,18558,710,3.70000000
CN3901700000000,39,017,"Butler County, OH",Apr-22,195426,189626,5800,3.00000000
CN3901900000000,39,019,"Carroll County, OH",Apr-22,12626,12151,475,3.80000000
CN3902100000000,39,021,"Champaign County, OH",Apr-22,19550,18962,588,3.00000000
CN3902300000000,39,023,"Clark County, OH",Apr-22,62497,60282,2215,3.50000000
CN3902500000000,39,025,"Clermont County, OH",Apr-22,107036,103966,3070,2.90000000
CN3902700000000,39,027,"Clinton County, OH",Apr-22,18009,17365,644,3.60000000
CN3902900000000,39,029,"Columbiana County, OH",Apr-22,45364,43606,1758,3.90000000
CN3903100000000,39,031,"Coshocton County, OH",Apr-22,13790,13230,560,4.10000000
CN3903300000000,39,033,"Crawford County, OH",Apr-22,17960,17248,712,4.00000000
CN3903500000000,39,035,"Cuyahoga County, OH",Apr-22,591554,556831,34723,5.90000000
CN3903700000000,39,037,"Darke County, OH",Apr-22,25993,25236,757,2.90000000
CN3903900000000,39,039,"Defiance County, OH",Apr-22,17639,16973,666,3.80000000
CN3904100000000,39,041,"Delaware County, OH",Apr-22,115292,112556,2736,2.40000000
CN3904300000000,39,043,"Erie County, OH",Apr-22,36554,35027,1527,4.20000000
CN3904500000000,39,045,"Fairfield County, OH",Apr-22,80127,77820,2307,2.90000000
CN3904700000000,39,047,"Fayette County, OH",Apr-22,13736,13291,445,3.20000000
CN3904900000000,39,049,"Franklin County, OH",Apr-22,709071,687412,21659,3.10000000
CN3905100000000,39,051,"Fulton County, OH",Apr-22,22053,21331,722,3.30000000
CN3905300000000,39,053,"Gallia County, OH",Apr-22,12198,11745,453,3.70000000
CN3905500000000,39,055,"Geauga County, OH",Apr-22,47132,45167,1965,4.20000000
CN3905700000000,39,057,"Greene County, OH",Apr-22,83407,81102,2305,2.80000000
CN3905900000000,39,059,"Guernsey County, OH",Apr-22,17845,17089,756,4.20000000
CN3906100000000,39,061,"Hamilton County, OH",Apr-22,414286,401486,12800,3.10000000
CN3906300000000,39,063,"Hancock County, OH",Apr-22,41814,40764,1050,2.50000000
CN3906500000000,39,065,"Hardin County, OH",Apr-22,13091,12652,439,3.40000000
CN3906700000000,39,067,"Harrison County, OH",Apr-22,6536,6262,274,4.20000000
CN3906900000000,39,069,"Henry County, OH",Apr-22,12748,12255,493,3.90000000
CN3907100000000,39,071,"Highland County, OH",Apr-22,17345,16664,681,3.90000000
CN3907300000000,39,073,"Hocking County, OH",Apr-22,12925,12477,448,3.50000000
CN3907500000000,39,075,"Holmes County, OH",Apr-22,21656,21240,416,1.90000000
CN3907700000000,39,077,"Huron County, OH",Apr-22,28190,27075,1115,4.00000000
CN3907900000000,39,079,"Jackson County, OH",Apr-22,12563,12061,502,4.00000000
CN3908100000000,39,081,"Jefferson County, OH",Apr-22,27225,25916,1309,4.80000000
CN3908300000000,39,083,"Knox County, OH",Apr-22,31465,30632,833,2.60000000
CN3908500000000,39,085,"Lake County, OH",Apr-22,122117,116438,5679,4.70000000
CN3908700000000,39,087,"Lawrence County, OH",Apr-22,23432,22587,845,3.60000000
CN3908900000000,39,089,"Licking County, OH",Apr-22,91723,89205,2518,2.70000000
CN3909100000000,39,091,"Logan County, OH",Apr-22,22341,21714,627,2.80000000
CN3909300000000,39,093,"Lorain County, OH",Apr-22,150906,142649,8257,5.50000000
CN3909500000000,39,095,"Lucas County, OH",Apr-22,207656,199479,8177,3.90000000
CN3909700000000,39,097,"Madison County, OH",Apr-22,20944,20384,560,2.70000000
CN3909900000000,39,099,"Mahoning County, OH",Apr-22,98452,94204,4248,4.30000000
CN3910100000000,39,101,"Marion County, OH",Apr-22,27983,27119,864,3.10000000
CN3910300000000,39,103,"Medina County, OH",Apr-22,95399,91441,3958,4.10000000
CN3910500000000,39,105,"Meigs County, OH",Apr-22,8779,8344,435,5.00000000
CN3910700000000,39,107,"Mercer County, OH",Apr-22,23098,22623,475,2.10000000
CN3910900000000,39,109,"Miami County, OH",Apr-22,54318,52748,1570,2.90000000
CN3911100000000,39,111,"Monroe County, OH",Apr-22,5205,4892,313,6.00000000
CN3911300000000,39,113,"Montgomery County, OH",Apr-22,250216,241431,8785,3.50000000
CN3911500000000,39,115,"Morgan County, OH",Apr-22,6833,6520,313,4.60000000
CN3911700000000,39,117,"Morrow County, OH",Apr-22,16967,16423,544,3.20000000
CN3911900000000,39,119,"Muskingum County, OH",Apr-22,40675,39123,1552,3.80000000
CN3912100000000,39,121,"Noble County, OH",Apr-22,4622,4390,232,5.00000000
CN3912300000000,39,123,"Ottawa County, OH",Apr-22,20298,19363,935,4.60000000
CN3912500000000,39,125,"Paulding County, OH",Apr-22,8713,8436,277,3.20000000
CN3912700000000,39,127,"Perry County, OH",Apr-22,15914,15324,590,3.70000000
CN3912900000000,39,129,"Pickaway County, OH",Apr-22,26735,25925,810,3.00000000
CN3913100000000,39,131,"Pike County, OH",Apr-22,10965,10496,469,4.30000000
CN3913300000000,39,133,"Portage County, OH",Apr-22,84362,81643,2719,3.20000000
CN3913500000000,39,135,"Preble County, OH",Apr-22,21868,21250,618,2.80000000
CN3913700000000,39,137,"Putnam County, OH",Apr-22,19072,18620,452,2.40000000
CN3913900000000,39,139,"Richland County, OH",Apr-22,51068,49038,2030,4.00000000
CN3914100000000,39,141,"Ross County, OH",Apr-22,35490,34368,1122,3.20000000
CN3914300000000,39,143,"Sandusky County, OH",Apr-22,30949,29936,1013,3.30000000
CN3914500000000,39,145,"Scioto County, OH",Apr-22,29708,28488,1220,4.10000000
CN3914700000000,39,147,"Seneca County, OH",Apr-22,27233,26425,808,3.00000000
CN3914900000000,39,149,"Shelby County, OH",Apr-22,24102,23426,676,2.80000000
CN3915100000000,39,151,"Stark County, OH",Apr-22,181533,175206,6327,3.50000000
CN3915300000000,39,153,"Summit County, OH",Apr-22,263168,253579,9589,3.60000000
CN3915500000000,39,155,"Trumbull County, OH",Apr-22,83097,79446,3651,4.40000000
CN3915700000000,39,157,"Tuscarawas County, OH",Apr-22,44902,43466,1436,3.20000000
CN3915900000000,39,159,"Union County, OH",Apr-22,30099,29401,698,2.30000000
CN3916100000000,39,161,"Van Wert County, OH",Apr-22,14679,14273,406,2.80000000
CN3916300000000,39,163,"Vinton County, OH",Apr-22,5465,5233,232,4.20000000
CN3916500000000,39,165,"Warren County, OH",Apr-22,121528,118253,3275,2.70000000
CN3916700000000,39,167,"Washington County, OH",Apr-22,27101,25991,1110,4.10000000
CN3916900000000,39,169,"Wayne County, OH",Apr-22,59981,58452,1529,2.50000000
CN3917100000000,39,171,"Williams County, OH",Apr-22,18192,17681,511,2.80000000
CN3917300000000,39,173,"Wood County, OH",Apr-22,70670,68723,1947,2.80000000
CN3917500000000,39,175,"Wyandot County, OH",Apr-22,13046,12742,304,2.30000000
CN4000100000000,40,001,"Adair County, OK",Apr-22,8627,8374,253,2.90000000
CN4000300000000,40,003,"Alfalfa County, OK",Apr-22,2675,2626,49,1.80000000
CN4000500000000,40,005,"Atoka County, OK",Apr-22,4944,4771,173,3.50000000
CN4000700000000,40,007,"Beaver County, OK",Apr-22,2614,2576,38,1.50000000
CN4000900000000,40,009,"Beckham County, OK",Apr-22,9328,9056,272,2.90000000
CN4001100000000,40,011,"Blaine County, OK",Apr-22,4371,4284,87,2.00000000
CN4001300000000,40,013,"Bryan County, OK",Apr-22,21913,21365,548,2.50000000
CN4001500000000,40,015,"Caddo County, OK",Apr-22,11911,11566,345,2.90000000
CN4001700000000,40,017,"Canadian County, OK",Apr-22,79608,77776,1832,2.30000000
CN4001900000000,40,019,"Carter County, OK",Apr-22,20970,20263,707,3.40000000
CN4002100000000,40,021,"Cherokee County, OK",Apr-22,19962,19340,622,3.10000000
CN4002300000000,40,023,"Choctaw County, OK",Apr-22,6033,5800,233,3.90000000
CN4002500000000,40,025,"Cimarron County, OK",Apr-22,1582,1561,21,1.30000000
CN4002700000000,40,027,"Cleveland County, OK",Apr-22,146537,143209,3328,2.30000000
CN4002900000000,40,029,"Coal County, OK",Apr-22,2314,2238,76,3.30000000
CN4003100000000,40,031,"Comanche County, OK",Apr-22,46768,45226,1542,3.30000000
CN4003300000000,40,033,"Cotton County, OK",Apr-22,2669,2600,69,2.60000000
CN4003500000000,40,035,"Craig County, OK",Apr-22,5752,5596,156,2.70000000
CN4003700000000,40,037,"Creek County, OK",Apr-22,31458,30431,1027,3.30000000
CN4003900000000,40,039,"Custer County, OK",Apr-22,15176,14805,371,2.40000000
CN4004100000000,40,041,"Delaware County, OK",Apr-22,18399,17893,506,2.80000000
CN4004300000000,40,043,"Dewey County, OK",Apr-22,2836,2778,58,2.00000000
CN4004500000000,40,045,"Ellis County, OK",Apr-22,2134,2093,41,1.90000000
CN4004700000000,40,047,"Garfield County, OK",Apr-22,26447,25766,681,2.60000000
CN4004900000000,40,049,"Garvin County, OK",Apr-22,12441,12110,331,2.70000000
CN4005100000000,40,051,"Grady County, OK",Apr-22,27143,26484,659,2.40000000
CN4005300000000,40,053,"Grant County, OK",Apr-22,2931,2884,47,1.60000000
CN4005500000000,40,055,"Greer County, OK",Apr-22,1847,1792,55,3.00000000
CN4005700000000,40,057,"Harmon County, OK",Apr-22,1177,1151,26,2.20000000
CN4005900000000,40,059,"Harper County, OK",Apr-22,1855,1822,33,1.80000000
CN4006100000000,40,061,"Haskell County, OK",Apr-22,4137,3972,165,4.00000000
CN4006300000000,40,063,"Hughes County, OK",Apr-22,5114,4919,195,3.80000000
CN4006500000000,40,065,"Jackson County, OK",Apr-22,10747,10495,252,2.30000000
CN4006700000000,40,067,"Jefferson County, OK",Apr-22,2496,2429,67,2.70000000
CN4006900000000,40,069,"Johnston County, OK",Apr-22,3615,3497,118,3.30000000
CN4007100000000,40,071,"Kay County, OK",Apr-22,18061,17477,584,3.20000000
CN4007300000000,40,073,"Kingfisher County, OK",Apr-22,8877,8712,165,1.90000000
CN4007500000000,40,075,"Kiowa County, OK",Apr-22,3697,3600,97,2.60000000
CN4007700000000,40,077,"Latimer County, OK",Apr-22,3060,2882,178,5.80000000
CN4007900000000,40,079,"Le Flore County, OK",Apr-22,19308,18631,677,3.50000000
CN4008100000000,40,081,"Lincoln County, OK",Apr-22,16105,15678,427,2.70000000
CN4008300000000,40,083,"Logan County, OK",Apr-22,23145,22594,551,2.40000000
CN4008500000000,40,085,"Love County, OK",Apr-22,5969,5852,117,2.00000000
CN4008700000000,40,087,"McClain County, OK",Apr-22,20834,20331,503,2.40000000
CN4008900000000,40,089,"McCurtain County, OK",Apr-22,15903,15331,572,3.60000000
CN4009100000000,40,091,"McIntosh County, OK",Apr-22,7088,6745,343,4.80000000
CN4009300000000,40,093,"Major County, OK",Apr-22,3671,3594,77,2.10000000
CN4009500000000,40,095,"Marshall County, OK",Apr-22,7275,7079,196,2.70000000
CN4009700000000,40,097,"Mayes County, OK",Apr-22,19153,18630,523,2.70000000
CN4009900000000,40,099,"Murray County, OK",Apr-22,6084,5923,161,2.60000000
CN4010100000000,40,101,"Muskogee County, OK",Apr-22,27535,26631,904,3.30000000
CN4010300000000,40,103,"Noble County, OK",Apr-22,5600,5496,104,1.90000000
CN4010500000000,40,105,"Nowata County, OK",Apr-22,4659,4532,127,2.70000000
CN4010700000000,40,107,"Okfuskee County, OK",Apr-22,4419,4256,163,3.70000000
CN4010900000000,40,109,"Oklahoma County, OK",Apr-22,394008,383249,10759,2.70000000
CN4011100000000,40,111,"Okmulgee County, OK",Apr-22,15599,14988,611,3.90000000
CN4011300000000,40,113,"Osage County, OK",Apr-22,20523,19834,689,3.40000000
CN4011500000000,40,115,"Ottawa County, OK",Apr-22,14641,14283,358,2.40000000
CN4011700000000,40,117,"Pawnee County, OK",Apr-22,7377,7146,231,3.10000000
CN4011900000000,40,119,"Payne County, OK",Apr-22,37286,36369,917,2.50000000
CN4012100000000,40,121,"Pittsburg County, OK",Apr-22,16104,15407,697,4.30000000
CN4012300000000,40,123,"Pontotoc County, OK",Apr-22,18863,18383,480,2.50000000
CN4012500000000,40,125,"Pottawatomie County, OK",Apr-22,32608,31592,1016,3.10000000
CN4012700000000,40,127,"Pushmataha County, OK",Apr-22,4751,4592,159,3.30000000
CN4012900000000,40,129,"Roger Mills County, OK",Apr-22,1834,1795,39,2.10000000
CN4013100000000,40,131,"Rogers County, OK",Apr-22,45331,44147,1184,2.60000000
CN4013300000000,40,133,"Seminole County, OK",Apr-22,9011,8657,354,3.90000000
CN4013500000000,40,135,"Sequoyah County, OK",Apr-22,16618,16086,532,3.20000000
CN4013700000000,40,137,"Stephens County, OK",Apr-22,18763,18181,582,3.10000000
CN4013900000000,40,139,"Texas County, OK",Apr-22,11794,11610,184,1.60000000
CN4014100000000,40,141,"Tillman County, OK",Apr-22,2866,2787,79,2.80000000
CN4014300000000,40,143,"Tulsa County, OK",Apr-22,326224,317041,9183,2.80000000
CN4014500000000,40,145,"Wagoner County, OK",Apr-22,39074,38036,1038,2.70000000
CN4014700000000,40,147,"Washington County, OK",Apr-22,22062,21381,681,3.10000000
CN4014900000000,40,149,"Washita County, OK",Apr-22,4979,4813,166,3.30000000
CN4015100000000,40,151,"Woods County, OK",Apr-22,4721,4643,78,1.70000000
CN4015300000000,40,153,"Woodward County, OK",Apr-22,8438,8200,238,2.80000000
CN4100100000000,41,001,"Baker County, OR",Apr-22,7696,7415,281,3.70000000
CN4100300000000,41,003,"Benton County, OR",Apr-22,49964,48524,1440,2.90000000
CN4100500000000,41,005,"Clackamas County, OR",Apr-22,230039,222703,7336,3.20000000
CN4100700000000,41,007,"Clatsop County, OR",Apr-22,19632,18872,760,3.90000000
CN4100900000000,41,009,"Columbia County, OR",Apr-22,25455,24407,1048,4.10000000
CN4101100000000,41,011,"Coos County, OR",Apr-22,26754,25531,1223,4.60000000
CN4101300000000,41,013,"Crook County, OR",Apr-22,11422,10887,535,4.70000000
CN4101500000000,41,015,"Curry County, OR",Apr-22,9167,8723,444,4.80000000
CN4101700000000,41,017,"Deschutes County, OR",Apr-22,105404,101835,3569,3.40000000
CN4101900000000,41,019,"Douglas County, OR",Apr-22,48209,46084,2125,4.40000000
CN4102100000000,41,021,"Gilliam County, OR",Apr-22,1018,982,36,3.50000000
CN4102300000000,41,023,"Grant County, OR",Apr-22,3128,2929,199,6.40000000
CN4102500000000,41,025,"Harney County, OR",Apr-22,3810,3665,145,3.80000000
CN4102700000000,41,027,"Hood River County, OR",Apr-22,14313,13861,452,3.20000000
CN4102900000000,41,029,"Jackson County, OR",Apr-22,108663,104398,4265,3.90000000
CN4103100000000,41,031,"Jefferson County, OR",Apr-22,10813,10326,487,4.50000000
CN4103300000000,41,033,"Josephine County, OR",Apr-22,37606,35843,1763,4.70000000
CN4103500000000,41,035,"Klamath County, OR",Apr-22,30229,28672,1557,5.20000000
CN4103700000000,41,037,"Lake County, OR",Apr-22,3665,3506,159,4.30000000
CN4103900000000,41,039,"Lane County, OR",Apr-22,186415,179301,7114,3.80000000
CN4104100000000,41,041,"Lincoln County, OR",Apr-22,21107,20104,1003,4.80000000
CN4104300000000,41,043,"Linn County, OR",Apr-22,61881,59397,2484,4.00000000
CN4104500000000,41,045,"Malheur County, OR",Apr-22,12906,12490,416,3.20000000
CN4104700000000,41,047,"Marion County, OR",Apr-22,169567,163417,6150,3.60000000
CN4104900000000,41,049,"Morrow County, OR",Apr-22,6136,5941,195,3.20000000
CN4105100000000,41,051,"Multnomah County, OR",Apr-22,475333,458737,16596,3.50000000
CN4105300000000,41,053,"Polk County, OR",Apr-22,42597,41083,1514,3.60000000
CN4105500000000,41,055,"Sherman County, OR",Apr-22,962,934,28,2.90000000
CN4105700000000,41,057,"Tillamook County, OR",Apr-22,12387,11910,477,3.90000000
CN4105900000000,41,059,"Umatilla County, OR",Apr-22,38197,36743,1454,3.80000000
CN4106100000000,41,061,"Union County, OR",Apr-22,12415,11921,494,4.00000000
CN4106300000000,41,063,"Wallowa County, OR",Apr-22,3584,3417,167,4.70000000
CN4106500000000,41,065,"Wasco County, OR",Apr-22,13161,12655,506,3.80000000
CN4106700000000,41,067,"Washington County, OR",Apr-22,338855,329117,9738,2.90000000
CN4106900000000,41,069,"Wheeler County, OR",Apr-22,728,709,19,2.60000000
CN4107100000000,41,071,"Yamhill County, OR",Apr-22,57069,55244,1825,3.20000000
CN4200100000000,42,001,"Adams County, PA",Apr-22,54555,53049,1506,2.80000000
CN4200300000000,42,003,"Allegheny County, PA",Apr-22,628244,603250,24994,4.00000000
CN4200500000000,42,005,"Armstrong County, PA",Apr-22,30911,29383,1528,4.90000000
CN4200700000000,42,007,"Beaver County, PA",Apr-22,81343,77257,4086,5.00000000
CN4200900000000,42,009,"Bedford County, PA",Apr-22,23461,22527,934,4.00000000
CN4201100000000,42,011,"Berks County, PA",Apr-22,208260,199259,9001,4.30000000
CN4201300000000,42,013,"Blair County, PA",Apr-22,58583,56245,2338,4.00000000
CN4201500000000,42,015,"Bradford County, PA",Apr-22,27345,26294,1051,3.80000000
CN4201700000000,42,017,"Bucks County, PA",Apr-22,342849,330759,12090,3.50000000
CN4201900000000,42,019,"Butler County, PA",Apr-22,97839,94232,3607,3.70000000
CN4202100000000,42,021,"Cambria County, PA",Apr-22,54973,52319,2654,4.80000000
CN4202300000000,42,023,"Cameron County, PA",Apr-22,1957,1855,102,5.20000000
CN4202500000000,42,025,"Carbon County, PA",Apr-22,32206,30658,1548,4.80000000
CN4202700000000,42,027,"Centre County, PA",Apr-22,77363,75144,2219,2.90000000
CN4202900000000,42,029,"Chester County, PA",Apr-22,287219,279200,8019,2.80000000
CN4203100000000,42,031,"Clarion County, PA",Apr-22,16549,15832,717,4.30000000
CN4203300000000,42,033,"Clearfield County, PA",Apr-22,35001,33231,1770,5.10000000
CN4203500000000,42,035,"Clinton County, PA",Apr-22,16969,16153,816,4.80000000
CN4203700000000,42,037,"Columbia County, PA",Apr-22,33085,31835,1250,3.80000000
CN4203900000000,42,039,"Crawford County, PA",Apr-22,37155,35504,1651,4.40000000
CN4204100000000,42,041,"Cumberland County, PA",Apr-22,135140,131248,3892,2.90000000
CN4204300000000,42,043,"Dauphin County, PA",Apr-22,146935,141315,5620,3.80000000
CN4204500000000,42,045,"Delaware County, PA",Apr-22,293841,281590,12251,4.20000000
CN4204700000000,42,047,"Elk County, PA",Apr-22,14666,13968,698,4.80000000
CN4204900000000,42,049,"Erie County, PA",Apr-22,125824,119519,6305,5.00000000
CN4205100000000,42,051,"Fayette County, PA",Apr-22,54782,51546,3236,5.90000000
CN4205300000000,42,053,"Forest County, PA",Apr-22,1686,1584,102,6.00000000
CN4205500000000,42,055,"Franklin County, PA",Apr-22,76313,73834,2479,3.20000000
CN4205700000000,42,057,"Fulton County, PA",Apr-22,7015,6748,267,3.80000000
CN4205900000000,42,059,"Greene County, PA",Apr-22,15398,14577,821,5.30000000
CN4206100000000,42,061,"Huntingdon County, PA",Apr-22,19023,18096,927,4.90000000
CN4206300000000,42,063,"Indiana County, PA",Apr-22,36332,34662,1670,4.60000000
CN4206500000000,42,065,"Jefferson County, PA",Apr-22,19308,18448,860,4.50000000
CN4206700000000,42,067,"Juniata County, PA",Apr-22,12521,12090,431,3.40000000
CN4206900000000,42,069,"Lackawanna County, PA",Apr-22,103616,98810,4806,4.60000000
CN4207100000000,42,071,"Lancaster County, PA",Apr-22,280644,271806,8838,3.10000000
CN4207300000000,42,073,"Lawrence County, PA",Apr-22,39057,37009,2048,5.20000000
CN4207500000000,42,075,"Lebanon County, PA",Apr-22,72552,70103,2449,3.40000000
CN4207700000000,42,077,"Lehigh County, PA",Apr-22,195971,187249,8722,4.50000000
CN4207900000000,42,079,"Luzerne County, PA",Apr-22,156399,147818,8581,5.50000000
CN4208100000000,42,081,"Lycoming County, PA",Apr-22,54349,51859,2490,4.60000000
CN4208300000000,42,083,"McKean County, PA",Apr-22,16393,15569,824,5.00000000
CN4208500000000,42,085,"Mercer County, PA",Apr-22,46820,44576,2244,4.80000000
CN4208700000000,42,087,"Mifflin County, PA",Apr-22,20503,19634,869,4.20000000
CN4208900000000,42,089,"Monroe County, PA",Apr-22,81923,77289,4634,5.70000000
CN4209100000000,42,091,"Montgomery County, PA",Apr-22,456085,441653,14432,3.20000000
CN4209300000000,42,093,"Montour County, PA",Apr-22,8993,8752,241,2.70000000
CN4209500000000,42,095,"Northampton County, PA",Apr-22,162578,156228,6350,3.90000000
CN4209700000000,42,097,"Northumberland County, PA",Apr-22,40956,38967,1989,4.90000000
CN4209900000000,42,099,"Perry County, PA",Apr-22,24583,23864,719,2.90000000
CN4210100000000,42,101,"Philadelphia County/city, PA",Apr-22,719856,676461,43395,6.00000000
CN4210300000000,42,103,"Pike County, PA",Apr-22,25394,23942,1452,5.70000000
CN4210500000000,42,105,"Potter County, PA",Apr-22,6908,6549,359,5.20000000
CN4210700000000,42,107,"Schuylkill County, PA",Apr-22,64134,61108,3026,4.70000000
CN4210900000000,42,109,"Snyder County, PA",Apr-22,19424,18725,699,3.60000000
CN4211100000000,42,111,"Somerset County, PA",Apr-22,31662,30148,1514,4.80000000
CN4211300000000,42,113,"Sullivan County, PA",Apr-22,2500,2376,124,5.00000000
CN4211500000000,42,115,"Susquehanna County, PA",Apr-22,19863,19105,758,3.80000000
CN4211700000000,42,117,"Tioga County, PA",Apr-22,18586,17736,850,4.60000000
CN4211900000000,42,119,"Union County, PA",Apr-22,19332,18691,641,3.30000000
CN4212100000000,42,121,"Venango County, PA",Apr-22,21049,20049,1000,4.80000000
CN4212300000000,42,123,"Warren County, PA",Apr-22,17291,16553,738,4.30000000
CN4212500000000,42,125,"Washington County, PA",Apr-22,104131,99553,4578,4.40000000
CN4212700000000,42,127,"Wayne County, PA",Apr-22,21723,20653,1070,4.90000000
CN4212900000000,42,129,"Westmoreland County, PA",Apr-22,174363,167094,7269,4.20000000
CN4213100000000,42,131,"Wyoming County, PA",Apr-22,13254,12663,591,4.50000000
CN4213300000000,42,133,"York County, PA",Apr-22,235117,227053,8064,3.40000000
CN4400100000000,44,001,"Bristol County, RI",Apr-22,26222,25693,529,2.00000000
CN4400300000000,44,003,"Kent County, RI",Apr-22,92750,90421,2329,2.50000000
CN4400500000000,44,005,"Newport County, RI",Apr-22,44669,43595,1074,2.40000000
CN4400700000000,44,007,"Providence County, RI",Apr-22,331011,320985,10026,3.00000000
CN4400900000000,44,009,"Washington County, RI",Apr-22,68883,67302,1581,2.30000000
CN4500100000000,45,001,"Abbeville County, SC",Apr-22,9525,9243,282,3.00000000
CN4500300000000,45,003,"Aiken County, SC",Apr-22,76198,74410,1788,2.30000000
CN4500500000000,45,005,"Allendale County, SC",Apr-22,2327,2203,124,5.30000000
CN4500700000000,45,007,"Anderson County, SC",Apr-22,91767,89678,2089,2.30000000
CN4500900000000,45,009,"Bamberg County, SC",Apr-22,4555,4325,230,5.00000000
CN4501100000000,45,011,"Barnwell County, SC",Apr-22,7536,7194,342,4.50000000
CN4501300000000,45,013,"Beaufort County, SC",Apr-22,77476,75683,1793,2.30000000
CN4501500000000,45,015,"Berkeley County, SC",Apr-22,110412,107623,2789,2.50000000
CN4501700000000,45,017,"Calhoun County, SC",Apr-22,6410,6228,182,2.80000000
CN4501900000000,45,019,"Charleston County, SC",Apr-22,216879,212021,4858,2.20000000
CN4502100000000,45,021,"Cherokee County, SC",Apr-22,24595,23789,806,3.30000000
CN4502300000000,45,023,"Chester County, SC",Apr-22,13489,12967,522,3.90000000
CN4502500000000,45,025,"Chesterfield County, SC",Apr-22,21635,20986,649,3.00000000
CN4502700000000,45,027,"Clarendon County, SC",Apr-22,12385,11989,396,3.20000000
CN4502900000000,45,029,"Colleton County, SC",Apr-22,16381,15930,451,2.80000000
CN4503100000000,45,031,"Darlington County, SC",Apr-22,29604,28747,857,2.90000000
CN4503300000000,45,033,"Dillon County, SC",Apr-22,13027,12494,533,4.10000000
CN4503500000000,45,035,"Dorchester County, SC",Apr-22,80098,78174,1924,2.40000000
CN4503700000000,45,037,"Edgefield County, SC",Apr-22,10674,10434,240,2.20000000
CN4503900000000,45,039,"Fairfield County, SC",Apr-22,9259,8838,421,4.50000000
CN4504100000000,45,041,"Florence County, SC",Apr-22,65602,63882,1720,2.60000000
CN4504300000000,45,043,"Georgetown County, SC",Apr-22,25974,25194,780,3.00000000
CN4504500000000,45,045,"Greenville County, SC",Apr-22,261103,255357,5746,2.20000000
CN4504700000000,45,047,"Greenwood County, SC",Apr-22,29998,29110,888,3.00000000
CN4504900000000,45,049,"Hampton County, SC",Apr-22,8047,7866,181,2.20000000
CN4505100000000,45,051,"Horry County, SC",Apr-22,153506,148738,4768,3.10000000
CN4505300000000,45,053,"Jasper County, SC",Apr-22,13390,13083,307,2.30000000
CN4505500000000,45,055,"Kershaw County, SC",Apr-22,29333,28562,771,2.60000000
CN4505700000000,45,057,"Lancaster County, SC",Apr-22,43939,42641,1298,3.00000000
CN4505900000000,45,059,"Laurens County, SC",Apr-22,30249,29411,838,2.80000000
CN4506100000000,45,061,"Lee County, SC",Apr-22,6553,6288,265,4.00000000
CN4506300000000,45,063,"Lexington County, SC",Apr-22,150983,147854,3129,2.10000000
CN4506500000000,45,065,"McCormick County, SC",Apr-22,3322,3226,96,2.90000000
CN4506700000000,45,067,"Marion County, SC",Apr-22,12817,12220,597,4.70000000
CN4506900000000,45,069,"Marlboro County, SC",Apr-22,8786,8259,527,6.00000000
CN4507100000000,45,071,"Newberry County, SC",Apr-22,19228,18820,408,2.10000000
CN4507300000000,45,073,"Oconee County, SC",Apr-22,33944,33157,787,2.30000000
CN4507500000000,45,075,"Orangeburg County, SC",Apr-22,33181,31528,1653,5.00000000
CN4507700000000,45,077,"Pickens County, SC",Apr-22,58172,56778,1394,2.40000000
CN4507900000000,45,079,"Richland County, SC",Apr-22,196616,191396,5220,2.70000000
CN4508100000000,45,081,"Saluda County, SC",Apr-22,8454,8276,178,2.10000000
CN4508300000000,45,083,"Spartanburg County, SC",Apr-22,158377,154497,3880,2.40000000
CN4508500000000,45,085,"Sumter County, SC",Apr-22,42319,41037,1282,3.00000000
CN4508700000000,45,087,"Union County, SC",Apr-22,11513,11041,472,4.10000000
CN4508900000000,45,089,"Williamsburg County, SC",Apr-22,10791,10332,459,4.30000000
CN4509100000000,45,091,"York County, SC",Apr-22,149468,145545,3923,2.60000000
CN4600300000000,46,003,"Aurora County, SD",Apr-22,1510,1482,28,1.90000000
CN4600500000000,46,005,"Beadle County, SD",Apr-22,9251,9053,198,2.10000000
CN4600700000000,46,007,"Bennett County, SD",Apr-22,1057,1021,36,3.40000000
CN4600900000000,46,009,"Bon Homme County, SD",Apr-22,2899,2844,55,1.90000000
CN4601100000000,46,011,"Brookings County, SD",Apr-22,19078,18609,469,2.50000000
CN4601300000000,46,013,"Brown County, SD",Apr-22,20307,19788,519,2.60000000
CN4601500000000,46,015,"Brule County, SD",Apr-22,2646,2597,49,1.90000000
CN4601700000000,46,017,"Buffalo County, SD",Apr-22,665,643,22,3.30000000
CN4601900000000,46,019,"Butte County, SD",Apr-22,4921,4810,111,2.30000000
CN4602100000000,46,021,"Campbell County, SD",Apr-22,786,763,23,2.90000000
CN4602300000000,46,023,"Charles Mix County, SD",Apr-22,3864,3774,90,2.30000000
CN4602500000000,46,025,"Clark County, SD",Apr-22,1982,1928,54,2.70000000
CN4602700000000,46,027,"Clay County, SD",Apr-22,7716,7533,183,2.40000000
CN4602900000000,46,029,"Codington County, SD",Apr-22,15729,15361,368,2.30000000
CN4603100000000,46,031,"Corson County, SD",Apr-22,1342,1304,38,2.80000000
CN4603300000000,46,033,"Custer County, SD",Apr-22,4225,4102,123,2.90000000
CN4603500000000,46,035,"Davison County, SD",Apr-22,11007,10786,221,2.00000000
CN4603700000000,46,037,"Day County, SD",Apr-22,2662,2565,97,3.60000000
CN4603900000000,46,039,"Deuel County, SD",Apr-22,2302,2225,77,3.30000000
CN4604100000000,46,041,"Dewey County, SD",Apr-22,2268,2174,94,4.10000000
CN4604300000000,46,043,"Douglas County, SD",Apr-22,1606,1578,28,1.70000000
CN4604500000000,46,045,"Edmunds County, SD",Apr-22,2054,2008,46,2.20000000
CN4604700000000,46,047,"Fall River County, SD",Apr-22,3119,3041,78,2.50000000
CN4604900000000,46,049,"Faulk County, SD",Apr-22,1126,1103,23,2.00000000
CN4605100000000,46,051,"Grant County, SD",Apr-22,4469,4341,128,2.90000000
CN4605300000000,46,053,"Gregory County, SD",Apr-22,2147,2105,42,2.00000000
CN4605500000000,46,055,"Haakon County, SD",Apr-22,1073,1053,20,1.90000000
CN4605700000000,46,057,"Hamlin County, SD",Apr-22,3569,3491,78,2.20000000
CN4605900000000,46,059,"Hand County, SD",Apr-22,1784,1753,31,1.70000000
CN4606100000000,46,061,"Hanson County, SD",Apr-22,1801,1754,47,2.60000000
CN4606300000000,46,063,"Harding County, SD",Apr-22,752,739,13,1.70000000
CN4606500000000,46,065,"Hughes County, SD",Apr-22,9679,9505,174,1.80000000
CN4606700000000,46,067,"Hutchinson County, SD",Apr-22,3705,3615,90,2.40000000
CN4606900000000,46,069,"Hyde County, SD",Apr-22,691,676,15,2.20000000
CN4607100000000,46,071,"Jackson County, SD",Apr-22,1225,1186,39,3.20000000
CN4607300000000,46,073,"Jerauld County, SD",Apr-22,1419,1400,19,1.30000000
CN4607500000000,46,075,"Jones County, SD",Apr-22,513,500,13,2.50000000
CN4607700000000,46,077,"Kingsbury County, SD",Apr-22,2845,2784,61,2.10000000
CN4607900000000,46,079,"Lake County, SD",Apr-22,6583,6436,147,2.20000000
CN4608100000000,46,081,"Lawrence County, SD",Apr-22,13538,13257,281,2.10000000
CN4608300000000,46,083,"Lincoln County, SD",Apr-22,37519,36869,650,1.70000000
CN4608500000000,46,085,"Lyman County, SD",Apr-22,1650,1607,43,2.60000000
CN4608700000000,46,087,"McCook County, SD",Apr-22,3154,3100,54,1.70000000
CN4608900000000,46,089,"McPherson County, SD",Apr-22,1019,988,31,3.00000000
CN4609100000000,46,091,"Marshall County, SD",Apr-22,2483,2395,88,3.50000000
CN4609300000000,46,093,"Meade County, SD",Apr-22,14260,13944,316,2.20000000
CN4609500000000,46,095,"Mellette County, SD",Apr-22,768,746,22,2.90000000
CN4609700000000,46,097,"Miner County, SD",Apr-22,1202,1179,23,1.90000000
CN4609900000000,46,099,"Minnehaha County, SD",Apr-22,116495,114157,2338,2.00000000
CN4610100000000,46,101,"Moody County, SD",Apr-22,4039,3959,80,2.00000000
CN4610200000000,46,102,"Oglala Lakota County, SD",Apr-22,3660,3440,220,6.00000000
CN4610300000000,46,103,"Pennington County, SD",Apr-22,58619,57319,1300,2.20000000
CN4610500000000,46,105,"Perkins County, SD",Apr-22,1455,1424,31,2.10000000
CN4610700000000,46,107,"Potter County, SD",Apr-22,1063,1033,30,2.80000000
CN4610900000000,46,109,"Roberts County, SD",Apr-22,4642,4449,193,4.20000000
CN4611100000000,46,111,"Sanborn County, SD",Apr-22,1234,1211,23,1.90000000
CN4611500000000,46,115,"Spink County, SD",Apr-22,3180,3103,77,2.40000000
CN4611700000000,46,117,"Stanley County, SD",Apr-22,1922,1880,42,2.20000000
CN4611900000000,46,119,"Sully County, SD",Apr-22,837,819,18,2.20000000
CN4612100000000,46,121,"Todd County, SD",Apr-22,3036,2917,119,3.90000000
CN4612300000000,46,123,"Tripp County, SD",Apr-22,3132,3081,51,1.60000000
CN4612500000000,46,125,"Turner County, SD",Apr-22,4814,4724,90,1.90000000
CN4612700000000,46,127,"Union County, SD",Apr-22,8725,8524,201,2.30000000
CN4612900000000,46,129,"Walworth County, SD",Apr-22,2143,2050,93,4.30000000
CN4613500000000,46,135,"Yankton County, SD",Apr-22,11544,11325,219,1.90000000
CN4613700000000,46,137,"Ziebach County, SD",Apr-22,958,927,31,3.20000000
CN4700100000000,47,001,"Anderson County, TN",Apr-22,35822,34801,1021,2.90000000
CN4700300000000,47,003,"Bedford County, TN",Apr-22,21768,21125,643,3.00000000
CN4700500000000,47,005,"Benton County, TN",Apr-22,6882,6629,253,3.70000000
CN4700700000000,47,007,"Bledsoe County, TN",Apr-22,4378,4173,205,4.70000000
CN4700900000000,47,009,"Blount County, TN",Apr-22,66558,64814,1744,2.60000000
CN4701100000000,47,011,"Bradley County, TN",Apr-22,50999,49452,1547,3.00000000
CN4701300000000,47,013,"Campbell County, TN",Apr-22,15184,14645,539,3.50000000
CN4701500000000,47,015,"Cannon County, TN",Apr-22,6973,6783,190,2.70000000
CN4701700000000,47,017,"Carroll County, TN",Apr-22,11515,11105,410,3.60000000
CN4701900000000,47,019,"Carter County, TN",Apr-22,24600,23827,773,3.10000000
CN4702100000000,47,021,"Cheatham County, TN",Apr-22,23032,22467,565,2.50000000
CN4702300000000,47,023,"Chester County, TN",Apr-22,8608,8402,206,2.40000000
CN4702500000000,47,025,"Claiborne County, TN",Apr-22,13084,12682,402,3.10000000
CN4702700000000,47,027,"Clay County, TN",Apr-22,2793,2676,117,4.20000000
CN4702900000000,47,029,"Cocke County, TN",Apr-22,14854,14159,695,4.70000000
CN4703100000000,47,031,"Coffee County, TN",Apr-22,25242,24488,754,3.00000000
CN4703300000000,47,033,"Crockett County, TN",Apr-22,6924,6735,189,2.70000000
CN4703500000000,47,035,"Cumberland County, TN",Apr-22,22649,21831,818,3.60000000
CN4703700000000,47,037,"Davidson County, TN",Apr-22,420156,408900,11256,2.70000000
CN4703900000000,47,039,"Decatur County, TN",Apr-22,4265,4088,177,4.20000000
CN4704100000000,47,041,"DeKalb County, TN",Apr-22,7898,7631,267,3.40000000
CN4704300000000,47,043,"Dickson County, TN",Apr-22,28337,27605,732,2.60000000
CN4704500000000,47,045,"Dyer County, TN",Apr-22,16121,15586,535,3.30000000
CN4704700000000,47,047,"Fayette County, TN",Apr-22,19734,19118,616,3.10000000
CN4704900000000,47,049,"Fentress County, TN",Apr-22,7611,7371,240,3.20000000
CN4705100000000,47,051,"Franklin County, TN",Apr-22,19695,19107,588,3.00000000
CN4705300000000,47,053,"Gibson County, TN",Apr-22,21567,20880,687,3.20000000
CN4705500000000,47,055,"Giles County, TN",Apr-22,14879,14443,436,2.90000000
CN4705700000000,47,057,"Grainger County, TN",Apr-22,9872,9559,313,3.20000000
CN4705900000000,47,059,"Greene County, TN",Apr-22,28959,28010,949,3.30000000
CN4706100000000,47,061,"Grundy County, TN",Apr-22,5185,4968,217,4.20000000
CN4706300000000,47,063,"Hamblen County, TN",Apr-22,28579,27680,899,3.10000000
CN4706500000000,47,065,"Hamilton County, TN",Apr-22,186457,180806,5651,3.00000000
CN4706700000000,47,067,"Hancock County, TN",Apr-22,2319,2228,91,3.90000000
CN4706900000000,47,069,"Hardeman County, TN",Apr-22,8893,8520,373,4.20000000
CN4707100000000,47,071,"Hardin County, TN",Apr-22,10138,9782,356,3.50000000
CN4707300000000,47,073,"Hawkins County, TN",Apr-22,23510,22722,788,3.40000000
CN4707500000000,47,075,"Haywood County, TN",Apr-22,7660,7342,318,4.20000000
CN4707700000000,47,077,"Henderson County, TN",Apr-22,11992,11632,360,3.00000000
CN4707900000000,47,079,"Henry County, TN",Apr-22,14401,13938,463,3.20000000
CN4708100000000,47,081,"Hickman County, TN",Apr-22,11934,11638,296,2.50000000
CN4708300000000,47,083,"Houston County, TN",Apr-22,3272,3151,121,3.70000000
CN4708500000000,47,085,"Humphreys County, TN",Apr-22,8820,8553,267,3.00000000
CN4708700000000,47,087,"Jackson County, TN",Apr-22,4842,4687,155,3.20000000
CN4708900000000,47,089,"Jefferson County, TN",Apr-22,25376,24603,773,3.00000000
CN4709100000000,47,091,"Johnson County, TN",Apr-22,7769,7549,220,2.80000000
CN4709300000000,47,093,"Knox County, TN",Apr-22,254983,248712,6271,2.50000000
CN4709500000000,47,095,"Lake County, TN",Apr-22,1659,1583,76,4.60000000
CN4709700000000,47,097,"Lauderdale County, TN",Apr-22,9660,9239,421,4.40000000
CN4709900000000,47,099,"Lawrence County, TN",Apr-22,19703,19128,575,2.90000000
CN4710100000000,47,101,"Lewis County, TN",Apr-22,5744,5563,181,3.20000000
CN4710300000000,47,103,"Lincoln County, TN",Apr-22,16300,15799,501,3.10000000
CN4710500000000,47,105,"Loudon County, TN",Apr-22,24754,24072,682,2.80000000
CN4710700000000,47,107,"McMinn County, TN",Apr-22,22238,21492,746,3.40000000
CN4710900000000,47,109,"McNairy County, TN",Apr-22,8333,8002,331,4.00000000
CN4711100000000,47,111,"Macon County, TN",Apr-22,11832,11526,306,2.60000000
CN4711300000000,47,113,"Madison County, TN",Apr-22,49646,48097,1549,3.10000000
CN4711500000000,47,115,"Marion County, TN",Apr-22,12474,12068,406,3.30000000
CN4711700000000,47,117,"Marshall County, TN",Apr-22,15698,15236,462,2.90000000
CN4711900000000,47,119,"Maury County, TN",Apr-22,53814,52325,1489,2.80000000
CN4712100000000,47,121,"Meigs County, TN",Apr-22,5209,5024,185,3.60000000
CN4712300000000,47,123,"Monroe County, TN",Apr-22,21200,20605,595,2.80000000
CN4712500000000,47,125,"Montgomery County, TN",Apr-22,89438,86493,2945,3.30000000
CN4712700000000,47,127,"Moore County, TN",Apr-22,3673,3597,76,2.10000000
CN4712900000000,47,129,"Morgan County, TN",Apr-22,7949,7693,256,3.20000000
CN4713100000000,47,131,"Obion County, TN",Apr-22,12442,12017,425,3.40000000
CN4713300000000,47,133,"Overton County, TN",Apr-22,10157,9890,267,2.60000000
CN4713500000000,47,135,"Perry County, TN",Apr-22,2842,2697,145,5.10000000
CN4713700000000,47,137,"Pickett County, TN",Apr-22,2201,2133,68,3.10000000
CN4713900000000,47,139,"Polk County, TN",Apr-22,7160,6929,231,3.20000000
CN4714100000000,47,141,"Putnam County, TN",Apr-22,35929,34920,1009,2.80000000
CN4714300000000,47,143,"Rhea County, TN",Apr-22,14127,13634,493,3.50000000
CN4714500000000,47,145,"Roane County, TN",Apr-22,24097,23342,755,3.10000000
CN4714700000000,47,147,"Robertson County, TN",Apr-22,39811,38822,989,2.50000000
CN4714900000000,47,149,"Rutherford County, TN",Apr-22,198624,193759,4865,2.40000000
CN4715100000000,47,151,"Scott County, TN",Apr-22,8082,7759,323,4.00000000
CN4715300000000,47,153,"Sequatchie County, TN",Apr-22,6270,6052,218,3.50000000
CN4715500000000,47,155,"Sevier County, TN",Apr-22,56401,54953,1448,2.60000000
CN4715700000000,47,157,"Shelby County, TN",Apr-22,452144,430971,21173,4.70000000
CN4715900000000,47,159,"Smith County, TN",Apr-22,9898,9651,247,2.50000000
CN4716100000000,47,161,"Stewart County, TN",Apr-22,5449,5269,180,3.30000000
CN4716300000000,47,163,"Sullivan County, TN",Apr-22,69897,67784,2113,3.00000000
CN4716500000000,47,165,"Sumner County, TN",Apr-22,110542,107845,2697,2.40000000
CN4716700000000,47,167,"Tipton County, TN",Apr-22,28313,27414,899,3.20000000
CN4716900000000,47,169,"Trousdale County, TN",Apr-22,5809,5660,149,2.60000000
CN4717100000000,47,171,"Unicoi County, TN",Apr-22,7204,6939,265,3.70000000
CN4717300000000,47,173,"Union County, TN",Apr-22,7981,7729,252,3.20000000
CN4717500000000,47,175,"Van Buren County, TN",Apr-22,2081,1999,82,3.90000000
CN4717700000000,47,177,"Warren County, TN",Apr-22,16754,16150,604,3.60000000
CN4717900000000,47,179,"Washington County, TN",Apr-22,62623,60929,1694,2.70000000
CN4718100000000,47,181,"Wayne County, TN",Apr-22,6382,6151,231,3.60000000
CN4718300000000,47,183,"Weakley County, TN",Apr-22,15735,15298,437,2.80000000
CN4718500000000,47,185,"White County, TN",Apr-22,11795,11438,357,3.00000000
CN4718700000000,47,187,"Williamson County, TN",Apr-22,140310,137490,2820,2.00000000
CN4718900000000,47,189,"Wilson County, TN",Apr-22,83206,81274,1932,2.30000000
CN4800100000000,48,001,"Anderson County, TX",Apr-22,23324,22621,703,3.00000000
CN4800300000000,48,003,"Andrews County, TX",Apr-22,8800,8492,308,3.50000000
CN4800500000000,48,005,"Angelina County, TX",Apr-22,35637,34106,1531,4.30000000
CN4800700000000,48,007,"Aransas County, TX",Apr-22,9246,8775,471,5.10000000
CN4800900000000,48,009,"Archer County, TX",Apr-22,4027,3914,113,2.80000000
CN4801100000000,48,011,"Armstrong County, TX",Apr-22,948,928,20,2.10000000
CN4801300000000,48,013,"Atascosa County, TX",Apr-22,22193,21320,873,3.90000000
CN4801500000000,48,015,"Austin County, TX",Apr-22,13999,13509,490,3.50000000
CN4801700000000,48,017,"Bailey County, TX",Apr-22,2489,2406,83,3.30000000
CN4801900000000,48,019,"Bandera County, TX",Apr-22,10397,10084,313,3.00000000
CN4802100000000,48,021,"Bastrop County, TX",Apr-22,46605,45252,1353,2.90000000
CN4802300000000,48,023,"Baylor County, TX",Apr-22,1808,1764,44,2.40000000
CN4802500000000,48,025,"Bee County, TX",Apr-22,8895,8334,561,6.30000000
CN4802700000000,48,027,"Bell County, TX",Apr-22,148573,142780,5793,3.90000000
CN4802900000000,48,029,"Bexar County, TX",Apr-22,955593,923370,32223,3.40000000
CN4803100000000,48,031,"Blanco County, TX",Apr-22,7053,6885,168,2.40000000
CN4803300000000,48,033,"Borden County, TX",Apr-22,717,707,10,1.40000000
CN4803500000000,48,035,"Bosque County, TX",Apr-22,8636,8365,271,3.10000000
CN4803700000000,48,037,"Bowie County, TX",Apr-22,39232,37586,1646,4.20000000
CN4803900000000,48,039,"Brazoria County, TX",Apr-22,182555,174266,8289,4.50000000
CN4804100000000,48,041,"Brazos County, TX",Apr-22,123478,120200,3278,2.70000000
CN4804300000000,48,043,"Brewster County, TX",Apr-22,4149,4030,119,2.90000000
CN4804500000000,48,045,"Briscoe County, TX",Apr-22,597,580,17,2.80000000
CN4804700000000,48,047,"Brooks County, TX",Apr-22,2481,2331,150,6.00000000
CN4804900000000,48,049,"Brown County, TX",Apr-22,15143,14623,520,3.40000000
CN4805100000000,48,051,"Burleson County, TX",Apr-22,8567,8294,273,3.20000000
CN4805300000000,48,053,"Burnet County, TX",Apr-22,24917,24292,625,2.50000000
CN4805500000000,48,055,"Caldwell County, TX",Apr-22,20590,19957,633,3.10000000
CN4805700000000,48,057,"Calhoun County, TX",Apr-22,12496,12085,411,3.30000000
CN4805900000000,48,059,"Callahan County, TX",Apr-22,6131,5946,185,3.00000000
CN4806100000000,48,061,"Cameron County, TX",Apr-22,175745,165355,10390,5.90000000
CN4806300000000,48,063,"Camp County, TX",Apr-22,5160,4957,203,3.90000000
CN4806500000000,48,065,"Carson County, TX",Apr-22,3045,2969,76,2.50000000
CN4806700000000,48,067,"Cass County, TX",Apr-22,12255,11714,541,4.40000000
CN4806900000000,48,069,"Castro County, TX",Apr-22,3583,3496,87,2.40000000
CN4807100000000,48,071,"Chambers County, TX",Apr-22,20840,19675,1165,5.60000000
CN4807300000000,48,073,"Cherokee County, TX",Apr-22,20646,19795,851,4.10000000
CN4807500000000,48,075,"Childress County, TX",Apr-22,3017,2941,76,2.50000000
CN4807700000000,48,077,"Clay County, TX",Apr-22,4906,4743,163,3.30000000
CN4807900000000,48,079,"Cochran County, TX",Apr-22,1170,1114,56,4.80000000
CN4808100000000,48,081,"Coke County, TX",Apr-22,1359,1313,46,3.40000000
CN4808300000000,48,083,"Coleman County, TX",Apr-22,2942,2829,113,3.80000000
CN4808500000000,48,085,"Collin County, TX",Apr-22,622502,605586,16916,2.70000000
CN4808700000000,48,087,"Collingsworth County, TX",Apr-22,1127,1097,30,2.70000000
CN4808900000000,48,089,"Colorado County, TX",Apr-22,10065,9749,316,3.10000000
CN4809100000000,48,091,"Comal County, TX",Apr-22,80120,77771,2349,2.90000000
CN4809300000000,48,093,"Comanche County, TX",Apr-22,6279,6096,183,2.90000000
CN4809500000000,48,095,"Concho County, TX",Apr-22,1472,1433,39,2.60000000
CN4809700000000,48,097,"Cooke County, TX",Apr-22,19576,19010,566,2.90000000
CN4809900000000,48,099,"Coryell County, TX",Apr-22,24530,23597,933,3.80000000
CN4810100000000,48,101,"Cottle County, TX",Apr-22,650,633,17,2.60000000
CN4810300000000,48,103,"Crane County, TX",Apr-22,1560,1471,89,5.70000000
CN4810500000000,48,105,"Crockett County, TX",Apr-22,1412,1353,59,4.20000000
CN4810700000000,48,107,"Crosby County, TX",Apr-22,2518,2429,89,3.50000000
CN4810900000000,48,109,"Culberson County, TX",Apr-22,1067,1037,30,2.80000000
CN4811100000000,48,111,"Dallam County, TX",Apr-22,3911,3850,61,1.60000000
CN4811300000000,48,113,"Dallas County, TX",Apr-22,1416167,1367277,48890,3.50000000
CN4811500000000,48,115,"Dawson County, TX",Apr-22,4597,4388,209,4.50000000
CN4811700000000,48,117,"Deaf Smith County, TX",Apr-22,9206,8983,223,2.40000000
CN4811900000000,48,119,"Delta County, TX",Apr-22,2465,2383,82,3.30000000
CN4812100000000,48,121,"Denton County, TX",Apr-22,549156,534125,15031,2.70000000
CN4812300000000,48,123,"DeWitt County, TX",Apr-22,9567,9292,275,2.90000000
CN4812500000000,48,125,"Dickens County, TX",Apr-22,743,718,25,3.40000000
CN4812700000000,48,127,"Dimmit County, TX",Apr-22,5638,5408,230,4.10000000
CN4812900000000,48,129,"Donley County, TX",Apr-22,1506,1466,40,2.70000000
CN4813100000000,48,131,"Duval County, TX",Apr-22,5522,5244,278,5.00000000
CN4813300000000,48,133,"Eastland County, TX",Apr-22,7112,6834,278,3.90000000
CN4813500000000,48,135,"Ector County, TX",Apr-22,80950,77077,3873,4.80000000
CN4813700000000,48,137,"Edwards County, TX",Apr-22,1270,1236,34,2.70000000
CN4813900000000,48,139,"Ellis County, TX",Apr-22,102817,99783,3034,3.00000000
CN4814100000000,48,141,"El Paso County, TX",Apr-22,360377,345396,14981,4.20000000
CN4814300000000,48,143,"Erath County, TX",Apr-22,21843,21242,601,2.80000000
CN4814500000000,48,145,"Falls County, TX",Apr-22,6807,6563,244,3.60000000
CN4814700000000,48,147,"Fannin County, TX",Apr-22,17445,16973,472,2.70000000
CN4814900000000,48,149,"Fayette County, TX",Apr-22,11699,11355,344,2.90000000
CN4815100000000,48,151,"Fisher County, TX",Apr-22,1629,1586,43,2.60000000
CN4815300000000,48,153,"Floyd County, TX",Apr-22,2581,2484,97,3.80000000
CN4815500000000,48,155,"Foard County, TX",Apr-22,608,594,14,2.30000000
CN4815700000000,48,157,"Fort Bend County, TX",Apr-22,413149,397460,15689,3.80000000
CN4815900000000,48,159,"Franklin County, TX",Apr-22,5191,5055,136,2.60000000
CN4816100000000,48,161,"Freestone County, TX",Apr-22,6273,5939,334,5.30000000
CN4816300000000,48,163,"Frio County, TX",Apr-22,9593,9309,284,3.00000000
CN4816500000000,48,165,"Gaines County, TX",Apr-22,9920,9654,266,2.70000000
CN4816700000000,48,167,"Galveston County, TX",Apr-22,167096,159886,7210,4.30000000
CN4816900000000,48,169,"Garza County, TX",Apr-22,1960,1908,52,2.70000000
CN4817100000000,48,171,"Gillespie County, TX",Apr-22,14421,14095,326,2.30000000
CN4817300000000,48,173,"Glasscock County, TX",Apr-22,879,858,21,2.40000000
CN4817500000000,48,175,"Goliad County, TX",Apr-22,3147,3018,129,4.10000000
CN4817700000000,48,177,"Gonzales County, TX",Apr-22,10046,9789,257,2.60000000
CN4817900000000,48,179,"Gray County, TX",Apr-22,7713,7388,325,4.20000000
CN4818100000000,48,181,"Grayson County, TX",Apr-22,66759,64741,2018,3.00000000
CN4818300000000,48,183,"Gregg County, TX",Apr-22,56088,53727,2361,4.20000000
CN4818500000000,48,185,"Grimes County, TX",Apr-22,11213,10725,488,4.40000000
CN4818700000000,48,187,"Guadalupe County, TX",Apr-22,83616,81196,2420,2.90000000
CN4818900000000,48,189,"Hale County, TX",Apr-22,12153,11657,496,4.10000000
CN4819100000000,48,191,"Hall County, TX",Apr-22,1128,1090,38,3.40000000
CN4819300000000,48,193,"Hamilton County, TX",Apr-22,3774,3670,104,2.80000000
CN4819500000000,48,195,"Hansford County, TX",Apr-22,2679,2627,52,1.90000000
CN4819700000000,48,197,"Hardeman County, TX",Apr-22,1724,1671,53,3.10000000
CN4819900000000,48,199,"Hardin County, TX",Apr-22,24791,23506,1285,5.20000000
CN4820100000000,48,201,"Harris County, TX",Apr-22,2309623,2213045,96578,4.20000000
CN4820300000000,48,203,"Harrison County, TX",Apr-22,28309,27020,1289,4.60000000
CN4820500000000,48,205,"Hartley County, TX",Apr-22,2837,2799,38,1.30000000
CN4820700000000,48,207,"Haskell County, TX",Apr-22,2870,2797,73,2.50000000
CN4820900000000,48,209,"Hays County, TX",Apr-22,133737,130254,3483,2.60000000
CN4821100000000,48,211,"Hemphill County, TX",Apr-22,1553,1509,44,2.80000000
CN4821300000000,48,213,"Henderson County, TX",Apr-22,38837,37563,1274,3.30000000
CN4821500000000,48,215,"Hidalgo County, TX",Apr-22,368939,343774,25165,6.80000000
CN4821700000000,48,217,"Hill County, TX",Apr-22,16963,16413,550,3.20000000
CN4821900000000,48,219,"Hockley County, TX",Apr-22,11127,10736,391,3.50000000
CN4822100000000,48,221,"Hood County, TX",Apr-22,29501,28528,973,3.30000000
CN4822300000000,48,223,"Hopkins County, TX",Apr-22,18045,17531,514,2.80000000
CN4822500000000,48,225,"Houston County, TX",Apr-22,10569,10247,322,3.00000000
CN4822700000000,48,227,"Howard County, TX",Apr-22,13410,12758,652,4.90000000
CN4822900000000,48,229,"Hudspeth County, TX",Apr-22,1907,1837,70,3.70000000
CN4823100000000,48,231,"Hunt County, TX",Apr-22,46587,45041,1546,3.30000000
CN4823300000000,48,233,"Hutchinson County, TX",Apr-22,8170,7833,337,4.10000000
CN4823500000000,48,235,"Irion County, TX",Apr-22,789,766,23,2.90000000
CN4823700000000,48,237,"Jack County, TX",Apr-22,3448,3323,125,3.60000000
CN4823900000000,48,239,"Jackson County, TX",Apr-22,7138,6923,215,3.00000000
CN4824100000000,48,241,"Jasper County, TX",Apr-22,12835,12005,830,6.50000000
CN4824300000000,48,243,"Jeff Davis County, TX",Apr-22,1037,1010,27,2.60000000
CN4824500000000,48,245,"Jefferson County, TX",Apr-22,101060,94384,6676,6.60000000
CN4824700000000,48,247,"Jim Hogg County, TX",Apr-22,1819,1707,112,6.20000000
CN4824900000000,48,249,"Jim Wells County, TX",Apr-22,15399,14423,976,6.30000000
CN4825100000000,48,251,"Johnson County, TX",Apr-22,87708,85051,2657,3.00000000
CN4825300000000,48,253,"Jones County, TX",Apr-22,5779,5555,224,3.90000000
CN4825500000000,48,255,"Karnes County, TX",Apr-22,6951,6736,215,3.10000000
CN4825700000000,48,257,"Kaufman County, TX",Apr-22,74764,72373,2391,3.20000000
CN4825900000000,48,259,"Kendall County, TX",Apr-22,23278,22699,579,2.50000000
CN4826100000000,48,261,"Kenedy County, TX",Apr-22,199,190,9,4.50000000
CN4826300000000,48,263,"Kent County, TX",Apr-22,474,465,9,1.90000000
CN4826500000000,48,265,"Kerr County, TX",Apr-22,21893,21234,659,3.00000000
CN4826700000000,48,267,"Kimble County, TX",Apr-22,1940,1888,52,2.70000000
CN4826900000000,48,269,"King County, TX",Apr-22,645,642,3,0.50000000
CN4827100000000,48,271,"Kinney County, TX",Apr-22,1219,1168,51,4.20000000
CN4827300000000,48,273,"Kleberg County, TX",Apr-22,13364,12740,624,4.70000000
CN4827500000000,48,275,"Knox County, TX",Apr-22,1552,1502,50,3.20000000
CN4827700000000,48,277,"Lamar County, TX",Apr-22,23931,23018,913,3.80000000
CN4827900000000,48,279,"Lamb County, TX",Apr-22,5391,5206,185,3.40000000
CN4828100000000,48,281,"Lampasas County, TX",Apr-22,9399,9112,287,3.10000000
CN4828300000000,48,283,"La Salle County, TX",Apr-22,3777,3666,111,2.90000000
CN4828500000000,48,285,"Lavaca County, TX",Apr-22,8532,8266,266,3.10000000
CN4828700000000,48,287,"Lee County, TX",Apr-22,8999,8726,273,3.00000000
CN4828900000000,48,289,"Leon County, TX",Apr-22,6272,5980,292,4.70000000
CN4829100000000,48,291,"Liberty County, TX",Apr-22,35094,32938,2156,6.10000000
CN4829300000000,48,293,"Limestone County, TX",Apr-22,8652,8297,355,4.10000000
CN4829500000000,48,295,"Lipscomb County, TX",Apr-22,1512,1478,34,2.20000000
CN4829700000000,48,297,"Live Oak County, TX",Apr-22,4799,4594,205,4.30000000
CN4829900000000,48,299,"Llano County, TX",Apr-22,8821,8521,300,3.40000000
CN4830100000000,48,301,"Loving County, TX",Apr-22,487,483,4,0.80000000
CN4830300000000,48,303,"Lubbock County, TX",Apr-22,162553,157955,4598,2.80000000
CN4830500000000,48,305,"Lynn County, TX",Apr-22,2967,2876,91,3.10000000
CN4830700000000,48,307,"McCulloch County, TX",Apr-22,3074,2947,127,4.10000000
CN4830900000000,48,309,"McLennan County, TX",Apr-22,124531,120623,3908,3.10000000
CN4831100000000,48,311,"McMullen County, TX",Apr-22,790,776,14,1.80000000
CN4831300000000,48,313,"Madison County, TX",Apr-22,4794,4610,184,3.80000000
CN4831500000000,48,315,"Marion County, TX",Apr-22,4208,4003,205,4.90000000
CN4831700000000,48,317,"Martin County, TX",Apr-22,2723,2643,80,2.90000000
CN4831900000000,48,319,"Mason County, TX",Apr-22,1839,1788,51,2.80000000
CN4832100000000,48,321,"Matagorda County, TX",Apr-22,16447,15397,1050,6.40000000
CN4832300000000,48,323,"Maverick County, TX",Apr-22,23205,20939,2266,9.80000000
CN4832500000000,48,325,"Medina County, TX",Apr-22,22294,21565,729,3.30000000
CN4832700000000,48,327,"Menard County, TX",Apr-22,815,786,29,3.60000000
CN4832900000000,48,329,"Midland County, TX",Apr-22,100645,97393,3252,3.20000000
CN4833100000000,48,331,"Milam County, TX",Apr-22,10386,10013,373,3.60000000
CN4833300000000,48,333,"Mills County, TX",Apr-22,1900,1833,67,3.50000000
CN4833500000000,48,335,"Mitchell County, TX",Apr-22,2319,2207,112,4.80000000
CN4833700000000,48,337,"Montague County, TX",Apr-22,9299,9021,278,3.00000000
CN4833900000000,48,339,"Montgomery County, TX",Apr-22,297630,286568,11062,3.70000000
CN4834100000000,48,341,"Moore County, TX",Apr-22,11064,10816,248,2.20000000
CN4834300000000,48,343,"Morris County, TX",Apr-22,4389,4084,305,6.90000000
CN4834500000000,48,345,"Motley County, TX",Apr-22,486,469,17,3.50000000
CN4834700000000,48,347,"Nacogdoches County, TX",Apr-22,28229,27221,1008,3.60000000
CN4834900000000,48,349,"Navarro County, TX",Apr-22,23531,22724,807,3.40000000
CN4835100000000,48,351,"Newton County, TX",Apr-22,4889,4550,339,6.90000000
CN4835300000000,48,353,"Nolan County, TX",Apr-22,6966,6744,222,3.20000000
CN4835500000000,48,355,"Nueces County, TX",Apr-22,163334,155528,7806,4.80000000
CN4835700000000,48,357,"Ochiltree County, TX",Apr-22,4038,3923,115,2.80000000
CN4835900000000,48,359,"Oldham County, TX",Apr-22,958,933,25,2.60000000
CN4836100000000,48,361,"Orange County, TX",Apr-22,34751,32656,2095,6.00000000
CN4836300000000,48,363,"Palo Pinto County, TX",Apr-22,12662,12208,454,3.60000000
CN4836500000000,48,365,"Panola County, TX",Apr-22,9585,9156,429,4.50000000
CN4836700000000,48,367,"Parker County, TX",Apr-22,73564,71498,2066,2.80000000
CN4836900000000,48,369,"Parmer County, TX",Apr-22,5109,5014,95,1.90000000
CN4837100000000,48,371,"Pecos County, TX",Apr-22,5880,5597,283,4.80000000
CN4837300000000,48,373,"Polk County, TX",Apr-22,18177,17116,1061,5.80000000
CN4837500000000,48,375,"Potter County, TX",Apr-22,54490,52981,1509,2.80000000
CN4837700000000,48,377,"Presidio County, TX",Apr-22,3158,2944,214,6.80000000
CN4837900000000,48,379,"Rains County, TX",Apr-22,6664,6488,176,2.60000000
CN4838100000000,48,381,"Randall County, TX",Apr-22,75522,73762,1760,2.30000000
CN4838300000000,48,383,"Reagan County, TX",Apr-22,1595,1527,68,4.30000000
CN4838500000000,48,385,"Real County, TX",Apr-22,1177,1131,46,3.90000000
CN4838700000000,48,387,"Red River County, TX",Apr-22,5349,5109,240,4.50000000
CN4838900000000,48,389,"Reeves County, TX",Apr-22,9242,8964,278,3.00000000
CN4839100000000,48,391,"Refugio County, TX",Apr-22,3052,2914,138,4.50000000
CN4839300000000,48,393,"Roberts County, TX",Apr-22,401,388,13,3.20000000
CN4839500000000,48,395,"Robertson County, TX",Apr-22,7753,7487,266,3.40000000
CN4839700000000,48,397,"Rockwall County, TX",Apr-22,58876,57240,1636,2.80000000
CN4839900000000,48,399,"Runnels County, TX",Apr-22,4673,4557,116,2.50000000
CN4840100000000,48,401,"Rusk County, TX",Apr-22,22091,21243,848,3.80000000
CN4840300000000,48,403,"Sabine County, TX",Apr-22,3959,3695,264,6.70000000
CN4840500000000,48,405,"San Augustine County, TX",Apr-22,3008,2824,184,6.10000000
CN4840700000000,48,407,"San Jacinto County, TX",Apr-22,11911,11345,566,4.80000000
CN4840900000000,48,409,"San Patricio County, TX",Apr-22,29442,27505,1937,6.60000000
CN4841100000000,48,411,"San Saba County, TX",Apr-22,2158,2090,68,3.20000000
CN4841300000000,48,413,"Schleicher County, TX",Apr-22,1189,1149,40,3.40000000
CN4841500000000,48,415,"Scurry County, TX",Apr-22,5807,5562,245,4.20000000
CN4841700000000,48,417,"Shackelford County, TX",Apr-22,1878,1835,43,2.30000000
CN4841900000000,48,419,"Shelby County, TX",Apr-22,11777,11356,421,3.60000000
CN4842100000000,48,421,"Sherman County, TX",Apr-22,1562,1533,29,1.90000000
CN4842300000000,48,423,"Smith County, TX",Apr-22,110380,106756,3624,3.30000000
CN4842500000000,48,425,"Somervell County, TX",Apr-22,4490,4349,141,3.10000000
CN4842700000000,48,427,"Starr County, TX",Apr-22,24633,21444,3189,12.90000000
CN4842900000000,48,429,"Stephens County, TX",Apr-22,4314,4181,133,3.10000000
CN4843100000000,48,431,"Sterling County, TX",Apr-22,611,591,20,3.30000000
CN4843300000000,48,433,"Stonewall County, TX",Apr-22,599,583,16,2.70000000
CN4843500000000,48,435,"Sutton County, TX",Apr-22,1111,1047,64,5.80000000
CN4843700000000,48,437,"Swisher County, TX",Apr-22,2651,2573,78,2.90000000
CN4843900000000,48,439,"Tarrant County, TX",Apr-22,1123338,1086464,36874,3.30000000
CN4844100000000,48,441,"Taylor County, TX",Apr-22,67243,65288,1955,2.90000000
CN4844300000000,48,443,"Terrell County, TX",Apr-22,436,424,12,2.80000000
CN4844500000000,48,445,"Terry County, TX",Apr-22,4877,4681,196,4.00000000
CN4844700000000,48,447,"Throckmorton County, TX",Apr-22,1311,1294,17,1.30000000
CN4844900000000,48,449,"Titus County, TX",Apr-22,13465,12977,488,3.60000000
CN4845100000000,48,451,"Tom Green County, TX",Apr-22,54132,52488,1644,3.00000000
CN4845300000000,48,453,"Travis County, TX",Apr-22,793590,774074,19516,2.50000000
CN4845500000000,48,455,"Trinity County, TX",Apr-22,5374,5097,277,5.20000000
CN4845700000000,48,457,"Tyler County, TX",Apr-22,7606,7169,437,5.70000000
CN4845900000000,48,459,"Upshur County, TX",Apr-22,17595,16870,725,4.10000000
CN4846100000000,48,461,"Upton County, TX",Apr-22,1817,1754,63,3.50000000
CN4846300000000,48,463,"Uvalde County, TX",Apr-22,11141,10716,425,3.80000000
CN4846500000000,48,465,"Val Verde County, TX",Apr-22,21922,21008,914,4.20000000
CN4846700000000,48,467,"Van Zandt County, TX",Apr-22,27260,26462,798,2.90000000
CN4846900000000,48,469,"Victoria County, TX",Apr-22,40586,38912,1674,4.10000000
CN4847100000000,48,471,"Walker County, TX",Apr-22,23966,22939,1027,4.30000000
CN4847300000000,48,473,"Waller County, TX",Apr-22,25249,24220,1029,4.10000000
CN4847500000000,48,475,"Ward County, TX",Apr-22,6129,5876,253,4.10000000
CN4847700000000,48,477,"Washington County, TX",Apr-22,14935,14412,523,3.50000000
CN4847900000000,48,479,"Webb County, TX",Apr-22,117194,112320,4874,4.20000000
CN4848100000000,48,481,"Wharton County, TX",Apr-22,21223,20456,767,3.60000000
CN4848300000000,48,483,"Wheeler County, TX",Apr-22,1967,1890,77,3.90000000
CN4848500000000,48,485,"Wichita County, TX",Apr-22,55040,53120,1920,3.50000000
CN4848700000000,48,487,"Wilbarger County, TX",Apr-22,4799,4569,230,4.80000000
CN4848900000000,48,489,"Willacy County, TX",Apr-22,7488,6797,691,9.20000000
CN4849100000000,48,491,"Williamson County, TX",Apr-22,351831,342951,8880,2.50000000
CN4849300000000,48,493,"Wilson County, TX",Apr-22,25439,24722,717,2.80000000
CN4849500000000,48,495,"Winkler County, TX",Apr-22,3669,3486,183,5.00000000
CN4849700000000,48,497,"Wise County, TX",Apr-22,33895,32857,1038,3.10000000
CN4849900000000,48,499,"Wood County, TX",Apr-22,17804,17093,711,4.00000000
CN4850100000000,48,501,"Yoakum County, TX",Apr-22,3247,3096,151,4.70000000
CN4850300000000,48,503,"Young County, TX",Apr-22,8120,7867,253,3.10000000
CN4850500000000,48,505,"Zapata County, TX",Apr-22,4335,3955,380,8.80000000
CN4850700000000,48,507,"Zavala County, TX",Apr-22,3317,3001,316,9.50000000
CN4900100000000,49,001,"Beaver County, UT",Apr-22,3085,3020,65,2.10000000
CN4900300000000,49,003,"Box Elder County, UT",Apr-22,27648,27119,529,1.90000000
CN4900500000000,49,005,"Cache County, UT",Apr-22,71533,70360,1173,1.60000000
CN4900700000000,49,007,"Carbon County, UT",Apr-22,8530,8268,262,3.10000000
CN4900900000000,49,009,"Daggett County, UT",Apr-22,441,425,16,3.60000000
CN4901100000000,49,011,"Davis County, UT",Apr-22,181907,178470,3437,1.90000000
CN4901300000000,49,013,"Duchesne County, UT",Apr-22,7924,7677,247,3.10000000
CN4901500000000,49,015,"Emery County, UT",Apr-22,4502,4372,130,2.90000000
CN4901700000000,49,017,"Garfield County, UT",Apr-22,2918,2772,146,5.00000000
CN4901900000000,49,019,"Grand County, UT",Apr-22,6745,6582,163,2.40000000
CN4902100000000,49,021,"Iron County, UT",Apr-22,27538,26958,580,2.10000000
CN4902300000000,49,023,"Juab County, UT",Apr-22,6476,6374,102,1.60000000
CN4902500000000,49,025,"Kane County, UT",Apr-22,4118,4033,85,2.10000000
CN4902700000000,49,027,"Millard County, UT",Apr-22,6534,6416,118,1.80000000
CN4902900000000,49,029,"Morgan County, UT",Apr-22,5898,5797,101,1.70000000
CN4903100000000,49,031,"Piute County, UT",Apr-22,496,480,16,3.20000000
CN4903300000000,49,033,"Rich County, UT",Apr-22,1159,1132,27,2.30000000
CN4903500000000,49,035,"Salt Lake County, UT",Apr-22,664224,650429,13795,2.10000000
CN4903700000000,49,037,"San Juan County, UT",Apr-22,5750,5514,236,4.10000000
CN4903900000000,49,039,"Sanpete County, UT",Apr-22,13704,13405,299,2.20000000
CN4904100000000,49,041,"Sevier County, UT",Apr-22,10177,9934,243,2.40000000
CN4904300000000,49,043,"Summit County, UT",Apr-22,25312,24788,524,2.10000000
CN4904500000000,49,045,"Tooele County, UT",Apr-22,37424,36592,832,2.20000000
CN4904700000000,49,047,"Uintah County, UT",Apr-22,13748,13233,515,3.70000000
CN4904900000000,49,049,"Utah County, UT",Apr-22,348399,342259,6140,1.80000000
CN4905100000000,49,051,"Wasatch County, UT",Apr-22,17066,16696,370,2.20000000
CN4905300000000,49,053,"Washington County, UT",Apr-22,85872,84010,1862,2.20000000
CN4905500000000,49,055,"Wayne County, UT",Apr-22,1557,1501,56,3.60000000
CN4905700000000,49,057,"Weber County, UT",Apr-22,133683,130767,2916,2.20000000
CN5000100000000,50,001,"Addison County, VT",Apr-22,20511,20081,430,2.10000000
CN5000300000000,50,003,"Bennington County, VT",Apr-22,16881,16350,531,3.10000000
CN5000500000000,50,005,"Caledonia County, VT",Apr-22,13979,13605,374,2.70000000
CN5000700000000,50,007,"Chittenden County, VT",Apr-22,94911,93324,1587,1.70000000
CN5000900000000,50,009,"Essex County, VT",Apr-22,2561,2477,84,3.30000000
CN5001100000000,50,011,"Franklin County, VT",Apr-22,27352,26699,653,2.40000000
CN5001300000000,50,013,"Grand Isle County, VT",Apr-22,4032,3916,116,2.90000000
CN5001500000000,50,015,"Lamoille County, VT",Apr-22,13458,12987,471,3.50000000
CN5001700000000,50,017,"Orange County, VT",Apr-22,15295,14920,375,2.50000000
CN5001900000000,50,019,"Orleans County, VT",Apr-22,12768,12236,532,4.20000000
CN5002100000000,50,021,"Rutland County, VT",Apr-22,28299,27476,823,2.90000000
CN5002300000000,50,023,"Washington County, VT",Apr-22,32574,31913,661,2.00000000
CN5002500000000,50,025,"Windham County, VT",Apr-22,20178,19584,594,2.90000000
CN5002700000000,50,027,"Windsor County, VT",Apr-22,27857,27273,584,2.10000000
CN5100100000000,51,001,"Accomack County, VA",Apr-22,15609,15171,438,2.80000000
CN5100300000000,51,003,"Albemarle County, VA",Apr-22,56584,55363,1221,2.20000000
CN5100500000000,51,005,"Alleghany County, VA",Apr-22,6846,6662,184,2.70000000
CN5100700000000,51,007,"Amelia County, VA",Apr-22,5980,5831,149,2.50000000
CN5100900000000,51,009,"Amherst County, VA",Apr-22,14564,14185,379,2.60000000
CN5101100000000,51,011,"Appomattox County, VA",Apr-22,6997,6817,180,2.60000000
CN5101300000000,51,013,"Arlington County, VA",Apr-22,153143,150266,2877,1.90000000
CN5101500000000,51,015,"Augusta County, VA",Apr-22,36960,36165,795,2.20000000
CN5101700000000,51,017,"Bath County, VA",Apr-22,2284,2228,56,2.50000000
CN5101900000000,51,019,"Bedford County, VA",Apr-22,37833,36940,893,2.40000000
CN5102100000000,51,021,"Bland County, VA",Apr-22,2834,2768,66,2.30000000
CN5102300000000,51,023,"Botetourt County, VA",Apr-22,17039,16678,361,2.10000000
CN5102500000000,51,025,"Brunswick County, VA",Apr-22,6012,5755,257,4.30000000
CN5102700000000,51,027,"Buchanan County, VA",Apr-22,6542,6246,296,4.50000000
CN5102900000000,51,029,"Buckingham County, VA",Apr-22,6271,6053,218,3.50000000
CN5103100000000,51,031,"Campbell County, VA",Apr-22,25349,24707,642,2.50000000
CN5103300000000,51,033,"Caroline County, VA",Apr-22,14635,14221,414,2.80000000
CN5103500000000,51,035,"Carroll County, VA",Apr-22,13388,13013,375,2.80000000
CN5103600000000,51,036,"Charles City County, VA",Apr-22,3431,3331,100,2.90000000
CN5103700000000,51,037,"Charlotte County, VA",Apr-22,5709,5576,133,2.30000000
CN5104100000000,51,041,"Chesterfield County, VA",Apr-22,184570,180099,4471,2.40000000
CN5104300000000,51,043,"Clarke County, VA",Apr-22,7461,7303,158,2.10000000
CN5104500000000,51,045,"Craig County, VA",Apr-22,2228,2173,55,2.50000000
CN5104700000000,51,047,"Culpeper County, VA",Apr-22,24868,24283,585,2.40000000
CN5104900000000,51,049,"Cumberland County, VA",Apr-22,4740,4614,126,2.70000000
CN5105100000000,51,051,"Dickenson County, VA",Apr-22,5150,4984,166,3.20000000
CN5105300000000,51,053,"Dinwiddie County, VA",Apr-22,13145,12772,373,2.80000000
CN5105700000000,51,057,"Essex County, VA",Apr-22,5360,5186,174,3.20000000
CN5105900000000,51,059,"Fairfax County, VA",Apr-22,623115,609593,13522,2.20000000
CN5106100000000,51,061,"Fauquier County, VA",Apr-22,36702,35921,781,2.10000000
CN5106300000000,51,063,"Floyd County, VA",Apr-22,8407,8237,170,2.00000000
CN5106500000000,51,065,"Fluvanna County, VA",Apr-22,13866,13571,295,2.10000000
CN5106700000000,51,067,"Franklin County, VA",Apr-22,25531,24901,630,2.50000000
CN5106900000000,51,069,"Frederick County, VA",Apr-22,49665,48657,1008,2.00000000
CN5107100000000,51,071,"Giles County, VA",Apr-22,8065,7868,197,2.40000000
CN5107300000000,51,073,"Gloucester County, VA",Apr-22,18890,18455,435,2.30000000
CN5107500000000,51,075,"Goochland County, VA",Apr-22,11279,11026,253,2.20000000
CN5107700000000,51,077,"Grayson County, VA",Apr-22,8676,8499,177,2.00000000
CN5107900000000,51,079,"Greene County, VA",Apr-22,10382,10173,209,2.00000000
CN5108100000000,51,081,"Greensville County, VA",Apr-22,4472,4351,121,2.70000000
CN5108300000000,51,083,"Halifax County, VA",Apr-22,15949,15412,537,3.40000000
CN5108500000000,51,085,"Hanover County, VA",Apr-22,57231,56050,1181,2.10000000
CN5108700000000,51,087,"Henrico County, VA",Apr-22,176944,172342,4602,2.60000000
CN5108900000000,51,089,"Henry County, VA",Apr-22,25478,24759,719,2.80000000
CN5109100000000,51,091,"Highland County, VA",Apr-22,1236,1213,23,1.90000000
CN5109300000000,51,093,"Isle of Wight County, VA",Apr-22,19070,18612,458,2.40000000
CN5109500000000,51,095,"James City County, VA",Apr-22,35890,34952,938,2.60000000
CN5109700000000,51,097,"King and Queen County, VA",Apr-22,3965,3882,83,2.10000000
CN5109900000000,51,099,"King George County, VA",Apr-22,14784,14487,297,2.00000000
CN5110100000000,51,101,"King William County, VA",Apr-22,9133,8921,212,2.30000000
CN5110300000000,51,103,"Lancaster County, VA",Apr-22,5606,5394,212,3.80000000
CN5110500000000,51,105,"Lee County, VA",Apr-22,8753,8504,249,2.80000000
CN5110700000000,51,107,"Loudoun County, VA",Apr-22,226227,221680,4547,2.00000000
CN5110900000000,51,109,"Louisa County, VA",Apr-22,21176,20711,465,2.20000000
CN5111100000000,51,111,"Lunenburg County, VA",Apr-22,5307,5169,138,2.60000000
CN5111300000000,51,113,"Madison County, VA",Apr-22,7539,7408,131,1.70000000
CN5111500000000,51,115,"Mathews County, VA",Apr-22,3964,3867,97,2.40000000
CN5111700000000,51,117,"Mecklenburg County, VA",Apr-22,13383,12976,407,3.00000000
CN5111900000000,51,119,"Middlesex County, VA",Apr-22,5312,5189,123,2.30000000
CN5112100000000,51,121,"Montgomery County, VA",Apr-22,51664,50616,1048,2.00000000
CN5112500000000,51,125,"Nelson County, VA",Apr-22,7189,7023,166,2.30000000
CN5112700000000,51,127,"New Kent County, VA",Apr-22,12625,12361,264,2.10000000
CN5113100000000,51,131,"Northampton County, VA",Apr-22,5481,5293,188,3.40000000
CN5113300000000,51,133,"Northumberland County, VA",Apr-22,5781,5565,216,3.70000000
CN5113500000000,51,135,"Nottoway County, VA",Apr-22,7444,7260,184,2.50000000
CN5113700000000,51,137,"Orange County, VA",Apr-22,17598,17169,429,2.40000000
CN5113900000000,51,139,"Page County, VA",Apr-22,12472,12117,355,2.80000000
CN5114100000000,51,141,"Patrick County, VA",Apr-22,7348,7123,225,3.10000000
CN5114300000000,51,143,"Pittsylvania County, VA",Apr-22,31225,30421,804,2.60000000
CN5114500000000,51,145,"Powhatan County, VA",Apr-22,13985,13690,295,2.10000000
CN5114700000000,51,147,"Prince Edward County, VA",Apr-22,11033,10715,318,2.90000000
CN5114900000000,51,149,"Prince George County, VA",Apr-22,14649,14221,428,2.90000000
CN5115300000000,51,153,"Prince William County, VA",Apr-22,244628,238706,5922,2.40000000
CN5115500000000,51,155,"Pulaski County, VA",Apr-22,16589,16161,428,2.60000000
CN5115700000000,51,157,"Rappahannock County, VA",Apr-22,3614,3536,78,2.20000000
CN5115900000000,51,159,"Richmond County, VA",Apr-22,4121,4014,107,2.60000000
CN5116100000000,51,161,"Roanoke County, VA",Apr-22,48108,47063,1045,2.20000000
CN5116300000000,51,163,"Rockbridge County, VA",Apr-22,11231,10980,251,2.20000000
CN5116500000000,51,165,"Rockingham County, VA",Apr-22,42377,41522,855,2.00000000
CN5116700000000,51,167,"Russell County, VA",Apr-22,11413,11086,327,2.90000000
CN5116900000000,51,169,"Scott County, VA",Apr-22,8899,8668,231,2.60000000
CN5117100000000,51,171,"Shenandoah County, VA",Apr-22,22682,22168,514,2.30000000
CN5117300000000,51,173,"Smyth County, VA",Apr-22,15355,15001,354,2.30000000
CN5117500000000,51,175,"Southampton County, VA",Apr-22,9035,8818,217,2.40000000
CN5117700000000,51,177,"Spotsylvania County, VA",Apr-22,67572,65886,1686,2.50000000
CN5117900000000,51,179,"Stafford County, VA",Apr-22,73632,71853,1779,2.40000000
CN5118100000000,51,181,"Surry County, VA",Apr-22,3597,3501,96,2.70000000
CN5118300000000,51,183,"Sussex County, VA",Apr-22,3521,3368,153,4.30000000
CN5118500000000,51,185,"Tazewell County, VA",Apr-22,16196,15646,550,3.40000000
CN5118700000000,51,187,"Warren County, VA",Apr-22,20189,19718,471,2.30000000
CN5119100000000,51,191,"Washington County, VA",Apr-22,25547,24920,627,2.50000000
CN5119300000000,51,193,"Westmoreland County, VA",Apr-22,10013,9750,263,2.60000000
CN5119500000000,51,195,"Wise County, VA",Apr-22,14368,13914,454,3.20000000
CN5119700000000,51,197,"Wythe County, VA",Apr-22,14466,14124,342,2.40000000
CN5119900000000,51,199,"York County, VA",Apr-22,32152,31403,749,2.30000000
CN5151000000000,51,510,"Alexandria city, VA",Apr-22,98484,96276,2208,2.20000000
CN5152000000000,51,520,"Bristol city, VA",Apr-22,7360,7130,230,3.10000000
CN5153000000000,51,530,"Buena Vista city, VA",Apr-22,3114,3040,74,2.40000000
CN5154000000000,51,540,"Charlottesville city, VA",Apr-22,25121,24543,578,2.30000000
CN5155000000000,51,550,"Chesapeake city, VA",Apr-22,120145,117059,3086,2.60000000
CN5157000000000,51,570,"Colonial Heights city, VA",Apr-22,8138,7904,234,2.90000000
CN5158000000000,51,580,"Covington city, VA",Apr-22,2401,2309,92,3.80000000
CN5159000000000,51,590,"Danville city, VA",Apr-22,19309,18431,878,4.50000000
CN5159500000000,51,595,"Emporia city, VA",Apr-22,2469,2341,128,5.20000000
CN5160000000000,51,600,"Fairfax city, VA",Apr-22,12600,12327,273,2.20000000
CN5161000000000,51,610,"Falls Church city, VA",Apr-22,8342,8194,148,1.80000000
CN5162000000000,51,620,"Franklin city, VA",Apr-22,3522,3379,143,4.10000000
CN5163000000000,51,630,"Fredericksburg city, VA",Apr-22,14005,13584,421,3.00000000
CN5164000000000,51,640,"Galax city, VA",Apr-22,2954,2875,79,2.70000000
CN5165000000000,51,650,"Hampton city, VA",Apr-22,62660,60284,2376,3.80000000
CN5166000000000,51,660,"Harrisonburg city, VA",Apr-22,24588,23956,632,2.60000000
CN5167000000000,51,670,"Hopewell city, VA",Apr-22,9269,8810,459,5.00000000
CN5167800000000,51,678,"Lexington city, VA",Apr-22,2233,2167,66,3.00000000
CN5168000000000,51,680,"Lynchburg city, VA",Apr-22,35026,33899,1127,3.20000000
CN5168300000000,51,683,"Manassas city, VA",Apr-22,21213,20718,495,2.30000000
CN5168500000000,51,685,"Manassas Park city, VA",Apr-22,9569,9344,225,2.40000000
CN5169000000000,51,690,"Martinsville city, VA",Apr-22,5901,5613,288,4.90000000
CN5170000000000,51,700,"Newport News city, VA",Apr-22,86104,82937,3167,3.70000000
CN5171000000000,51,710,"Norfolk city, VA",Apr-22,107308,103455,3853,3.60000000
CN5172000000000,51,720,"Norton city, VA",Apr-22,1777,1721,56,3.20000000
CN5173000000000,51,730,"Petersburg city, VA",Apr-22,12218,11394,824,6.70000000
CN5173500000000,51,735,"Poquoson city, VA",Apr-22,6165,6040,125,2.00000000
CN5174000000000,51,740,"Portsmouth city, VA",Apr-22,43112,41268,1844,4.30000000
CN5175000000000,51,750,"Radford city, VA",Apr-22,8914,8688,226,2.50000000
CN5176000000000,51,760,"Richmond city, VA",Apr-22,115736,111653,4083,3.50000000
CN5177000000000,51,770,"Roanoke city, VA",Apr-22,47441,46017,1424,3.00000000
CN5177500000000,51,775,"Salem city, VA",Apr-22,12434,12134,300,2.40000000
CN5179000000000,51,790,"Staunton city, VA",Apr-22,12042,11754,288,2.40000000
CN5180000000000,51,800,"Suffolk city, VA",Apr-22,44241,42992,1249,2.80000000
CN5181000000000,51,810,"Virginia Beach city, VA",Apr-22,224895,219441,5454,2.40000000
CN5182000000000,51,820,"Waynesboro city, VA",Apr-22,10461,10193,268,2.60000000
CN5183000000000,51,830,"Williamsburg city, VA",Apr-22,6576,6363,213,3.20000000
CN5184000000000,51,840,"Winchester city, VA",Apr-22,14554,14217,337,2.30000000
CN5300100000000,53,001,"Adams County, WA",Apr-22,10246,9841,405,4.00000000
CN5300300000000,53,003,"Asotin County, WA",Apr-22,10705,10365,340,3.20000000
CN5300500000000,53,005,"Benton County, WA",Apr-22,107055,102288,4767,4.50000000
CN5300700000000,53,007,"Chelan County, WA",Apr-22,43422,41483,1939,4.50000000
CN5300900000000,53,009,"Clallam County, WA",Apr-22,29926,28341,1585,5.30000000
CN5301100000000,53,011,"Clark County, WA",Apr-22,251422,240635,10787,4.30000000
CN5301300000000,53,013,"Columbia County, WA",Apr-22,1825,1731,94,5.20000000
CN5301500000000,53,015,"Cowlitz County, WA",Apr-22,49401,46787,2614,5.30000000
CN5301700000000,53,017,"Douglas County, WA",Apr-22,21645,20640,1005,4.60000000
CN5301900000000,53,019,"Ferry County, WA",Apr-22,2323,2135,188,8.10000000
CN5302100000000,53,021,"Franklin County, WA",Apr-22,45027,42446,2581,5.70000000
CN5302300000000,53,023,"Garfield County, WA",Apr-22,806,755,51,6.30000000
CN5302500000000,53,025,"Grant County, WA",Apr-22,46984,44311,2673,5.70000000
CN5302700000000,53,027,"Grays Harbor County, WA",Apr-22,29195,27284,1911,6.50000000
CN5302900000000,53,029,"Island County, WA",Apr-22,36769,35148,1621,4.40000000
CN5303100000000,53,031,"Jefferson County, WA",Apr-22,12912,12272,640,5.00000000
CN5303300000000,53,033,"King County, WA",Apr-22,1327821,1302551,25270,1.90000000
CN5303500000000,53,035,"Kitsap County, WA",Apr-22,130711,125547,5164,4.00000000
CN5303700000000,53,037,"Kittitas County, WA",Apr-22,22518,21355,1163,5.20000000
CN5303900000000,53,039,"Klickitat County, WA",Apr-22,9761,9247,514,5.30000000
CN5304100000000,53,041,"Lewis County, WA",Apr-22,35735,33770,1965,5.50000000
CN5304300000000,53,043,"Lincoln County, WA",Apr-22,4460,4257,203,4.60000000
CN5304500000000,53,045,"Mason County, WA",Apr-22,25910,24419,1491,5.80000000
CN5304700000000,53,047,"Okanogan County, WA",Apr-22,19548,18389,1159,5.90000000
CN5304900000000,53,049,"Pacific County, WA",Apr-22,8555,7995,560,6.50000000
CN5305100000000,53,051,"Pend Oreille County, WA",Apr-22,5230,4894,336,6.40000000
CN5305300000000,53,053,"Pierce County, WA",Apr-22,455946,433763,22183,4.90000000
CN5305500000000,53,055,"San Juan County, WA",Apr-22,8129,7812,317,3.90000000
CN5305700000000,53,057,"Skagit County, WA",Apr-22,62787,59697,3090,4.90000000
CN5305900000000,53,059,"Skamania County, WA",Apr-22,5592,5318,274,4.90000000
CN5306100000000,53,061,"Snohomish County, WA",Apr-22,452758,442607,10151,2.20000000
CN5306300000000,53,063,"Spokane County, WA",Apr-22,267101,256166,10935,4.10000000
CN5306500000000,53,065,"Stevens County, WA",Apr-22,19506,18306,1200,6.20000000
CN5306700000000,53,067,"Thurston County, WA",Apr-22,147685,141482,6203,4.20000000
CN5306900000000,53,069,"Wahkiakum County, WA",Apr-22,1348,1262,86,6.40000000
CN5307100000000,53,071,"Walla Walla County, WA",Apr-22,31216,30016,1200,3.80000000
CN5307300000000,53,073,"Whatcom County, WA",Apr-22,117262,112090,5172,4.40000000
CN5307500000000,53,075,"Whitman County, WA",Apr-22,23080,22176,904,3.90000000
CN5307700000000,53,077,"Yakima County, WA",Apr-22,131224,123170,8054,6.10000000
CN5400100000000,54,001,"Barbour County, WV",Apr-22,7263,6989,274,3.80000000
CN5400300000000,54,003,"Berkeley County, WV",Apr-22,60012,58568,1444,2.40000000
CN5400500000000,54,005,"Boone County, WV",Apr-22,7227,6908,319,4.40000000
CN5400700000000,54,007,"Braxton County, WV",Apr-22,5025,4737,288,5.70000000
CN5400900000000,54,009,"Brooke County, WV",Apr-22,9857,9418,439,4.50000000
CN5401100000000,54,011,"Cabell County, WV",Apr-22,41536,40211,1325,3.20000000
CN5401300000000,54,013,"Calhoun County, WV",Apr-22,2573,2370,203,7.90000000
CN5401500000000,54,015,"Clay County, WV",Apr-22,3027,2846,181,6.00000000
CN5401700000000,54,017,"Doddridge County, WV",Apr-22,3778,3681,97,2.60000000
CN5401900000000,54,019,"Fayette County, WV",Apr-22,16009,15276,733,4.60000000
CN5402100000000,54,021,"Gilmer County, WV",Apr-22,2389,2266,123,5.10000000
CN5402300000000,54,023,"Grant County, WV",Apr-22,5979,5782,197,3.30000000
CN5402500000000,54,025,"Greenbrier County, WV",Apr-22,15326,14861,465,3.00000000
CN5402700000000,54,027,"Hampshire County, WV",Apr-22,11026,10788,238,2.20000000
CN5402900000000,54,029,"Hancock County, WV",Apr-22,13046,12405,641,4.90000000
CN5403100000000,54,031,"Hardy County, WV",Apr-22,5680,5475,205,3.60000000
CN5403300000000,54,033,"Harrison County, WV",Apr-22,33648,32534,1114,3.30000000
CN5403500000000,54,035,"Jackson County, WV",Apr-22,12101,11617,484,4.00000000
CN5403700000000,54,037,"Jefferson County, WV",Apr-22,30665,30044,621,2.00000000
CN5403900000000,54,039,"Kanawha County, WV",Apr-22,81531,78609,2922,3.60000000
CN5404100000000,54,041,"Lewis County, WV",Apr-22,6091,5780,311,5.10000000
CN5404300000000,54,043,"Lincoln County, WV",Apr-22,7098,6744,354,5.00000000
CN5404500000000,54,045,"Logan County, WV",Apr-22,11098,10596,502,4.50000000
CN5404700000000,54,047,"McDowell County, WV",Apr-22,4261,4000,261,6.10000000
CN5404900000000,54,049,"Marion County, WV",Apr-22,25463,24444,1019,4.00000000
CN5405100000000,54,051,"Marshall County, WV",Apr-22,13422,12737,685,5.10000000
CN5405300000000,54,053,"Mason County, WV",Apr-22,10052,9665,387,3.80000000
CN5405500000000,54,055,"Mercer County, WV",Apr-22,20795,19935,860,4.10000000
CN5405700000000,54,057,"Mineral County, WV",Apr-22,12173,11767,406,3.30000000
CN5405900000000,54,059,"Mingo County, WV",Apr-22,6045,5665,380,6.30000000
CN5406100000000,54,061,"Monongalia County, WV",Apr-22,57248,55553,1695,3.00000000
CN5406300000000,54,063,"Monroe County, WV",Apr-22,6074,5923,151,2.50000000
CN5406500000000,54,065,"Morgan County, WV",Apr-22,8491,8291,200,2.40000000
CN5406700000000,54,067,"Nicholas County, WV",Apr-22,9079,8687,392,4.30000000
CN5406900000000,54,069,"Ohio County, WV",Apr-22,20372,19612,760,3.70000000
CN5407100000000,54,071,"Pendleton County, WV",Apr-22,3757,3677,80,2.10000000
CN5407300000000,54,073,"Pleasants County, WV",Apr-22,2684,2539,145,5.40000000
CN5407500000000,54,075,"Pocahontas County, WV",Apr-22,4153,3922,231,5.60000000
CN5407700000000,54,077,"Preston County, WV",Apr-22,15939,15378,561,3.50000000
CN5407900000000,54,079,"Putnam County, WV",Apr-22,26972,26193,779,2.90000000
CN5408100000000,54,081,"Raleigh County, WV",Apr-22,30099,29065,1034,3.40000000
CN5408300000000,54,083,"Randolph County, WV",Apr-22,12023,11471,552,4.60000000
CN5408500000000,54,085,"Ritchie County, WV",Apr-22,4308,4144,164,3.80000000
CN5408700000000,54,087,"Roane County, WV",Apr-22,5043,4697,346,6.90000000
CN5408900000000,54,089,"Summers County, WV",Apr-22,4492,4341,151,3.40000000
CN5409100000000,54,091,"Taylor County, WV",Apr-22,7919,7628,291,3.70000000
CN5409300000000,54,093,"Tucker County, WV",Apr-22,3327,3186,141,4.20000000
CN5409500000000,54,095,"Tyler County, WV",Apr-22,3000,2822,178,5.90000000
CN5409700000000,54,097,"Upshur County, WV",Apr-22,9802,9350,452,4.60000000
CN5409900000000,54,099,"Wayne County, WV",Apr-22,15582,15037,545,3.50000000
CN5410100000000,54,101,"Webster County, WV",Apr-22,3150,3007,143,4.50000000
CN5410300000000,54,103,"Wetzel County, WV",Apr-22,6957,6588,369,5.30000000
CN5410500000000,54,105,"Wirt County, WV",Apr-22,2285,2147,138,6.00000000
CN5410700000000,54,107,"Wood County, WV",Apr-22,37034,35619,1415,3.80000000
CN5410900000000,54,109,"Wyoming County, WV",Apr-22,7332,7043,289,3.90000000
CN5500100000000,55,001,"Adams County, WI",Apr-22,7721,7331,390,5.10000000
CN5500300000000,55,003,"Ashland County, WI",Apr-22,7384,7023,361,4.90000000
CN5500500000000,55,005,"Barron County, WI",Apr-22,24314,23365,949,3.90000000
CN5500700000000,55,007,"Bayfield County, WI",Apr-22,7410,6917,493,6.70000000
CN5500900000000,55,009,"Brown County, WI",Apr-22,141753,138090,3663,2.60000000
CN5501100000000,55,011,"Buffalo County, WI",Apr-22,6397,6149,248,3.90000000
CN5501300000000,55,013,"Burnett County, WI",Apr-22,7373,6948,425,5.80000000
CN5501500000000,55,015,"Calumet County, WI",Apr-22,27938,27349,589,2.10000000
CN5501700000000,55,017,"Chippewa County, WI",Apr-22,33943,32694,1249,3.70000000
CN5501900000000,55,019,"Clark County, WI",Apr-22,18359,17857,502,2.70000000
CN5502100000000,55,021,"Columbia County, WI",Apr-22,32324,31496,828,2.60000000
CN5502300000000,55,023,"Crawford County, WI",Apr-22,7310,7040,270,3.70000000
CN5502500000000,55,025,"Dane County, WI",Apr-22,333354,326575,6779,2.00000000
CN5502700000000,55,027,"Dodge County, WI",Apr-22,47999,46790,1209,2.50000000
CN5502900000000,55,029,"Door County, WI",Apr-22,14499,13949,550,3.80000000
CN5503100000000,55,031,"Douglas County, WI",Apr-22,23451,22380,1071,4.60000000
CN5503300000000,55,033,"Dunn County, WI",Apr-22,24673,23854,819,3.30000000
CN5503500000000,55,035,"Eau Claire County, WI",Apr-22,59599,58113,1486,2.50000000
CN5503700000000,55,037,"Florence County, WI",Apr-22,2208,2103,105,4.80000000
CN5503900000000,55,039,"Fond du Lac County, WI",Apr-22,57436,56110,1326,2.30000000
CN5504100000000,55,041,"Forest County, WI",Apr-22,3852,3602,250,6.50000000
CN5504300000000,55,043,"Grant County, WI",Apr-22,28030,27340,690,2.50000000
CN5504500000000,55,045,"Green County, WI",Apr-22,21251,20821,430,2.00000000
CN5504700000000,55,047,"Green Lake County, WI",Apr-22,9298,9004,294,3.20000000
CN5504900000000,55,049,"Iowa County, WI",Apr-22,14047,13679,368,2.60000000
CN5505100000000,55,051,"Iron County, WI",Apr-22,2503,2312,191,7.60000000
CN5505300000000,55,053,"Jackson County, WI",Apr-22,9642,9232,410,4.30000000
CN5505500000000,55,055,"Jefferson County, WI",Apr-22,45990,44789,1201,2.60000000
CN5505700000000,55,057,"Juneau County, WI",Apr-22,13300,12868,432,3.20000000
CN5505900000000,55,059,"Kenosha County, WI",Apr-22,91545,88379,3166,3.50000000
CN5506100000000,55,061,"Kewaunee County, WI",Apr-22,11066,10814,252,2.30000000
CN5506300000000,55,063,"La Crosse County, WI",Apr-22,67371,65824,1547,2.30000000
CN5506500000000,55,065,"Lafayette County, WI",Apr-22,10615,10409,206,1.90000000
CN5506700000000,55,067,"Langlade County, WI",Apr-22,9487,9108,379,4.00000000
CN5506900000000,55,069,"Lincoln County, WI",Apr-22,14676,14196,480,3.30000000
CN5507100000000,55,071,"Manitowoc County, WI",Apr-22,40432,39337,1095,2.70000000
CN5507300000000,55,073,"Marathon County, WI",Apr-22,74707,72864,1843,2.50000000
CN5507500000000,55,075,"Marinette County, WI",Apr-22,18899,18126,773,4.10000000
CN5507700000000,55,077,"Marquette County, WI",Apr-22,7706,7461,245,3.20000000
CN5507800000000,55,078,"Menominee County, WI",Apr-22,1553,1443,110,7.10000000
CN5507900000000,55,079,"Milwaukee County, WI",Apr-22,464686,444605,20081,4.30000000
CN5508100000000,55,081,"Monroe County, WI",Apr-22,23747,23151,596,2.50000000
CN5508300000000,55,083,"Oconto County, WI",Apr-22,20975,20270,705,3.40000000
CN5508500000000,55,085,"Oneida County, WI",Apr-22,17436,16748,688,3.90000000
CN5508700000000,55,087,"Outagamie County, WI",Apr-22,105013,102428,2585,2.50000000
CN5508900000000,55,089,"Ozaukee County, WI",Apr-22,49243,48123,1120,2.30000000
CN5509100000000,55,091,"Pepin County, WI",Apr-22,4193,4075,118,2.80000000
CN5509300000000,55,093,"Pierce County, WI",Apr-22,25463,24659,804,3.20000000
CN5509500000000,55,095,"Polk County, WI",Apr-22,24799,23695,1104,4.50000000
CN5509700000000,55,097,"Portage County, WI",Apr-22,37918,36787,1131,3.00000000
CN5509900000000,55,099,"Price County, WI",Apr-22,6217,5965,252,4.10000000
CN5510100000000,55,101,"Racine County, WI",Apr-22,97858,94129,3729,3.80000000
CN5510300000000,55,103,"Richland County, WI",Apr-22,9022,8772,250,2.80000000
CN5510500000000,55,105,"Rock County, WI",Apr-22,86707,83565,3142,3.60000000
CN5510700000000,55,107,"Rusk County, WI",Apr-22,6579,6268,311,4.70000000
CN5510900000000,55,109,"St. Croix County, WI",Apr-22,51495,49953,1542,3.00000000
CN5511100000000,55,111,"Sauk County, WI",Apr-22,33206,32159,1047,3.20000000
CN5511300000000,55,113,"Sawyer County, WI",Apr-22,7846,7401,445,5.70000000
CN5511500000000,55,115,"Shawano County, WI",Apr-22,20844,20200,644,3.10000000
CN5511700000000,55,117,"Sheboygan County, WI",Apr-22,62380,60930,1450,2.30000000
CN5511900000000,55,119,"Taylor County, WI",Apr-22,11131,10719,412,3.70000000
CN5512100000000,55,121,"Trempealeau County, WI",Apr-22,15304,14802,502,3.30000000
CN5512300000000,55,123,"Vernon County, WI",Apr-22,15801,15404,397,2.50000000
CN5512500000000,55,125,"Vilas County, WI",Apr-22,9894,9346,548,5.50000000
CN5512700000000,55,127,"Walworth County, WI",Apr-22,55980,54284,1696,3.00000000
CN5512900000000,55,129,"Washburn County, WI",Apr-22,7790,7435,355,4.60000000
CN5513100000000,55,131,"Washington County, WI",Apr-22,76942,75134,1808,2.30000000
CN5513300000000,55,133,"Waukesha County, WI",Apr-22,224351,219013,5338,2.40000000
CN5513500000000,55,135,"Waupaca County, WI",Apr-22,25659,24851,808,3.10000000
CN5513700000000,55,137,"Waushara County, WI",Apr-22,11342,10972,370,3.30000000
CN5513900000000,55,139,"Winnebago County, WI",Apr-22,92299,90005,2294,2.50000000
CN5514100000000,55,141,"Wood County, WI",Apr-22,33550,32404,1146,3.40000000
CN5600100000000,56,001,"Albany County, WY",Apr-22,21379,20857,522,2.40000000
CN5600300000000,56,003,"Big Horn County, WY",Apr-22,5288,5082,206,3.90000000
CN5600500000000,56,005,"Campbell County, WY",Apr-22,21833,21043,790,3.60000000
CN5600700000000,56,007,"Carbon County, WY",Apr-22,7286,7033,253,3.50000000
CN5600900000000,56,009,"Converse County, WY",Apr-22,7727,7480,247,3.20000000
CN5601100000000,56,011,"Crook County, WY",Apr-22,3894,3798,96,2.50000000
CN5601300000000,56,013,"Fremont County, WY",Apr-22,18736,18028,708,3.80000000
CN5601500000000,56,015,"Goshen County, WY",Apr-22,6590,6435,155,2.40000000
CN5601700000000,56,017,"Hot Springs County, WY",Apr-22,2203,2146,57,2.60000000
CN5601900000000,56,019,"Johnson County, WY",Apr-22,4270,4134,136,3.20000000
CN5602100000000,56,021,"Laramie County, WY",Apr-22,49626,48099,1527,3.10000000
CN5602300000000,56,023,"Lincoln County, WY",Apr-22,9309,9020,289,3.10000000
CN5602500000000,56,025,"Natrona County, WY",Apr-22,39114,37380,1734,4.40000000
CN5602700000000,56,027,"Niobrara County, WY",Apr-22,1244,1219,25,2.00000000
CN5602900000000,56,029,"Park County, WY",Apr-22,14863,14338,525,3.50000000
CN5603100000000,56,031,"Platte County, WY",Apr-22,4551,4417,134,2.90000000
CN5603300000000,56,033,"Sheridan County, WY",Apr-22,15998,15519,479,3.00000000
CN5603500000000,56,035,"Sublette County, WY",Apr-22,3795,3627,168,4.40000000
CN5603700000000,56,037,"Sweetwater County, WY",Apr-22,19010,18225,785,4.10000000
CN5603900000000,56,039,"Teton County, WY",Apr-22,14896,14258,638,4.30000000
CN5604100000000,56,041,"Uinta County, WY",Apr-22,8579,8276,303,3.50000000
CN5604300000000,56,043,"Washakie County, WY",Apr-22,3896,3744,152,3.90000000
CN5604500000000,56,045,"Weston County, WY",Apr-22,3712,3607,105,2.80000000
CN7200100000000,72,001,"Adjuntas Municipio, PR",Apr-22,4305,3937,368,8.50000000
CN7200300000000,72,003,"Aguada Municipio, PR",Apr-22,13282,12326,956,7.20000000
CN7200500000000,72,005,"Aguadilla Municipio, PR",Apr-22,16001,14820,1181,7.40000000
CN7200700000000,72,007,"Aguas Buenas Municipio, PR",Apr-22,7213,6753,460,6.40000000
CN7200900000000,72,009,"Aibonito Municipio, PR",Apr-22,6882,6439,443,6.40000000
CN7201100000000,72,011,"Anasco Municipio, PR",Apr-22,9940,9351,589,5.90000000
CN7201300000000,72,013,"Arecibo Municipio, PR",Apr-22,26202,24491,1711,6.50000000
CN7201500000000,72,015,"Arroyo Municipio, PR",Apr-22,5115,4717,398,7.80000000
CN7201700000000,72,017,"Barceloneta Municipio, PR",Apr-22,6549,6029,520,7.90000000
CN7201900000000,72,019,"Barranquitas Municipio, PR",Apr-22,7951,7431,520,6.50000000
CN7202100000000,72,021,"Bayamon Municipio, PR",Apr-22,71910,68342,3568,5.00000000
CN7202300000000,72,023,"Cabo Rojo Municipio, PR",Apr-22,15482,14483,999,6.50000000
CN7202500000000,72,025,"Caguas Municipio, PR",Apr-22,52696,50387,2309,4.40000000
CN7202700000000,72,027,"Camuy Municipio, PR",Apr-22,10464,9861,603,5.80000000
CN7202900000000,72,029,"Canovanas Municipio, PR",Apr-22,18068,17220,848,4.70000000
CN7203100000000,72,031,"Carolina Municipio, PR",Apr-22,68080,64807,3273,4.80000000
CN7203300000000,72,033,"Catano Municipio, PR",Apr-22,8636,8155,481,5.60000000
CN7203500000000,72,035,"Cayey Municipio, PR",Apr-22,17806,17049,757,4.30000000
CN7203700000000,72,037,"Ceiba Municipio, PR",Apr-22,3987,3703,284,7.10000000
CN7203900000000,72,039,"Ciales Municipio, PR",Apr-22,4025,3664,361,9.00000000
CN7204100000000,72,041,"Cidra Municipio, PR",Apr-22,16994,16328,666,3.90000000
CN7204300000000,72,043,"Coamo Municipio, PR",Apr-22,11177,10383,794,7.10000000
CN7204500000000,72,045,"Comerio Municipio, PR",Apr-22,5374,5025,349,6.50000000
CN7204700000000,72,047,"Corozal Municipio, PR",Apr-22,9730,9036,694,7.10000000
CN7204900000000,72,049,"Culebra Municipio, PR",Apr-22,990,959,31,3.10000000
CN7205100000000,72,051,"Dorado Municipio, PR",Apr-22,14893,14298,595,4.00000000
CN7205300000000,72,053,"Fajardo Municipio, PR",Apr-22,11685,10898,787,6.70000000
CN7205400000000,72,054,"Florida Municipio, PR",Apr-22,3616,3335,281,7.80000000
CN7205500000000,72,055,"Guanica Municipio, PR",Apr-22,4231,3760,471,11.10000000
CN7205700000000,72,057,"Guayama Municipio, PR",Apr-22,11954,11274,680,5.70000000
CN7205900000000,72,059,"Guayanilla Municipio, PR",Apr-22,5476,4942,534,9.80000000
CN7206100000000,72,061,"Guaynabo Municipio, PR",Apr-22,42051,40858,1193,2.80000000
CN7206300000000,72,063,"Gurabo Municipio, PR",Apr-22,20722,20024,698,3.40000000
CN7206500000000,72,065,"Hatillo Municipio, PR",Apr-22,14955,13719,1236,8.30000000
CN7206700000000,72,067,"Hormigueros Municipio, PR",Apr-22,6110,5697,413,6.80000000
CN7206900000000,72,069,"Humacao Municipio, PR",Apr-22,19148,17913,1235,6.40000000
CN7207100000000,72,071,"Isabela Municipio, PR",Apr-22,13050,12274,776,5.90000000
CN7207300000000,72,073,"Jayuya Municipio, PR",Apr-22,4452,4058,394,8.80000000
CN7207500000000,72,075,"Juana Diaz Municipio, PR",Apr-22,17160,16108,1052,6.10000000
CN7207700000000,72,077,"Juncos Municipio, PR",Apr-22,13741,12921,820,6.00000000
CN7207900000000,72,079,"Lajas Municipio, PR",Apr-22,5704,5158,546,9.60000000
CN7208100000000,72,081,"Lares Municipio, PR",Apr-22,7405,6547,858,11.60000000
CN7208300000000,72,083,"Las Marias Municipio, PR",Apr-22,2789,2529,260,9.30000000
CN7208500000000,72,085,"Las Piedras Municipio, PR",Apr-22,12645,11944,701,5.50000000
CN7208700000000,72,087,"Loiza Municipio, PR",Apr-22,9238,8664,574,6.20000000
CN7208900000000,72,089,"Luquillo Municipio, PR",Apr-22,6790,6373,417,6.10000000
CN7209100000000,72,091,"Manati Municipio, PR",Apr-22,12373,11660,713,5.80000000
CN7209300000000,72,093,"Maricao Municipio, PR",Apr-22,2108,1860,248,11.80000000
CN7209500000000,72,095,"Maunabo Municipio, PR",Apr-22,3184,2802,382,12.00000000
CN7209700000000,72,097,"Mayaguez Municipio, PR",Apr-22,24058,22410,1648,6.90000000
CN7209900000000,72,099,"Moca Municipio, PR",Apr-22,11594,10710,884,7.60000000
CN7210100000000,72,101,"Morovis Municipio, PR",Apr-22,8900,8298,602,6.80000000
CN7210300000000,72,103,"Naguabo Municipio, PR",Apr-22,9143,8592,551,6.00000000
CN7210500000000,72,105,"Naranjito Municipio, PR",Apr-22,7859,7287,572,7.30000000
CN7210700000000,72,107,"Orocovis Municipio, PR",Apr-22,5323,4904,419,7.90000000
CN7210900000000,72,109,"Patillas Municipio, PR",Apr-22,4629,4162,467,10.10000000
CN7211100000000,72,111,"Penuelas Municipio, PR",Apr-22,6335,5735,600,9.50000000
CN7211300000000,72,113,"Ponce Municipio, PR",Apr-22,50188,46646,3542,7.10000000
CN7211500000000,72,115,"Quebradillas Municipio, PR",Apr-22,6614,6159,455,6.90000000
CN7211700000000,72,117,"Rincon Municipio, PR",Apr-22,5226,4759,467,8.90000000
CN7211900000000,72,119,"Rio Grande Municipio, PR",Apr-22,18892,17802,1090,5.80000000
CN7212100000000,72,121,"Sabana Grande Municipio, PR",Apr-22,6563,6054,509,7.80000000
CN7212300000000,72,123,"Salinas Municipio, PR",Apr-22,7554,6947,607,8.00000000
CN7212500000000,72,125,"San German Municipio, PR",Apr-22,10746,9900,846,7.90000000
CN7212700000000,72,127,"San Juan Municipio, PR",Apr-22,147862,141704,6158,4.20000000
CN7212900000000,72,129,"San Lorenzo Municipio, PR",Apr-22,12707,12025,682,5.40000000
CN7213100000000,72,131,"San Sebastian Municipio, PR",Apr-22,10994,9909,1085,9.90000000
CN7213300000000,72,133,"Santa Isabel Municipio, PR",Apr-22,8928,8234,694,7.80000000
CN7213500000000,72,135,"Toa Alta Municipio, PR",Apr-22,30908,29586,1322,4.30000000
CN7213700000000,72,137,"Toa Baja Municipio, PR",Apr-22,32173,30703,1470,4.60000000
CN7213900000000,72,139,"Trujillo Alto Municipio, PR",Apr-22,30073,29025,1048,3.50000000
CN7214100000000,72,141,"Utuado Municipio, PR",Apr-22,7211,6630,581,8.10000000
CN7214300000000,72,143,"Vega Alta Municipio, PR",Apr-22,10933,10160,773,7.10000000
CN7214500000000,72,145,"Vega Baja Municipio, PR",Apr-22,14501,13401,1100,7.60000000
CN7214700000000,72,147,"Vieques Municipio, PR",Apr-22,2871,2629,242,8.40000000
CN7214900000000,72,149,"Villalba Municipio, PR",Apr-22,7922,7167,755,9.50000000
CN7215100000000,72,151,"Yabucoa Municipio, PR",Apr-22,9427,8661,766,8.10000000
CN7215300000000,72,153,"Yauco Municipio, PR",Apr-22,10548,9453,1095,10.40000000
CN0100100000000,01,001,"Autauga County, AL",May-22,26916,26362,554,2.10000000
CN0100300000000,01,003,"Baldwin County, AL",May-22,101761,99568,2193,2.20000000
CN0100500000000,01,005,"Barbour County, AL",May-22,8220,7920,300,3.60000000
CN0100700000000,01,007,"Bibb County, AL",May-22,8769,8574,195,2.20000000
CN0100900000000,01,009,"Blount County, AL",May-22,25868,25356,512,2.00000000
CN0101100000000,01,011,"Bullock County, AL",May-22,4469,4346,123,2.80000000
CN0101300000000,01,013,"Butler County, AL",May-22,8759,8451,308,3.50000000
CN0101500000000,01,015,"Calhoun County, AL",May-22,46602,45262,1340,2.90000000
CN0101700000000,01,017,"Chambers County, AL",May-22,15887,15509,378,2.40000000
CN0101900000000,01,019,"Cherokee County, AL",May-22,11683,11440,243,2.10000000
CN0102100000000,01,021,"Chilton County, AL",May-22,20256,19853,403,2.00000000
CN0102300000000,01,023,"Choctaw County, AL",May-22,4327,4172,155,3.60000000
CN0102500000000,01,025,"Clarke County, AL",May-22,7757,7412,345,4.40000000
CN0102700000000,01,027,"Clay County, AL",May-22,5999,5876,123,2.10000000
CN0102900000000,01,029,"Cleburne County, AL",May-22,5998,5866,132,2.20000000
CN0103100000000,01,031,"Coffee County, AL",May-22,21492,21010,482,2.20000000
CN0103300000000,01,033,"Colbert County, AL",May-22,23830,23134,696,2.90000000
CN0103500000000,01,035,"Conecuh County, AL",May-22,4249,4109,140,3.30000000
CN0103700000000,01,037,"Coosa County, AL",May-22,4394,4296,98,2.20000000
CN0103900000000,01,039,"Covington County, AL",May-22,15134,14785,349,2.30000000
CN0104100000000,01,041,"Crenshaw County, AL",May-22,5879,5743,136,2.30000000
CN0104300000000,01,043,"Cullman County, AL",May-22,39348,38618,730,1.90000000
CN0104500000000,01,045,"Dale County, AL",May-22,20911,20409,502,2.40000000
CN0104700000000,01,047,"Dallas County, AL",May-22,13646,12905,741,5.40000000
CN0104900000000,01,049,"DeKalb County, AL",May-22,31085,30440,645,2.10000000
CN0105100000000,01,051,"Elmore County, AL",May-22,38472,37733,739,1.90000000
CN0105300000000,01,053,"Escambia County, AL",May-22,14051,13678,373,2.70000000
CN0105500000000,01,055,"Etowah County, AL",May-22,39676,38539,1137,2.90000000
CN0105700000000,01,057,"Fayette County, AL",May-22,6724,6557,167,2.50000000
CN0105900000000,01,059,"Franklin County, AL",May-22,14429,14139,290,2.00000000
CN0106100000000,01,061,"Geneva County, AL",May-22,11038,10794,244,2.20000000
CN0106300000000,01,063,"Greene County, AL",May-22,2816,2682,134,4.80000000
CN0106500000000,01,065,"Hale County, AL",May-22,5811,5574,237,4.10000000
CN0106700000000,01,067,"Henry County, AL",May-22,6982,6810,172,2.50000000
CN0106900000000,01,069,"Houston County, AL",May-22,47753,46616,1137,2.40000000
CN0107100000000,01,071,"Jackson County, AL",May-22,23317,22758,559,2.40000000
CN0107300000000,01,073,"Jefferson County, AL",May-22,326352,318488,7864,2.40000000
CN0107500000000,01,075,"Lamar County, AL",May-22,5646,5515,131,2.30000000
CN0107700000000,01,077,"Lauderdale County, AL",May-22,42921,41879,1042,2.40000000
CN0107900000000,01,079,"Lawrence County, AL",May-22,14590,14271,319,2.20000000
CN0108100000000,01,081,"Lee County, AL",May-22,78848,77176,1672,2.10000000
CN0108300000000,01,083,"Limestone County, AL",May-22,47834,46930,904,1.90000000
CN0108500000000,01,085,"Lowndes County, AL",May-22,3525,3318,207,5.90000000
CN0108700000000,01,087,"Macon County, AL",May-22,7838,7516,322,4.10000000
CN0108900000000,01,089,"Madison County, AL",May-22,197774,193916,3858,2.00000000
CN0109100000000,01,091,"Marengo County, AL",May-22,7610,7387,223,2.90000000
CN0109300000000,01,093,"Marion County, AL",May-22,13762,13467,295,2.10000000
CN0109500000000,01,095,"Marshall County, AL",May-22,45131,44300,831,1.80000000
CN0109700000000,01,097,"Mobile County, AL",May-22,192528,186417,6111,3.20000000
CN0109900000000,01,099,"Monroe County, AL",May-22,7314,7029,285,3.90000000
CN0110100000000,01,101,"Montgomery County, AL",May-22,108064,104760,3304,3.10000000
CN0110300000000,01,103,"Morgan County, AL",May-22,60469,59308,1161,1.90000000
CN0110500000000,01,105,"Perry County, AL",May-22,3022,2843,179,5.90000000
CN0110700000000,01,107,"Pickens County, AL",May-22,7571,7346,225,3.00000000
CN0110900000000,01,109,"Pike County, AL",May-22,16327,15942,385,2.40000000
CN0111100000000,01,111,"Randolph County, AL",May-22,9615,9403,212,2.20000000
CN0111300000000,01,113,"Russell County, AL",May-22,24006,23477,529,2.20000000
CN0111500000000,01,115,"St. Clair County, AL",May-22,42547,41706,841,2.00000000
CN0111700000000,01,117,"Shelby County, AL",May-22,122463,120472,1991,1.60000000
CN0111900000000,01,119,"Sumter County, AL",May-22,4494,4340,154,3.40000000
CN0112100000000,01,121,"Talladega County, AL",May-22,36193,35140,1053,2.90000000
CN0112300000000,01,123,"Tallapoosa County, AL",May-22,17918,17435,483,2.70000000
CN0112500000000,01,125,"Tuscaloosa County, AL",May-22,103381,100885,2496,2.40000000
CN0112700000000,01,127,"Walker County, AL",May-22,25774,25126,648,2.50000000
CN0112900000000,01,129,"Washington County, AL",May-22,6488,6261,227,3.50000000
CN0113100000000,01,131,"Wilcox County, AL",May-22,2534,2320,214,8.40000000
CN0113300000000,01,133,"Winston County, AL",May-22,10251,10027,224,2.20000000
CN0201300000000,02,013,"Aleutians East Borough, AK",May-22,2261,2212,49,2.20000000
CN0201600000000,02,016,"Aleutians West Census Area, AK",May-22,2872,2729,143,5.00000000
CN0202000000000,02,020,"Anchorage Borough/municipality, AK",May-22,154523,148794,5729,3.70000000
CN0205000000000,02,050,"Bethel Census Area, AK",May-22,6541,5791,750,11.50000000
CN0206000000000,02,060,"Bristol Bay Borough, AK",May-22,480,463,17,3.50000000
CN0206300000000,02,063,"Chugach Census Area, AK",May-22,3446,3310,136,3.90000000
CN0206600000000,02,066,"Copper River Census Area, AK",May-22,1424,1285,139,9.80000000
CN0206800000000,02,068,"Denali Borough, AK",May-22,932,866,66,7.10000000
CN0207000000000,02,070,"Dillingham Census Area, AK",May-22,1630,1517,113,6.90000000
CN0209000000000,02,090,"Fairbanks North Star Borough, AK",May-22,46190,44403,1787,3.90000000
CN0210000000000,02,100,"Haines Borough, AK",May-22,1081,1006,75,6.90000000
CN0210500000000,02,105,"Hoonah-Angoon Census Area, AK",May-22,1235,1169,66,5.30000000
CN0211000000000,02,110,"Juneau Borough/city, AK",May-22,17612,17101,511,2.90000000
CN0212200000000,02,122,"Kenai Peninsula Borough, AK",May-22,28988,27571,1417,4.90000000
CN0213000000000,02,130,"Ketchikan Gateway Borough, AK",May-22,6687,6385,302,4.50000000
CN0215000000000,02,150,"Kodiak Island Borough, AK",May-22,5916,5647,269,4.50000000
CN0215800000000,02,158,"Kusilvak Census Area, AK",May-22,2281,1918,363,15.90000000
CN0216400000000,02,164,"Lake and Peninsula Borough, AK",May-22,661,616,45,6.80000000
CN0217000000000,02,170,"Matanuska-Susitna Borough, AK",May-22,51047,48491,2556,5.00000000
CN0218000000000,02,180,"Nome Census Area, AK",May-22,4076,3722,354,8.70000000
CN0218500000000,02,185,"North Slope Borough, AK",May-22,2908,2743,165,5.70000000
CN0218800000000,02,188,"Northwest Arctic Borough, AK",May-22,2936,2631,305,10.40000000
CN0219500000000,02,195,"Petersburg Borough, AK",May-22,1686,1596,90,5.30000000
CN0219800000000,02,198,"Prince of Wales-Hyder Census Area, AK",May-22,3028,2856,172,5.70000000
CN0222000000000,02,220,"Sitka Borough/city, AK",May-22,4664,4530,134,2.90000000
CN0223000000000,02,230,"Skagway Municipality, AK",May-22,653,611,42,6.40000000
CN0224000000000,02,240,"Southeast Fairbanks Census Area, AK",May-22,3389,3208,181,5.30000000
CN0227500000000,02,275,"Wrangell Borough/city, AK",May-22,1029,978,51,5.00000000
CN0228200000000,02,282,"Yakutat Borough/city, AK",May-22,360,345,15,4.20000000
CN0229000000000,02,290,"Yukon-Koyukuk Census Area, AK",May-22,2509,2272,237,9.40000000
CN0400100000000,04,001,"Apache County, AZ",May-22,18335,16951,1384,7.50000000
CN0400300000000,04,003,"Cochise County, AZ",May-22,48478,46703,1775,3.70000000
CN0400500000000,04,005,"Coconino County, AZ",May-22,74157,71056,3101,4.20000000
CN0400700000000,04,007,"Gila County, AZ",May-22,20303,19577,726,3.60000000
CN0400900000000,04,009,"Graham County, AZ",May-22,16011,15538,473,3.00000000
CN0401100000000,04,011,"Greenlee County, AZ",May-22,4426,4313,113,2.60000000
CN0401200000000,04,012,"La Paz County, AZ",May-22,8153,7791,362,4.40000000
CN0401300000000,04,013,"Maricopa County, AZ",May-22,2355279,2288334,66945,2.80000000
CN0401500000000,04,015,"Mohave County, AZ",May-22,89431,85906,3525,3.90000000
CN0401700000000,04,017,"Navajo County, AZ",May-22,39421,37514,1907,4.80000000
CN0401900000000,04,019,"Pima County, AZ",May-22,488698,472437,16261,3.30000000
CN0402100000000,04,021,"Pinal County, AZ",May-22,194128,187719,6409,3.30000000
CN0402300000000,04,023,"Santa Cruz County, AZ",May-22,19068,17825,1243,6.50000000
CN0402500000000,04,025,"Yavapai County, AZ",May-22,107352,104363,2989,2.80000000
CN0402700000000,04,027,"Yuma County, AZ",May-22,94384,80820,13564,14.40000000
CN0500100000000,05,001,"Arkansas County, AR",May-22,9326,9026,300,3.20000000
CN0500300000000,05,003,"Ashley County, AR",May-22,6724,6321,403,6.00000000
CN0500500000000,05,005,"Baxter County, AR",May-22,16515,16013,502,3.00000000
CN0500700000000,05,007,"Benton County, AR",May-22,147803,144550,3253,2.20000000
CN0500900000000,05,009,"Boone County, AR",May-22,15833,15449,384,2.40000000
CN0501100000000,05,011,"Bradley County, AR",May-22,3988,3828,160,4.00000000
CN0501300000000,05,013,"Calhoun County, AR",May-22,2370,2297,73,3.10000000
CN0501500000000,05,015,"Carroll County, AR",May-22,12689,12379,310,2.40000000
CN0501700000000,05,017,"Chicot County, AR",May-22,2917,2701,216,7.40000000
CN0501900000000,05,019,"Clark County, AR",May-22,8632,8276,356,4.10000000
CN0502100000000,05,021,"Clay County, AR",May-22,5303,5121,182,3.40000000
CN0502300000000,05,023,"Cleburne County, AR",May-22,8982,8635,347,3.90000000
CN0502500000000,05,025,"Cleveland County, AR",May-22,3109,3003,106,3.40000000
CN0502700000000,05,027,"Columbia County, AR",May-22,8781,8399,382,4.40000000
CN0502900000000,05,029,"Conway County, AR",May-22,8384,8098,286,3.40000000
CN0503100000000,05,031,"Craighead County, AR",May-22,56352,54902,1450,2.60000000
CN0503300000000,05,033,"Crawford County, AR",May-22,26180,25398,782,3.00000000
CN0503500000000,05,035,"Crittenden County, AR",May-22,20688,19890,798,3.90000000
CN0503700000000,05,037,"Cross County, AR",May-22,6905,6679,226,3.30000000
CN0503900000000,05,039,"Dallas County, AR",May-22,2767,2664,103,3.70000000
CN0504100000000,05,041,"Desha County, AR",May-22,4773,4504,269,5.60000000
CN0504300000000,05,043,"Drew County, AR",May-22,7397,7079,318,4.30000000
CN0504500000000,05,045,"Faulkner County, AR",May-22,62114,60383,1731,2.80000000
CN0504700000000,05,047,"Franklin County, AR",May-22,7255,7021,234,3.20000000
CN0504900000000,05,049,"Fulton County, AR",May-22,5054,4898,156,3.10000000
CN0505100000000,05,051,"Garland County, AR",May-22,40841,39315,1526,3.70000000
CN0505300000000,05,053,"Grant County, AR",May-22,8293,8058,235,2.80000000
CN0505500000000,05,055,"Greene County, AR",May-22,19333,18796,537,2.80000000
CN0505700000000,05,057,"Hempstead County, AR",May-22,8907,8643,264,3.00000000
CN0505900000000,05,059,"Hot Spring County, AR",May-22,13715,13291,424,3.10000000
CN0506100000000,05,061,"Howard County, AR",May-22,5353,5198,155,2.90000000
CN0506300000000,05,063,"Independence County, AR",May-22,16676,16164,512,3.10000000
CN0506500000000,05,065,"Izard County, AR",May-22,4386,4175,211,4.80000000
CN0506700000000,05,067,"Jackson County, AR",May-22,5455,5209,246,4.50000000
CN0506900000000,05,069,"Jefferson County, AR",May-22,26314,24874,1440,5.50000000
CN0507100000000,05,071,"Johnson County, AR",May-22,9925,9497,428,4.30000000
CN0507300000000,05,073,"Lafayette County, AR",May-22,2284,2178,106,4.60000000
CN0507500000000,05,075,"Lawrence County, AR",May-22,6619,6389,230,3.50000000
CN0507700000000,05,077,"Lee County, AR",May-22,2449,2337,112,4.60000000
CN0507900000000,05,079,"Lincoln County, AR",May-22,3730,3569,161,4.30000000
CN0508100000000,05,081,"Little River County, AR",May-22,5339,5146,193,3.60000000
CN0508300000000,05,083,"Logan County, AR",May-22,8235,7935,300,3.60000000
CN0508500000000,05,085,"Lonoke County, AR",May-22,33600,32702,898,2.70000000
CN0508700000000,05,087,"Madison County, AR",May-22,7516,7339,177,2.40000000
CN0508900000000,05,089,"Marion County, AR",May-22,6247,6044,203,3.20000000
CN0509100000000,05,091,"Miller County, AR",May-22,19200,18516,684,3.60000000
CN0509300000000,05,093,"Mississippi County, AR",May-22,16092,15045,1047,6.50000000
CN0509500000000,05,095,"Monroe County, AR",May-22,2558,2449,109,4.30000000
CN0509700000000,05,097,"Montgomery County, AR",May-22,2769,2646,123,4.40000000
CN0509900000000,05,099,"Nevada County, AR",May-22,3300,3174,126,3.80000000
CN0510100000000,05,101,"Newton County, AR",May-22,3171,3086,85,2.70000000
CN0510300000000,05,103,"Ouachita County, AR",May-22,9739,9389,350,3.60000000
CN0510500000000,05,105,"Perry County, AR",May-22,4146,3996,150,3.60000000
CN0510700000000,05,107,"Phillips County, AR",May-22,5643,5258,385,6.80000000
CN0510900000000,05,109,"Pike County, AR",May-22,4138,3992,146,3.50000000
CN0511100000000,05,111,"Poinsett County, AR",May-22,9691,9380,311,3.20000000
CN0511300000000,05,113,"Polk County, AR",May-22,7641,7387,254,3.30000000
CN0511500000000,05,115,"Pope County, AR",May-22,27286,26311,975,3.60000000
CN0511700000000,05,117,"Prairie County, AR",May-22,3519,3431,88,2.50000000
CN0511900000000,05,119,"Pulaski County, AR",May-22,187168,180513,6655,3.60000000
CN0512100000000,05,121,"Randolph County, AR",May-22,7216,6995,221,3.10000000
CN0512300000000,05,123,"St. Francis County, AR",May-22,7523,7155,368,4.90000000
CN0512500000000,05,125,"Saline County, AR",May-22,59077,57571,1506,2.50000000
CN0512700000000,05,127,"Scott County, AR",May-22,4068,3958,110,2.70000000
CN0512900000000,05,129,"Searcy County, AR",May-22,3049,2932,117,3.80000000
CN0513100000000,05,131,"Sebastian County, AR",May-22,55161,53552,1609,2.90000000
CN0513300000000,05,133,"Sevier County, AR",May-22,5232,5048,184,3.50000000
CN0513500000000,05,135,"Sharp County, AR",May-22,5794,5568,226,3.90000000
CN0513700000000,05,137,"Stone County, AR",May-22,4505,4333,172,3.80000000
CN0513900000000,05,139,"Union County, AR",May-22,14836,14102,734,4.90000000
CN0514100000000,05,141,"Van Buren County, AR",May-22,5937,5712,225,3.80000000
CN0514300000000,05,143,"Washington County, AR",May-22,130723,127815,2908,2.20000000
CN0514500000000,05,145,"White County, AR",May-22,33956,32804,1152,3.40000000
CN0514700000000,05,147,"Woodruff County, AR",May-22,2722,2620,102,3.70000000
CN0514900000000,05,149,"Yell County, AR",May-22,7742,7466,276,3.60000000
CN0600100000000,06,001,"Alameda County, CA",May-22,823207,802631,20576,2.50000000
CN0600300000000,06,003,"Alpine County, CA",May-22,442,418,24,5.40000000
CN0600500000000,06,005,"Amador County, CA",May-22,14437,13959,478,3.30000000
CN0600700000000,06,007,"Butte County, CA",May-22,92589,89466,3123,3.40000000
CN0600900000000,06,009,"Calaveras County, CA",May-22,21726,21149,577,2.70000000
CN0601100000000,06,011,"Colusa County, CA",May-22,11131,10180,951,8.50000000
CN0601300000000,06,013,"Contra Costa County, CA",May-22,549778,534838,14940,2.70000000
CN0601500000000,06,015,"Del Norte County, CA",May-22,9337,8952,385,4.10000000
CN0601700000000,06,017,"El Dorado County, CA",May-22,92353,90096,2257,2.40000000
CN0601900000000,06,019,"Fresno County, CA",May-22,454691,430811,23880,5.30000000
CN0602100000000,06,021,"Glenn County, CA",May-22,12616,12095,521,4.10000000
CN0602300000000,06,023,"Humboldt County, CA",May-22,59779,58034,1745,2.90000000
CN0602500000000,06,025,"Imperial County, CA",May-22,68770,60840,7930,11.50000000
CN0602700000000,06,027,"Inyo County, CA",May-22,8224,7998,226,2.70000000
CN0602900000000,06,029,"Kern County, CA",May-22,384729,361401,23328,6.10000000
CN0603100000000,06,031,"Kings County, CA",May-22,56634,53426,3208,5.70000000
CN0603300000000,06,033,"Lake County, CA",May-22,28493,27401,1092,3.80000000
CN0603500000000,06,035,"Lassen County, CA",May-22,9166,8905,261,2.80000000
CN0603700000000,06,037,"Los Angeles County, CA",May-22,4987130,4763298,223832,4.50000000
CN0603900000000,06,039,"Madera County, CA",May-22,62962,59818,3144,5.00000000
CN0604100000000,06,041,"Marin County, CA",May-22,129790,127451,2339,1.80000000
CN0604300000000,06,043,"Mariposa County, CA",May-22,7001,6750,251,3.60000000
CN0604500000000,06,045,"Mendocino County, CA",May-22,37438,36346,1092,2.90000000
CN0604700000000,06,047,"Merced County, CA",May-22,116741,109404,7337,6.30000000
CN0604900000000,06,049,"Modoc County, CA",May-22,3254,3139,115,3.50000000
CN0605100000000,06,051,"Mono County, CA",May-22,8676,8431,245,2.80000000
CN0605300000000,06,053,"Monterey County, CA",May-22,217770,208051,9719,4.50000000
CN0605500000000,06,055,"Napa County, CA",May-22,70754,69112,1642,2.30000000
CN0605700000000,06,057,"Nevada County, CA",May-22,46810,45640,1170,2.50000000
CN0605900000000,06,059,"Orange County, CA",May-22,1581406,1542875,38531,2.40000000
CN0606100000000,06,061,"Placer County, CA",May-22,191758,187713,4045,2.10000000
CN0606300000000,06,063,"Plumas County, CA",May-22,7513,7168,345,4.60000000
CN0606500000000,06,065,"Riverside County, CA",May-22,1148700,1110063,38637,3.40000000
CN0606700000000,06,067,"Sacramento County, CA",May-22,721071,698455,22616,3.10000000
CN0606900000000,06,069,"San Benito County, CA",May-22,32651,31347,1304,4.00000000
CN0607100000000,06,071,"San Bernardino County, CA",May-22,1005165,971040,34125,3.40000000
CN0607300000000,06,073,"San Diego County, CA",May-22,1574148,1531950,42198,2.70000000
CN0607500000000,06,075,"San Francisco County/city, CA",May-22,567562,556846,10716,1.90000000
CN0607700000000,06,077,"San Joaquin County, CA",May-22,341119,326380,14739,4.30000000
CN0607900000000,06,079,"San Luis Obispo County, CA",May-22,137665,134731,2934,2.10000000
CN0608100000000,06,081,"San Mateo County, CA",May-22,448973,441324,7649,1.70000000
CN0608300000000,06,083,"Santa Barbara County, CA",May-22,224287,218882,5405,2.40000000
CN0608500000000,06,085,"Santa Clara County, CA",May-22,1038458,1019359,19099,1.80000000
CN0608700000000,06,087,"Santa Cruz County, CA",May-22,134893,130001,4892,3.60000000
CN0608900000000,06,089,"Shasta County, CA",May-22,73380,70857,2523,3.40000000
CN0609100000000,06,091,"Sierra County, CA",May-22,1339,1300,39,2.90000000
CN0609300000000,06,093,"Siskiyou County, CA",May-22,16256,15549,707,4.30000000
CN0609500000000,06,095,"Solano County, CA",May-22,199209,192210,6999,3.50000000
CN0609700000000,06,097,"Sonoma County, CA",May-22,247966,242367,5599,2.30000000
CN0609900000000,06,099,"Stanislaus County, CA",May-22,239510,228648,10862,4.50000000
CN0610100000000,06,101,"Sutter County, CA",May-22,46142,43630,2512,5.40000000
CN0610300000000,06,103,"Tehama County, CA",May-22,25244,24296,948,3.80000000
CN0610500000000,06,105,"Trinity County, CA",May-22,4411,4272,139,3.20000000
CN0610700000000,06,107,"Tulare County, CA",May-22,208405,194784,13621,6.50000000
CN0610900000000,06,109,"Tuolumne County, CA",May-22,19932,19241,691,3.50000000
CN0611100000000,06,111,"Ventura County, CA",May-22,410040,399022,11018,2.70000000
CN0611300000000,06,113,"Yolo County, CA",May-22,108521,105427,3094,2.90000000
CN0611500000000,06,115,"Yuba County, CA",May-22,31149,29782,1367,4.40000000
CN0800100000000,08,001,"Adams County, CO",May-22,282889,272675,10214,3.60000000
CN0800300000000,08,003,"Alamosa County, CO",May-22,8813,8535,278,3.20000000
CN0800500000000,08,005,"Arapahoe County, CO",May-22,376156,363918,12238,3.30000000
CN0800700000000,08,007,"Archuleta County, CO",May-22,7380,7164,216,2.90000000
CN0800900000000,08,009,"Baca County, CO",May-22,2120,2089,31,1.50000000
CN0801100000000,08,011,"Bent County, CO",May-22,1922,1851,71,3.70000000
CN0801300000000,08,013,"Boulder County, CO",May-22,202379,197567,4812,2.40000000
CN0801400000000,08,014,"Broomfield County/city, CO",May-22,42438,41409,1029,2.40000000
CN0801500000000,08,015,"Chaffee County, CO",May-22,10599,10368,231,2.20000000
CN0801700000000,08,017,"Cheyenne County, CO",May-22,1119,1102,17,1.50000000
CN0801900000000,08,019,"Clear Creek County, CO",May-22,6166,5979,187,3.00000000
CN0802100000000,08,021,"Conejos County, CO",May-22,4243,4121,122,2.90000000
CN0802300000000,08,023,"Costilla County, CO",May-22,1931,1854,77,4.00000000
CN0802500000000,08,025,"Crowley County, CO",May-22,1474,1423,51,3.50000000
CN0802700000000,08,027,"Custer County, CO",May-22,2513,2450,63,2.50000000
CN0802900000000,08,029,"Delta County, CO",May-22,14292,13833,459,3.20000000
CN0803100000000,08,031,"Denver County/city, CO",May-22,437467,423050,14417,3.30000000
CN0803300000000,08,033,"Dolores County, CO",May-22,1178,1146,32,2.70000000
CN0803500000000,08,035,"Douglas County, CO",May-22,207436,202631,4805,2.30000000
CN0803700000000,08,037,"Eagle County, CO",May-22,36001,34995,1006,2.80000000
CN0803900000000,08,039,"Elbert County, CO",May-22,15965,15606,359,2.20000000
CN0804100000000,08,041,"El Paso County, CO",May-22,356952,345291,11661,3.30000000
CN0804300000000,08,043,"Fremont County, CO",May-22,16073,15374,699,4.30000000
CN0804500000000,08,045,"Garfield County, CO",May-22,31306,30431,875,2.80000000
CN0804700000000,08,047,"Gilpin County, CO",May-22,3946,3823,123,3.10000000
CN0804900000000,08,049,"Grand County, CO",May-22,9298,9069,229,2.50000000
CN0805100000000,08,051,"Gunnison County, CO",May-22,11768,11480,288,2.40000000
CN0805300000000,08,053,"Hinsdale County, CO",May-22,446,435,11,2.50000000
CN0805500000000,08,055,"Huerfano County, CO",May-22,2619,2478,141,5.40000000
CN0805700000000,08,057,"Jackson County, CO",May-22,1029,1009,20,1.90000000
CN0805900000000,08,059,"Jefferson County, CO",May-22,343102,333629,9473,2.80000000
CN0806100000000,08,061,"Kiowa County, CO",May-22,938,923,15,1.60000000
CN0806300000000,08,063,"Kit Carson County, CO",May-22,4266,4192,74,1.70000000
CN0806500000000,08,065,"Lake County, CO",May-22,4894,4771,123,2.50000000
CN0806700000000,08,067,"La Plata County, CO",May-22,32626,31745,881,2.70000000
CN0806900000000,08,069,"Larimer County, CO",May-22,211319,205880,5439,2.60000000
CN0807100000000,08,071,"Las Animas County, CO",May-22,6582,6295,287,4.40000000
CN0807300000000,08,073,"Lincoln County, CO",May-22,2357,2301,56,2.40000000
CN0807500000000,08,075,"Logan County, CO",May-22,10897,10625,272,2.50000000
CN0807700000000,08,077,"Mesa County, CO",May-22,78598,76038,2560,3.30000000
CN0807900000000,08,079,"Mineral County, CO",May-22,403,392,11,2.70000000
CN0808100000000,08,081,"Moffat County, CO",May-22,7179,6989,190,2.60000000
CN0808300000000,08,083,"Montezuma County, CO",May-22,13761,13319,442,3.20000000
CN0808500000000,08,085,"Montrose County, CO",May-22,23008,22326,682,3.00000000
CN0808700000000,08,087,"Morgan County, CO",May-22,16252,15738,514,3.20000000
CN0808900000000,08,089,"Otero County, CO",May-22,8374,8041,333,4.00000000
CN0809100000000,08,091,"Ouray County, CO",May-22,2875,2794,81,2.80000000
CN0809300000000,08,093,"Park County, CO",May-22,11591,11316,275,2.40000000
CN0809500000000,08,095,"Phillips County, CO",May-22,2527,2482,45,1.80000000
CN0809700000000,08,097,"Pitkin County, CO",May-22,10861,10395,466,4.30000000
CN0809900000000,08,099,"Prowers County, CO",May-22,6360,6189,171,2.70000000
CN0810100000000,08,101,"Pueblo County, CO",May-22,78845,74928,3917,5.00000000
CN0810300000000,08,103,"Rio Blanco County, CO",May-22,2927,2820,107,3.70000000
CN0810500000000,08,105,"Rio Grande County, CO",May-22,5623,5402,221,3.90000000
CN0810700000000,08,107,"Routt County, CO",May-22,15191,14777,414,2.70000000
CN0810900000000,08,109,"Saguache County, CO",May-22,3602,3480,122,3.40000000
CN0811100000000,08,111,"San Juan County, CO",May-22,617,604,13,2.10000000
CN0811300000000,08,113,"San Miguel County, CO",May-22,5462,5206,256,4.70000000
CN0811500000000,08,115,"Sedgwick County, CO",May-22,1200,1176,24,2.00000000
CN0811700000000,08,117,"Summit County, CO",May-22,21521,21028,493,2.30000000
CN0811900000000,08,119,"Teller County, CO",May-22,13330,12937,393,2.90000000
CN0812100000000,08,121,"Washington County, CO",May-22,2782,2720,62,2.20000000
CN0812300000000,08,123,"Weld County, CO",May-22,169105,163535,5570,3.30000000
CN0812500000000,08,125,"Yuma County, CO",May-22,5824,5721,103,1.80000000
CN0900100000000,09,001,"Fairfield County, CT",May-22,479714,460867,18847,3.90000000
CN0900300000000,09,003,"Hartford County, CT",May-22,478263,458894,19369,4.00000000
CN0900500000000,09,005,"Litchfield County, CT",May-22,104479,100906,3573,3.40000000
CN0900700000000,09,007,"Middlesex County, CT",May-22,93475,90449,3026,3.20000000
CN0900900000000,09,009,"New Haven County, CT",May-22,463431,444114,19317,4.20000000
CN0901100000000,09,011,"New London County, CT",May-22,133161,127449,5712,4.30000000
CN0901300000000,09,013,"Tolland County, CT",May-22,86237,83311,2926,3.40000000
CN0901500000000,09,015,"Windham County, CT",May-22,63623,61015,2608,4.10000000
CN1000100000000,10,001,"Kent County, DE",May-22,81112,77065,4047,5.00000000
CN1000300000000,10,003,"New Castle County, DE",May-22,304082,291293,12789,4.20000000
CN1000500000000,10,005,"Sussex County, DE",May-22,112493,108207,4286,3.80000000
CN1100100000000,11,001,District of Columbia,May-22,387666,370956,16710,4.30000000
CN1200100000000,12,001,"Alachua County, FL",May-22,139923,136660,3263,2.30000000
CN1200300000000,12,003,"Baker County, FL",May-22,12567,12284,283,2.30000000
CN1200500000000,12,005,"Bay County, FL",May-22,88207,86322,1885,2.10000000
CN1200700000000,12,007,"Bradford County, FL",May-22,10986,10710,276,2.50000000
CN1200900000000,12,009,"Brevard County, FL",May-22,295704,288763,6941,2.30000000
CN1201100000000,12,011,"Broward County, FL",May-22,1058964,1032153,26811,2.50000000
CN1201300000000,12,013,"Calhoun County, FL",May-22,4997,4869,128,2.60000000
CN1201500000000,12,015,"Charlotte County, FL",May-22,75998,74026,1972,2.60000000
CN1201700000000,12,017,"Citrus County, FL",May-22,47881,46211,1670,3.50000000
CN1201900000000,12,019,"Clay County, FL",May-22,112175,109768,2407,2.10000000
CN1202100000000,12,021,"Collier County, FL",May-22,187845,183860,3985,2.10000000
CN1202300000000,12,023,"Columbia County, FL",May-22,29499,28701,798,2.70000000
CN1202700000000,12,027,"DeSoto County, FL",May-22,15847,15489,358,2.30000000
CN1202900000000,12,029,"Dixie County, FL",May-22,5996,5841,155,2.60000000
CN1203100000000,12,031,"Duval County, FL",May-22,509951,496924,13027,2.60000000
CN1203300000000,12,033,"Escambia County, FL",May-22,149436,145636,3800,2.50000000
CN1203500000000,12,035,"Flagler County, FL",May-22,49718,48354,1364,2.70000000
CN1203700000000,12,037,"Franklin County, FL",May-22,4923,4821,102,2.10000000
CN1203900000000,12,039,"Gadsden County, FL",May-22,20276,19653,623,3.10000000
CN1204100000000,12,041,"Gilchrist County, FL",May-22,7270,7092,178,2.40000000
CN1204300000000,12,043,"Glades County, FL",May-22,5457,5326,131,2.40000000
CN1204500000000,12,045,"Gulf County, FL",May-22,5426,5321,105,1.90000000
CN1204700000000,12,047,"Hamilton County, FL",May-22,4124,3978,146,3.50000000
CN1204900000000,12,049,"Hardee County, FL",May-22,9137,8876,261,2.90000000
CN1205100000000,12,051,"Hendry County, FL",May-22,16784,16210,574,3.40000000
CN1205300000000,12,053,"Hernando County, FL",May-22,75967,73683,2284,3.00000000
CN1205500000000,12,055,"Highlands County, FL",May-22,34787,33540,1247,3.60000000
CN1205700000000,12,057,"Hillsborough County, FL",May-22,795747,777169,18578,2.30000000
CN1205900000000,12,059,"Holmes County, FL",May-22,7061,6884,177,2.50000000
CN1206100000000,12,061,"Indian River County, FL",May-22,66775,64830,1945,2.90000000
CN1206300000000,12,063,"Jackson County, FL",May-22,17320,16851,469,2.70000000
CN1206500000000,12,065,"Jefferson County, FL",May-22,5738,5584,154,2.70000000
CN1206700000000,12,067,"Lafayette County, FL",May-22,2826,2753,73,2.60000000
CN1206900000000,12,069,"Lake County, FL",May-22,166471,162150,4321,2.60000000
CN1207100000000,12,071,"Lee County, FL",May-22,370119,361401,8718,2.40000000
CN1207300000000,12,073,"Leon County, FL",May-22,157577,153610,3967,2.50000000
CN1207500000000,12,075,"Levy County, FL",May-22,17022,16553,469,2.80000000
CN1207700000000,12,077,"Liberty County, FL",May-22,2603,2535,68,2.60000000
CN1207900000000,12,079,"Madison County, FL",May-22,7893,7665,228,2.90000000
CN1208100000000,12,081,"Manatee County, FL",May-22,191985,187680,4305,2.20000000
CN1208300000000,12,083,"Marion County, FL",May-22,143994,139718,4276,3.00000000
CN1208500000000,12,085,"Martin County, FL",May-22,75891,74259,1632,2.20000000
CN1208600000000,12,086,"Miami-Dade County, FL",May-22,1362628,1328690,33938,2.50000000
CN1208700000000,12,087,"Monroe County, FL",May-22,49429,48685,744,1.50000000
CN1208900000000,12,089,"Nassau County, FL",May-22,44454,43574,880,2.00000000
CN1209100000000,12,091,"Okaloosa County, FL",May-22,102249,100237,2012,2.00000000
CN1209300000000,12,093,"Okeechobee County, FL",May-22,17837,17369,468,2.60000000
CN1209500000000,12,095,"Orange County, FL",May-22,769682,749249,20433,2.70000000
CN1209700000000,12,097,"Osceola County, FL",May-22,191969,185617,6352,3.30000000
CN1209900000000,12,099,"Palm Beach County, FL",May-22,763722,745327,18395,2.40000000
CN1210100000000,12,101,"Pasco County, FL",May-22,255305,248820,6485,2.50000000
CN1210300000000,12,103,"Pinellas County, FL",May-22,504223,493108,11115,2.20000000
CN1210500000000,12,105,"Polk County, FL",May-22,334710,324557,10153,3.00000000
CN1210700000000,12,107,"Putnam County, FL",May-22,27774,26778,996,3.60000000
CN1210900000000,12,109,"St. Johns County, FL",May-22,148474,145710,2764,1.90000000
CN1211100000000,12,111,"St. Lucie County, FL",May-22,154182,149748,4434,2.90000000
CN1211300000000,12,113,"Santa Rosa County, FL",May-22,87436,85582,1854,2.10000000
CN1211500000000,12,115,"Sarasota County, FL",May-22,201405,196963,4442,2.20000000
CN1211700000000,12,117,"Seminole County, FL",May-22,256023,250203,5820,2.30000000
CN1211900000000,12,119,"Sumter County, FL",May-22,35774,34570,1204,3.40000000
CN1212100000000,12,121,"Suwannee County, FL",May-22,17562,17083,479,2.70000000
CN1212300000000,12,123,"Taylor County, FL",May-22,8028,7806,222,2.80000000
CN1212500000000,12,125,"Union County, FL",May-22,4579,4477,102,2.20000000
CN1212700000000,12,127,"Volusia County, FL",May-22,262496,255603,6893,2.60000000
CN1212900000000,12,129,"Wakulla County, FL",May-22,15835,15514,321,2.00000000
CN1213100000000,12,131,"Walton County, FL",May-22,34764,34054,710,2.00000000
CN1213300000000,12,133,"Washington County, FL",May-22,9727,9467,260,2.70000000
CN1300100000000,13,001,"Appling County, GA",May-22,9315,9035,280,3.00000000
CN1300300000000,13,003,"Atkinson County, GA",May-22,4674,4572,102,2.20000000
CN1300500000000,13,005,"Bacon County, GA",May-22,4931,4810,121,2.50000000
CN1300700000000,13,007,"Baker County, GA",May-22,1183,1143,40,3.40000000
CN1300900000000,13,009,"Baldwin County, GA",May-22,17576,16960,616,3.50000000
CN1301100000000,13,011,"Banks County, GA",May-22,10251,10041,210,2.00000000
CN1301300000000,13,013,"Barrow County, GA",May-22,43278,42344,934,2.20000000
CN1301500000000,13,015,"Bartow County, GA",May-22,52575,51262,1313,2.50000000
CN1301700000000,13,017,"Ben Hill County, GA",May-22,5526,5325,201,3.60000000
CN1301900000000,13,019,"Berrien County, GA",May-22,7737,7525,212,2.70000000
CN1302100000000,13,021,"Bibb County, GA",May-22,67875,65636,2239,3.30000000
CN1302300000000,13,023,"Bleckley County, GA",May-22,4614,4442,172,3.70000000
CN1302500000000,13,025,"Brantley County, GA",May-22,7491,7270,221,3.00000000
CN1302700000000,13,027,"Brooks County, GA",May-22,6930,6748,182,2.60000000
CN1302900000000,13,029,"Bryan County, GA",May-22,20360,19903,457,2.20000000
CN1303100000000,13,031,"Bulloch County, GA",May-22,37897,36734,1163,3.10000000
CN1303300000000,13,033,"Burke County, GA",May-22,9234,8792,442,4.80000000
CN1303500000000,13,035,"Butts County, GA",May-22,11402,11121,281,2.50000000
CN1303700000000,13,037,"Calhoun County, GA",May-22,2325,2265,60,2.60000000
CN1303900000000,13,039,"Camden County, GA",May-22,21646,21070,576,2.70000000
CN1304300000000,13,043,"Candler County, GA",May-22,6209,6078,131,2.10000000
CN1304500000000,13,045,"Carroll County, GA",May-22,57598,56041,1557,2.70000000
CN1304700000000,13,047,"Catoosa County, GA",May-22,33399,32641,758,2.30000000
CN1304900000000,13,049,"Charlton County, GA",May-22,4977,4840,137,2.80000000
CN1305100000000,13,051,"Chatham County, GA",May-22,145683,141653,4030,2.80000000
CN1305300000000,13,053,"Chattahoochee County, GA",May-22,1948,1870,78,4.00000000
CN1305500000000,13,055,"Chattooga County, GA",May-22,9304,8987,317,3.40000000
CN1305700000000,13,057,"Cherokee County, GA",May-22,143428,140491,2937,2.00000000
CN1305900000000,13,059,"Clarke County, GA",May-22,60926,59259,1667,2.70000000
CN1306100000000,13,061,"Clay County, GA",May-22,880,819,61,6.90000000
CN1306300000000,13,063,"Clayton County, GA",May-22,141504,135759,5745,4.10000000
CN1306500000000,13,065,"Clinch County, GA",May-22,3193,3118,75,2.30000000
CN1306700000000,13,067,"Cobb County, GA",May-22,433455,423557,9898,2.30000000
CN1306900000000,13,069,"Coffee County, GA",May-22,18461,17896,565,3.10000000
CN1307100000000,13,071,"Colquitt County, GA",May-22,22688,22143,545,2.40000000
CN1307300000000,13,073,"Columbia County, GA",May-22,77118,75286,1832,2.40000000
CN1307500000000,13,075,"Cook County, GA",May-22,8322,8091,231,2.80000000
CN1307700000000,13,077,"Coweta County, GA",May-22,78131,76283,1848,2.40000000
CN1307900000000,13,079,"Crawford County, GA",May-22,5598,5451,147,2.60000000
CN1308100000000,13,081,"Crisp County, GA",May-22,9421,9005,416,4.40000000
CN1308300000000,13,083,"Dade County, GA",May-22,8071,7891,180,2.20000000
CN1308500000000,13,085,"Dawson County, GA",May-22,13530,13238,292,2.20000000
CN1308700000000,13,087,"Decatur County, GA",May-22,11511,11183,328,2.80000000
CN1308900000000,13,089,"DeKalb County, GA",May-22,407128,395369,11759,2.90000000
CN1309100000000,13,091,"Dodge County, GA",May-22,7034,6790,244,3.50000000
CN1309300000000,13,093,"Dooly County, GA",May-22,4787,4604,183,3.80000000
CN1309500000000,13,095,"Dougherty County, GA",May-22,37002,35502,1500,4.10000000
CN1309700000000,13,097,"Douglas County, GA",May-22,75421,73226,2195,2.90000000
CN1309900000000,13,099,"Early County, GA",May-22,4281,4136,145,3.40000000
CN1310100000000,13,101,"Echols County, GA",May-22,1965,1922,43,2.20000000
CN1310300000000,13,103,"Effingham County, GA",May-22,34009,33251,758,2.20000000
CN1310500000000,13,105,"Elbert County, GA",May-22,7742,7481,261,3.40000000
CN1310700000000,13,107,"Emanuel County, GA",May-22,8742,8432,310,3.50000000
CN1310900000000,13,109,"Evans County, GA",May-22,5213,5079,134,2.60000000
CN1311100000000,13,111,"Fannin County, GA",May-22,11951,11674,277,2.30000000
CN1311300000000,13,113,"Fayette County, GA",May-22,59818,58452,1366,2.30000000
CN1311500000000,13,115,"Floyd County, GA",May-22,43774,42563,1211,2.80000000
CN1311700000000,13,117,"Forsyth County, GA",May-22,130926,128271,2655,2.00000000
CN1311900000000,13,119,"Franklin County, GA",May-22,10140,9860,280,2.80000000
CN1312100000000,13,121,"Fulton County, GA",May-22,578547,561707,16840,2.90000000
CN1312300000000,13,123,"Gilmer County, GA",May-22,12375,12042,333,2.70000000
CN1312500000000,13,125,"Glascock County, GA",May-22,1289,1258,31,2.40000000
CN1312700000000,13,127,"Glynn County, GA",May-22,39736,38642,1094,2.80000000
CN1312900000000,13,129,"Gordon County, GA",May-22,29091,28325,766,2.60000000
CN1313100000000,13,131,"Grady County, GA",May-22,11259,10974,285,2.50000000
CN1313300000000,13,133,"Greene County, GA",May-22,7299,7097,202,2.80000000
CN1313500000000,13,135,"Gwinnett County, GA",May-22,503615,491522,12093,2.40000000
CN1313700000000,13,137,"Habersham County, GA",May-22,18650,18145,505,2.70000000
CN1313900000000,13,139,"Hall County, GA",May-22,106327,104103,2224,2.10000000
CN1314100000000,13,141,"Hancock County, GA",May-22,2554,2437,117,4.60000000
CN1314300000000,13,143,"Haralson County, GA",May-22,13082,12736,346,2.60000000
CN1314500000000,13,145,"Harris County, GA",May-22,17113,16717,396,2.30000000
CN1314700000000,13,147,"Hart County, GA",May-22,11922,11602,320,2.70000000
CN1314900000000,13,149,"Heard County, GA",May-22,5366,5229,137,2.60000000
CN1315100000000,13,151,"Henry County, GA",May-22,121124,117694,3430,2.80000000
CN1315300000000,13,153,"Houston County, GA",May-22,71343,69460,1883,2.60000000
CN1315500000000,13,155,"Irwin County, GA",May-22,3614,3496,118,3.30000000
CN1315700000000,13,157,"Jackson County, GA",May-22,43519,42681,838,1.90000000
CN1315900000000,13,159,"Jasper County, GA",May-22,7269,7106,163,2.20000000
CN1316100000000,13,161,"Jeff Davis County, GA",May-22,6274,6090,184,2.90000000
CN1316300000000,13,163,"Jefferson County, GA",May-22,7071,6827,244,3.50000000
CN1316500000000,13,165,"Jenkins County, GA",May-22,3174,3053,121,3.80000000
CN1316700000000,13,167,"Johnson County, GA",May-22,4088,3987,101,2.50000000
CN1316900000000,13,169,"Jones County, GA",May-22,13852,13510,342,2.50000000
CN1317100000000,13,171,"Lamar County, GA",May-22,8425,8181,244,2.90000000
CN1317300000000,13,173,"Lanier County, GA",May-22,3832,3721,111,2.90000000
CN1317500000000,13,175,"Laurens County, GA",May-22,19397,18776,621,3.20000000
CN1317700000000,13,177,"Lee County, GA",May-22,15247,14884,363,2.40000000
CN1317900000000,13,179,"Liberty County, GA",May-22,26153,25390,763,2.90000000
CN1318100000000,13,181,"Lincoln County, GA",May-22,3610,3502,108,3.00000000
CN1318300000000,13,183,"Long County, GA",May-22,8558,8324,234,2.70000000
CN1318500000000,13,185,"Lowndes County, GA",May-22,51046,49590,1456,2.90000000
CN1318700000000,13,187,"Lumpkin County, GA",May-22,17543,17151,392,2.20000000
CN1318900000000,13,189,"McDuffie County, GA",May-22,8536,8206,330,3.90000000
CN1319100000000,13,191,"McIntosh County, GA",May-22,6296,6114,182,2.90000000
CN1319300000000,13,193,"Macon County, GA",May-22,4644,4479,165,3.60000000
CN1319500000000,13,195,"Madison County, GA",May-22,14068,13732,336,2.40000000
CN1319700000000,13,197,"Marion County, GA",May-22,3304,3208,96,2.90000000
CN1319900000000,13,199,"Meriwether County, GA",May-22,9072,8759,313,3.50000000
CN1320100000000,13,201,"Miller County, GA",May-22,2829,2760,69,2.40000000
CN1320500000000,13,205,"Mitchell County, GA",May-22,8176,7894,282,3.40000000
CN1320700000000,13,207,"Monroe County, GA",May-22,13309,12994,315,2.40000000
CN1320900000000,13,209,"Montgomery County, GA",May-22,3808,3681,127,3.30000000
CN1321100000000,13,211,"Morgan County, GA",May-22,9835,9605,230,2.30000000
CN1321300000000,13,213,"Murray County, GA",May-22,15442,14915,527,3.40000000
CN1321500000000,13,215,"Muscogee County, GA",May-22,76544,73695,2849,3.70000000
CN1321700000000,13,217,"Newton County, GA",May-22,54513,52907,1606,2.90000000
CN1321900000000,13,219,"Oconee County, GA",May-22,21074,20668,406,1.90000000
CN1322100000000,13,221,"Oglethorpe County, GA",May-22,7321,7156,165,2.30000000
CN1322300000000,13,223,"Paulding County, GA",May-22,91857,89756,2101,2.30000000
CN1322500000000,13,225,"Peach County, GA",May-22,12045,11658,387,3.20000000
CN1322700000000,13,227,"Pickens County, GA",May-22,15988,15628,360,2.30000000
CN1322900000000,13,229,"Pierce County, GA",May-22,8639,8423,216,2.50000000
CN1323100000000,13,231,"Pike County, GA",May-22,9260,9053,207,2.20000000
CN1323300000000,13,233,"Polk County, GA",May-22,18398,17911,487,2.60000000
CN1323500000000,13,235,"Pulaski County, GA",May-22,4084,3964,120,2.90000000
CN1323700000000,13,237,"Putnam County, GA",May-22,8749,8475,274,3.10000000
CN1323900000000,13,239,"Quitman County, GA",May-22,756,726,30,4.00000000
CN1324100000000,13,241,"Rabun County, GA",May-22,7574,7377,197,2.60000000
CN1324300000000,13,243,"Randolph County, GA",May-22,2415,2320,95,3.90000000
CN1324500000000,13,245,"Richmond County, GA",May-22,83954,80757,3197,3.80000000
CN1324700000000,13,247,"Rockdale County, GA",May-22,45403,44014,1389,3.10000000
CN1324900000000,13,249,"Schley County, GA",May-22,2133,2063,70,3.30000000
CN1325100000000,13,251,"Screven County, GA",May-22,4998,4807,191,3.80000000
CN1325300000000,13,253,"Seminole County, GA",May-22,3078,2986,92,3.00000000
CN1325500000000,13,255,"Spalding County, GA",May-22,29493,28623,870,2.90000000
CN1325700000000,13,257,"Stephens County, GA",May-22,10398,10083,315,3.00000000
CN1325900000000,13,259,"Stewart County, GA",May-22,2576,2497,79,3.10000000
CN1326100000000,13,261,"Sumter County, GA",May-22,12168,11705,463,3.80000000
CN1326300000000,13,263,"Talbot County, GA",May-22,2807,2722,85,3.00000000
CN1326500000000,13,265,"Taliaferro County, GA",May-22,538,520,18,3.30000000
CN1326700000000,13,267,"Tattnall County, GA",May-22,9901,9651,250,2.50000000
CN1326900000000,13,269,"Taylor County, GA",May-22,2892,2784,108,3.70000000
CN1327100000000,13,271,"Telfair County, GA",May-22,3679,3488,191,5.20000000
CN1327300000000,13,273,"Terrell County, GA",May-22,3551,3400,151,4.30000000
CN1327500000000,13,275,"Thomas County, GA",May-22,17435,16892,543,3.10000000
CN1327700000000,13,277,"Tift County, GA",May-22,21479,20975,504,2.30000000
CN1327900000000,13,279,"Toombs County, GA",May-22,11963,11573,390,3.30000000
CN1328100000000,13,281,"Towns County, GA",May-22,4171,4025,146,3.50000000
CN1328300000000,13,283,"Treutlen County, GA",May-22,2615,2529,86,3.30000000
CN1328500000000,13,285,"Troup County, GA",May-22,37285,36307,978,2.60000000
CN1328700000000,13,287,"Turner County, GA",May-22,3276,3151,125,3.80000000
CN1328900000000,13,289,"Twiggs County, GA",May-22,2823,2716,107,3.80000000
CN1329100000000,13,291,"Union County, GA",May-22,11428,11170,258,2.30000000
CN1329300000000,13,293,"Upson County, GA",May-22,11737,11425,312,2.70000000
CN1329500000000,13,295,"Walker County, GA",May-22,31247,30468,779,2.50000000
CN1329700000000,13,297,"Walton County, GA",May-22,48249,47073,1176,2.40000000
CN1329900000000,13,299,"Ware County, GA",May-22,15325,14926,399,2.60000000
CN1330100000000,13,301,"Warren County, GA",May-22,2653,2567,86,3.20000000
CN1330300000000,13,303,"Washington County, GA",May-22,6679,6430,249,3.70000000
CN1330500000000,13,305,"Wayne County, GA",May-22,11985,11656,329,2.70000000
CN1330700000000,13,307,"Webster County, GA",May-22,988,955,33,3.30000000
CN1330900000000,13,309,"Wheeler County, GA",May-22,1668,1594,74,4.40000000
CN1331100000000,13,311,"White County, GA",May-22,16587,16244,343,2.10000000
CN1331300000000,13,313,"Whitfield County, GA",May-22,43377,41827,1550,3.60000000
CN1331500000000,13,315,"Wilcox County, GA",May-22,2771,2682,89,3.20000000
CN1331700000000,13,317,"Wilkes County, GA",May-22,3724,3591,133,3.60000000
CN1331900000000,13,319,"Wilkinson County, GA",May-22,3652,3538,114,3.10000000
CN1332100000000,13,321,"Worth County, GA",May-22,8944,8710,234,2.60000000
CN1500100000000,15,001,"Hawaii County, HI",May-22,93076,89769,3307,3.60000000
CN1500300000000,15,003,"Honolulu County/city, HI",May-22,455169,439796,15373,3.40000000
CN1500700000000,15,007,"Kauai County, HI",May-22,36252,34653,1599,4.40000000
CN1500900000000,15,009,"Maui County, HI",May-22,86556,82925,3631,4.20000000
CN1600100000000,16,001,"Ada County, ID",May-22,277349,271713,5636,2.00000000
CN1600300000000,16,003,"Adams County, ID",May-22,1832,1725,107,5.80000000
CN1600500000000,16,005,"Bannock County, ID",May-22,44816,43769,1047,2.30000000
CN1600700000000,16,007,"Bear Lake County, ID",May-22,3345,3268,77,2.30000000
CN1600900000000,16,009,"Benewah County, ID",May-22,4143,3974,169,4.10000000
CN1601100000000,16,011,"Bingham County, ID",May-22,25286,24750,536,2.10000000
CN1601300000000,16,013,"Blaine County, ID",May-22,12836,12528,308,2.40000000
CN1601500000000,16,015,"Boise County, ID",May-22,3865,3721,144,3.70000000
CN1601700000000,16,017,"Bonner County, ID",May-22,22285,21577,708,3.20000000
CN1601900000000,16,019,"Bonneville County, ID",May-22,63487,62232,1255,2.00000000
CN1602100000000,16,021,"Boundary County, ID",May-22,5928,5733,195,3.30000000
CN1602300000000,16,023,"Butte County, ID",May-22,1529,1489,40,2.60000000
CN1602500000000,16,025,"Camas County, ID",May-22,714,697,17,2.40000000
CN1602700000000,16,027,"Canyon County, ID",May-22,113955,111097,2858,2.50000000
CN1602900000000,16,029,"Caribou County, ID",May-22,4327,4225,102,2.40000000
CN1603100000000,16,031,"Cassia County, ID",May-22,13039,12753,286,2.20000000
CN1603300000000,16,033,"Clark County, ID",May-22,402,391,11,2.70000000
CN1603500000000,16,035,"Clearwater County, ID",May-22,3047,2903,144,4.70000000
CN1603700000000,16,037,"Custer County, ID",May-22,2325,2255,70,3.00000000
CN1603900000000,16,039,"Elmore County, ID",May-22,12457,12141,316,2.50000000
CN1604100000000,16,041,"Franklin County, ID",May-22,7785,7652,133,1.70000000
CN1604300000000,16,043,"Fremont County, ID",May-22,8757,8579,178,2.00000000
CN1604500000000,16,045,"Gem County, ID",May-22,9040,8791,249,2.80000000
CN1604700000000,16,047,"Gooding County, ID",May-22,8597,8419,178,2.10000000
CN1604900000000,16,049,"Idaho County, ID",May-22,7092,6828,264,3.70000000
CN1605100000000,16,051,"Jefferson County, ID",May-22,15447,15175,272,1.80000000
CN1605300000000,16,053,"Jerome County, ID",May-22,12949,12668,281,2.20000000
CN1605500000000,16,055,"Kootenai County, ID",May-22,86779,84487,2292,2.60000000
CN1605700000000,16,057,"Latah County, ID",May-22,21086,20633,453,2.10000000
CN1605900000000,16,059,"Lemhi County, ID",May-22,3849,3715,134,3.50000000
CN1606100000000,16,061,"Lewis County, ID",May-22,1731,1670,61,3.50000000
CN1606300000000,16,063,"Lincoln County, ID",May-22,2689,2609,80,3.00000000
CN1606500000000,16,065,"Madison County, ID",May-22,24838,24479,359,1.40000000
CN1606700000000,16,067,"Minidoka County, ID",May-22,12278,12014,264,2.20000000
CN1606900000000,16,069,"Nez Perce County, ID",May-22,21730,21269,461,2.10000000
CN1607100000000,16,071,"Oneida County, ID",May-22,2828,2784,44,1.60000000
CN1607300000000,16,073,"Owyhee County, ID",May-22,5831,5664,167,2.90000000
CN1607500000000,16,075,"Payette County, ID",May-22,12378,12052,326,2.60000000
CN1607700000000,16,077,"Power County, ID",May-22,4316,4202,114,2.60000000
CN1607900000000,16,079,"Shoshone County, ID",May-22,5436,5174,262,4.80000000
CN1608100000000,16,081,"Teton County, ID",May-22,7512,7318,194,2.60000000
CN1608300000000,16,083,"Twin Falls County, ID",May-22,43948,42944,1004,2.30000000
CN1608500000000,16,085,"Valley County, ID",May-22,5737,5514,223,3.90000000
CN1608700000000,16,087,"Washington County, ID",May-22,4937,4801,136,2.80000000
CN1700100000000,17,001,"Adams County, IL",May-22,30291,29189,1102,3.60000000
CN1700300000000,17,003,"Alexander County, IL",May-22,1817,1670,147,8.10000000
CN1700500000000,17,005,"Bond County, IL",May-22,7378,7079,299,4.10000000
CN1700700000000,17,007,"Boone County, IL",May-22,25253,23125,2128,8.40000000
CN1700900000000,17,009,"Brown County, IL",May-22,3084,3006,78,2.50000000
CN1701100000000,17,011,"Bureau County, IL",May-22,16223,15444,779,4.80000000
CN1701300000000,17,013,"Calhoun County, IL",May-22,2151,2058,93,4.30000000
CN1701500000000,17,015,"Carroll County, IL",May-22,7454,7174,280,3.80000000
CN1701700000000,17,017,"Cass County, IL",May-22,5540,5275,265,4.80000000
CN1701900000000,17,019,"Champaign County, IL",May-22,108792,104050,4742,4.40000000
CN1702100000000,17,021,"Christian County, IL",May-22,13256,12477,779,5.90000000
CN1702300000000,17,023,"Clark County, IL",May-22,7114,6793,321,4.50000000
CN1702500000000,17,025,"Clay County, IL",May-22,5742,5459,283,4.90000000
CN1702700000000,17,027,"Clinton County, IL",May-22,19679,19052,627,3.20000000
CN1702900000000,17,029,"Coles County, IL",May-22,21530,20450,1080,5.00000000
CN1703100000000,17,031,"Cook County, IL",May-22,2653052,2529920,123132,4.60000000
CN1703300000000,17,033,"Crawford County, IL",May-22,8446,8054,392,4.60000000
CN1703500000000,17,035,"Cumberland County, IL",May-22,5868,5662,206,3.50000000
CN1703700000000,17,037,"DeKalb County, IL",May-22,53560,50900,2660,5.00000000
CN1703900000000,17,039,"De Witt County, IL",May-22,7163,6856,307,4.30000000
CN1704100000000,17,041,"Douglas County, IL",May-22,10097,9731,366,3.60000000
CN1704300000000,17,043,"DuPage County, IL",May-22,515276,500569,14707,2.90000000
CN1704500000000,17,045,"Edgar County, IL",May-22,8867,8524,343,3.90000000
CN1704700000000,17,047,"Edwards County, IL",May-22,2476,2354,122,4.90000000
CN1704900000000,17,049,"Effingham County, IL",May-22,19514,18900,614,3.10000000
CN1705100000000,17,051,"Fayette County, IL",May-22,9790,9342,448,4.60000000
CN1705300000000,17,053,"Ford County, IL",May-22,6218,5953,265,4.30000000
CN1705500000000,17,055,"Franklin County, IL",May-22,15553,14581,972,6.20000000
CN1705700000000,17,057,"Fulton County, IL",May-22,14331,13589,742,5.20000000
CN1705900000000,17,059,"Gallatin County, IL",May-22,1970,1853,117,5.90000000
CN1706100000000,17,061,"Greene County, IL",May-22,5853,5602,251,4.30000000
CN1706300000000,17,063,"Grundy County, IL",May-22,25912,24960,952,3.70000000
CN1706500000000,17,065,"Hamilton County, IL",May-22,4253,4090,163,3.80000000
CN1706700000000,17,067,"Hancock County, IL",May-22,8089,7770,319,3.90000000
CN1706900000000,17,069,"Hardin County, IL",May-22,1323,1237,86,6.50000000
CN1707100000000,17,071,"Henderson County, IL",May-22,3525,3391,134,3.80000000
CN1707300000000,17,073,"Henry County, IL",May-22,24053,22948,1105,4.60000000
CN1707500000000,17,075,"Iroquois County, IL",May-22,12672,12101,571,4.50000000
CN1707700000000,17,077,"Jackson County, IL",May-22,26849,25508,1341,5.00000000
CN1707900000000,17,079,"Jasper County, IL",May-22,4814,4628,186,3.90000000
CN1708100000000,17,081,"Jefferson County, IL",May-22,16108,15194,914,5.70000000
CN1708300000000,17,083,"Jersey County, IL",May-22,10487,10077,410,3.90000000
CN1708500000000,17,085,"Jo Daviess County, IL",May-22,10598,10223,375,3.50000000
CN1708700000000,17,087,"Johnson County, IL",May-22,4185,3933,252,6.00000000
CN1708900000000,17,089,"Kane County, IL",May-22,262485,249111,13374,5.10000000
CN1709100000000,17,091,"Kankakee County, IL",May-22,52227,49004,3223,6.20000000
CN1709300000000,17,093,"Kendall County, IL",May-22,71742,69616,2126,3.00000000
CN1709500000000,17,095,"Knox County, IL",May-22,20257,19017,1240,6.10000000
CN1709700000000,17,097,"Lake County, IL",May-22,365792,349364,16428,4.50000000
CN1709900000000,17,099,"LaSalle County, IL",May-22,52174,49333,2841,5.40000000
CN1710100000000,17,101,"Lawrence County, IL",May-22,5509,5185,324,5.90000000
CN1710300000000,17,103,"Lee County, IL",May-22,16569,15841,728,4.40000000
CN1710500000000,17,105,"Livingston County, IL",May-22,15363,14697,666,4.30000000
CN1710700000000,17,107,"Logan County, IL",May-22,11685,11170,515,4.40000000
CN1710900000000,17,109,"McDonough County, IL",May-22,12811,12225,586,4.60000000
CN1711100000000,17,111,"McHenry County, IL",May-22,168064,162981,5083,3.00000000
CN1711300000000,17,113,"McLean County, IL",May-22,86865,83312,3553,4.10000000
CN1711500000000,17,115,"Macon County, IL",May-22,46601,43284,3317,7.10000000
CN1711700000000,17,117,"Macoupin County, IL",May-22,21887,20973,914,4.20000000
CN1711900000000,17,119,"Madison County, IL",May-22,130175,124499,5676,4.40000000
CN1712100000000,17,121,"Marion County, IL",May-22,16498,15583,915,5.50000000
CN1712300000000,17,123,"Marshall County, IL",May-22,5059,4789,270,5.30000000
CN1712500000000,17,125,"Mason County, IL",May-22,5815,5526,289,5.00000000
CN1712700000000,17,127,"Massac County, IL",May-22,5266,4973,293,5.60000000
CN1712900000000,17,129,"Menard County, IL",May-22,6186,5953,233,3.80000000
CN1713100000000,17,131,"Mercer County, IL",May-22,7620,7319,301,4.00000000
CN1713300000000,17,133,"Monroe County, IL",May-22,18473,17896,577,3.10000000
CN1713500000000,17,135,"Montgomery County, IL",May-22,11194,10625,569,5.10000000
CN1713700000000,17,137,"Morgan County, IL",May-22,15687,14980,707,4.50000000
CN1713900000000,17,139,"Moultrie County, IL",May-22,7321,7066,255,3.50000000
CN1714100000000,17,141,"Ogle County, IL",May-22,23544,22243,1301,5.50000000
CN1714300000000,17,143,"Peoria County, IL",May-22,82159,76723,5436,6.60000000
CN1714500000000,17,145,"Perry County, IL",May-22,7930,7485,445,5.60000000
CN1714700000000,17,147,"Piatt County, IL",May-22,8511,8200,311,3.70000000
CN1714900000000,17,149,"Pike County, IL",May-22,6756,6466,290,4.30000000
CN1715100000000,17,151,"Pope County, IL",May-22,1694,1612,82,4.80000000
CN1715300000000,17,153,"Pulaski County, IL",May-22,1685,1540,145,8.60000000
CN1715500000000,17,155,"Putnam County, IL",May-22,2929,2781,148,5.10000000
CN1715700000000,17,157,"Randolph County, IL",May-22,13567,13033,534,3.90000000
CN1715900000000,17,159,"Richland County, IL",May-22,7078,6784,294,4.20000000
CN1716100000000,17,161,"Rock Island County, IL",May-22,68568,65331,3237,4.70000000
CN1716300000000,17,163,"St. Clair County, IL",May-22,122946,116287,6659,5.40000000
CN1716500000000,17,165,"Saline County, IL",May-22,9148,8579,569,6.20000000
CN1716700000000,17,167,"Sangamon County, IL",May-22,98170,93483,4687,4.80000000
CN1716900000000,17,169,"Schuyler County, IL",May-22,3282,3159,123,3.70000000
CN1717100000000,17,171,"Scott County, IL",May-22,2274,2172,102,4.50000000
CN1717300000000,17,173,"Shelby County, IL",May-22,10347,9892,455,4.40000000
CN1717500000000,17,175,"Stark County, IL",May-22,2340,2225,115,4.90000000
CN1717700000000,17,177,"Stephenson County, IL",May-22,20486,19436,1050,5.10000000
CN1717900000000,17,179,"Tazewell County, IL",May-22,60996,58258,2738,4.50000000
CN1718100000000,17,181,"Union County, IL",May-22,7255,6865,390,5.40000000
CN1718300000000,17,183,"Vermilion County, IL",May-22,31292,29399,1893,6.00000000
CN1718500000000,17,185,"Wabash County, IL",May-22,5428,5203,225,4.10000000
CN1718700000000,17,187,"Warren County, IL",May-22,7511,7175,336,4.50000000
CN1718900000000,17,189,"Washington County, IL",May-22,9548,9287,261,2.70000000
CN1719100000000,17,191,"Wayne County, IL",May-22,6887,6595,292,4.20000000
CN1719300000000,17,193,"White County, IL",May-22,5945,5670,275,4.60000000
CN1719500000000,17,195,"Whiteside County, IL",May-22,27416,26210,1206,4.40000000
CN1719700000000,17,197,"Will County, IL",May-22,364836,351225,13611,3.70000000
CN1719900000000,17,199,"Williamson County, IL",May-22,30698,29174,1524,5.00000000
CN1720100000000,17,201,"Winnebago County, IL",May-22,134822,123683,11139,8.30000000
CN1720300000000,17,203,"Woodford County, IL",May-22,17912,17265,647,3.60000000
CN1800100000000,18,001,"Adams County, IN",May-22,16985,16674,311,1.80000000
CN1800300000000,18,003,"Allen County, IN",May-22,188589,184043,4546,2.40000000
CN1800500000000,18,005,"Bartholomew County, IN",May-22,43576,42683,893,2.00000000
CN1800700000000,18,007,"Benton County, IN",May-22,4429,4338,91,2.10000000
CN1800900000000,18,009,"Blackford County, IN",May-22,4651,4522,129,2.80000000
CN1801100000000,18,011,"Boone County, IN",May-22,37965,37301,664,1.70000000
CN1801300000000,18,013,"Brown County, IN",May-22,7727,7538,189,2.40000000
CN1801500000000,18,015,"Carroll County, IN",May-22,9906,9686,220,2.20000000
CN1801700000000,18,017,"Cass County, IN",May-22,17268,16832,436,2.50000000
CN1801900000000,18,019,"Clark County, IN",May-22,62833,61408,1425,2.30000000
CN1802100000000,18,021,"Clay County, IN",May-22,11775,11456,319,2.70000000
CN1802300000000,18,023,"Clinton County, IN",May-22,16977,16628,349,2.10000000
CN1802500000000,18,025,"Crawford County, IN",May-22,4800,4673,127,2.60000000
CN1802700000000,18,027,"Daviess County, IN",May-22,16543,16227,316,1.90000000
CN1802900000000,18,029,"Dearborn County, IN",May-22,25489,24927,562,2.20000000
CN1803100000000,18,031,"Decatur County, IN",May-22,14682,14366,316,2.20000000
CN1803300000000,18,033,"DeKalb County, IN",May-22,22184,21749,435,2.00000000
CN1803500000000,18,035,"Delaware County, IN",May-22,52720,51196,1524,2.90000000
CN1803700000000,18,037,"Dubois County, IN",May-22,22094,21690,404,1.80000000
CN1803900000000,18,039,"Elkhart County, IN",May-22,121331,119185,2146,1.80000000
CN1804100000000,18,041,"Fayette County, IN",May-22,8115,7808,307,3.80000000
CN1804300000000,18,043,"Floyd County, IN",May-22,42382,41483,899,2.10000000
CN1804500000000,18,045,"Fountain County, IN",May-22,7888,7714,174,2.20000000
CN1804700000000,18,047,"Franklin County, IN",May-22,11210,10959,251,2.20000000
CN1804900000000,18,049,"Fulton County, IN",May-22,9478,9245,233,2.50000000
CN1805100000000,18,051,"Gibson County, IN",May-22,19327,18960,367,1.90000000
CN1805300000000,18,053,"Grant County, IN",May-22,31541,30710,831,2.60000000
CN1805500000000,18,055,"Greene County, IN",May-22,13579,13207,372,2.70000000
CN1805700000000,18,057,"Hamilton County, IN",May-22,194144,190660,3484,1.80000000
CN1805900000000,18,059,"Hancock County, IN",May-22,42471,41571,900,2.10000000
CN1806100000000,18,061,"Harrison County, IN",May-22,20502,20071,431,2.10000000
CN1806300000000,18,063,"Hendricks County, IN",May-22,94618,92738,1880,2.00000000
CN1806500000000,18,065,"Henry County, IN",May-22,21888,21367,521,2.40000000
CN1806700000000,18,067,"Howard County, IN",May-22,33730,32339,1391,4.10000000
CN1806900000000,18,069,"Huntington County, IN",May-22,18130,17747,383,2.10000000
CN1807100000000,18,071,"Jackson County, IN",May-22,23054,22553,501,2.20000000
CN1807300000000,18,073,"Jasper County, IN",May-22,15937,15525,412,2.60000000
CN1807500000000,18,075,"Jay County, IN",May-22,8590,8384,206,2.40000000
CN1807700000000,18,077,"Jefferson County, IN",May-22,14882,14533,349,2.30000000
CN1807900000000,18,079,"Jennings County, IN",May-22,13451,13115,336,2.50000000
CN1808100000000,18,081,"Johnson County, IN",May-22,86397,84707,1690,2.00000000
CN1808300000000,18,083,"Knox County, IN",May-22,17923,17509,414,2.30000000
CN1808500000000,18,085,"Kosciusko County, IN",May-22,40568,39740,828,2.00000000
CN1808700000000,18,087,"LaGrange County, IN",May-22,21317,20954,363,1.70000000
CN1808900000000,18,089,"Lake County, IN",May-22,227396,217749,9647,4.20000000
CN1809100000000,18,091,"LaPorte County, IN",May-22,46599,45088,1511,3.20000000
CN1809300000000,18,093,"Lawrence County, IN",May-22,20816,20262,554,2.70000000
CN1809500000000,18,095,"Madison County, IN",May-22,59769,58145,1624,2.70000000
CN1809700000000,18,097,"Marion County, IN",May-22,504334,490218,14116,2.80000000
CN1809900000000,18,099,"Marshall County, IN",May-22,22701,22232,469,2.10000000
CN1810100000000,18,101,"Martin County, IN",May-22,5506,5393,113,2.10000000
CN1810300000000,18,103,"Miami County, IN",May-22,14529,14085,444,3.10000000
CN1810500000000,18,105,"Monroe County, IN",May-22,71392,69667,1725,2.40000000
CN1810700000000,18,107,"Montgomery County, IN",May-22,18655,18256,399,2.10000000
CN1810900000000,18,109,"Morgan County, IN",May-22,37027,36200,827,2.20000000
CN1811100000000,18,111,"Newton County, IN",May-22,6732,6542,190,2.80000000
CN1811300000000,18,113,"Noble County, IN",May-22,21455,20935,520,2.40000000
CN1811500000000,18,115,"Ohio County, IN",May-22,3150,3089,61,1.90000000
CN1811700000000,18,117,"Orange County, IN",May-22,8137,7894,243,3.00000000
CN1811900000000,18,119,"Owen County, IN",May-22,9402,9151,251,2.70000000
CN1812100000000,18,121,"Parke County, IN",May-22,7134,6958,176,2.50000000
CN1812300000000,18,123,"Perry County, IN",May-22,8763,8564,199,2.30000000
CN1812500000000,18,125,"Pike County, IN",May-22,5781,5642,139,2.40000000
CN1812700000000,18,127,"Porter County, IN",May-22,85454,83153,2301,2.70000000
CN1812900000000,18,129,"Posey County, IN",May-22,13104,12824,280,2.10000000
CN1813100000000,18,131,"Pulaski County, IN",May-22,6514,6366,148,2.30000000
CN1813300000000,18,133,"Putnam County, IN",May-22,16796,16380,416,2.50000000
CN1813500000000,18,135,"Randolph County, IN",May-22,12506,12238,268,2.10000000
CN1813700000000,18,137,"Ripley County, IN",May-22,13295,12987,308,2.30000000
CN1813900000000,18,139,"Rush County, IN",May-22,8973,8785,188,2.10000000
CN1814100000000,18,141,"St. Joseph County, IN",May-22,132766,129143,3623,2.70000000
CN1814300000000,18,143,"Scott County, IN",May-22,10586,10284,302,2.90000000
CN1814500000000,18,145,"Shelby County, IN",May-22,23590,23073,517,2.20000000
CN1814700000000,18,147,"Spencer County, IN",May-22,10811,10579,232,2.10000000
CN1814900000000,18,149,"Starke County, IN",May-22,9516,9236,280,2.90000000
CN1815100000000,18,151,"Steuben County, IN",May-22,20108,19749,359,1.80000000
CN1815300000000,18,153,"Sullivan County, IN",May-22,8095,7861,234,2.90000000
CN1815500000000,18,155,"Switzerland County, IN",May-22,4533,4413,120,2.60000000
CN1815700000000,18,157,"Tippecanoe County, IN",May-22,96937,94579,2358,2.40000000
CN1815900000000,18,159,"Tipton County, IN",May-22,9014,8819,195,2.20000000
CN1816100000000,18,161,"Union County, IN",May-22,3542,3469,73,2.10000000
CN1816300000000,18,163,"Vanderburgh County, IN",May-22,92768,90418,2350,2.50000000
CN1816500000000,18,165,"Vermillion County, IN",May-22,6656,6457,199,3.00000000
CN1816700000000,18,167,"Vigo County, IN",May-22,46410,45020,1390,3.00000000
CN1816900000000,18,169,"Wabash County, IN",May-22,14672,14343,329,2.20000000
CN1817100000000,18,171,"Warren County, IN",May-22,4141,4053,88,2.10000000
CN1817300000000,18,173,"Warrick County, IN",May-22,32431,31741,690,2.10000000
CN1817500000000,18,175,"Washington County, IN",May-22,13824,13527,297,2.10000000
CN1817700000000,18,177,"Wayne County, IN",May-22,29404,28620,784,2.70000000
CN1817900000000,18,179,"Wells County, IN",May-22,14332,14060,272,1.90000000
CN1818100000000,18,181,"White County, IN",May-22,13355,13091,264,2.00000000
CN1818300000000,18,183,"Whitley County, IN",May-22,17845,17494,351,2.00000000
CN1900100000000,19,001,"Adair County, IA",May-22,4473,4405,68,1.50000000
CN1900300000000,19,003,"Adams County, IA",May-22,2039,2010,29,1.40000000
CN1900500000000,19,005,"Allamakee County, IA",May-22,7087,6918,169,2.40000000
CN1900700000000,19,007,"Appanoose County, IA",May-22,6072,5935,137,2.30000000
CN1900900000000,19,009,"Audubon County, IA",May-22,3079,3025,54,1.80000000
CN1901100000000,19,011,"Benton County, IA",May-22,12841,12543,298,2.30000000
CN1901300000000,19,013,"Black Hawk County, IA",May-22,68318,66634,1684,2.50000000
CN1901500000000,19,015,"Boone County, IA",May-22,14792,14516,276,1.90000000
CN1901700000000,19,017,"Bremer County, IA",May-22,14084,13835,249,1.80000000
CN1901900000000,19,019,"Buchanan County, IA",May-22,11272,11030,242,2.10000000
CN1902100000000,19,021,"Buena Vista County, IA",May-22,12095,11853,242,2.00000000
CN1902300000000,19,023,"Butler County, IA",May-22,8048,7880,168,2.10000000
CN1902500000000,19,025,"Calhoun County, IA",May-22,4105,4021,84,2.00000000
CN1902700000000,19,027,"Carroll County, IA",May-22,10770,10595,175,1.60000000
CN1902900000000,19,029,"Cass County, IA",May-22,6828,6697,131,1.90000000
CN1903100000000,19,031,"Cedar County, IA",May-22,10537,10332,205,1.90000000
CN1903300000000,19,033,"Cerro Gordo County, IA",May-22,22292,21782,510,2.30000000
CN1903500000000,19,035,"Cherokee County, IA",May-22,6116,6001,115,1.90000000
CN1903700000000,19,037,"Chickasaw County, IA",May-22,6500,6372,128,2.00000000
CN1903900000000,19,039,"Clarke County, IA",May-22,4845,4730,115,2.40000000
CN1904100000000,19,041,"Clay County, IA",May-22,8527,8344,183,2.10000000
CN1904300000000,19,043,"Clayton County, IA",May-22,9646,9409,237,2.50000000
CN1904500000000,19,045,"Clinton County, IA",May-22,22084,21427,657,3.00000000
CN1904700000000,19,047,"Crawford County, IA",May-22,7913,7667,246,3.10000000
CN1904900000000,19,049,"Dallas County, IA",May-22,53182,52318,864,1.60000000
CN1905100000000,19,051,"Davis County, IA",May-22,4235,4166,69,1.60000000
CN1905300000000,19,053,"Decatur County, IA",May-22,4388,4294,94,2.10000000
CN1905500000000,19,055,"Delaware County, IA",May-22,10617,10434,183,1.70000000
CN1905700000000,19,057,"Des Moines County, IA",May-22,17858,17128,730,4.10000000
CN1905900000000,19,059,"Dickinson County, IA",May-22,10731,10486,245,2.30000000
CN1906100000000,19,061,"Dubuque County, IA",May-22,55049,53804,1245,2.30000000
CN1906300000000,19,063,"Emmet County, IA",May-22,4992,4851,141,2.80000000
CN1906500000000,19,065,"Fayette County, IA",May-22,10168,9917,251,2.50000000
CN1906700000000,19,067,"Floyd County, IA",May-22,8201,8019,182,2.20000000
CN1906900000000,19,069,"Franklin County, IA",May-22,5626,5517,109,1.90000000
CN1907100000000,19,071,"Fremont County, IA",May-22,3708,3643,65,1.80000000
CN1907300000000,19,073,"Greene County, IA",May-22,5344,5248,96,1.80000000
CN1907500000000,19,075,"Grundy County, IA",May-22,6431,6309,122,1.90000000
CN1907700000000,19,077,"Guthrie County, IA",May-22,5555,5433,122,2.20000000
CN1907900000000,19,079,"Hamilton County, IA",May-22,6956,6786,170,2.40000000
CN1908100000000,19,081,"Hancock County, IA",May-22,5712,5603,109,1.90000000
CN1908300000000,19,083,"Hardin County, IA",May-22,7911,7730,181,2.30000000
CN1908500000000,19,085,"Harrison County, IA",May-22,7139,6985,154,2.20000000
CN1908700000000,19,087,"Henry County, IA",May-22,9614,9355,259,2.70000000
CN1908900000000,19,089,"Howard County, IA",May-22,5197,5087,110,2.10000000
CN1909100000000,19,091,"Humboldt County, IA",May-22,4953,4861,92,1.90000000
CN1909300000000,19,093,"Ida County, IA",May-22,3994,3935,59,1.50000000
CN1909500000000,19,095,"Iowa County, IA",May-22,9917,9729,188,1.90000000
CN1909700000000,19,097,"Jackson County, IA",May-22,10724,10456,268,2.50000000
CN1909900000000,19,099,"Jasper County, IA",May-22,18751,18316,435,2.30000000
CN1910100000000,19,101,"Jefferson County, IA",May-22,10087,9864,223,2.20000000
CN1910300000000,19,103,"Johnson County, IA",May-22,85836,84180,1656,1.90000000
CN1910500000000,19,105,"Jones County, IA",May-22,10174,9929,245,2.40000000
CN1910700000000,19,107,"Keokuk County, IA",May-22,5159,5043,116,2.20000000
CN1910900000000,19,109,"Kossuth County, IA",May-22,8220,8063,157,1.90000000
CN1911100000000,19,111,"Lee County, IA",May-22,15081,14555,526,3.50000000
CN1911300000000,19,113,"Linn County, IA",May-22,118557,115394,3163,2.70000000
CN1911500000000,19,115,"Louisa County, IA",May-22,5849,5706,143,2.40000000
CN1911700000000,19,117,"Lucas County, IA",May-22,4717,4636,81,1.70000000
CN1911900000000,19,119,"Lyon County, IA",May-22,7173,7076,97,1.40000000
CN1912100000000,19,121,"Madison County, IA",May-22,8610,8408,202,2.30000000
CN1912300000000,19,123,"Mahaska County, IA",May-22,12117,11881,236,1.90000000
CN1912500000000,19,125,"Marion County, IA",May-22,19158,18836,322,1.70000000
CN1912700000000,19,127,"Marshall County, IA",May-22,17039,16319,720,4.20000000
CN1912900000000,19,129,"Mills County, IA",May-22,7120,6990,130,1.80000000
CN1913100000000,19,131,"Mitchell County, IA",May-22,5797,5704,93,1.60000000
CN1913300000000,19,133,"Monona County, IA",May-22,4437,4338,99,2.20000000
CN1913500000000,19,135,"Monroe County, IA",May-22,3960,3879,81,2.00000000
CN1913700000000,19,137,"Montgomery County, IA",May-22,4939,4838,101,2.00000000
CN1913900000000,19,139,"Muscatine County, IA",May-22,20594,20072,522,2.50000000
CN1914100000000,19,141,"O'Brien County, IA",May-22,8236,8105,131,1.60000000
CN1914300000000,19,143,"Osceola County, IA",May-22,3690,3638,52,1.40000000
CN1914500000000,19,145,"Page County, IA",May-22,6384,6252,132,2.10000000
CN1914700000000,19,147,"Palo Alto County, IA",May-22,4547,4451,96,2.10000000
CN1914900000000,19,149,"Plymouth County, IA",May-22,14653,14425,228,1.60000000
CN1915100000000,19,151,"Pocahontas County, IA",May-22,4380,4308,72,1.60000000
CN1915300000000,19,153,"Polk County, IA",May-22,272343,266002,6341,2.30000000
CN1915500000000,19,155,"Pottawattamie County, IA",May-22,47739,46710,1029,2.20000000
CN1915700000000,19,157,"Poweshiek County, IA",May-22,10722,10498,224,2.10000000
CN1915900000000,19,159,"Ringgold County, IA",May-22,2419,2373,46,1.90000000
CN1916100000000,19,161,"Sac County, IA",May-22,5323,5230,93,1.70000000
CN1916300000000,19,163,"Scott County, IA",May-22,89636,87154,2482,2.80000000
CN1916500000000,19,165,"Shelby County, IA",May-22,6284,6174,110,1.80000000
CN1916700000000,19,167,"Sioux County, IA",May-22,22480,22188,292,1.30000000
CN1916900000000,19,169,"Story County, IA",May-22,59532,58560,972,1.60000000
CN1917100000000,19,171,"Tama County, IA",May-22,9154,8945,209,2.30000000
CN1917300000000,19,173,"Taylor County, IA",May-22,3127,3077,50,1.60000000
CN1917500000000,19,175,"Union County, IA",May-22,6133,5997,136,2.20000000
CN1917700000000,19,177,"Van Buren County, IA",May-22,3689,3604,85,2.30000000
CN1917900000000,19,179,"Wapello County, IA",May-22,16936,16496,440,2.60000000
CN1918100000000,19,181,"Warren County, IA",May-22,28865,28293,572,2.00000000
CN1918300000000,19,183,"Washington County, IA",May-22,11608,11380,228,2.00000000
CN1918500000000,19,185,"Wayne County, IA",May-22,2866,2811,55,1.90000000
CN1918700000000,19,187,"Webster County, IA",May-22,18399,17947,452,2.50000000
CN1918900000000,19,189,"Winnebago County, IA",May-22,4900,4781,119,2.40000000
CN1919100000000,19,191,"Winneshiek County, IA",May-22,11937,11679,258,2.20000000
CN1919300000000,19,193,"Woodbury County, IA",May-22,55403,54192,1211,2.20000000
CN1919500000000,19,195,"Worth County, IA",May-22,4005,3919,86,2.10000000
CN1919700000000,19,197,"Wright County, IA",May-22,6681,6536,145,2.20000000
CN2000100000000,20,001,"Allen County, KS",May-22,6657,6493,164,2.50000000
CN2000300000000,20,003,"Anderson County, KS",May-22,4750,4660,90,1.90000000
CN2000500000000,20,005,"Atchison County, KS",May-22,6645,6431,214,3.20000000
CN2000700000000,20,007,"Barber County, KS",May-22,2218,2176,42,1.90000000
CN2000900000000,20,009,"Barton County, KS",May-22,13083,12774,309,2.40000000
CN2001100000000,20,011,"Bourbon County, KS",May-22,6378,6185,193,3.00000000
CN2001300000000,20,013,"Brown County, KS",May-22,4979,4872,107,2.10000000
CN2001500000000,20,015,"Butler County, KS",May-22,32871,32039,832,2.50000000
CN2001700000000,20,017,"Chase County, KS",May-22,1353,1325,28,2.10000000
CN2001900000000,20,019,"Chautauqua County, KS",May-22,1378,1339,39,2.80000000
CN2002100000000,20,021,"Cherokee County, KS",May-22,9863,9642,221,2.20000000
CN2002300000000,20,023,"Cheyenne County, KS",May-22,1244,1218,26,2.10000000
CN2002500000000,20,025,"Clark County, KS",May-22,1101,1083,18,1.60000000
CN2002700000000,20,027,"Clay County, KS",May-22,3659,3578,81,2.20000000
CN2002900000000,20,029,"Cloud County, KS",May-22,3880,3792,88,2.30000000
CN2003100000000,20,031,"Coffey County, KS",May-22,3715,3597,118,3.20000000
CN2003300000000,20,033,"Comanche County, KS",May-22,886,871,15,1.70000000
CN2003500000000,20,035,"Cowley County, KS",May-22,16476,16040,436,2.60000000
CN2003700000000,20,037,"Crawford County, KS",May-22,18824,18338,486,2.60000000
CN2003900000000,20,039,"Decatur County, KS",May-22,1130,1104,26,2.30000000
CN2004100000000,20,041,"Dickinson County, KS",May-22,8981,8761,220,2.40000000
CN2004300000000,20,043,"Doniphan County, KS",May-22,4129,4041,88,2.10000000
CN2004500000000,20,045,"Douglas County, KS",May-22,66933,65394,1539,2.30000000
CN2004700000000,20,047,"Edwards County, KS",May-22,1415,1387,28,2.00000000
CN2004900000000,20,049,"Elk County, KS",May-22,1144,1118,26,2.30000000
CN2005100000000,20,051,"Ellis County, KS",May-22,16824,16539,285,1.70000000
CN2005300000000,20,053,"Ellsworth County, KS",May-22,2711,2660,51,1.90000000
CN2005500000000,20,055,"Finney County, KS",May-22,19764,19392,372,1.90000000
CN2005700000000,20,057,"Ford County, KS",May-22,17488,17148,340,1.90000000
CN2005900000000,20,059,"Franklin County, KS",May-22,14590,14248,342,2.30000000
CN2006100000000,20,061,"Geary County, KS",May-22,11286,10895,391,3.50000000
CN2006300000000,20,063,"Gove County, KS",May-22,1432,1407,25,1.70000000
CN2006500000000,20,065,"Graham County, KS",May-22,1108,1084,24,2.20000000
CN2006700000000,20,067,"Grant County, KS",May-22,2781,2713,68,2.40000000
CN2006900000000,20,069,"Gray County, KS",May-22,3125,3072,53,1.70000000
CN2007100000000,20,071,"Greeley County, KS",May-22,783,772,11,1.40000000
CN2007300000000,20,073,"Greenwood County, KS",May-22,2917,2849,68,2.30000000
CN2007500000000,20,075,"Hamilton County, KS",May-22,1546,1524,22,1.40000000
CN2007700000000,20,077,"Harper County, KS",May-22,2826,2772,54,1.90000000
CN2007900000000,20,079,"Harvey County, KS",May-22,17212,16781,431,2.50000000
CN2008100000000,20,081,"Haskell County, KS",May-22,2126,2091,35,1.60000000
CN2008300000000,20,083,"Hodgeman County, KS",May-22,995,977,18,1.80000000
CN2008500000000,20,085,"Jackson County, KS",May-22,7241,7089,152,2.10000000
CN2008700000000,20,087,"Jefferson County, KS",May-22,10328,10080,248,2.40000000
CN2008900000000,20,089,"Jewell County, KS",May-22,1193,1167,26,2.20000000
CN2009100000000,20,091,"Johnson County, KS",May-22,348705,341458,7247,2.10000000
CN2009300000000,20,093,"Kearny County, KS",May-22,2014,1979,35,1.70000000
CN2009500000000,20,095,"Kingman County, KS",May-22,3266,3195,71,2.20000000
CN2009700000000,20,097,"Kiowa County, KS",May-22,1178,1154,24,2.00000000
CN2009900000000,20,099,"Labette County, KS",May-22,9125,8870,255,2.80000000
CN2010100000000,20,101,"Lane County, KS",May-22,715,697,18,2.50000000
CN2010300000000,20,103,"Leavenworth County, KS",May-22,37262,36298,964,2.60000000
CN2010500000000,20,105,"Lincoln County, KS",May-22,1603,1563,40,2.50000000
CN2010700000000,20,107,"Linn County, KS",May-22,4363,4203,160,3.70000000
CN2010900000000,20,109,"Logan County, KS",May-22,1578,1553,25,1.60000000
CN2011100000000,20,111,"Lyon County, KS",May-22,16824,16448,376,2.20000000
CN2011300000000,20,113,"McPherson County, KS",May-22,17131,16818,313,1.80000000
CN2011500000000,20,115,"Marion County, KS",May-22,5931,5783,148,2.50000000
CN2011700000000,20,117,"Marshall County, KS",May-22,5279,5193,86,1.60000000
CN2011900000000,20,119,"Meade County, KS",May-22,2096,2061,35,1.70000000
CN2012100000000,20,121,"Miami County, KS",May-22,17962,17558,404,2.20000000
CN2012300000000,20,123,"Mitchell County, KS",May-22,3386,3326,60,1.80000000
CN2012500000000,20,125,"Montgomery County, KS",May-22,14507,14091,416,2.90000000
CN2012700000000,20,127,"Morris County, KS",May-22,2973,2905,68,2.30000000
CN2012900000000,20,129,"Morton County, KS",May-22,1080,1054,26,2.40000000
CN2013100000000,20,131,"Nemaha County, KS",May-22,5437,5349,88,1.60000000
CN2013300000000,20,133,"Neosho County, KS",May-22,6029,5829,200,3.30000000
CN2013500000000,20,135,"Ness County, KS",May-22,1283,1258,25,1.90000000
CN2013700000000,20,137,"Norton County, KS",May-22,2602,2557,45,1.70000000
CN2013900000000,20,139,"Osage County, KS",May-22,8016,7809,207,2.60000000
CN2014100000000,20,141,"Osborne County, KS",May-22,1912,1880,32,1.70000000
CN2014300000000,20,143,"Ottawa County, KS",May-22,2887,2822,65,2.30000000
CN2014500000000,20,145,"Pawnee County, KS",May-22,2711,2655,56,2.10000000
CN2014700000000,20,147,"Phillips County, KS",May-22,2579,2530,49,1.90000000
CN2014900000000,20,149,"Pottawatomie County, KS",May-22,12395,12131,264,2.10000000
CN2015100000000,20,151,"Pratt County, KS",May-22,4897,4804,93,1.90000000
CN2015300000000,20,153,"Rawlins County, KS",May-22,1601,1576,25,1.60000000
CN2015500000000,20,155,"Reno County, KS",May-22,29506,28729,777,2.60000000
CN2015700000000,20,157,"Republic County, KS",May-22,2273,2228,45,2.00000000
CN2015900000000,20,159,"Rice County, KS",May-22,5374,5263,111,2.10000000
CN2016100000000,20,161,"Riley County, KS",May-22,34231,33422,809,2.40000000
CN2016300000000,20,163,"Rooks County, KS",May-22,2363,2307,56,2.40000000
CN2016500000000,20,165,"Rush County, KS",May-22,1535,1506,29,1.90000000
CN2016700000000,20,167,"Russell County, KS",May-22,3297,3227,70,2.10000000
CN2016900000000,20,169,"Saline County, KS",May-22,28779,28122,657,2.30000000
CN2017100000000,20,171,"Scott County, KS",May-22,2711,2671,40,1.50000000
CN2017300000000,20,173,"Sedgwick County, KS",May-22,257482,249546,7936,3.10000000
CN2017500000000,20,175,"Seward County, KS",May-22,9709,9485,224,2.30000000
CN2017700000000,20,177,"Shawnee County, KS",May-22,91521,89237,2284,2.50000000
CN2017900000000,20,179,"Sheridan County, KS",May-22,1412,1386,26,1.80000000
CN2018100000000,20,181,"Sherman County, KS",May-22,2801,2744,57,2.00000000
CN2018300000000,20,183,"Smith County, KS",May-22,1947,1912,35,1.80000000
CN2018500000000,20,185,"Stafford County, KS",May-22,1947,1908,39,2.00000000
CN2018700000000,20,187,"Stanton County, KS",May-22,1119,1101,18,1.60000000
CN2018900000000,20,189,"Stevens County, KS",May-22,2883,2834,49,1.70000000
CN2019100000000,20,191,"Sumner County, KS",May-22,10792,10477,315,2.90000000
CN2019300000000,20,193,"Thomas County, KS",May-22,4155,4087,68,1.60000000
CN2019500000000,20,195,"Trego County, KS",May-22,1401,1372,29,2.10000000
CN2019700000000,20,197,"Wabaunsee County, KS",May-22,3688,3605,83,2.30000000
CN2019900000000,20,199,"Wallace County, KS",May-22,872,857,15,1.70000000
CN2020100000000,20,201,"Washington County, KS",May-22,2963,2913,50,1.70000000
CN2020300000000,20,203,"Wichita County, KS",May-22,1148,1129,19,1.70000000
CN2020500000000,20,205,"Wilson County, KS",May-22,3747,3634,113,3.00000000
CN2020700000000,20,207,"Woodson County, KS",May-22,1558,1507,51,3.30000000
CN2020900000000,20,209,"Wyandotte County, KS",May-22,77816,75332,2484,3.20000000
CN2100100000000,21,001,"Adair County, KY",May-22,7232,6948,284,3.90000000
CN2100300000000,21,003,"Allen County, KY",May-22,8863,8563,300,3.40000000
CN2100500000000,21,005,"Anderson County, KY",May-22,11893,11545,348,2.90000000
CN2100700000000,21,007,"Ballard County, KY",May-22,3426,3252,174,5.10000000
CN2100900000000,21,009,"Barren County, KY",May-22,17859,17175,684,3.80000000
CN2101100000000,21,011,"Bath County, KY",May-22,4653,4438,215,4.60000000
CN2101300000000,21,013,"Bell County, KY",May-22,8265,7880,385,4.70000000
CN2101500000000,21,015,"Boone County, KY",May-22,71884,69806,2078,2.90000000
CN2101700000000,21,017,"Bourbon County, KY",May-22,9435,9131,304,3.20000000
CN2101900000000,21,019,"Boyd County, KY",May-22,17477,16630,847,4.80000000
CN2102100000000,21,021,"Boyle County, KY",May-22,12677,12210,467,3.70000000
CN2102300000000,21,023,"Bracken County, KY",May-22,3751,3621,130,3.50000000
CN2102500000000,21,025,"Breathitt County, KY",May-22,3266,3008,258,7.90000000
CN2102700000000,21,027,"Breckinridge County, KY",May-22,7963,7611,352,4.40000000
CN2102900000000,21,029,"Bullitt County, KY",May-22,44172,41907,2265,5.10000000
CN2103100000000,21,031,"Butler County, KY",May-22,4982,4806,176,3.50000000
CN2103300000000,21,033,"Caldwell County, KY",May-22,5997,5807,190,3.20000000
CN2103500000000,21,035,"Calloway County, KY",May-22,16914,16273,641,3.80000000
CN2103700000000,21,037,"Campbell County, KY",May-22,50588,49002,1586,3.10000000
CN2103900000000,21,039,"Carlisle County, KY",May-22,2180,2105,75,3.40000000
CN2104100000000,21,041,"Carroll County, KY",May-22,5433,5270,163,3.00000000
CN2104300000000,21,043,"Carter County, KY",May-22,9754,9113,641,6.60000000
CN2104500000000,21,045,"Casey County, KY",May-22,6737,6510,227,3.40000000
CN2104700000000,21,047,"Christian County, KY",May-22,24983,23766,1217,4.90000000
CN2104900000000,21,049,"Clark County, KY",May-22,17212,16629,583,3.40000000
CN2105100000000,21,051,"Clay County, KY",May-22,5177,4900,277,5.40000000
CN2105300000000,21,053,"Clinton County, KY",May-22,3958,3803,155,3.90000000
CN2105500000000,21,055,"Crittenden County, KY",May-22,3783,3641,142,3.80000000
CN2105700000000,21,057,"Cumberland County, KY",May-22,3364,3279,85,2.50000000
CN2105900000000,21,059,"Daviess County, KY",May-22,46702,45004,1698,3.60000000
CN2106100000000,21,061,"Edmonson County, KY",May-22,4709,4507,202,4.30000000
CN2106300000000,21,063,"Elliott County, KY",May-22,1846,1709,137,7.40000000
CN2106500000000,21,065,"Estill County, KY",May-22,5174,4943,231,4.50000000
CN2106700000000,21,067,"Fayette County, KY",May-22,175011,169919,5092,2.90000000
CN2106900000000,21,069,"Fleming County, KY",May-22,5975,5735,240,4.00000000
CN2107100000000,21,071,"Floyd County, KY",May-22,11015,10372,643,5.80000000
CN2107300000000,21,073,"Franklin County, KY",May-22,24972,24166,806,3.20000000
CN2107500000000,21,075,"Fulton County, KY",May-22,2063,1974,89,4.30000000
CN2107700000000,21,077,"Gallatin County, KY",May-22,3981,3848,133,3.30000000
CN2107900000000,21,079,"Garrard County, KY",May-22,7732,7448,284,3.70000000
CN2108100000000,21,081,"Grant County, KY",May-22,11652,11242,410,3.50000000
CN2108300000000,21,083,"Graves County, KY",May-22,15568,14927,641,4.10000000
CN2108500000000,21,085,"Grayson County, KY",May-22,10585,10098,487,4.60000000
CN2108700000000,21,087,"Green County, KY",May-22,5318,5142,176,3.30000000
CN2108900000000,21,089,"Greenup County, KY",May-22,13132,12413,719,5.50000000
CN2109100000000,21,091,"Hancock County, KY",May-22,3867,3737,130,3.40000000
CN2109300000000,21,093,"Hardin County, KY",May-22,47353,45406,1947,4.10000000
CN2109500000000,21,095,"Harlan County, KY",May-22,6637,6207,430,6.50000000
CN2109700000000,21,097,"Harrison County, KY",May-22,8817,8559,258,2.90000000
CN2109900000000,21,099,"Hart County, KY",May-22,7561,7287,274,3.60000000
CN2110100000000,21,101,"Henderson County, KY",May-22,20895,20179,716,3.40000000
CN2110300000000,21,103,"Henry County, KY",May-22,8206,7927,279,3.40000000
CN2110500000000,21,105,"Hickman County, KY",May-22,1661,1597,64,3.90000000
CN2110700000000,21,107,"Hopkins County, KY",May-22,18001,17216,785,4.40000000
CN2110900000000,21,109,"Jackson County, KY",May-22,4139,3908,231,5.60000000
CN2111100000000,21,111,"Jefferson County, KY",May-22,402374,385691,16683,4.10000000
CN2111300000000,21,113,"Jessamine County, KY",May-22,26508,25725,783,3.00000000
CN2111500000000,21,115,"Johnson County, KY",May-22,6672,6271,401,6.00000000
CN2111700000000,21,117,"Kenton County, KY",May-22,87464,84768,2696,3.10000000
CN2111900000000,21,119,"Knott County, KY",May-22,4279,4021,258,6.00000000
CN2112100000000,21,121,"Knox County, KY",May-22,10164,9644,520,5.10000000
CN2112300000000,21,123,"Larue County, KY",May-22,5804,5548,256,4.40000000
CN2112500000000,21,125,"Laurel County, KY",May-22,25654,24677,977,3.80000000
CN2112700000000,21,127,"Lawrence County, KY",May-22,5494,5224,270,4.90000000
CN2112900000000,21,129,"Lee County, KY",May-22,2021,1918,103,5.10000000
CN2113100000000,21,131,"Leslie County, KY",May-22,2533,2361,172,6.80000000
CN2113300000000,21,133,"Letcher County, KY",May-22,6135,5767,368,6.00000000
CN2113500000000,21,135,"Lewis County, KY",May-22,4704,4400,304,6.50000000
CN2113700000000,21,137,"Lincoln County, KY",May-22,9282,8877,405,4.40000000
CN2113900000000,21,139,"Livingston County, KY",May-22,3568,3401,167,4.70000000
CN2114100000000,21,141,"Logan County, KY",May-22,12467,12090,377,3.00000000
CN2114300000000,21,143,"Lyon County, KY",May-22,3102,2992,110,3.50000000
CN2114500000000,21,145,"McCracken County, KY",May-22,29379,28189,1190,4.10000000
CN2114700000000,21,147,"McCreary County, KY",May-22,4785,4563,222,4.60000000
CN2114900000000,21,149,"McLean County, KY",May-22,4012,3856,156,3.90000000
CN2115100000000,21,151,"Madison County, KY",May-22,47708,46179,1529,3.20000000
CN2115300000000,21,153,"Magoffin County, KY",May-22,3351,2980,371,11.10000000
CN2115500000000,21,155,"Marion County, KY",May-22,9160,8853,307,3.40000000
CN2115700000000,21,157,"Marshall County, KY",May-22,14318,13766,552,3.90000000
CN2115900000000,21,159,"Martin County, KY",May-22,2313,2137,176,7.60000000
CN2116100000000,21,161,"Mason County, KY",May-22,6604,6327,277,4.20000000
CN2116300000000,21,163,"Meade County, KY",May-22,11720,11159,561,4.80000000
CN2116500000000,21,165,"Menifee County, KY",May-22,2349,2225,124,5.30000000
CN2116700000000,21,167,"Mercer County, KY",May-22,9942,9596,346,3.50000000
CN2116900000000,21,169,"Metcalfe County, KY",May-22,3915,3737,178,4.50000000
CN2117100000000,21,171,"Monroe County, KY",May-22,4562,4432,130,2.80000000
CN2117300000000,21,173,"Montgomery County, KY",May-22,11801,11302,499,4.20000000
CN2117500000000,21,175,"Morgan County, KY",May-22,4309,4110,199,4.60000000
CN2117700000000,21,177,"Muhlenberg County, KY",May-22,9698,9142,556,5.70000000
CN2117900000000,21,179,"Nelson County, KY",May-22,23992,23038,954,4.00000000
CN2118100000000,21,181,"Nicholas County, KY",May-22,3311,3174,137,4.10000000
CN2118300000000,21,183,"Ohio County, KY",May-22,8958,8541,417,4.70000000
CN2118500000000,21,185,"Oldham County, KY",May-22,33740,32703,1037,3.10000000
CN2118700000000,21,187,"Owen County, KY",May-22,5061,4908,153,3.00000000
CN2118900000000,21,189,"Owsley County, KY",May-22,1044,973,71,6.80000000
CN2119100000000,21,191,"Pendleton County, KY",May-22,6894,6683,211,3.10000000
CN2119300000000,21,193,"Perry County, KY",May-22,8028,7627,401,5.00000000
CN2119500000000,21,195,"Pike County, KY",May-22,18924,17945,979,5.20000000
CN2119700000000,21,197,"Powell County, KY",May-22,5164,4974,190,3.70000000
CN2119900000000,21,199,"Pulaski County, KY",May-22,25804,24713,1091,4.20000000
CN2120100000000,21,201,"Robertson County, KY",May-22,796,762,34,4.30000000
CN2120300000000,21,203,"Rockcastle County, KY",May-22,6597,6327,270,4.10000000
CN2120500000000,21,205,"Rowan County, KY",May-22,9910,9477,433,4.40000000
CN2120700000000,21,207,"Russell County, KY",May-22,6116,5841,275,4.50000000
CN2120900000000,21,209,"Scott County, KY",May-22,30200,29363,837,2.80000000
CN2121100000000,21,211,"Shelby County, KY",May-22,26205,25297,908,3.50000000
CN2121300000000,21,213,"Simpson County, KY",May-22,8947,8684,263,2.90000000
CN2121500000000,21,215,"Spencer County, KY",May-22,10840,10339,501,4.60000000
CN2121700000000,21,217,"Taylor County, KY",May-22,12713,12299,414,3.30000000
CN2121900000000,21,219,"Todd County, KY",May-22,5459,5296,163,3.00000000
CN2122100000000,21,221,"Trigg County, KY",May-22,6045,5796,249,4.10000000
CN2122300000000,21,223,"Trimble County, KY",May-22,3861,3712,149,3.90000000
CN2122500000000,21,225,"Union County, KY",May-22,5943,5719,224,3.80000000
CN2122700000000,21,227,"Warren County, KY",May-22,65382,63274,2108,3.20000000
CN2122900000000,21,229,"Washington County, KY",May-22,6159,5973,186,3.00000000
CN2123100000000,21,231,"Wayne County, KY",May-22,7040,6706,334,4.70000000
CN2123300000000,21,233,"Webster County, KY",May-22,5282,5097,185,3.50000000
CN2123500000000,21,235,"Whitley County, KY",May-22,14204,13634,570,4.00000000
CN2123700000000,21,237,"Wolfe County, KY",May-22,2268,2158,110,4.90000000
CN2123900000000,21,239,"Woodford County, KY",May-22,14786,14385,401,2.70000000
CN2200100000000,22,001,"Acadia Parish, LA",May-22,24245,23480,765,3.20000000
CN2200300000000,22,003,"Allen Parish, LA",May-22,8127,7810,317,3.90000000
CN2200500000000,22,005,"Ascension Parish, LA",May-22,65803,64024,1779,2.70000000
CN2200700000000,22,007,"Assumption Parish, LA",May-22,8673,8227,446,5.10000000
CN2200900000000,22,009,"Avoyelles Parish, LA",May-22,14726,14189,537,3.60000000
CN2201100000000,22,011,"Beauregard Parish, LA",May-22,15110,14709,401,2.70000000
CN2201300000000,22,013,"Bienville Parish, LA",May-22,5294,5082,212,4.00000000
CN2201500000000,22,015,"Bossier Parish, LA",May-22,58630,57152,1478,2.50000000
CN2201700000000,22,017,"Caddo Parish, LA",May-22,103604,99154,4450,4.30000000
CN2201900000000,22,019,"Calcasieu Parish, LA",May-22,99182,95728,3454,3.50000000
CN2202100000000,22,021,"Caldwell Parish, LA",May-22,3697,3578,119,3.20000000
CN2202300000000,22,023,"Cameron Parish, LA",May-22,3656,3577,79,2.20000000
CN2202500000000,22,025,"Catahoula Parish, LA",May-22,3567,3434,133,3.70000000
CN2202700000000,22,027,"Claiborne Parish, LA",May-22,5388,5207,181,3.40000000
CN2202900000000,22,029,"Concordia Parish, LA",May-22,7025,6724,301,4.30000000
CN2203100000000,22,031,"De Soto Parish, LA",May-22,11011,10646,365,3.30000000
CN2203300000000,22,033,"East Baton Rouge Parish, LA",May-22,230274,222324,7950,3.50000000
CN2203500000000,22,035,"East Carroll Parish, LA",May-22,1707,1574,133,7.80000000
CN2203700000000,22,037,"East Feliciana Parish, LA",May-22,7801,7569,232,3.00000000
CN2203900000000,22,039,"Evangeline Parish, LA",May-22,12056,11601,455,3.80000000
CN2204100000000,22,041,"Franklin Parish, LA",May-22,7601,7270,331,4.40000000
CN2204300000000,22,043,"Grant Parish, LA",May-22,8405,8180,225,2.70000000
CN2204500000000,22,045,"Iberia Parish, LA",May-22,28441,27132,1309,4.60000000
CN2204700000000,22,047,"Iberville Parish, LA",May-22,13794,13087,707,5.10000000
CN2204900000000,22,049,"Jackson Parish, LA",May-22,6912,6733,179,2.60000000
CN2205100000000,22,051,"Jefferson Parish, LA",May-22,211104,202999,8105,3.80000000
CN2205300000000,22,053,"Jefferson Davis Parish, LA",May-22,12822,12420,402,3.10000000
CN2205500000000,22,055,"Lafayette Parish, LA",May-22,118598,115301,3297,2.80000000
CN2205700000000,22,057,"Lafourche Parish, LA",May-22,40724,39535,1189,2.90000000
CN2205900000000,22,059,"LaSalle Parish, LA",May-22,6663,6516,147,2.20000000
CN2206100000000,22,061,"Lincoln Parish, LA",May-22,21509,20870,639,3.00000000
CN2206300000000,22,063,"Livingston Parish, LA",May-22,70621,68885,1736,2.50000000
CN2206500000000,22,065,"Madison Parish, LA",May-22,3472,3303,169,4.90000000
CN2206700000000,22,067,"Morehouse Parish, LA",May-22,10118,9549,569,5.60000000
CN2206900000000,22,069,"Natchitoches Parish, LA",May-22,16850,16315,535,3.20000000
CN2207100000000,22,071,"Orleans Parish, LA",May-22,178819,169043,9776,5.50000000
CN2207300000000,22,073,"Ouachita Parish, LA",May-22,70253,67841,2412,3.40000000
CN2207500000000,22,075,"Plaquemines Parish, LA",May-22,9761,9493,268,2.70000000
CN2207700000000,22,077,"Pointe Coupee Parish, LA",May-22,9735,9360,375,3.90000000
CN2207900000000,22,079,"Rapides Parish, LA",May-22,56552,55036,1516,2.70000000
CN2208100000000,22,081,"Red River Parish, LA",May-22,3791,3686,105,2.80000000
CN2208300000000,22,083,"Richland Parish, LA",May-22,8369,8066,303,3.60000000
CN2208500000000,22,085,"Sabine Parish, LA",May-22,9406,9162,244,2.60000000
CN2208700000000,22,087,"St. Bernard Parish, LA",May-22,20224,19310,914,4.50000000
CN2208900000000,22,089,"St. Charles Parish, LA",May-22,24737,23969,768,3.10000000
CN2209100000000,22,091,"St. Helena Parish, LA",May-22,4266,4004,262,6.10000000
CN2209300000000,22,093,"St. James Parish, LA",May-22,8918,8462,456,5.10000000
CN2209500000000,22,095,"St. John the Baptist Parish, LA",May-22,19241,18103,1138,5.90000000
CN2209700000000,22,097,"St. Landry Parish, LA",May-22,32392,30928,1464,4.50000000
CN2209900000000,22,099,"St. Martin Parish, LA",May-22,22400,21602,798,3.60000000
CN2210100000000,22,101,"St. Mary Parish, LA",May-22,19269,18357,912,4.70000000
CN2210300000000,22,103,"St. Tammany Parish, LA",May-22,119607,116661,2946,2.50000000
CN2210500000000,22,105,"Tangipahoa Parish, LA",May-22,56718,54212,2506,4.40000000
CN2210700000000,22,107,"Tensas Parish, LA",May-22,1339,1278,61,4.60000000
CN2210900000000,22,109,"Terrebonne Parish, LA",May-22,44852,43166,1686,3.80000000
CN2211100000000,22,111,"Union Parish, LA",May-22,9138,8849,289,3.20000000
CN2211300000000,22,113,"Vermilion Parish, LA",May-22,24660,23888,772,3.10000000
CN2211500000000,22,115,"Vernon Parish, LA",May-22,15941,15420,521,3.30000000
CN2211700000000,22,117,"Washington Parish, LA",May-22,16914,16224,690,4.10000000
CN2211900000000,22,119,"Webster Parish, LA",May-22,14309,13785,524,3.70000000
CN2212100000000,22,121,"West Baton Rouge Parish, LA",May-22,13775,13351,424,3.10000000
CN2212300000000,22,123,"West Carroll Parish, LA",May-22,3584,3415,169,4.70000000
CN2212500000000,22,125,"West Feliciana Parish, LA",May-22,5360,5243,117,2.20000000
CN2212700000000,22,127,"Winn Parish, LA",May-22,4638,4480,158,3.40000000
CN2300100000000,23,001,"Androscoggin County, ME",May-22,53043,51436,1607,3.00000000
CN2300300000000,23,003,"Aroostook County, ME",May-22,28171,26796,1375,4.90000000
CN2300500000000,23,005,"Cumberland County, ME",May-22,161013,156964,4049,2.50000000
CN2300700000000,23,007,"Franklin County, ME",May-22,13144,12592,552,4.20000000
CN2300900000000,23,009,"Hancock County, ME",May-22,28637,27720,917,3.20000000
CN2301100000000,23,011,"Kennebec County, ME",May-22,60111,58385,1726,2.90000000
CN2301300000000,23,013,"Knox County, ME",May-22,19719,19133,586,3.00000000
CN2301500000000,23,015,"Lincoln County, ME",May-22,16565,16084,481,2.90000000
CN2301700000000,23,017,"Oxford County, ME",May-22,25251,24352,899,3.60000000
CN2301900000000,23,019,"Penobscot County, ME",May-22,74246,71917,2329,3.10000000
CN2302100000000,23,021,"Piscataquis County, ME",May-22,7281,6965,316,4.30000000
CN2302300000000,23,023,"Sagadahoc County, ME",May-22,18973,18497,476,2.50000000
CN2302500000000,23,025,"Somerset County, ME",May-22,21886,20961,925,4.20000000
CN2302700000000,23,027,"Waldo County, ME",May-22,20167,19539,628,3.10000000
CN2302900000000,23,029,"Washington County, ME",May-22,13222,12593,629,4.80000000
CN2303100000000,23,031,"York County, ME",May-22,110510,107564,2946,2.70000000
CN2400100000000,24,001,"Allegany County, MD",May-22,30389,29007,1382,4.50000000
CN2400300000000,24,003,"Anne Arundel County, MD",May-22,316762,306977,9785,3.10000000
CN2400500000000,24,005,"Baltimore County, MD",May-22,449243,432497,16746,3.70000000
CN2400900000000,24,009,"Calvert County, MD",May-22,48591,46993,1598,3.30000000
CN2401100000000,24,011,"Caroline County, MD",May-22,17845,17279,566,3.20000000
CN2401300000000,24,013,"Carroll County, MD",May-22,95843,93149,2694,2.80000000
CN2401500000000,24,015,"Cecil County, MD",May-22,52539,50613,1926,3.70000000
CN2401700000000,24,017,"Charles County, MD",May-22,84999,81717,3282,3.90000000
CN2401900000000,24,019,"Dorchester County, MD",May-22,16181,15566,615,3.80000000
CN2402100000000,24,021,"Frederick County, MD",May-22,136286,131845,4441,3.30000000
CN2402300000000,24,023,"Garrett County, MD",May-22,15458,14945,513,3.30000000
CN2402500000000,24,025,"Harford County, MD",May-22,141045,136479,4566,3.20000000
CN2402700000000,24,027,"Howard County, MD",May-22,189482,183990,5492,2.90000000
CN2402900000000,24,029,"Kent County, MD",May-22,9911,9539,372,3.80000000
CN2403100000000,24,031,"Montgomery County, MD",May-22,552431,533859,18572,3.40000000
CN2403300000000,24,033,"Prince George's County, MD",May-22,492093,469275,22818,4.60000000
CN2403500000000,24,035,"Queen Anne's County, MD",May-22,28557,27743,814,2.90000000
CN2403700000000,24,037,"St. Mary's County, MD",May-22,57045,55154,1891,3.30000000
CN2403900000000,24,039,"Somerset County, MD",May-22,8990,8515,475,5.30000000
CN2404100000000,24,041,"Talbot County, MD",May-22,18026,17407,619,3.40000000
CN2404300000000,24,043,"Washington County, MD",May-22,72102,69466,2636,3.70000000
CN2404500000000,24,045,"Wicomico County, MD",May-22,50430,48283,2147,4.30000000
CN2404700000000,24,047,"Worcester County, MD",May-22,25019,23682,1337,5.30000000
CN2451000000000,24,510,"Baltimore city, MD",May-22,277617,263431,14186,5.10000000
CN2500100000000,25,001,"Barnstable County, MA",May-22,109467,105025,4442,4.10000000
CN2500300000000,25,003,"Berkshire County, MA",May-22,60124,57674,2450,4.10000000
CN2500500000000,25,005,"Bristol County, MA",May-22,296007,284020,11987,4.00000000
CN2500700000000,25,007,"Dukes County, MA",May-22,9486,9081,405,4.30000000
CN2500900000000,25,009,"Essex County, MA",May-22,418730,403305,15425,3.70000000
CN2501100000000,25,011,"Franklin County, MA",May-22,40591,39418,1173,2.90000000
CN2501300000000,25,013,"Hampden County, MA",May-22,223827,213672,10155,4.50000000
CN2501500000000,25,015,"Hampshire County, MA",May-22,89281,86734,2547,2.90000000
CN2501700000000,25,017,"Middlesex County, MA",May-22,908645,884106,24539,2.70000000
CN2501900000000,25,019,"Nantucket County/town, MA",May-22,7477,7141,336,4.50000000
CN2502100000000,25,021,"Norfolk County, MA",May-22,391102,379347,11755,3.00000000
CN2502300000000,25,023,"Plymouth County, MA",May-22,281013,270774,10239,3.60000000
CN2502500000000,25,025,"Suffolk County, MA",May-22,451372,436528,14844,3.30000000
CN2502700000000,25,027,"Worcester County, MA",May-22,436521,421168,15353,3.50000000
CN2600100000000,26,001,"Alcona County, MI",May-22,4036,3792,244,6.00000000
CN2600300000000,26,003,"Alger County, MI",May-22,3237,3005,232,7.20000000
CN2600500000000,26,005,"Allegan County, MI",May-22,63464,61300,2164,3.40000000
CN2600700000000,26,007,"Alpena County, MI",May-22,14010,13405,605,4.30000000
CN2600900000000,26,009,"Antrim County, MI",May-22,10254,9686,568,5.50000000
CN2601100000000,26,011,"Arenac County, MI",May-22,6009,5605,404,6.70000000
CN2601300000000,26,013,"Baraga County, MI",May-22,3154,2924,230,7.30000000
CN2601500000000,26,015,"Barry County, MI",May-22,32057,30918,1139,3.60000000
CN2601700000000,26,017,"Bay County, MI",May-22,49465,47050,2415,4.90000000
CN2601900000000,26,019,"Benzie County, MI",May-22,8921,8492,429,4.80000000
CN2602100000000,26,021,"Berrien County, MI",May-22,72104,68929,3175,4.40000000
CN2602300000000,26,023,"Branch County, MI",May-22,19684,18907,777,3.90000000
CN2602500000000,26,025,"Calhoun County, MI",May-22,61151,58170,2981,4.90000000
CN2602700000000,26,027,"Cass County, MI",May-22,23972,23008,964,4.00000000
CN2602900000000,26,029,"Charlevoix County, MI",May-22,12706,12141,565,4.40000000
CN2603100000000,26,031,"Cheboygan County, MI",May-22,10551,10014,537,5.10000000
CN2603300000000,26,033,"Chippewa County, MI",May-22,16544,15602,942,5.70000000
CN2603500000000,26,035,"Clare County, MI",May-22,11651,10884,767,6.60000000
CN2603700000000,26,037,"Clinton County, MI",May-22,40818,39173,1645,4.00000000
CN2603900000000,26,039,"Crawford County, MI",May-22,5561,5213,348,6.30000000
CN2604100000000,26,041,"Delta County, MI",May-22,16773,15897,876,5.20000000
CN2604300000000,26,043,"Dickinson County, MI",May-22,12488,11999,489,3.90000000
CN2604500000000,26,045,"Eaton County, MI",May-22,56763,53943,2820,5.00000000
CN2604700000000,26,047,"Emmet County, MI",May-22,17177,16323,854,5.00000000
CN2604900000000,26,049,"Genesee County, MI",May-22,178902,168566,10336,5.80000000
CN2605100000000,26,051,"Gladwin County, MI",May-22,9906,9333,573,5.80000000
CN2605300000000,26,053,"Gogebic County, MI",May-22,5715,5419,296,5.20000000
CN2605500000000,26,055,"Grand Traverse County, MI",May-22,50448,48637,1811,3.60000000
CN2605700000000,26,057,"Gratiot County, MI",May-22,17525,16733,792,4.50000000
CN2605900000000,26,059,"Hillsdale County, MI",May-22,20345,19449,896,4.40000000
CN2606100000000,26,061,"Houghton County, MI",May-22,15348,14556,792,5.20000000
CN2606300000000,26,063,"Huron County, MI",May-22,15165,14519,646,4.30000000
CN2606500000000,26,065,"Ingham County, MI",May-22,147922,140856,7066,4.80000000
CN2606700000000,26,067,"Ionia County, MI",May-22,30647,29495,1152,3.80000000
CN2606900000000,26,069,"Iosco County, MI",May-22,10452,9846,606,5.80000000
CN2607100000000,26,071,"Iron County, MI",May-22,5005,4743,262,5.20000000
CN2607300000000,26,073,"Isabella County, MI",May-22,32932,31386,1546,4.70000000
CN2607500000000,26,075,"Jackson County, MI",May-22,74494,71194,3300,4.40000000
CN2607700000000,26,077,"Kalamazoo County, MI",May-22,132988,127768,5220,3.90000000
CN2607900000000,26,079,"Kalkaska County, MI",May-22,8002,7558,444,5.50000000
CN2608100000000,26,081,"Kent County, MI",May-22,361531,349004,12527,3.50000000
CN2608300000000,26,083,"Keweenaw County, MI",May-22,868,810,58,6.70000000
CN2608500000000,26,085,"Lake County, MI",May-22,4053,3784,269,6.60000000
CN2608700000000,26,087,"Lapeer County, MI",May-22,39963,38017,1946,4.90000000
CN2608900000000,26,089,"Leelanau County, MI",May-22,10592,10181,411,3.90000000
CN2609100000000,26,091,"Lenawee County, MI",May-22,45159,43196,1963,4.30000000
CN2609300000000,26,093,"Livingston County, MI",May-22,101988,98471,3517,3.40000000
CN2609500000000,26,095,"Luce County, MI",May-22,2135,2000,135,6.30000000
CN2609700000000,26,097,"Mackinac County, MI",May-22,5441,5175,266,4.90000000
CN2609900000000,26,099,"Macomb County, MI",May-22,437416,416986,20430,4.70000000
CN2610100000000,26,101,"Manistee County, MI",May-22,10546,9976,570,5.40000000
CN2610300000000,26,103,"Marquette County, MI",May-22,31116,29613,1503,4.80000000
CN2610500000000,26,105,"Mason County, MI",May-22,13542,12890,652,4.80000000
CN2610700000000,26,107,"Mecosta County, MI",May-22,18360,17377,983,5.40000000
CN2610900000000,26,109,"Menominee County, MI",May-22,10763,10330,433,4.00000000
CN2611100000000,26,111,"Midland County, MI",May-22,39676,38043,1633,4.10000000
CN2611300000000,26,113,"Missaukee County, MI",May-22,7080,6767,313,4.40000000
CN2611500000000,26,115,"Monroe County, MI",May-22,75023,71538,3485,4.60000000
CN2611700000000,26,117,"Montcalm County, MI",May-22,27981,26796,1185,4.20000000
CN2611900000000,26,119,"Montmorency County, MI",May-22,3151,2916,235,7.50000000
CN2612100000000,26,121,"Muskegon County, MI",May-22,77604,73406,4198,5.40000000
CN2612300000000,26,123,"Newaygo County, MI",May-22,24145,23097,1048,4.30000000
CN2612500000000,26,125,"Oakland County, MI",May-22,659615,634887,24728,3.70000000
CN2612700000000,26,127,"Oceana County, MI",May-22,12308,11553,755,6.10000000
CN2612900000000,26,129,"Ogemaw County, MI",May-22,8347,7814,533,6.40000000
CN2613100000000,26,131,"Ontonagon County, MI",May-22,2156,1988,168,7.80000000
CN2613300000000,26,133,"Osceola County, MI",May-22,11795,11299,496,4.20000000
CN2613500000000,26,135,"Oscoda County, MI",May-22,2756,2547,209,7.60000000
CN2613700000000,26,137,"Otsego County, MI",May-22,11880,11255,625,5.30000000
CN2613900000000,26,139,"Ottawa County, MI",May-22,162967,157682,5285,3.20000000
CN2614100000000,26,141,"Presque Isle County, MI",May-22,5082,4765,317,6.20000000
CN2614300000000,26,143,"Roscommon County, MI",May-22,7645,6965,680,8.90000000
CN2614500000000,26,145,"Saginaw County, MI",May-22,82309,77568,4741,5.80000000
CN2614700000000,26,147,"St. Clair County, MI",May-22,73900,70464,3436,4.60000000
CN2614900000000,26,149,"St. Joseph County, MI",May-22,28531,27361,1170,4.10000000
CN2615100000000,26,151,"Sanilac County, MI",May-22,19587,18666,921,4.70000000
CN2615300000000,26,153,"Schoolcraft County, MI",May-22,3238,3006,232,7.20000000
CN2615500000000,26,155,"Shiawassee County, MI",May-22,33142,31573,1569,4.70000000
CN2615700000000,26,157,"Tuscola County, MI",May-22,23308,22123,1185,5.10000000
CN2615900000000,26,159,"Van Buren County, MI",May-22,34852,33239,1613,4.60000000
CN2616100000000,26,161,"Washtenaw County, MI",May-22,197456,190297,7159,3.60000000
CN2616300000000,26,163,"Wayne County, MI",May-22,787879,739452,48427,6.10000000
CN2616500000000,26,165,"Wexford County, MI",May-22,15124,14444,680,4.50000000
CN2700100000000,27,001,"Aitkin County, MN",May-22,7331,7138,193,2.60000000
CN2700300000000,27,003,"Anoka County, MN",May-22,200905,197755,3150,1.60000000
CN2700500000000,27,005,"Becker County, MN",May-22,18249,17938,311,1.70000000
CN2700700000000,27,007,"Beltrami County, MN",May-22,23881,23355,526,2.20000000
CN2700900000000,27,009,"Benton County, MN",May-22,21617,21205,412,1.90000000
CN2701100000000,27,011,"Big Stone County, MN",May-22,2337,2295,42,1.80000000
CN2701300000000,27,013,"Blue Earth County, MN",May-22,40212,39677,535,1.30000000
CN2701500000000,27,015,"Brown County, MN",May-22,13168,12960,208,1.60000000
CN2701700000000,27,017,"Carlton County, MN",May-22,17559,17156,403,2.30000000
CN2701900000000,27,019,"Carver County, MN",May-22,59977,59219,758,1.30000000
CN2702100000000,27,021,"Cass County, MN",May-22,15953,15612,341,2.10000000
CN2702300000000,27,023,"Chippewa County, MN",May-22,6318,6230,88,1.40000000
CN2702500000000,27,025,"Chisago County, MN",May-22,30132,29627,505,1.70000000
CN2702700000000,27,027,"Clay County, MN",May-22,36471,35953,518,1.40000000
CN2702900000000,27,029,"Clearwater County, MN",May-22,4369,4166,203,4.60000000
CN2703100000000,27,031,"Cook County, MN",May-22,2667,2602,65,2.40000000
CN2703300000000,27,033,"Cottonwood County, MN",May-22,6523,6414,109,1.70000000
CN2703500000000,27,035,"Crow Wing County, MN",May-22,31823,31229,594,1.90000000
CN2703700000000,27,037,"Dakota County, MN",May-22,245281,241748,3533,1.40000000
CN2703900000000,27,039,"Dodge County, MN",May-22,11896,11736,160,1.30000000
CN2704100000000,27,041,"Douglas County, MN",May-22,20868,20588,280,1.30000000
CN2704300000000,27,043,"Faribault County, MN",May-22,6597,6470,127,1.90000000
CN2704500000000,27,045,"Fillmore County, MN",May-22,11344,11193,151,1.30000000
CN2704700000000,27,047,"Freeborn County, MN",May-22,14966,14725,241,1.60000000
CN2704900000000,27,049,"Goodhue County, MN",May-22,25741,25353,388,1.50000000
CN2705100000000,27,051,"Grant County, MN",May-22,3168,3117,51,1.60000000
CN2705300000000,27,053,"Hennepin County, MN",May-22,713499,702275,11224,1.60000000
CN2705500000000,27,055,"Houston County, MN",May-22,10130,10008,122,1.20000000
CN2705700000000,27,057,"Hubbard County, MN",May-22,10014,9765,249,2.50000000
CN2705900000000,27,059,"Isanti County, MN",May-22,21817,21446,371,1.70000000
CN2706100000000,27,061,"Itasca County, MN",May-22,20717,20034,683,3.30000000
CN2706300000000,27,063,"Jackson County, MN",May-22,5287,5167,120,2.30000000
CN2706500000000,27,065,"Kanabec County, MN",May-22,8937,8743,194,2.20000000
CN2706700000000,27,067,"Kandiyohi County, MN",May-22,22201,21838,363,1.60000000
CN2706900000000,27,069,"Kittson County, MN",May-22,2176,2139,37,1.70000000
CN2707100000000,27,071,"Koochiching County, MN",May-22,5501,5298,203,3.70000000
CN2707300000000,27,073,"Lac qui Parle County, MN",May-22,3227,3177,50,1.50000000
CN2707500000000,27,075,"Lake County, MN",May-22,5267,5066,201,3.80000000
CN2707700000000,27,077,"Lake of the Woods County, MN",May-22,2299,2249,50,2.20000000
CN2707900000000,27,079,"Le Sueur County, MN",May-22,15863,15602,261,1.60000000
CN2708100000000,27,081,"Lincoln County, MN",May-22,2836,2798,38,1.30000000
CN2708300000000,27,083,"Lyon County, MN",May-22,13862,13655,207,1.50000000
CN2708500000000,27,085,"McLeod County, MN",May-22,18591,18292,299,1.60000000
CN2708700000000,27,087,"Mahnomen County, MN",May-22,2096,2031,65,3.10000000
CN2708900000000,27,089,"Marshall County, MN",May-22,5144,5023,121,2.40000000
CN2709100000000,27,091,"Martin County, MN",May-22,9200,9019,181,2.00000000
CN2709300000000,27,093,"Meeker County, MN",May-22,12911,12727,184,1.40000000
CN2709500000000,27,095,"Mille Lacs County, MN",May-22,12628,12348,280,2.20000000
CN2709700000000,27,097,"Morrison County, MN",May-22,17103,16726,377,2.20000000
CN2709900000000,27,099,"Mower County, MN",May-22,20221,19908,313,1.50000000
CN2710100000000,27,101,"Murray County, MN",May-22,4450,4374,76,1.70000000
CN2710300000000,27,103,"Nicollet County, MN",May-22,20599,20363,236,1.10000000
CN2710500000000,27,105,"Nobles County, MN",May-22,10871,10715,156,1.40000000
CN2710700000000,27,107,"Norman County, MN",May-22,3113,3051,62,2.00000000
CN2710900000000,27,109,"Olmsted County, MN",May-22,91994,90810,1184,1.30000000
CN2711100000000,27,111,"Otter Tail County, MN",May-22,30701,30208,493,1.60000000
CN2711300000000,27,113,"Pennington County, MN",May-22,8450,8295,155,1.80000000
CN2711500000000,27,115,"Pine County, MN",May-22,13831,13497,334,2.40000000
CN2711700000000,27,117,"Pipestone County, MN",May-22,4343,4288,55,1.30000000
CN2711900000000,27,119,"Polk County, MN",May-22,15726,15437,289,1.80000000
CN2712100000000,27,121,"Pope County, MN",May-22,6250,6171,79,1.30000000
CN2712300000000,27,123,"Ramsey County, MN",May-22,288895,283924,4971,1.70000000
CN2712500000000,27,125,"Red Lake County, MN",May-22,2133,2081,52,2.40000000
CN2712700000000,27,127,"Redwood County, MN",May-22,7209,7101,108,1.50000000
CN2712900000000,27,129,"Renville County, MN",May-22,7685,7519,166,2.20000000
CN2713100000000,27,131,"Rice County, MN",May-22,36543,36014,529,1.40000000
CN2713300000000,27,133,"Rock County, MN",May-22,5838,5787,51,0.90000000
CN2713500000000,27,135,"Roseau County, MN",May-22,7778,7645,133,1.70000000
CN2713700000000,27,137,"St. Louis County, MN",May-22,100465,98302,2163,2.20000000
CN2713900000000,27,139,"Scott County, MN",May-22,85390,84262,1128,1.30000000
CN2714100000000,27,141,"Sherburne County, MN",May-22,53541,52741,800,1.50000000
CN2714300000000,27,143,"Sibley County, MN",May-22,7998,7865,133,1.70000000
CN2714500000000,27,145,"Stearns County, MN",May-22,89766,88338,1428,1.60000000
CN2714700000000,27,147,"Steele County, MN",May-22,18909,18606,303,1.60000000
CN2714900000000,27,149,"Stevens County, MN",May-22,5109,5042,67,1.30000000
CN2715100000000,27,151,"Swift County, MN",May-22,4509,4425,84,1.90000000
CN2715300000000,27,153,"Todd County, MN",May-22,12904,12675,229,1.80000000
CN2715500000000,27,155,"Traverse County, MN",May-22,1594,1572,22,1.40000000
CN2715700000000,27,157,"Wabasha County, MN",May-22,12109,11938,171,1.40000000
CN2715900000000,27,159,"Wadena County, MN",May-22,5811,5679,132,2.30000000
CN2716100000000,27,161,"Waseca County, MN",May-22,8418,8243,175,2.10000000
CN2716300000000,27,163,"Washington County, MN",May-22,146658,144669,1989,1.40000000
CN2716500000000,27,165,"Watonwan County, MN",May-22,6320,6216,104,1.60000000
CN2716700000000,27,167,"Wilkin County, MN",May-22,3222,3179,43,1.30000000
CN2716900000000,27,169,"Winona County, MN",May-22,27039,26661,378,1.40000000
CN2717100000000,27,171,"Wright County, MN",May-22,77195,76161,1034,1.30000000
CN2717300000000,27,173,"Yellow Medicine County, MN",May-22,4808,4725,83,1.70000000
CN2800100000000,28,001,"Adams County, MS",May-22,10581,9995,586,5.50000000
CN2800300000000,28,003,"Alcorn County, MS",May-22,15376,14902,474,3.10000000
CN2800500000000,28,005,"Amite County, MS",May-22,4477,4265,212,4.70000000
CN2800700000000,28,007,"Attala County, MS",May-22,7177,6899,278,3.90000000
CN2800900000000,28,009,"Benton County, MS",May-22,3089,2952,137,4.40000000
CN2801100000000,28,011,"Bolivar County, MS",May-22,11638,11104,534,4.60000000
CN2801300000000,28,013,"Calhoun County, MS",May-22,5647,5465,182,3.20000000
CN2801500000000,28,015,"Carroll County, MS",May-22,3625,3485,140,3.90000000
CN2801700000000,28,017,"Chickasaw County, MS",May-22,6957,6685,272,3.90000000
CN2801900000000,28,019,"Choctaw County, MS",May-22,3682,3555,127,3.40000000
CN2802100000000,28,021,"Claiborne County, MS",May-22,2968,2706,262,8.80000000
CN2802300000000,28,023,"Clarke County, MS",May-22,5697,5428,269,4.70000000
CN2802500000000,28,025,"Clay County, MS",May-22,8429,8043,386,4.60000000
CN2802700000000,28,027,"Coahoma County, MS",May-22,8002,7529,473,5.90000000
CN2802900000000,28,029,"Copiah County, MS",May-22,10705,10237,468,4.40000000
CN2803100000000,28,031,"Covington County, MS",May-22,8225,7944,281,3.40000000
CN2803300000000,28,033,"DeSoto County, MS",May-22,94809,92076,2733,2.90000000
CN2803500000000,28,035,"Forrest County, MS",May-22,33288,32058,1230,3.70000000
CN2803700000000,28,037,"Franklin County, MS",May-22,2695,2568,127,4.70000000
CN2803900000000,28,039,"George County, MS",May-22,8870,8408,462,5.20000000
CN2804100000000,28,041,"Greene County, MS",May-22,4302,4035,267,6.20000000
CN2804300000000,28,043,"Grenada County, MS",May-22,9163,8869,294,3.20000000
CN2804500000000,28,045,"Hancock County, MS",May-22,19384,18657,727,3.80000000
CN2804700000000,28,047,"Harrison County, MS",May-22,88613,85452,3161,3.60000000
CN2804900000000,28,049,"Hinds County, MS",May-22,100308,96135,4173,4.20000000
CN2805100000000,28,051,"Holmes County, MS",May-22,5095,4728,367,7.20000000
CN2805300000000,28,053,"Humphreys County, MS",May-22,2061,1898,163,7.90000000
CN2805500000000,28,055,"Issaquena County, MS",May-22,350,325,25,7.10000000
CN2805700000000,28,057,"Itawamba County, MS",May-22,10387,10082,305,2.90000000
CN2805900000000,28,059,"Jackson County, MS",May-22,59313,56819,2494,4.20000000
CN2806100000000,28,061,"Jasper County, MS",May-22,5835,5551,284,4.90000000
CN2806300000000,28,063,"Jefferson County, MS",May-22,1956,1672,284,14.50000000
CN2806500000000,28,065,"Jefferson Davis County, MS",May-22,3895,3689,206,5.30000000
CN2806700000000,28,067,"Jones County, MS",May-22,24712,23760,952,3.90000000
CN2806900000000,28,069,"Kemper County, MS",May-22,3322,3132,190,5.70000000
CN2807100000000,28,071,"Lafayette County, MS",May-22,28342,27539,803,2.80000000
CN2807300000000,28,073,"Lamar County, MS",May-22,31517,30633,884,2.80000000
CN2807500000000,28,075,"Lauderdale County, MS",May-22,28815,27709,1106,3.80000000
CN2807700000000,28,077,"Lawrence County, MS",May-22,4732,4511,221,4.70000000
CN2807900000000,28,079,"Leake County, MS",May-22,8221,7913,308,3.70000000
CN2808100000000,28,081,"Lee County, MS",May-22,41033,39800,1233,3.00000000
CN2808300000000,28,083,"Leflore County, MS",May-22,10205,9657,548,5.40000000
CN2808500000000,28,085,"Lincoln County, MS",May-22,14909,14403,506,3.40000000
CN2808700000000,28,087,"Lowndes County, MS",May-22,25250,24243,1007,4.00000000
CN2808900000000,28,089,"Madison County, MS",May-22,52445,50926,1519,2.90000000
CN2809100000000,28,091,"Marion County, MS",May-22,10440,10088,352,3.40000000
CN2809300000000,28,093,"Marshall County, MS",May-22,14478,13947,531,3.70000000
CN2809500000000,28,095,"Monroe County, MS",May-22,15990,15445,545,3.40000000
CN2809700000000,28,097,"Montgomery County, MS",May-22,3980,3817,163,4.10000000
CN2809900000000,28,099,"Neshoba County, MS",May-22,10262,9869,393,3.80000000
CN2810100000000,28,101,"Newton County, MS",May-22,8339,8033,306,3.70000000
CN2810300000000,28,103,"Noxubee County, MS",May-22,3639,3411,228,6.30000000
CN2810500000000,28,105,"Oktibbeha County, MS",May-22,22695,21849,846,3.70000000
CN2810700000000,28,107,"Panola County, MS",May-22,12665,12070,595,4.70000000
CN2810900000000,28,109,"Pearl River County, MS",May-22,23620,22742,878,3.70000000
CN2811100000000,28,111,"Perry County, MS",May-22,4267,4075,192,4.50000000
CN2811300000000,28,113,"Pike County, MS",May-22,14503,13803,700,4.80000000
CN2811500000000,28,115,"Pontotoc County, MS",May-22,15079,14646,433,2.90000000
CN2811700000000,28,117,"Prentiss County, MS",May-22,11572,11244,328,2.80000000
CN2811900000000,28,119,"Quitman County, MS",May-22,2444,2307,137,5.60000000
CN2812100000000,28,121,"Rankin County, MS",May-22,75028,73087,1941,2.60000000
CN2812300000000,28,123,"Scott County, MS",May-22,12546,12172,374,3.00000000
CN2812500000000,28,125,"Sharkey County, MS",May-22,1474,1391,83,5.60000000
CN2812700000000,28,127,"Simpson County, MS",May-22,10478,10123,355,3.40000000
CN2812900000000,28,129,"Smith County, MS",May-22,6846,6628,218,3.20000000
CN2813100000000,28,131,"Stone County, MS",May-22,7074,6807,267,3.80000000
CN2813300000000,28,133,"Sunflower County, MS",May-22,7747,7284,463,6.00000000
CN2813500000000,28,135,"Tallahatchie County, MS",May-22,4830,4635,195,4.00000000
CN2813700000000,28,137,"Tate County, MS",May-22,12409,11957,452,3.60000000
CN2813900000000,28,139,"Tippah County, MS",May-22,9924,9635,289,2.90000000
CN2814100000000,28,141,"Tishomingo County, MS",May-22,8403,8125,278,3.30000000
CN2814300000000,28,143,"Tunica County, MS",May-22,4326,4100,226,5.20000000
CN2814500000000,28,145,"Union County, MS",May-22,14528,14170,358,2.50000000
CN2814700000000,28,147,"Walthall County, MS",May-22,4985,4753,232,4.70000000
CN2814900000000,28,149,"Warren County, MS",May-22,19410,18573,837,4.30000000
CN2815100000000,28,151,"Washington County, MS",May-22,15780,14897,883,5.60000000
CN2815300000000,28,153,"Wayne County, MS",May-22,7613,7264,349,4.60000000
CN2815500000000,28,155,"Webster County, MS",May-22,3992,3854,138,3.50000000
CN2815700000000,28,157,"Wilkinson County, MS",May-22,2634,2439,195,7.40000000
CN2815900000000,28,159,"Winston County, MS",May-22,7181,6865,316,4.40000000
CN2816100000000,28,161,"Yalobusha County, MS",May-22,4850,4679,171,3.50000000
CN2816300000000,28,163,"Yazoo County, MS",May-22,8990,8552,438,4.90000000
CN2900100000000,29,001,"Adair County, MO",May-22,9850,9494,356,3.60000000
CN2900300000000,29,003,"Andrew County, MO",May-22,9691,9490,201,2.10000000
CN2900500000000,29,005,"Atchison County, MO",May-22,2716,2655,61,2.20000000
CN2900700000000,29,007,"Audrain County, MO",May-22,10212,9859,353,3.50000000
CN2900900000000,29,009,"Barry County, MO",May-22,14903,14480,423,2.80000000
CN2901100000000,29,011,"Barton County, MO",May-22,5373,5239,134,2.50000000
CN2901300000000,29,013,"Bates County, MO",May-22,7656,7434,222,2.90000000
CN2901500000000,29,015,"Benton County, MO",May-22,7362,7090,272,3.70000000
CN2901700000000,29,017,"Bollinger County, MO",May-22,5352,5206,146,2.70000000
CN2901900000000,29,019,"Boone County, MO",May-22,100414,98144,2270,2.30000000
CN2902100000000,29,021,"Buchanan County, MO",May-22,43360,42251,1109,2.60000000
CN2902300000000,29,023,"Butler County, MO",May-22,18163,17615,548,3.00000000
CN2902500000000,29,025,"Caldwell County, MO",May-22,4257,4143,114,2.70000000
CN2902700000000,29,027,"Callaway County, MO",May-22,21328,20768,560,2.60000000
CN2902900000000,29,029,"Camden County, MO",May-22,19778,19180,598,3.00000000
CN2903100000000,29,031,"Cape Girardeau County, MO",May-22,40557,39536,1021,2.50000000
CN2903300000000,29,033,"Carroll County, MO",May-22,4564,4435,129,2.80000000
CN2903500000000,29,035,"Carter County, MO",May-22,2590,2501,89,3.40000000
CN2903700000000,29,037,"Cass County, MO",May-22,54345,52951,1394,2.60000000
CN2903900000000,29,039,"Cedar County, MO",May-22,5801,5635,166,2.90000000
CN2904100000000,29,041,"Chariton County, MO",May-22,3779,3699,80,2.10000000
CN2904300000000,29,043,"Christian County, MO",May-22,47021,45990,1031,2.20000000
CN2904500000000,29,045,"Clark County, MO",May-22,3133,3040,93,3.00000000
CN2904700000000,29,047,"Clay County, MO",May-22,136805,133260,3545,2.60000000
CN2904900000000,29,049,"Clinton County, MO",May-22,10530,10248,282,2.70000000
CN2905100000000,29,051,"Cole County, MO",May-22,38546,37712,834,2.20000000
CN2905300000000,29,053,"Cooper County, MO",May-22,7150,6967,183,2.60000000
CN2905500000000,29,055,"Crawford County, MO",May-22,10976,10642,334,3.00000000
CN2905700000000,29,057,"Dade County, MO",May-22,3581,3498,83,2.30000000
CN2905900000000,29,059,"Dallas County, MO",May-22,7257,7030,227,3.10000000
CN2906100000000,29,061,"Daviess County, MO",May-22,4216,4117,99,2.30000000
CN2906300000000,29,063,"DeKalb County, MO",May-22,4173,4079,94,2.30000000
CN2906500000000,29,065,"Dent County, MO",May-22,6438,6224,214,3.30000000
CN2906700000000,29,067,"Douglas County, MO",May-22,5209,5056,153,2.90000000
CN2906900000000,29,069,"Dunklin County, MO",May-22,11304,10803,501,4.40000000
CN2907100000000,29,071,"Franklin County, MO",May-22,53031,51707,1324,2.50000000
CN2907300000000,29,073,"Gasconade County, MO",May-22,7656,7481,175,2.30000000
CN2907500000000,29,075,"Gentry County, MO",May-22,3413,3342,71,2.10000000
CN2907700000000,29,077,"Greene County, MO",May-22,153850,150256,3594,2.30000000
CN2907900000000,29,079,"Grundy County, MO",May-22,4222,4105,117,2.80000000
CN2908100000000,29,081,"Harrison County, MO",May-22,3826,3733,93,2.40000000
CN2908300000000,29,083,"Henry County, MO",May-22,10075,9810,265,2.60000000
CN2908500000000,29,085,"Hickory County, MO",May-22,4048,3936,112,2.80000000
CN2908700000000,29,087,"Holt County, MO",May-22,2555,2506,49,1.90000000
CN2908900000000,29,089,"Howard County, MO",May-22,4816,4696,120,2.50000000
CN2909100000000,29,091,"Howell County, MO",May-22,15932,15411,521,3.30000000
CN2909300000000,29,093,"Iron County, MO",May-22,3476,3329,147,4.20000000
CN2909500000000,29,095,"Jackson County, MO",May-22,355748,344285,11463,3.20000000
CN2909700000000,29,097,"Jasper County, MO",May-22,57407,55909,1498,2.60000000
CN2909900000000,29,099,"Jefferson County, MO",May-22,118085,115055,3030,2.60000000
CN2910100000000,29,101,"Johnson County, MO",May-22,22742,22065,677,3.00000000
CN2910300000000,29,103,"Knox County, MO",May-22,1733,1691,42,2.40000000
CN2910500000000,29,105,"Laclede County, MO",May-22,16570,16120,450,2.70000000
CN2910700000000,29,107,"Lafayette County, MO",May-22,16661,16213,448,2.70000000
CN2910900000000,29,109,"Lawrence County, MO",May-22,17260,16815,445,2.60000000
CN2911100000000,29,111,"Lewis County, MO",May-22,4843,4728,115,2.40000000
CN2911300000000,29,113,"Lincoln County, MO",May-22,29362,28564,798,2.70000000
CN2911500000000,29,115,"Linn County, MO",May-22,5100,4947,153,3.00000000
CN2911700000000,29,117,"Livingston County, MO",May-22,7309,7156,153,2.10000000
CN2911900000000,29,119,"McDonald County, MO",May-22,10949,10652,297,2.70000000
CN2912100000000,29,121,"Macon County, MO",May-22,7358,7171,187,2.50000000
CN2912300000000,29,123,"Madison County, MO",May-22,5470,5307,163,3.00000000
CN2912500000000,29,125,"Maries County, MO",May-22,3940,3835,105,2.70000000
CN2912700000000,29,127,"Marion County, MO",May-22,14008,13656,352,2.50000000
CN2912900000000,29,129,"Mercer County, MO",May-22,1846,1805,41,2.20000000
CN2913100000000,29,131,"Miller County, MO",May-22,12867,12540,327,2.50000000
CN2913300000000,29,133,"Mississippi County, MO",May-22,5354,5168,186,3.50000000
CN2913500000000,29,135,"Moniteau County, MO",May-22,7063,6897,166,2.40000000
CN2913700000000,29,137,"Monroe County, MO",May-22,3838,3730,108,2.80000000
CN2913900000000,29,139,"Montgomery County, MO",May-22,5933,5783,150,2.50000000
CN2914100000000,29,141,"Morgan County, MO",May-22,8560,8307,253,3.00000000
CN2914300000000,29,143,"New Madrid County, MO",May-22,8512,8248,264,3.10000000
CN2914500000000,29,145,"Newton County, MO",May-22,27278,26554,724,2.70000000
CN2914700000000,29,147,"Nodaway County, MO",May-22,10700,10415,285,2.70000000
CN2914900000000,29,149,"Oregon County, MO",May-22,3807,3682,125,3.30000000
CN2915100000000,29,151,"Osage County, MO",May-22,7018,6869,149,2.10000000
CN2915300000000,29,153,"Ozark County, MO",May-22,3538,3413,125,3.50000000
CN2915500000000,29,155,"Pemiscot County, MO",May-22,5840,5566,274,4.70000000
CN2915700000000,29,157,"Perry County, MO",May-22,9598,9360,238,2.50000000
CN2915900000000,29,159,"Pettis County, MO",May-22,19904,19367,537,2.70000000
CN2916100000000,29,161,"Phelps County, MO",May-22,20200,19646,554,2.70000000
CN2916300000000,29,163,"Pike County, MO",May-22,7304,7105,199,2.70000000
CN2916500000000,29,165,"Platte County, MO",May-22,59248,57805,1443,2.40000000
CN2916700000000,29,167,"Polk County, MO",May-22,14751,14355,396,2.70000000
CN2916900000000,29,169,"Pulaski County, MO",May-22,14611,14148,463,3.20000000
CN2917100000000,29,171,"Putnam County, MO",May-22,2229,2178,51,2.30000000
CN2917300000000,29,173,"Ralls County, MO",May-22,5534,5403,131,2.40000000
CN2917500000000,29,175,"Randolph County, MO",May-22,10475,10184,291,2.80000000
CN2917700000000,29,177,"Ray County, MO",May-22,10736,10413,323,3.00000000
CN2917900000000,29,179,"Reynolds County, MO",May-22,2961,2874,87,2.90000000
CN2918100000000,29,181,"Ripley County, MO",May-22,5125,4949,176,3.40000000
CN2918300000000,29,183,"St. Charles County, MO",May-22,229472,224218,5254,2.30000000
CN2918500000000,29,185,"St. Clair County, MO",May-22,3857,3744,113,2.90000000
CN2918600000000,29,186,"Ste. Genevieve County, MO",May-22,9323,9096,227,2.40000000
CN2918700000000,29,187,"St. Francois County, MO",May-22,25754,24872,882,3.40000000
CN2918900000000,29,189,"St. Louis County, MO",May-22,527554,512772,14782,2.80000000
CN2919500000000,29,195,"Saline County, MO",May-22,10478,10207,271,2.60000000
CN2919700000000,29,197,"Schuyler County, MO",May-22,1831,1780,51,2.80000000
CN2919900000000,29,199,"Scotland County, MO",May-22,2328,2274,54,2.30000000
CN2920100000000,29,201,"Scott County, MO",May-22,20454,19934,520,2.50000000
CN2920300000000,29,203,"Shannon County, MO",May-22,3373,3248,125,3.70000000
CN2920500000000,29,205,"Shelby County, MO",May-22,3053,2989,64,2.10000000
CN2920700000000,29,207,"Stoddard County, MO",May-22,13491,13102,389,2.90000000
CN2920900000000,29,209,"Stone County, MO",May-22,12988,12499,489,3.80000000
CN2921100000000,29,211,"Sullivan County, MO",May-22,2647,2571,76,2.90000000
CN2921300000000,29,213,"Taney County, MO",May-22,24958,23893,1065,4.30000000
CN2921500000000,29,215,"Texas County, MO",May-22,9177,8890,287,3.10000000
CN2921700000000,29,217,"Vernon County, MO",May-22,9450,9190,260,2.80000000
CN2921900000000,29,219,"Warren County, MO",May-22,18826,18330,496,2.60000000
CN2922100000000,29,221,"Washington County, MO",May-22,10143,9796,347,3.40000000
CN2922300000000,29,223,"Wayne County, MO",May-22,4854,4681,173,3.60000000
CN2922500000000,29,225,"Webster County, MO",May-22,17618,17196,422,2.40000000
CN2922700000000,29,227,"Worth County, MO",May-22,1207,1187,20,1.70000000
CN2922900000000,29,229,"Wright County, MO",May-22,7923,7693,230,2.90000000
CN2951000000000,29,510,"St. Louis city, MO",May-22,149519,143897,5622,3.80000000
CN3000100000000,30,001,"Beaverhead County, MT",May-22,5165,5049,116,2.20000000
CN3000300000000,30,003,"Big Horn County, MT",May-22,4681,4431,250,5.30000000
CN3000500000000,30,005,"Blaine County, MT",May-22,2282,2216,66,2.90000000
CN3000700000000,30,007,"Broadwater County, MT",May-22,2723,2645,78,2.90000000
CN3000900000000,30,009,"Carbon County, MT",May-22,5808,5651,157,2.70000000
CN3001100000000,30,011,"Carter County, MT",May-22,619,606,13,2.10000000
CN3001300000000,30,013,"Cascade County, MT",May-22,38774,37804,970,2.50000000
CN3001500000000,30,015,"Chouteau County, MT",May-22,2450,2395,55,2.20000000
CN3001700000000,30,017,"Custer County, MT",May-22,6563,6437,126,1.90000000
CN3001900000000,30,019,"Daniels County, MT",May-22,884,868,16,1.80000000
CN3002100000000,30,021,"Dawson County, MT",May-22,4522,4415,107,2.40000000
CN3002300000000,30,023,"Deer Lodge County, MT",May-22,5345,5229,116,2.20000000
CN3002500000000,30,025,"Fallon County, MT",May-22,1606,1577,29,1.80000000
CN3002700000000,30,027,"Fergus County, MT",May-22,6024,5876,148,2.50000000
CN3002900000000,30,029,"Flathead County, MT",May-22,52060,50513,1547,3.00000000
CN3003100000000,30,031,"Gallatin County, MT",May-22,76359,74863,1496,2.00000000
CN3003300000000,30,033,"Garfield County, MT",May-22,715,697,18,2.50000000
CN3003500000000,30,035,"Glacier County, MT",May-22,5561,5241,320,5.80000000
CN3003700000000,30,037,"Golden Valley County, MT",May-22,374,361,13,3.50000000
CN3003900000000,30,039,"Granite County, MT",May-22,1607,1546,61,3.80000000
CN3004100000000,30,041,"Hill County, MT",May-22,7534,7356,178,2.40000000
CN3004300000000,30,043,"Jefferson County, MT",May-22,6007,5860,147,2.40000000
CN3004500000000,30,045,"Judith Basin County, MT",May-22,896,876,20,2.20000000
CN3004700000000,30,047,"Lake County, MT",May-22,14501,14121,380,2.60000000
CN3004900000000,30,049,"Lewis and Clark County, MT",May-22,38105,37249,856,2.20000000
CN3005100000000,30,051,"Liberty County, MT",May-22,960,939,21,2.20000000
CN3005300000000,30,053,"Lincoln County, MT",May-22,8563,8128,435,5.10000000
CN3005500000000,30,055,"McCone County, MT",May-22,967,952,15,1.60000000
CN3005700000000,30,057,"Madison County, MT",May-22,4621,4500,121,2.60000000
CN3005900000000,30,059,"Meagher County, MT",May-22,952,931,21,2.20000000
CN3006100000000,30,061,"Mineral County, MT",May-22,1932,1850,82,4.20000000
CN3006300000000,30,063,"Missoula County, MT",May-22,67481,65825,1656,2.50000000
CN3006500000000,30,065,"Musselshell County, MT",May-22,2404,2342,62,2.60000000
CN3006700000000,30,067,"Park County, MT",May-22,9469,9223,246,2.60000000
CN3006900000000,30,069,"Petroleum County, MT",May-22,269,262,7,2.60000000
CN3007100000000,30,071,"Phillips County, MT",May-22,1805,1750,55,3.00000000
CN3007300000000,30,073,"Pondera County, MT",May-22,2640,2581,59,2.20000000
CN3007500000000,30,075,"Powder River County, MT",May-22,983,960,23,2.30000000
CN3007700000000,30,077,"Powell County, MT",May-22,3025,2952,73,2.40000000
CN3007900000000,30,079,"Prairie County, MT",May-22,485,472,13,2.70000000
CN3008100000000,30,081,"Ravalli County, MT",May-22,22038,21491,547,2.50000000
CN3008300000000,30,083,"Richland County, MT",May-22,5693,5523,170,3.00000000
CN3008500000000,30,085,"Roosevelt County, MT",May-22,4389,4231,158,3.60000000
CN3008700000000,30,087,"Rosebud County, MT",May-22,3750,3636,114,3.00000000
CN3008900000000,30,089,"Sanders County, MT",May-22,5462,5254,208,3.80000000
CN3009100000000,30,091,"Sheridan County, MT",May-22,1766,1734,32,1.80000000
CN3009300000000,30,093,"Silver Bow County, MT",May-22,17945,17474,471,2.60000000
CN3009500000000,30,095,"Stillwater County, MT",May-22,5616,5496,120,2.10000000
CN3009700000000,30,097,"Sweet Grass County, MT",May-22,1924,1890,34,1.80000000
CN3009900000000,30,099,"Teton County, MT",May-22,2825,2755,70,2.50000000
CN3010100000000,30,101,"Toole County, MT",May-22,2045,2005,40,2.00000000
CN3010300000000,30,103,"Treasure County, MT",May-22,355,349,6,1.70000000
CN3010500000000,30,105,"Valley County, MT",May-22,4022,3931,91,2.30000000
CN3010700000000,30,107,"Wheatland County, MT",May-22,739,717,22,3.00000000
CN3010900000000,30,109,"Wibaux County, MT",May-22,428,415,13,3.00000000
CN3011100000000,30,111,"Yellowstone County, MT",May-22,87164,85205,1959,2.20000000
CN3100100000000,31,001,"Adams County, NE",May-22,17020,16690,330,1.90000000
CN3100300000000,31,003,"Antelope County, NE",May-22,3767,3714,53,1.40000000
CN3100500000000,31,005,"Arthur County, NE",May-22,238,233,5,2.10000000
CN3100700000000,31,007,"Banner County, NE",May-22,392,384,8,2.00000000
CN3100900000000,31,009,"Blaine County, NE",May-22,256,248,8,3.10000000
CN3101100000000,31,011,"Boone County, NE",May-22,3023,2978,45,1.50000000
CN3101300000000,31,013,"Box Butte County, NE",May-22,5438,5330,108,2.00000000
CN3101500000000,31,015,"Boyd County, NE",May-22,1050,1031,19,1.80000000
CN3101700000000,31,017,"Brown County, NE",May-22,1444,1415,29,2.00000000
CN3101900000000,31,019,"Buffalo County, NE",May-22,28172,27693,479,1.70000000
CN3102100000000,31,021,"Burt County, NE",May-22,4023,3950,73,1.80000000
CN3102300000000,31,023,"Butler County, NE",May-22,4701,4627,74,1.60000000
CN3102500000000,31,025,"Cass County, NE",May-22,13827,13564,263,1.90000000
CN3102700000000,31,027,"Cedar County, NE",May-22,4750,4679,71,1.50000000
CN3102900000000,31,029,"Chase County, NE",May-22,2298,2261,37,1.60000000
CN3103100000000,31,031,"Cherry County, NE",May-22,3512,3462,50,1.40000000
CN3103300000000,31,033,"Cheyenne County, NE",May-22,4203,4114,89,2.10000000
CN3103500000000,31,035,"Clay County, NE",May-22,3286,3226,60,1.80000000
CN3103700000000,31,037,"Colfax County, NE",May-22,5800,5706,94,1.60000000
CN3103900000000,31,039,"Cuming County, NE",May-22,5019,4942,77,1.50000000
CN3104100000000,31,041,"Custer County, NE",May-22,6437,6343,94,1.50000000
CN3104300000000,31,043,"Dakota County, NE",May-22,10999,10777,222,2.00000000
CN3104500000000,31,045,"Dawes County, NE",May-22,5154,5066,88,1.70000000
CN3104700000000,31,047,"Dawson County, NE",May-22,13694,13422,272,2.00000000
CN3104900000000,31,049,"Deuel County, NE",May-22,986,968,18,1.80000000
CN3105100000000,31,051,"Dixon County, NE",May-22,3049,2999,50,1.60000000
CN3105300000000,31,053,"Dodge County, NE",May-22,20467,20087,380,1.90000000
CN3105500000000,31,055,"Douglas County, NE",May-22,309735,302932,6803,2.20000000
CN3105700000000,31,057,"Dundy County, NE",May-22,1175,1157,18,1.50000000
CN3105900000000,31,059,"Fillmore County, NE",May-22,3310,3260,50,1.50000000
CN3106100000000,31,061,"Franklin County, NE",May-22,1525,1494,31,2.00000000
CN3106300000000,31,063,"Frontier County, NE",May-22,1609,1581,28,1.70000000
CN3106500000000,31,065,"Furnas County, NE",May-22,2635,2592,43,1.60000000
CN3106700000000,31,067,"Gage County, NE",May-22,11101,10884,217,2.00000000
CN3106900000000,31,069,"Garden County, NE",May-22,1159,1138,21,1.80000000
CN3107100000000,31,071,"Garfield County, NE",May-22,1152,1133,19,1.60000000
CN3107300000000,31,073,"Gosper County, NE",May-22,1203,1187,16,1.30000000
CN3107500000000,31,075,"Grant County, NE",May-22,433,428,5,1.20000000
CN3107700000000,31,077,"Greeley County, NE",May-22,1282,1257,25,2.00000000
CN3107900000000,31,079,"Hall County, NE",May-22,32426,31606,820,2.50000000
CN3108100000000,31,081,"Hamilton County, NE",May-22,4868,4770,98,2.00000000
CN3108300000000,31,083,"Harlan County, NE",May-22,1858,1828,30,1.60000000
CN3108500000000,31,085,"Hayes County, NE",May-22,638,630,8,1.30000000
CN3108700000000,31,087,"Hitchcock County, NE",May-22,1341,1313,28,2.10000000
CN3108900000000,31,089,"Holt County, NE",May-22,5808,5726,82,1.40000000
CN3109100000000,31,091,"Hooker County, NE",May-22,458,448,10,2.20000000
CN3109300000000,31,093,"Howard County, NE",May-22,3471,3380,91,2.60000000
CN3109500000000,31,095,"Jefferson County, NE",May-22,4263,4205,58,1.40000000
CN3109700000000,31,097,"Johnson County, NE",May-22,2031,1987,44,2.20000000
CN3109900000000,31,099,"Kearney County, NE",May-22,3873,3813,60,1.50000000
CN3110100000000,31,101,"Keith County, NE",May-22,4672,4596,76,1.60000000
CN3110300000000,31,103,"Keya Paha County, NE",May-22,618,609,9,1.50000000
CN3110500000000,31,105,"Kimball County, NE",May-22,1959,1931,28,1.40000000
CN3110700000000,31,107,"Knox County, NE",May-22,4807,4735,72,1.50000000
CN3110900000000,31,109,"Lancaster County, NE",May-22,182502,179055,3447,1.90000000
CN3111100000000,31,111,"Lincoln County, NE",May-22,18553,18231,322,1.70000000
CN3111300000000,31,113,"Logan County, NE",May-22,472,463,9,1.90000000
CN3111500000000,31,115,"Loup County, NE",May-22,413,404,9,2.20000000
CN3111700000000,31,117,"McPherson County, NE",May-22,433,427,6,1.40000000
CN3111900000000,31,119,"Madison County, NE",May-22,20141,19815,326,1.60000000
CN3112100000000,31,121,"Merrick County, NE",May-22,4153,4069,84,2.00000000
CN3112300000000,31,123,"Morrill County, NE",May-22,2668,2621,47,1.80000000
CN3112500000000,31,125,"Nance County, NE",May-22,2001,1971,30,1.50000000
CN3112700000000,31,127,"Nemaha County, NE",May-22,3688,3614,74,2.00000000
CN3112900000000,31,129,"Nuckolls County, NE",May-22,2539,2496,43,1.70000000
CN3113100000000,31,131,"Otoe County, NE",May-22,8704,8539,165,1.90000000
CN3113300000000,31,133,"Pawnee County, NE",May-22,1531,1510,21,1.40000000
CN3113500000000,31,135,"Perkins County, NE",May-22,1887,1859,28,1.50000000
CN3113700000000,31,137,"Phelps County, NE",May-22,5015,4936,79,1.60000000
CN3113900000000,31,139,"Pierce County, NE",May-22,4225,4160,65,1.50000000
CN3114100000000,31,141,"Platte County, NE",May-22,18514,18193,321,1.70000000
CN3114300000000,31,143,"Polk County, NE",May-22,2992,2944,48,1.60000000
CN3114500000000,31,145,"Red Willow County, NE",May-22,5911,5809,102,1.70000000
CN3114700000000,31,147,"Richardson County, NE",May-22,4357,4288,69,1.60000000
CN3114900000000,31,149,"Rock County, NE",May-22,920,909,11,1.20000000
CN3115100000000,31,151,"Saline County, NE",May-22,7361,7215,146,2.00000000
CN3115300000000,31,153,"Sarpy County, NE",May-22,101011,99131,1880,1.90000000
CN3115500000000,31,155,"Saunders County, NE",May-22,11697,11499,198,1.70000000
CN3115700000000,31,157,"Scotts Bluff County, NE",May-22,17738,17353,385,2.20000000
CN3115900000000,31,159,"Seward County, NE",May-22,9012,8842,170,1.90000000
CN3116100000000,31,161,"Sheridan County, NE",May-22,2756,2708,48,1.70000000
CN3116300000000,31,163,"Sherman County, NE",May-22,1712,1681,31,1.80000000
CN3116500000000,31,165,"Sioux County, NE",May-22,764,753,11,1.40000000
CN3116700000000,31,167,"Stanton County, NE",May-22,3644,3594,50,1.40000000
CN3116900000000,31,169,"Thayer County, NE",May-22,2728,2689,39,1.40000000
CN3117100000000,31,171,"Thomas County, NE",May-22,426,418,8,1.90000000
CN3117300000000,31,173,"Thurston County, NE",May-22,3187,3086,101,3.20000000
CN3117500000000,31,175,"Valley County, NE",May-22,2152,2117,35,1.60000000
CN3117700000000,31,177,"Washington County, NE",May-22,11648,11438,210,1.80000000
CN3117900000000,31,179,"Wayne County, NE",May-22,5703,5596,107,1.90000000
CN3118100000000,31,181,"Webster County, NE",May-22,1685,1654,31,1.80000000
CN3118300000000,31,183,"Wheeler County, NE",May-22,594,588,6,1.00000000
CN3118500000000,31,185,"York County, NE",May-22,7389,7256,133,1.80000000
CN3200100000000,32,001,"Churchill County, NV",May-22,11368,11048,320,2.80000000
CN3200300000000,32,003,"Clark County, NV",May-22,1121001,1062311,58690,5.20000000
CN3200500000000,32,005,"Douglas County, NV",May-22,21616,20881,735,3.40000000
CN3200700000000,32,007,"Elko County, NV",May-22,25637,24971,666,2.60000000
CN3200900000000,32,009,"Esmeralda County, NV",May-22,446,435,11,2.50000000
CN3201100000000,32,011,"Eureka County, NV",May-22,1094,1069,25,2.30000000
CN3201300000000,32,013,"Humboldt County, NV",May-22,8106,7896,210,2.60000000
CN3201500000000,32,015,"Lander County, NV",May-22,3112,3020,92,3.00000000
CN3201700000000,32,017,"Lincoln County, NV",May-22,2198,2132,66,3.00000000
CN3201900000000,32,019,"Lyon County, NV",May-22,23743,22802,941,4.00000000
CN3202100000000,32,021,"Mineral County, NV",May-22,2054,1985,69,3.40000000
CN3202300000000,32,023,"Nye County, NV",May-22,17426,16596,830,4.80000000
CN3202700000000,32,027,"Pershing County, NV",May-22,2548,2470,78,3.10000000
CN3202900000000,32,029,"Storey County, NV",May-22,2079,2005,74,3.60000000
CN3203100000000,32,031,"Washoe County, NV",May-22,255043,247672,7371,2.90000000
CN3203300000000,32,033,"White Pine County, NV",May-22,4562,4449,113,2.50000000
CN3251000000000,32,510,"Carson City, NV",May-22,25608,24791,817,3.20000000
CN3300100000000,33,001,"Belknap County, NH",May-22,31077,30517,560,1.80000000
CN3300300000000,33,003,"Carroll County, NH",May-22,22554,22131,423,1.90000000
CN3300500000000,33,005,"Cheshire County, NH",May-22,39150,38373,777,2.00000000
CN3300700000000,33,007,"Coos County, NH",May-22,14191,13871,320,2.30000000
CN3300900000000,33,009,"Grafton County, NH",May-22,47908,47076,832,1.70000000
CN3301100000000,33,011,"Hillsborough County, NH",May-22,239772,235369,4403,1.80000000
CN3301300000000,33,013,"Merrimack County, NH",May-22,82189,80847,1342,1.60000000
CN3301500000000,33,015,"Rockingham County, NH",May-22,186053,182587,3466,1.90000000
CN3301700000000,33,017,"Strafford County, NH",May-22,72771,71558,1213,1.70000000
CN3301900000000,33,019,"Sullivan County, NH",May-22,22772,22370,402,1.80000000
CN3400100000000,34,001,"Atlantic County, NJ",May-22,127668,121586,6082,4.80000000
CN3400300000000,34,003,"Bergen County, NJ",May-22,490004,474261,15743,3.20000000
CN3400500000000,34,005,"Burlington County, NJ",May-22,245228,238318,6910,2.80000000
CN3400700000000,34,007,"Camden County, NJ",May-22,268243,258381,9862,3.70000000
CN3400900000000,34,009,"Cape May County, NJ",May-22,47358,44887,2471,5.20000000
CN3401100000000,34,011,"Cumberland County, NJ",May-22,67530,64435,3095,4.60000000
CN3401300000000,34,013,"Essex County, NJ",May-22,381105,364293,16812,4.40000000
CN3401500000000,34,015,"Gloucester County, NJ",May-22,159804,154610,5194,3.30000000
CN3401700000000,34,017,"Hudson County, NJ",May-22,367353,354126,13227,3.60000000
CN3401900000000,34,019,"Hunterdon County, NJ",May-22,66679,65055,1624,2.40000000
CN3402100000000,34,021,"Mercer County, NJ",May-22,209205,203314,5891,2.80000000
CN3402300000000,34,023,"Middlesex County, NJ",May-22,450528,436975,13553,3.00000000
CN3402500000000,34,025,"Monmouth County, NJ",May-22,337967,328020,9947,2.90000000
CN3402700000000,34,027,"Morris County, NJ",May-22,263011,256125,6886,2.60000000
CN3402900000000,34,029,"Ocean County, NJ",May-22,289470,279936,9534,3.30000000
CN3403100000000,34,031,"Passaic County, NJ",May-22,246340,235208,11132,4.50000000
CN3403300000000,34,033,"Salem County, NJ",May-22,29736,28465,1271,4.30000000
CN3403500000000,34,035,"Somerset County, NJ",May-22,175606,170869,4737,2.70000000
CN3403700000000,34,037,"Sussex County, NJ",May-22,75944,73495,2449,3.20000000
CN3403900000000,34,039,"Union County, NJ",May-22,283959,273699,10260,3.60000000
CN3404100000000,34,041,"Warren County, NJ",May-22,58184,56480,1704,2.90000000
CN3500100000000,35,001,"Bernalillo County, NM",May-22,335119,322872,12247,3.70000000
CN3500300000000,35,003,"Catron County, NM",May-22,1112,1061,51,4.60000000
CN3500500000000,35,005,"Chaves County, NM",May-22,26326,25146,1180,4.50000000
CN3500600000000,35,006,"Cibola County, NM",May-22,8719,8241,478,5.50000000
CN3500700000000,35,007,"Colfax County, NM",May-22,5085,4882,203,4.00000000
CN3500900000000,35,009,"Curry County, NM",May-22,21058,20419,639,3.00000000
CN3501100000000,35,011,"De Baca County, NM",May-22,657,637,20,3.00000000
CN3501300000000,35,013,"Dona Ana County, NM",May-22,99570,95228,4342,4.40000000
CN3501500000000,35,015,"Eddy County, NM",May-22,31165,30049,1116,3.60000000
CN3501700000000,35,017,"Grant County, NM",May-22,11284,10800,484,4.30000000
CN3501900000000,35,019,"Guadalupe County, NM",May-22,1656,1569,87,5.30000000
CN3502100000000,35,021,"Harding County, NM",May-22,280,271,9,3.20000000
CN3502300000000,35,023,"Hidalgo County, NM",May-22,1802,1741,61,3.40000000
CN3502500000000,35,025,"Lea County, NM",May-22,27190,25715,1475,5.40000000
CN3502700000000,35,027,"Lincoln County, NM",May-22,8376,7998,378,4.50000000
CN3502800000000,35,028,"Los Alamos County, NM",May-22,10040,9855,185,1.80000000
CN3502900000000,35,029,"Luna County, NM",May-22,9513,8421,1092,11.50000000
CN3503100000000,35,031,"McKinley County, NM",May-22,23876,22543,1333,5.60000000
CN3503300000000,35,033,"Mora County, NM",May-22,1959,1837,122,6.20000000
CN3503500000000,35,035,"Otero County, NM",May-22,24791,23789,1002,4.00000000
CN3503700000000,35,037,"Quay County, NM",May-22,2902,2776,126,4.30000000
CN3503900000000,35,039,"Rio Arriba County, NM",May-22,16492,15749,743,4.50000000
CN3504100000000,35,041,"Roosevelt County, NM",May-22,8046,7778,268,3.30000000
CN3504300000000,35,043,"Sandoval County, NM",May-22,67713,65095,2618,3.90000000
CN3504500000000,35,045,"San Juan County, NM",May-22,50135,47770,2365,4.70000000
CN3504700000000,35,047,"San Miguel County, NM",May-22,10030,9537,493,4.90000000
CN3504900000000,35,049,"Santa Fe County, NM",May-22,73562,70983,2579,3.50000000
CN3505100000000,35,051,"Sierra County, NM",May-22,4011,3751,260,6.50000000
CN3505300000000,35,053,"Socorro County, NM",May-22,5981,5748,233,3.90000000
CN3505500000000,35,055,"Taos County, NM",May-22,13864,13037,827,6.00000000
CN3505700000000,35,057,"Torrance County, NM",May-22,5381,5092,289,5.40000000
CN3505900000000,35,059,"Union County, NM",May-22,1512,1474,38,2.50000000
CN3506100000000,35,061,"Valencia County, NM",May-22,30941,29625,1316,4.30000000
CN3600100000000,36,001,"Albany County, NY",May-22,160300,155875,4425,2.80000000
CN3600300000000,36,003,"Allegany County, NY",May-22,19874,19237,637,3.20000000
CN3600500000000,36,005,"Bronx County, NY",May-22,586474,539717,46757,8.00000000
CN3600700000000,36,007,"Broome County, NY",May-22,83434,80651,2783,3.30000000
CN3600900000000,36,009,"Cattaraugus County, NY",May-22,33783,32613,1170,3.50000000
CN3601100000000,36,011,"Cayuga County, NY",May-22,35360,34307,1053,3.00000000
CN3601300000000,36,013,"Chautauqua County, NY",May-22,53454,51641,1813,3.40000000
CN3601500000000,36,015,"Chemung County, NY",May-22,34829,33649,1180,3.40000000
CN3601700000000,36,017,"Chenango County, NY",May-22,22146,21535,611,2.80000000
CN3601900000000,36,019,"Clinton County, NY",May-22,35475,34464,1011,2.80000000
CN3602100000000,36,021,"Columbia County, NY",May-22,30380,29656,724,2.40000000
CN3602300000000,36,023,"Cortland County, NY",May-22,22732,22024,708,3.10000000
CN3602500000000,36,025,"Delaware County, NY",May-22,18934,18356,578,3.10000000
CN3602700000000,36,027,"Dutchess County, NY",May-22,145321,141259,4062,2.80000000
CN3602900000000,36,029,"Erie County, NY",May-22,448828,433777,15051,3.40000000
CN3603100000000,36,031,"Essex County, NY",May-22,16456,15958,498,3.00000000
CN3603300000000,36,033,"Franklin County, NY",May-22,19278,18693,585,3.00000000
CN3603500000000,36,035,"Fulton County, NY",May-22,22784,21965,819,3.60000000
CN3603700000000,36,037,"Genesee County, NY",May-22,30260,29472,788,2.60000000
CN3603900000000,36,039,"Greene County, NY",May-22,20082,19457,625,3.10000000
CN3604100000000,36,041,"Hamilton County, NY",May-22,2257,2178,79,3.50000000
CN3604300000000,36,043,"Herkimer County, NY",May-22,27590,26625,965,3.50000000
CN3604500000000,36,045,"Jefferson County, NY",May-22,44526,43046,1480,3.30000000
CN3604700000000,36,047,"Kings County, NY",May-22,1172732,1104215,68517,5.80000000
CN3604900000000,36,049,"Lewis County, NY",May-22,11689,11316,373,3.20000000
CN3605100000000,36,051,"Livingston County, NY",May-22,30374,29503,871,2.90000000
CN3605300000000,36,053,"Madison County, NY",May-22,32697,31794,903,2.80000000
CN3605500000000,36,055,"Monroe County, NY",May-22,366716,354769,11947,3.30000000
CN3605700000000,36,057,"Montgomery County, NY",May-22,22202,21375,827,3.70000000
CN3605900000000,36,059,"Nassau County, NY",May-22,729426,709912,19514,2.70000000
CN3606100000000,36,061,"New York County, NY",May-22,890669,851223,39446,4.40000000
CN3606300000000,36,063,"Niagara County, NY",May-22,98953,95517,3436,3.50000000
CN3606500000000,36,065,"Oneida County, NY",May-22,101010,97793,3217,3.20000000
CN3606700000000,36,067,"Onondaga County, NY",May-22,223813,216896,6917,3.10000000
CN3606900000000,36,069,"Ontario County, NY",May-22,56033,54542,1491,2.70000000
CN3607100000000,36,071,"Orange County, NY",May-22,188045,182455,5590,3.00000000
CN3607300000000,36,073,"Orleans County, NY",May-22,17167,16598,569,3.30000000
CN3607500000000,36,075,"Oswego County, NY",May-22,52745,50792,1953,3.70000000
CN3607700000000,36,077,"Otsego County, NY",May-22,27596,26859,737,2.70000000
CN3607900000000,36,079,"Putnam County, NY",May-22,51590,50211,1379,2.70000000
CN3608100000000,36,081,"Queens County, NY",May-22,1108518,1049195,59323,5.40000000
CN3608300000000,36,083,"Rensselaer County, NY",May-22,82638,80414,2224,2.70000000
CN3608500000000,36,085,"Richmond County, NY",May-22,219363,207865,11498,5.20000000
CN3608700000000,36,087,"Rockland County, NY",May-22,157689,153519,4170,2.60000000
CN3608900000000,36,089,"St. Lawrence County, NY",May-22,43777,42275,1502,3.40000000
CN3609100000000,36,091,"Saratoga County, NY",May-22,122362,119531,2831,2.30000000
CN3609300000000,36,093,"Schenectady County, NY",May-22,78444,76000,2444,3.10000000
CN3609500000000,36,095,"Schoharie County, NY",May-22,14800,14375,425,2.90000000
CN3609700000000,36,097,"Schuyler County, NY",May-22,8274,8017,257,3.10000000
CN3609900000000,36,099,"Seneca County, NY",May-22,15465,15055,410,2.70000000
CN3610100000000,36,101,"Steuben County, NY",May-22,41867,40544,1323,3.20000000
CN3610300000000,36,103,"Suffolk County, NY",May-22,799451,776954,22497,2.80000000
CN3610500000000,36,105,"Sullivan County, NY",May-22,37366,36260,1106,3.00000000
CN3610700000000,36,107,"Tioga County, NY",May-22,22527,21922,605,2.70000000
CN3610900000000,36,109,"Tompkins County, NY",May-22,50059,48856,1203,2.40000000
CN3611100000000,36,111,"Ulster County, NY",May-22,88701,86234,2467,2.80000000
CN3611300000000,36,113,"Warren County, NY",May-22,31519,30577,942,3.00000000
CN3611500000000,36,115,"Washington County, NY",May-22,27754,26962,792,2.90000000
CN3611700000000,36,117,"Wayne County, NY",May-22,43491,42298,1193,2.70000000
CN3611900000000,36,119,"Westchester County, NY",May-22,491847,477305,14542,3.00000000
CN3612100000000,36,121,"Wyoming County, NY",May-22,18271,17790,481,2.60000000
CN3612300000000,36,123,"Yates County, NY",May-22,11689,11405,284,2.40000000
CN3700100000000,37,001,"Alamance County, NC",May-22,83408,80362,3046,3.70000000
CN3700300000000,37,003,"Alexander County, NC",May-22,18009,17437,572,3.20000000
CN3700500000000,37,005,"Alleghany County, NC",May-22,4351,4187,164,3.80000000
CN3700700000000,37,007,"Anson County, NC",May-22,10336,9854,482,4.70000000
CN3700900000000,37,009,"Ashe County, NC",May-22,13017,12606,411,3.20000000
CN3701100000000,37,011,"Avery County, NC",May-22,7695,7441,254,3.30000000
CN3701300000000,37,013,"Beaufort County, NC",May-22,20241,19478,763,3.80000000
CN3701500000000,37,015,"Bertie County, NC",May-22,7395,7029,366,4.90000000
CN3701700000000,37,017,"Bladen County, NC",May-22,14148,13512,636,4.50000000
CN3701900000000,37,019,"Brunswick County, NC",May-22,57203,54567,2636,4.60000000
CN3702100000000,37,021,"Buncombe County, NC",May-22,142388,138172,4216,3.00000000
CN3702300000000,37,023,"Burke County, NC",May-22,40768,39404,1364,3.30000000
CN3702500000000,37,025,"Cabarrus County, NC",May-22,114475,110696,3779,3.30000000
CN3702700000000,37,027,"Caldwell County, NC",May-22,36348,35031,1317,3.60000000
CN3702900000000,37,029,"Camden County, NC",May-22,4669,4504,165,3.50000000
CN3703100000000,37,031,"Carteret County, NC",May-22,32303,31241,1062,3.30000000
CN3703300000000,37,033,"Caswell County, NC",May-22,9832,9449,383,3.90000000
CN3703500000000,37,035,"Catawba County, NC",May-22,79223,76533,2690,3.40000000
CN3703700000000,37,037,"Chatham County, NC",May-22,38106,36992,1114,2.90000000
CN3703900000000,37,039,"Cherokee County, NC",May-22,11117,10693,424,3.80000000
CN3704100000000,37,041,"Chowan County, NC",May-22,5754,5527,227,3.90000000
CN3704300000000,37,043,"Clay County, NC",May-22,4117,3953,164,4.00000000
CN3704500000000,37,045,"Cleveland County, NC",May-22,48811,46871,1940,4.00000000
CN3704700000000,37,047,"Columbus County, NC",May-22,23298,22229,1069,4.60000000
CN3704900000000,37,049,"Craven County, NC",May-22,41441,39949,1492,3.60000000
CN3705100000000,37,051,"Cumberland County, NC",May-22,129050,122232,6818,5.30000000
CN3705300000000,37,053,"Currituck County, NC",May-22,14545,14079,466,3.20000000
CN3705500000000,37,055,"Dare County, NC",May-22,20476,19686,790,3.90000000
CN3705700000000,37,057,"Davidson County, NC",May-22,81175,78393,2782,3.40000000
CN3705900000000,37,059,"Davie County, NC",May-22,20722,20034,688,3.30000000
CN3706100000000,37,061,"Duplin County, NC",May-22,24979,24087,892,3.60000000
CN3706300000000,37,063,"Durham County, NC",May-22,181959,176410,5549,3.00000000
CN3706500000000,37,065,"Edgecombe County, NC",May-22,20218,18762,1456,7.20000000
CN3706700000000,37,067,"Forsyth County, NC",May-22,188008,181063,6945,3.70000000
CN3706900000000,37,069,"Franklin County, NC",May-22,33557,32337,1220,3.60000000
CN3707100000000,37,071,"Gaston County, NC",May-22,113230,108971,4259,3.80000000
CN3707300000000,37,073,"Gates County, NC",May-22,5101,4928,173,3.40000000
CN3707500000000,37,075,"Graham County, NC",May-22,3046,2886,160,5.30000000
CN3707700000000,37,077,"Granville County, NC",May-22,30676,29737,939,3.10000000
CN3707900000000,37,079,"Greene County, NC",May-22,9695,9384,311,3.20000000
CN3708100000000,37,081,"Guilford County, NC",May-22,261945,251084,10861,4.10000000
CN3708300000000,37,083,"Halifax County, NC",May-22,19271,18159,1112,5.80000000
CN3708500000000,37,085,"Harnett County, NC",May-22,54860,52614,2246,4.10000000
CN3708700000000,37,087,"Haywood County, NC",May-22,30279,29327,952,3.10000000
CN3708900000000,37,089,"Henderson County, NC",May-22,55724,53987,1737,3.10000000
CN3709100000000,37,091,"Hertford County, NC",May-22,8586,8149,437,5.10000000
CN3709300000000,37,093,"Hoke County, NC",May-22,20496,19483,1013,4.90000000
CN3709500000000,37,095,"Hyde County, NC",May-22,1867,1772,95,5.10000000
CN3709700000000,37,097,"Iredell County, NC",May-22,93403,90258,3145,3.40000000
CN3709900000000,37,099,"Jackson County, NC",May-22,20386,19649,737,3.60000000
CN3710100000000,37,101,"Johnston County, NC",May-22,106748,103262,3486,3.30000000
CN3710300000000,37,103,"Jones County, NC",May-22,4298,4156,142,3.30000000
CN3710500000000,37,105,"Lee County, NC",May-22,26257,25166,1091,4.20000000
CN3710700000000,37,107,"Lenoir County, NC",May-22,27236,26231,1005,3.70000000
CN3710900000000,37,109,"Lincoln County, NC",May-22,45813,44387,1426,3.10000000
CN3711100000000,37,111,"McDowell County, NC",May-22,20114,19431,683,3.40000000
CN3711300000000,37,113,"Macon County, NC",May-22,15815,15275,540,3.40000000
CN3711500000000,37,115,"Madison County, NC",May-22,10110,9772,338,3.30000000
CN3711700000000,37,117,"Martin County, NC",May-22,8789,8406,383,4.40000000
CN3711900000000,37,119,"Mecklenburg County, NC",May-22,643295,620817,22478,3.50000000
CN3712100000000,37,121,"Mitchell County, NC",May-22,5951,5709,242,4.10000000
CN3712300000000,37,123,"Montgomery County, NC",May-22,11493,11078,415,3.60000000
CN3712500000000,37,125,"Moore County, NC",May-22,40940,39427,1513,3.70000000
CN3712700000000,37,127,"Nash County, NC",May-22,41970,39790,2180,5.20000000
CN3712900000000,37,129,"New Hanover County, NC",May-22,127061,122938,4123,3.20000000
CN3713100000000,37,131,"Northampton County, NC",May-22,7252,6916,336,4.60000000
CN3713300000000,37,133,"Onslow County, NC",May-22,67690,64854,2836,4.20000000
CN3713500000000,37,135,"Orange County, NC",May-22,82909,80467,2442,2.90000000
CN3713700000000,37,137,"Pamlico County, NC",May-22,5441,5243,198,3.60000000
CN3713900000000,37,139,"Pasquotank County, NC",May-22,16616,15916,700,4.20000000
CN3714100000000,37,141,"Pender County, NC",May-22,30246,29235,1011,3.30000000
CN3714300000000,37,143,"Perquimans County, NC",May-22,4977,4763,214,4.30000000
CN3714500000000,37,145,"Person County, NC",May-22,19179,18467,712,3.70000000
CN3714700000000,37,147,"Pitt County, NC",May-22,89540,85922,3618,4.00000000
CN3714900000000,37,149,"Polk County, NC",May-22,9359,9012,347,3.70000000
CN3715100000000,37,151,"Randolph County, NC",May-22,65746,63455,2291,3.50000000
CN3715300000000,37,153,"Richmond County, NC",May-22,16583,15666,917,5.50000000
CN3715500000000,37,155,"Robeson County, NC",May-22,48485,45626,2859,5.90000000
CN3715700000000,37,157,"Rockingham County, NC",May-22,39736,38120,1616,4.10000000
CN3715900000000,37,159,"Rowan County, NC",May-22,66927,64492,2435,3.60000000
CN3716100000000,37,161,"Rutherford County, NC",May-22,24521,23293,1228,5.00000000
CN3716300000000,37,163,"Sampson County, NC",May-22,28898,27867,1031,3.60000000
CN3716500000000,37,165,"Scotland County, NC",May-22,11165,10352,813,7.30000000
CN3716700000000,37,167,"Stanly County, NC",May-22,30399,29411,988,3.30000000
CN3716900000000,37,169,"Stokes County, NC",May-22,21586,20889,697,3.20000000
CN3717100000000,37,171,"Surry County, NC",May-22,32738,31617,1121,3.40000000
CN3717300000000,37,173,"Swain County, NC",May-22,6928,6699,229,3.30000000
CN3717500000000,37,175,"Transylvania County, NC",May-22,14704,14218,486,3.30000000
CN3717700000000,37,177,"Tyrrell County, NC",May-22,1361,1294,67,4.90000000
CN3717900000000,37,179,"Union County, NC",May-22,128749,124725,4024,3.10000000
CN3718100000000,37,181,"Vance County, NC",May-22,16972,15923,1049,6.20000000
CN3718300000000,37,183,"Wake County, NC",May-22,622159,603288,18871,3.00000000
CN3718500000000,37,185,"Warren County, NC",May-22,6557,6152,405,6.20000000
CN3718700000000,37,187,"Washington County, NC",May-22,4373,4144,229,5.20000000
CN3718900000000,37,189,"Watauga County, NC",May-22,28783,27830,953,3.30000000
CN3719100000000,37,191,"Wayne County, NC",May-22,51916,49861,2055,4.00000000
CN3719300000000,37,193,"Wilkes County, NC",May-22,27228,26188,1040,3.80000000
CN3719500000000,37,195,"Wilson County, NC",May-22,32907,31068,1839,5.60000000
CN3719700000000,37,197,"Yadkin County, NC",May-22,17635,17053,582,3.30000000
CN3719900000000,37,199,"Yancey County, NC",May-22,8349,8059,290,3.50000000
CN3800100000000,38,001,"Adams County, ND",May-22,928,908,20,2.20000000
CN3800300000000,38,003,"Barnes County, ND",May-22,5250,5140,110,2.10000000
CN3800500000000,38,005,"Benson County, ND",May-22,2322,2256,66,2.80000000
CN3800700000000,38,007,"Billings County, ND",May-22,448,438,10,2.20000000
CN3800900000000,38,009,"Bottineau County, ND",May-22,3029,2943,86,2.80000000
CN3801100000000,38,011,"Bowman County, ND",May-22,1590,1566,24,1.50000000
CN3801300000000,38,013,"Burke County, ND",May-22,1049,1026,23,2.20000000
CN3801500000000,38,015,"Burleigh County, ND",May-22,52486,51528,958,1.80000000
CN3801700000000,38,017,"Cass County, ND",May-22,109118,107254,1864,1.70000000
CN3801900000000,38,019,"Cavalier County, ND",May-22,1921,1876,45,2.30000000
CN3802100000000,38,021,"Dickey County, ND",May-22,2280,2238,42,1.80000000
CN3802300000000,38,023,"Divide County, ND",May-22,1385,1366,19,1.40000000
CN3802500000000,38,025,"Dunn County, ND",May-22,3039,2989,50,1.60000000
CN3802700000000,38,027,"Eddy County, ND",May-22,1195,1164,31,2.60000000
CN3802900000000,38,029,"Emmons County, ND",May-22,1417,1367,50,3.50000000
CN3803100000000,38,031,"Foster County, ND",May-22,1519,1488,31,2.00000000
CN3803300000000,38,033,"Golden Valley County, ND",May-22,859,847,12,1.40000000
CN3803500000000,38,035,"Grand Forks County, ND",May-22,38082,37385,697,1.80000000
CN3803700000000,38,037,"Grant County, ND",May-22,1239,1220,19,1.50000000
CN3803900000000,38,039,"Griggs County, ND",May-22,1048,1028,20,1.90000000
CN3804100000000,38,041,"Hettinger County, ND",May-22,1400,1380,20,1.40000000
CN3804300000000,38,043,"Kidder County, ND",May-22,1317,1270,47,3.60000000
CN3804500000000,38,045,"LaMoure County, ND",May-22,2064,2030,34,1.60000000
CN3804700000000,38,047,"Logan County, ND",May-22,851,837,14,1.60000000
CN3804900000000,38,049,"McHenry County, ND",May-22,3149,3058,91,2.90000000
CN3805100000000,38,051,"McIntosh County, ND",May-22,1078,1058,20,1.90000000
CN3805300000000,38,053,"McKenzie County, ND",May-22,8854,8663,191,2.20000000
CN3805500000000,38,055,"McLean County, ND",May-22,4744,4608,136,2.90000000
CN3805700000000,38,057,"Mercer County, ND",May-22,3846,3746,100,2.60000000
CN3805900000000,38,059,"Morton County, ND",May-22,17197,16806,391,2.30000000
CN3806100000000,38,061,"Mountrail County, ND",May-22,6332,6228,104,1.60000000
CN3806300000000,38,063,"Nelson County, ND",May-22,1436,1397,39,2.70000000
CN3806500000000,38,065,"Oliver County, ND",May-22,873,851,22,2.50000000
CN3806700000000,38,067,"Pembina County, ND",May-22,3234,3129,105,3.20000000
CN3806900000000,38,069,"Pierce County, ND",May-22,1645,1603,42,2.60000000
CN3807100000000,38,071,"Ramsey County, ND",May-22,5798,5664,134,2.30000000
CN3807300000000,38,073,"Ransom County, ND",May-22,2708,2663,45,1.70000000
CN3807500000000,38,075,"Renville County, ND",May-22,1215,1190,25,2.10000000
CN3807700000000,38,077,"Richland County, ND",May-22,8657,8498,159,1.80000000
CN3807900000000,38,079,"Rolette County, ND",May-22,4766,4491,275,5.80000000
CN3808100000000,38,081,"Sargent County, ND",May-22,2323,2281,42,1.80000000
CN3808300000000,38,083,"Sheridan County, ND",May-22,658,641,17,2.60000000
CN3808500000000,38,085,"Sioux County, ND",May-22,1226,1195,31,2.50000000
CN3808700000000,38,087,"Slope County, ND",May-22,344,337,7,2.00000000
CN3808900000000,38,089,"Stark County, ND",May-22,17580,17219,361,2.10000000
CN3809100000000,38,091,"Steele County, ND",May-22,900,881,19,2.10000000
CN3809300000000,38,093,"Stutsman County, ND",May-22,10406,10204,202,1.90000000
CN3809500000000,38,095,"Towner County, ND",May-22,1138,1112,26,2.30000000
CN3809700000000,38,097,"Traill County, ND",May-22,4440,4354,86,1.90000000
CN3809900000000,38,099,"Walsh County, ND",May-22,5288,5145,143,2.70000000
CN3810100000000,38,101,"Ward County, ND",May-22,32290,31549,741,2.30000000
CN3810300000000,38,103,"Wells County, ND",May-22,1899,1847,52,2.70000000
CN3810500000000,38,105,"Williams County, ND",May-22,20218,19631,587,2.90000000
CN3900100000000,39,001,"Adams County, OH",May-22,11086,10685,401,3.60000000
CN3900300000000,39,003,"Allen County, OH",May-22,47460,45871,1589,3.30000000
CN3900500000000,39,005,"Ashland County, OH",May-22,26493,25756,737,2.80000000
CN3900700000000,39,007,"Ashtabula County, OH",May-22,43286,41794,1492,3.40000000
CN3900900000000,39,009,"Athens County, OH",May-22,25540,24511,1029,4.00000000
CN3901100000000,39,011,"Auglaize County, OH",May-22,24402,23818,584,2.40000000
CN3901300000000,39,013,"Belmont County, OH",May-22,28389,27269,1120,3.90000000
CN3901500000000,39,015,"Brown County, OH",May-22,19372,18707,665,3.40000000
CN3901700000000,39,017,"Butler County, OH",May-22,196712,190930,5782,2.90000000
CN3901900000000,39,019,"Carroll County, OH",May-22,12701,12268,433,3.40000000
CN3902100000000,39,021,"Champaign County, OH",May-22,19596,19041,555,2.80000000
CN3902300000000,39,023,"Clark County, OH",May-22,62787,60736,2051,3.30000000
CN3902500000000,39,025,"Clermont County, OH",May-22,107731,104693,3038,2.80000000
CN3902700000000,39,027,"Clinton County, OH",May-22,18047,17429,618,3.40000000
CN3902900000000,39,029,"Columbiana County, OH",May-22,45272,43567,1705,3.80000000
CN3903100000000,39,031,"Coshocton County, OH",May-22,13823,13270,553,4.00000000
CN3903300000000,39,033,"Crawford County, OH",May-22,17914,17236,678,3.80000000
CN3903500000000,39,035,"Cuyahoga County, OH",May-22,600877,565172,35705,5.90000000
CN3903700000000,39,037,"Darke County, OH",May-22,25978,25282,696,2.70000000
CN3903900000000,39,039,"Defiance County, OH",May-22,17498,16953,545,3.10000000
CN3904100000000,39,041,"Delaware County, OH",May-22,116892,114037,2855,2.40000000
CN3904300000000,39,043,"Erie County, OH",May-22,37090,35619,1471,4.00000000
CN3904500000000,39,045,"Fairfield County, OH",May-22,81171,78881,2290,2.80000000
CN3904700000000,39,047,"Fayette County, OH",May-22,13760,13347,413,3.00000000
CN3904900000000,39,049,"Franklin County, OH",May-22,717558,696332,21226,3.00000000
CN3905100000000,39,051,"Fulton County, OH",May-22,22335,21604,731,3.30000000
CN3905300000000,39,053,"Gallia County, OH",May-22,12190,11742,448,3.70000000
CN3905500000000,39,055,"Geauga County, OH",May-22,47918,45875,2043,4.30000000
CN3905700000000,39,057,"Greene County, OH",May-22,83784,81372,2412,2.90000000
CN3905900000000,39,059,"Guernsey County, OH",May-22,17723,17048,675,3.80000000
CN3906100000000,39,061,"Hamilton County, OH",May-22,417026,404193,12833,3.10000000
CN3906300000000,39,063,"Hancock County, OH",May-22,41800,40650,1150,2.80000000
CN3906500000000,39,065,"Hardin County, OH",May-22,13215,12762,453,3.40000000
CN3906700000000,39,067,"Harrison County, OH",May-22,6531,6266,265,4.10000000
CN3906900000000,39,069,"Henry County, OH",May-22,12802,12379,423,3.30000000
CN3907100000000,39,071,"Highland County, OH",May-22,17419,16781,638,3.70000000
CN3907300000000,39,073,"Hocking County, OH",May-22,13036,12639,397,3.00000000
CN3907500000000,39,075,"Holmes County, OH",May-22,21908,21448,460,2.10000000
CN3907700000000,39,077,"Huron County, OH",May-22,27952,26939,1013,3.60000000
CN3907900000000,39,079,"Jackson County, OH",May-22,12590,12103,487,3.90000000
CN3908100000000,39,081,"Jefferson County, OH",May-22,27581,26348,1233,4.50000000
CN3908300000000,39,083,"Knox County, OH",May-22,31469,30623,846,2.70000000
CN3908500000000,39,085,"Lake County, OH",May-22,124066,118213,5853,4.70000000
CN3908700000000,39,087,"Lawrence County, OH",May-22,23610,22777,833,3.50000000
CN3908900000000,39,089,"Licking County, OH",May-22,92939,90417,2522,2.70000000
CN3909100000000,39,091,"Logan County, OH",May-22,22384,21770,614,2.70000000
CN3909300000000,39,093,"Lorain County, OH",May-22,153359,144851,8508,5.50000000
CN3909500000000,39,095,"Lucas County, OH",May-22,209423,201649,7774,3.70000000
CN3909700000000,39,097,"Madison County, OH",May-22,21230,20692,538,2.50000000
CN3909900000000,39,099,"Mahoning County, OH",May-22,98837,94873,3964,4.00000000
CN3910100000000,39,101,"Marion County, OH",May-22,27909,27061,848,3.00000000
CN3910300000000,39,103,"Medina County, OH",May-22,97076,92856,4220,4.30000000
CN3910500000000,39,105,"Meigs County, OH",May-22,8689,8295,394,4.50000000
CN3910700000000,39,107,"Mercer County, OH",May-22,23198,22701,497,2.10000000
CN3910900000000,39,109,"Miami County, OH",May-22,54429,52926,1503,2.80000000
CN3911100000000,39,111,"Monroe County, OH",May-22,5237,4987,250,4.80000000
CN3911300000000,39,113,"Montgomery County, OH",May-22,250677,242092,8585,3.40000000
CN3911500000000,39,115,"Morgan County, OH",May-22,6784,6519,265,3.90000000
CN3911700000000,39,117,"Morrow County, OH",May-22,17161,16648,513,3.00000000
CN3911900000000,39,119,"Muskingum County, OH",May-22,40556,39193,1363,3.40000000
CN3912100000000,39,121,"Noble County, OH",May-22,4674,4458,216,4.60000000
CN3912300000000,39,123,"Ottawa County, OH",May-22,21030,20266,764,3.60000000
CN3912500000000,39,125,"Paulding County, OH",May-22,8756,8518,238,2.70000000
CN3912700000000,39,127,"Perry County, OH",May-22,16081,15538,543,3.40000000
CN3912900000000,39,129,"Pickaway County, OH",May-22,27094,26292,802,3.00000000
CN3913100000000,39,131,"Pike County, OH",May-22,10919,10474,445,4.10000000
CN3913300000000,39,133,"Portage County, OH",May-22,85371,82788,2583,3.00000000
CN3913500000000,39,135,"Preble County, OH",May-22,21882,21298,584,2.70000000
CN3913700000000,39,137,"Putnam County, OH",May-22,19110,18685,425,2.20000000
CN3913900000000,39,139,"Richland County, OH",May-22,51394,49551,1843,3.60000000
CN3914100000000,39,141,"Ross County, OH",May-22,35599,34537,1062,3.00000000
CN3914300000000,39,143,"Sandusky County, OH",May-22,30783,29621,1162,3.80000000
CN3914500000000,39,145,"Scioto County, OH",May-22,29583,28391,1192,4.00000000
CN3914700000000,39,147,"Seneca County, OH",May-22,26923,26028,895,3.30000000
CN3914900000000,39,149,"Shelby County, OH",May-22,23996,23329,667,2.80000000
CN3915100000000,39,151,"Stark County, OH",May-22,182679,176663,6016,3.30000000
CN3915300000000,39,153,"Summit County, OH",May-22,266078,257088,8990,3.40000000
CN3915500000000,39,155,"Trumbull County, OH",May-22,83398,80005,3393,4.10000000
CN3915700000000,39,157,"Tuscarawas County, OH",May-22,44965,43666,1299,2.90000000
CN3915900000000,39,159,"Union County, OH",May-22,30545,29832,713,2.30000000
CN3916100000000,39,161,"Van Wert County, OH",May-22,14654,14269,385,2.60000000
CN3916300000000,39,163,"Vinton County, OH",May-22,5467,5256,211,3.90000000
CN3916500000000,39,165,"Warren County, OH",May-22,122336,119073,3263,2.70000000
CN3916700000000,39,167,"Washington County, OH",May-22,27225,26212,1013,3.70000000
CN3916900000000,39,169,"Wayne County, OH",May-22,60443,58918,1525,2.50000000
CN3917100000000,39,171,"Williams County, OH",May-22,17958,17459,499,2.80000000
CN3917300000000,39,173,"Wood County, OH",May-22,71482,69495,1987,2.80000000
CN3917500000000,39,175,"Wyandot County, OH",May-22,13036,12730,306,2.30000000
CN4000100000000,40,001,"Adair County, OK",May-22,8680,8419,261,3.00000000
CN4000300000000,40,003,"Alfalfa County, OK",May-22,2701,2646,55,2.00000000
CN4000500000000,40,005,"Atoka County, OK",May-22,5002,4814,188,3.80000000
CN4000700000000,40,007,"Beaver County, OK",May-22,2638,2599,39,1.50000000
CN4000900000000,40,009,"Beckham County, OK",May-22,9409,9133,276,2.90000000
CN4001100000000,40,011,"Blaine County, OK",May-22,4448,4344,104,2.30000000
CN4001300000000,40,013,"Bryan County, OK",May-22,22223,21639,584,2.60000000
CN4001500000000,40,015,"Caddo County, OK",May-22,11981,11622,359,3.00000000
CN4001700000000,40,017,"Canadian County, OK",May-22,80009,78079,1930,2.40000000
CN4001900000000,40,019,"Carter County, OK",May-22,21281,20514,767,3.60000000
CN4002100000000,40,021,"Cherokee County, OK",May-22,20297,19618,679,3.30000000
CN4002300000000,40,023,"Choctaw County, OK",May-22,6107,5850,257,4.20000000
CN4002500000000,40,025,"Cimarron County, OK",May-22,1583,1559,24,1.50000000
CN4002700000000,40,027,"Cleveland County, OK",May-22,147359,143864,3495,2.40000000
CN4002900000000,40,029,"Coal County, OK",May-22,2340,2271,69,2.90000000
CN4003100000000,40,031,"Comanche County, OK",May-22,47029,45382,1647,3.50000000
CN4003300000000,40,033,"Cotton County, OK",May-22,2679,2608,71,2.70000000
CN4003500000000,40,035,"Craig County, OK",May-22,5812,5651,161,2.80000000
CN4003700000000,40,037,"Creek County, OK",May-22,31920,30850,1070,3.40000000
CN4003900000000,40,039,"Custer County, OK",May-22,15357,14972,385,2.50000000
CN4004100000000,40,041,"Delaware County, OK",May-22,18745,18211,534,2.80000000
CN4004300000000,40,043,"Dewey County, OK",May-22,2841,2785,56,2.00000000
CN4004500000000,40,045,"Ellis County, OK",May-22,2155,2109,46,2.10000000
CN4004700000000,40,047,"Garfield County, OK",May-22,26796,26074,722,2.70000000
CN4004900000000,40,049,"Garvin County, OK",May-22,12549,12206,343,2.70000000
CN4005100000000,40,051,"Grady County, OK",May-22,27311,26601,710,2.60000000
CN4005300000000,40,053,"Grant County, OK",May-22,2953,2905,48,1.60000000
CN4005500000000,40,055,"Greer County, OK",May-22,1865,1805,60,3.20000000
CN4005700000000,40,057,"Harmon County, OK",May-22,1195,1168,27,2.30000000
CN4005900000000,40,059,"Harper County, OK",May-22,1859,1827,32,1.70000000
CN4006100000000,40,061,"Haskell County, OK",May-22,4194,4010,184,4.40000000
CN4006300000000,40,063,"Hughes County, OK",May-22,5143,4945,198,3.80000000
CN4006500000000,40,065,"Jackson County, OK",May-22,10894,10612,282,2.60000000
CN4006700000000,40,067,"Jefferson County, OK",May-22,2504,2437,67,2.70000000
CN4006900000000,40,069,"Johnston County, OK",May-22,3679,3547,132,3.60000000
CN4007100000000,40,071,"Kay County, OK",May-22,18304,17677,627,3.40000000
CN4007300000000,40,073,"Kingfisher County, OK",May-22,8958,8790,168,1.90000000
CN4007500000000,40,075,"Kiowa County, OK",May-22,3733,3619,114,3.10000000
CN4007700000000,40,077,"Latimer County, OK",May-22,3110,2912,198,6.40000000
CN4007900000000,40,079,"Le Flore County, OK",May-22,19463,18767,696,3.60000000
CN4008100000000,40,081,"Lincoln County, OK",May-22,16229,15765,464,2.90000000
CN4008300000000,40,083,"Logan County, OK",May-22,23263,22691,572,2.50000000
CN4008500000000,40,085,"Love County, OK",May-22,6022,5906,116,1.90000000
CN4008700000000,40,087,"McClain County, OK",May-22,20940,20426,514,2.50000000
CN4008900000000,40,089,"McCurtain County, OK",May-22,16206,15588,618,3.80000000
CN4009100000000,40,091,"McIntosh County, OK",May-22,7245,6882,363,5.00000000
CN4009300000000,40,093,"Major County, OK",May-22,3698,3609,89,2.40000000
CN4009500000000,40,095,"Marshall County, OK",May-22,7384,7183,201,2.70000000
CN4009700000000,40,097,"Mayes County, OK",May-22,19460,18906,554,2.80000000
CN4009900000000,40,099,"Murray County, OK",May-22,6192,6018,174,2.80000000
CN4010100000000,40,101,"Muskogee County, OK",May-22,27839,26900,939,3.40000000
CN4010300000000,40,103,"Noble County, OK",May-22,5667,5550,117,2.10000000
CN4010500000000,40,105,"Nowata County, OK",May-22,4676,4546,130,2.80000000
CN4010700000000,40,107,"Okfuskee County, OK",May-22,4449,4279,170,3.80000000
CN4010900000000,40,109,"Oklahoma County, OK",May-22,396405,385117,11288,2.80000000
CN4011100000000,40,111,"Okmulgee County, OK",May-22,15809,15177,632,4.00000000
CN4011300000000,40,113,"Osage County, OK",May-22,20804,20078,726,3.50000000
CN4011500000000,40,115,"Ottawa County, OK",May-22,14859,14462,397,2.70000000
CN4011700000000,40,117,"Pawnee County, OK",May-22,7485,7243,242,3.20000000
CN4011900000000,40,119,"Payne County, OK",May-22,37592,36643,949,2.50000000
CN4012100000000,40,121,"Pittsburg County, OK",May-22,16275,15548,727,4.50000000
CN4012300000000,40,123,"Pontotoc County, OK",May-22,19098,18572,526,2.80000000
CN4012500000000,40,125,"Pottawatomie County, OK",May-22,32932,31862,1070,3.20000000
CN4012700000000,40,127,"Pushmataha County, OK",May-22,4798,4636,162,3.40000000
CN4012900000000,40,129,"Roger Mills County, OK",May-22,1849,1810,39,2.10000000
CN4013100000000,40,131,"Rogers County, OK",May-22,45969,44700,1269,2.80000000
CN4013300000000,40,133,"Seminole County, OK",May-22,9127,8762,365,4.00000000
CN4013500000000,40,135,"Sequoyah County, OK",May-22,16775,16215,560,3.30000000
CN4013700000000,40,137,"Stephens County, OK",May-22,18868,18279,589,3.10000000
CN4013900000000,40,139,"Texas County, OK",May-22,11815,11626,189,1.60000000
CN4014100000000,40,141,"Tillman County, OK",May-22,2843,2763,80,2.80000000
CN4014300000000,40,143,"Tulsa County, OK",May-22,331119,321460,9659,2.90000000
CN4014500000000,40,145,"Wagoner County, OK",May-22,39664,38545,1119,2.80000000
CN4014700000000,40,147,"Washington County, OK",May-22,22329,21622,707,3.20000000
CN4014900000000,40,149,"Washita County, OK",May-22,5009,4842,167,3.30000000
CN4015100000000,40,151,"Woods County, OK",May-22,4747,4666,81,1.70000000
CN4015300000000,40,153,"Woodward County, OK",May-22,8534,8290,244,2.90000000
CN4100100000000,41,001,"Baker County, OR",May-22,7697,7456,241,3.10000000
CN4100300000000,41,003,"Benton County, OR",May-22,49565,48390,1175,2.40000000
CN4100500000000,41,005,"Clackamas County, OR",May-22,229742,223411,6331,2.80000000
CN4100700000000,41,007,"Clatsop County, OR",May-22,19737,19087,650,3.30000000
CN4100900000000,41,009,"Columbia County, OR",May-22,25385,24476,909,3.60000000
CN4101100000000,41,011,"Coos County, OR",May-22,26822,25737,1085,4.00000000
CN4101300000000,41,013,"Crook County, OR",May-22,11431,10978,453,4.00000000
CN4101500000000,41,015,"Curry County, OR",May-22,9219,8842,377,4.10000000
CN4101700000000,41,017,"Deschutes County, OR",May-22,105143,102116,3027,2.90000000
CN4101900000000,41,019,"Douglas County, OR",May-22,48030,46202,1828,3.80000000
CN4102100000000,41,021,"Gilliam County, OR",May-22,1015,988,27,2.70000000
CN4102300000000,41,023,"Grant County, OR",May-22,3150,3002,148,4.70000000
CN4102500000000,41,025,"Harney County, OR",May-22,3804,3683,121,3.20000000
CN4102700000000,41,027,"Hood River County, OR",May-22,13954,13596,358,2.60000000
CN4102900000000,41,029,"Jackson County, OR",May-22,108314,104676,3638,3.40000000
CN4103100000000,41,031,"Jefferson County, OR",May-22,10800,10396,404,3.70000000
CN4103300000000,41,033,"Josephine County, OR",May-22,37498,35952,1546,4.10000000
CN4103500000000,41,035,"Klamath County, OR",May-22,30417,29131,1286,4.20000000
CN4103700000000,41,037,"Lake County, OR",May-22,3708,3568,140,3.80000000
CN4103900000000,41,039,"Lane County, OR",May-22,186766,180629,6137,3.30000000
CN4104100000000,41,041,"Lincoln County, OR",May-22,21186,20309,877,4.10000000
CN4104300000000,41,043,"Linn County, OR",May-22,61455,59340,2115,3.40000000
CN4104500000000,41,045,"Malheur County, OR",May-22,12745,12370,375,2.90000000
CN4104700000000,41,047,"Marion County, OR",May-22,169848,164648,5200,3.10000000
CN4104900000000,41,049,"Morrow County, OR",May-22,6057,5887,170,2.80000000
CN4105100000000,41,051,"Multnomah County, OR",May-22,474669,460128,14541,3.10000000
CN4105300000000,41,053,"Polk County, OR",May-22,42678,41394,1284,3.00000000
CN4105500000000,41,055,"Sherman County, OR",May-22,966,941,25,2.60000000
CN4105700000000,41,057,"Tillamook County, OR",May-22,12451,12044,407,3.30000000
CN4105900000000,41,059,"Umatilla County, OR",May-22,38259,37049,1210,3.20000000
CN4106100000000,41,061,"Union County, OR",May-22,12371,11968,403,3.30000000
CN4106300000000,41,063,"Wallowa County, OR",May-22,3708,3572,136,3.70000000
CN4106500000000,41,065,"Wasco County, OR",May-22,13077,12643,434,3.30000000
CN4106700000000,41,067,"Washington County, OR",May-22,338611,330222,8389,2.50000000
CN4106900000000,41,069,"Wheeler County, OR",May-22,727,711,16,2.20000000
CN4107100000000,41,071,"Yamhill County, OR",May-22,57175,55604,1571,2.70000000
CN4200100000000,42,001,"Adams County, PA",May-22,55808,54267,1541,2.80000000
CN4200300000000,42,003,"Allegheny County, PA",May-22,636811,612158,24653,3.90000000
CN4200500000000,42,005,"Armstrong County, PA",May-22,31403,29959,1444,4.60000000
CN4200700000000,42,007,"Beaver County, PA",May-22,82458,78460,3998,4.80000000
CN4200900000000,42,009,"Bedford County, PA",May-22,24199,23317,882,3.60000000
CN4201100000000,42,011,"Berks County, PA",May-22,212064,203195,8869,4.20000000
CN4201300000000,42,013,"Blair County, PA",May-22,59760,57481,2279,3.80000000
CN4201500000000,42,015,"Bradford County, PA",May-22,28173,27149,1024,3.60000000
CN4201700000000,42,017,"Bucks County, PA",May-22,347182,335249,11933,3.40000000
CN4201900000000,42,019,"Butler County, PA",May-22,99330,95872,3458,3.50000000
CN4202100000000,42,021,"Cambria County, PA",May-22,55688,53106,2582,4.60000000
CN4202300000000,42,023,"Cameron County, PA",May-22,2001,1902,99,4.90000000
CN4202500000000,42,025,"Carbon County, PA",May-22,32707,31210,1497,4.60000000
CN4202700000000,42,027,"Centre County, PA",May-22,78505,76136,2369,3.00000000
CN4202900000000,42,029,"Chester County, PA",May-22,293324,285287,8037,2.70000000
CN4203100000000,42,031,"Clarion County, PA",May-22,16814,16093,721,4.30000000
CN4203300000000,42,033,"Clearfield County, PA",May-22,35485,33836,1649,4.60000000
CN4203500000000,42,035,"Clinton County, PA",May-22,17264,16484,780,4.50000000
CN4203700000000,42,037,"Columbia County, PA",May-22,33315,32036,1279,3.80000000
CN4203900000000,42,039,"Crawford County, PA",May-22,38058,36477,1581,4.20000000
CN4204100000000,42,041,"Cumberland County, PA",May-22,137221,133194,4027,2.90000000
CN4204300000000,42,043,"Dauphin County, PA",May-22,148563,143025,5538,3.70000000
CN4204500000000,42,045,"Delaware County, PA",May-22,297432,285441,11991,4.00000000
CN4204700000000,42,047,"Elk County, PA",May-22,14876,14201,675,4.50000000
CN4204900000000,42,049,"Erie County, PA",May-22,127015,121146,5869,4.60000000
CN4205100000000,42,051,"Fayette County, PA",May-22,55522,52448,3074,5.50000000
CN4205300000000,42,053,"Forest County, PA",May-22,1739,1645,94,5.40000000
CN4205500000000,42,055,"Franklin County, PA",May-22,78400,75874,2526,3.20000000
CN4205700000000,42,057,"Fulton County, PA",May-22,7223,6956,267,3.70000000
CN4205900000000,42,059,"Greene County, PA",May-22,15554,14766,788,5.10000000
CN4206100000000,42,061,"Huntingdon County, PA",May-22,19401,18515,886,4.60000000
CN4206300000000,42,063,"Indiana County, PA",May-22,36185,34504,1681,4.60000000
CN4206500000000,42,065,"Jefferson County, PA",May-22,19721,18914,807,4.10000000
CN4206700000000,42,067,"Juniata County, PA",May-22,12889,12469,420,3.30000000
CN4206900000000,42,069,"Lackawanna County, PA",May-22,104268,99604,4664,4.50000000
CN4207100000000,42,071,"Lancaster County, PA",May-22,287012,277928,9084,3.20000000
CN4207300000000,42,073,"Lawrence County, PA",May-22,39547,37696,1851,4.70000000
CN4207500000000,42,075,"Lebanon County, PA",May-22,74402,71919,2483,3.30000000
CN4207700000000,42,077,"Lehigh County, PA",May-22,198903,190449,8454,4.30000000
CN4207900000000,42,079,"Luzerne County, PA",May-22,157232,149046,8186,5.20000000
CN4208100000000,42,081,"Lycoming County, PA",May-22,54748,52352,2396,4.40000000
CN4208300000000,42,083,"McKean County, PA",May-22,16796,16017,779,4.60000000
CN4208500000000,42,085,"Mercer County, PA",May-22,47597,45428,2169,4.60000000
CN4208700000000,42,087,"Mifflin County, PA",May-22,21001,20148,853,4.10000000
CN4208900000000,42,089,"Monroe County, PA",May-22,83073,78564,4509,5.40000000
CN4209100000000,42,091,"Montgomery County, PA",May-22,461682,447180,14502,3.10000000
CN4209300000000,42,093,"Montour County, PA",May-22,9066,8806,260,2.90000000
CN4209500000000,42,095,"Northampton County, PA",May-22,165160,158892,6268,3.80000000
CN4209700000000,42,097,"Northumberland County, PA",May-22,42308,40398,1910,4.50000000
CN4209900000000,42,099,"Perry County, PA",May-22,25134,24406,728,2.90000000
CN4210100000000,42,101,"Philadelphia County/city, PA",May-22,724879,683244,41635,5.70000000
CN4210300000000,42,103,"Pike County, PA",May-22,25898,24546,1352,5.20000000
CN4210500000000,42,105,"Potter County, PA",May-22,7222,6878,344,4.80000000
CN4210700000000,42,107,"Schuylkill County, PA",May-22,65285,62289,2996,4.60000000
CN4210900000000,42,109,"Snyder County, PA",May-22,19715,19012,703,3.60000000
CN4211100000000,42,111,"Somerset County, PA",May-22,32485,30955,1530,4.70000000
CN4211300000000,42,113,"Sullivan County, PA",May-22,2610,2481,129,4.90000000
CN4211500000000,42,115,"Susquehanna County, PA",May-22,20485,19759,726,3.50000000
CN4211700000000,42,117,"Tioga County, PA",May-22,19114,18311,803,4.20000000
CN4211900000000,42,119,"Union County, PA",May-22,19944,19283,661,3.30000000
CN4212100000000,42,121,"Venango County, PA",May-22,21477,20526,951,4.40000000
CN4212300000000,42,123,"Warren County, PA",May-22,17712,17006,706,4.00000000
CN4212500000000,42,125,"Washington County, PA",May-22,105643,101209,4434,4.20000000
CN4212700000000,42,127,"Wayne County, PA",May-22,22432,21426,1006,4.50000000
CN4212900000000,42,129,"Westmoreland County, PA",May-22,176954,169918,7036,4.00000000
CN4213100000000,42,131,"Wyoming County, PA",May-22,13440,12873,567,4.20000000
CN4213300000000,42,133,"York County, PA",May-22,239020,230917,8103,3.40000000
CN4400100000000,44,001,"Bristol County, RI",May-22,26406,25885,521,2.00000000
CN4400300000000,44,003,"Kent County, RI",May-22,93360,91102,2258,2.40000000
CN4400500000000,44,005,"Newport County, RI",May-22,44912,43923,989,2.20000000
CN4400700000000,44,007,"Providence County, RI",May-22,333487,323403,10084,3.00000000
CN4400900000000,44,009,"Washington County, RI",May-22,69639,68147,1492,2.10000000
CN4500100000000,45,001,"Abbeville County, SC",May-22,9581,9244,337,3.50000000
CN4500300000000,45,003,"Aiken County, SC",May-22,75790,73626,2164,2.90000000
CN4500500000000,45,005,"Allendale County, SC",May-22,2388,2246,142,5.90000000
CN4500700000000,45,007,"Anderson County, SC",May-22,91890,89320,2570,2.80000000
CN4500900000000,45,009,"Bamberg County, SC",May-22,4619,4348,271,5.90000000
CN4501100000000,45,011,"Barnwell County, SC",May-22,7568,7182,386,5.10000000
CN4501300000000,45,013,"Beaufort County, SC",May-22,78379,76237,2142,2.70000000
CN4501500000000,45,015,"Berkeley County, SC",May-22,110734,107378,3356,3.00000000
CN4501700000000,45,017,"Calhoun County, SC",May-22,6465,6249,216,3.30000000
CN4501900000000,45,019,"Charleston County, SC",May-22,217921,212230,5691,2.60000000
CN4502100000000,45,021,"Cherokee County, SC",May-22,24648,23597,1051,4.30000000
CN4502300000000,45,023,"Chester County, SC",May-22,13559,12963,596,4.40000000
CN4502500000000,45,025,"Chesterfield County, SC",May-22,21867,21138,729,3.30000000
CN4502700000000,45,027,"Clarendon County, SC",May-22,12566,12107,459,3.70000000
CN4502900000000,45,029,"Colleton County, SC",May-22,16558,16031,527,3.20000000
CN4503100000000,45,031,"Darlington County, SC",May-22,29856,28840,1016,3.40000000
CN4503300000000,45,033,"Dillon County, SC",May-22,13231,12611,620,4.70000000
CN4503500000000,45,035,"Dorchester County, SC",May-22,80364,78056,2308,2.90000000
CN4503700000000,45,037,"Edgefield County, SC",May-22,10716,10412,304,2.80000000
CN4503900000000,45,039,"Fairfield County, SC",May-22,9278,8835,443,4.80000000
CN4504100000000,45,041,"Florence County, SC",May-22,66025,63974,2051,3.10000000
CN4504300000000,45,043,"Georgetown County, SC",May-22,26586,25669,917,3.40000000
CN4504500000000,45,045,"Greenville County, SC",May-22,261122,254178,6944,2.70000000
CN4504700000000,45,047,"Greenwood County, SC",May-22,30158,29106,1052,3.50000000
CN4504900000000,45,049,"Hampton County, SC",May-22,8152,7936,216,2.60000000
CN4505100000000,45,051,"Horry County, SC",May-22,154986,149467,5519,3.60000000
CN4505300000000,45,053,"Jasper County, SC",May-22,13675,13302,373,2.70000000
CN4505500000000,45,055,"Kershaw County, SC",May-22,29437,28542,895,3.00000000
CN4505700000000,45,057,"Lancaster County, SC",May-22,44148,42653,1495,3.40000000
CN4505900000000,45,059,"Laurens County, SC",May-22,30358,29371,987,3.30000000
CN4506100000000,45,061,"Lee County, SC",May-22,6618,6308,310,4.70000000
CN4506300000000,45,063,"Lexington County, SC",May-22,151292,147520,3772,2.50000000
CN4506500000000,45,065,"McCormick County, SC",May-22,3335,3219,116,3.50000000
CN4506700000000,45,067,"Marion County, SC",May-22,12947,12274,673,5.20000000
CN4506900000000,45,069,"Marlboro County, SC",May-22,8822,8238,584,6.60000000
CN4507100000000,45,071,"Newberry County, SC",May-22,19457,18962,495,2.50000000
CN4507300000000,45,073,"Oconee County, SC",May-22,34319,33375,944,2.80000000
CN4507500000000,45,075,"Orangeburg County, SC",May-22,33447,31519,1928,5.80000000
CN4507700000000,45,077,"Pickens County, SC",May-22,58368,56573,1795,3.10000000
CN4507900000000,45,079,"Richland County, SC",May-22,196586,190217,6369,3.20000000
CN4508100000000,45,081,"Saluda County, SC",May-22,8645,8435,210,2.40000000
CN4508300000000,45,083,"Spartanburg County, SC",May-22,158590,153885,4705,3.00000000
CN4508500000000,45,085,"Sumter County, SC",May-22,42396,40865,1531,3.60000000
CN4508700000000,45,087,"Union County, SC",May-22,11539,11008,531,4.60000000
CN4508900000000,45,089,"Williamsburg County, SC",May-22,10898,10383,515,4.70000000
CN4509100000000,45,091,"York County, SC",May-22,149957,145397,4560,3.00000000
CN4600300000000,46,003,"Aurora County, SD",May-22,1540,1510,30,1.90000000
CN4600500000000,46,005,"Beadle County, SD",May-22,9373,9181,192,2.00000000
CN4600700000000,46,007,"Bennett County, SD",May-22,1052,1019,33,3.10000000
CN4600900000000,46,009,"Bon Homme County, SD",May-22,2931,2871,60,2.00000000
CN4601100000000,46,011,"Brookings County, SD",May-22,18925,18534,391,2.10000000
CN4601300000000,46,013,"Brown County, SD",May-22,20516,20029,487,2.40000000
CN4601500000000,46,015,"Brule County, SD",May-22,2706,2654,52,1.90000000
CN4601700000000,46,017,"Buffalo County, SD",May-22,667,642,25,3.70000000
CN4601900000000,46,019,"Butte County, SD",May-22,4975,4869,106,2.10000000
CN4602100000000,46,021,"Campbell County, SD",May-22,798,778,20,2.50000000
CN4602300000000,46,023,"Charles Mix County, SD",May-22,3957,3863,94,2.40000000
CN4602500000000,46,025,"Clark County, SD",May-22,2008,1961,47,2.30000000
CN4602700000000,46,027,"Clay County, SD",May-22,7098,6933,165,2.30000000
CN4602900000000,46,029,"Codington County, SD",May-22,15873,15533,340,2.10000000
CN4603100000000,46,031,"Corson County, SD",May-22,1347,1304,43,3.20000000
CN4603300000000,46,033,"Custer County, SD",May-22,4301,4179,122,2.80000000
CN4603500000000,46,035,"Davison County, SD",May-22,11118,10905,213,1.90000000
CN4603700000000,46,037,"Day County, SD",May-22,2758,2676,82,3.00000000
CN4603900000000,46,039,"Deuel County, SD",May-22,2349,2284,65,2.80000000
CN4604100000000,46,041,"Dewey County, SD",May-22,2256,2172,84,3.70000000
CN4604300000000,46,043,"Douglas County, SD",May-22,1618,1589,29,1.80000000
CN4604500000000,46,045,"Edmunds County, SD",May-22,2059,2021,38,1.80000000
CN4604700000000,46,047,"Fall River County, SD",May-22,3204,3122,82,2.60000000
CN4604900000000,46,049,"Faulk County, SD",May-22,1133,1108,25,2.20000000
CN4605100000000,46,051,"Grant County, SD",May-22,4491,4397,94,2.10000000
CN4605300000000,46,053,"Gregory County, SD",May-22,2173,2131,42,1.90000000
CN4605500000000,46,055,"Haakon County, SD",May-22,1088,1067,21,1.90000000
CN4605700000000,46,057,"Hamlin County, SD",May-22,3603,3538,65,1.80000000
CN4605900000000,46,059,"Hand County, SD",May-22,1832,1797,35,1.90000000
CN4606100000000,46,061,"Hanson County, SD",May-22,1811,1767,44,2.40000000
CN4606300000000,46,063,"Harding County, SD",May-22,754,740,14,1.90000000
CN4606500000000,46,065,"Hughes County, SD",May-22,9990,9807,183,1.80000000
CN4606700000000,46,067,"Hutchinson County, SD",May-22,3734,3653,81,2.20000000
CN4606900000000,46,069,"Hyde County, SD",May-22,689,673,16,2.30000000
CN4607100000000,46,071,"Jackson County, SD",May-22,1301,1267,34,2.60000000
CN4607300000000,46,073,"Jerauld County, SD",May-22,1429,1405,24,1.70000000
CN4607500000000,46,075,"Jones County, SD",May-22,539,525,14,2.60000000
CN4607700000000,46,077,"Kingsbury County, SD",May-22,2900,2837,63,2.20000000
CN4607900000000,46,079,"Lake County, SD",May-22,6655,6503,152,2.30000000
CN4608100000000,46,081,"Lawrence County, SD",May-22,13914,13625,289,2.10000000
CN4608300000000,46,083,"Lincoln County, SD",May-22,37824,37154,670,1.80000000
CN4608500000000,46,085,"Lyman County, SD",May-22,1697,1655,42,2.50000000
CN4608700000000,46,087,"McCook County, SD",May-22,3169,3113,56,1.80000000
CN4608900000000,46,089,"McPherson County, SD",May-22,1020,993,27,2.60000000
CN4609100000000,46,091,"Marshall County, SD",May-22,2538,2465,73,2.90000000
CN4609300000000,46,093,"Meade County, SD",May-22,14618,14293,325,2.20000000
CN4609500000000,46,095,"Mellette County, SD",May-22,758,737,21,2.80000000
CN4609700000000,46,097,"Miner County, SD",May-22,1221,1197,24,2.00000000
CN4609900000000,46,099,"Minnehaha County, SD",May-22,117338,115065,2273,1.90000000
CN4610100000000,46,101,"Moody County, SD",May-22,4092,4012,80,2.00000000
CN4610200000000,46,102,"Oglala Lakota County, SD",May-22,3642,3439,203,5.60000000
CN4610300000000,46,103,"Pennington County, SD",May-22,60172,58841,1331,2.20000000
CN4610500000000,46,105,"Perkins County, SD",May-22,1479,1448,31,2.10000000
CN4610700000000,46,107,"Potter County, SD",May-22,1098,1073,25,2.30000000
CN4610900000000,46,109,"Roberts County, SD",May-22,4648,4503,145,3.10000000
CN4611100000000,46,111,"Sanborn County, SD",May-22,1252,1226,26,2.10000000
CN4611500000000,46,115,"Spink County, SD",May-22,3234,3155,79,2.40000000
CN4611700000000,46,117,"Stanley County, SD",May-22,1966,1927,39,2.00000000
CN4611900000000,46,119,"Sully County, SD",May-22,848,831,17,2.00000000
CN4612100000000,46,121,"Todd County, SD",May-22,2986,2888,98,3.30000000
CN4612300000000,46,123,"Tripp County, SD",May-22,3157,3105,52,1.60000000
CN4612500000000,46,125,"Turner County, SD",May-22,4841,4745,96,2.00000000
CN4612700000000,46,127,"Union County, SD",May-22,8722,8524,198,2.30000000
CN4612900000000,46,129,"Walworth County, SD",May-22,2186,2106,80,3.70000000
CN4613500000000,46,135,"Yankton County, SD",May-22,11726,11500,226,1.90000000
CN4613700000000,46,137,"Ziebach County, SD",May-22,957,927,30,3.10000000
CN4700100000000,47,001,"Anderson County, TN",May-22,35948,34801,1147,3.20000000
CN4700300000000,47,003,"Bedford County, TN",May-22,21742,21025,717,3.30000000
CN4700500000000,47,005,"Benton County, TN",May-22,6900,6620,280,4.10000000
CN4700700000000,47,007,"Bledsoe County, TN",May-22,4375,4151,224,5.10000000
CN4700900000000,47,009,"Blount County, TN",May-22,66788,64801,1987,3.00000000
CN4701100000000,47,011,"Bradley County, TN",May-22,51052,49336,1716,3.40000000
CN4701300000000,47,013,"Campbell County, TN",May-22,15254,14645,609,4.00000000
CN4701500000000,47,015,"Cannon County, TN",May-22,6953,6748,205,2.90000000
CN4701700000000,47,017,"Carroll County, TN",May-22,11448,11002,446,3.90000000
CN4701900000000,47,019,"Carter County, TN",May-22,24671,23783,888,3.60000000
CN4702100000000,47,021,"Cheatham County, TN",May-22,22978,22374,604,2.60000000
CN4702300000000,47,023,"Chester County, TN",May-22,8610,8366,244,2.80000000
CN4702500000000,47,025,"Claiborne County, TN",May-22,13052,12588,464,3.60000000
CN4702700000000,47,027,"Clay County, TN",May-22,2825,2699,126,4.50000000
CN4702900000000,47,029,"Cocke County, TN",May-22,14892,14175,717,4.80000000
CN4703100000000,47,031,"Coffee County, TN",May-22,25335,24475,860,3.40000000
CN4703300000000,47,033,"Crockett County, TN",May-22,6911,6700,211,3.10000000
CN4703500000000,47,035,"Cumberland County, TN",May-22,22751,21832,919,4.00000000
CN4703700000000,47,037,"Davidson County, TN",May-22,419259,407058,12201,2.90000000
CN4703900000000,47,039,"Decatur County, TN",May-22,4282,4079,203,4.70000000
CN4704100000000,47,041,"DeKalb County, TN",May-22,7988,7675,313,3.90000000
CN4704300000000,47,043,"Dickson County, TN",May-22,28296,27473,823,2.90000000
CN4704500000000,47,045,"Dyer County, TN",May-22,16080,15487,593,3.70000000
CN4704700000000,47,047,"Fayette County, TN",May-22,19668,18996,672,3.40000000
CN4704900000000,47,049,"Fentress County, TN",May-22,7647,7366,281,3.70000000
CN4705100000000,47,051,"Franklin County, TN",May-22,19626,18958,668,3.40000000
CN4705300000000,47,053,"Gibson County, TN",May-22,21566,20815,751,3.50000000
CN4705500000000,47,055,"Giles County, TN",May-22,14781,14291,490,3.30000000
CN4705700000000,47,057,"Grainger County, TN",May-22,9911,9555,356,3.60000000
CN4705900000000,47,059,"Greene County, TN",May-22,28948,27868,1080,3.70000000
CN4706100000000,47,061,"Grundy County, TN",May-22,5177,4940,237,4.60000000
CN4706300000000,47,063,"Hamblen County, TN",May-22,28611,27609,1002,3.50000000
CN4706500000000,47,065,"Hamilton County, TN",May-22,185853,179725,6128,3.30000000
CN4706700000000,47,067,"Hancock County, TN",May-22,2315,2214,101,4.40000000
CN4706900000000,47,069,"Hardeman County, TN",May-22,8888,8489,399,4.50000000
CN4707100000000,47,071,"Hardin County, TN",May-22,10167,9770,397,3.90000000
CN4707300000000,47,073,"Hawkins County, TN",May-22,23634,22754,880,3.70000000
CN4707500000000,47,075,"Haywood County, TN",May-22,7626,7295,331,4.30000000
CN4707700000000,47,077,"Henderson County, TN",May-22,12040,11625,415,3.40000000
CN4707900000000,47,079,"Henry County, TN",May-22,14442,13935,507,3.50000000
CN4708100000000,47,081,"Hickman County, TN",May-22,11919,11586,333,2.80000000
CN4708300000000,47,083,"Houston County, TN",May-22,3255,3124,131,4.00000000
CN4708500000000,47,085,"Humphreys County, TN",May-22,8826,8525,301,3.40000000
CN4708700000000,47,087,"Jackson County, TN",May-22,4834,4659,175,3.60000000
CN4708900000000,47,089,"Jefferson County, TN",May-22,25416,24540,876,3.40000000
CN4709100000000,47,091,"Johnson County, TN",May-22,7756,7510,246,3.20000000
CN4709300000000,47,093,"Knox County, TN",May-22,255768,248691,7077,2.80000000
CN4709500000000,47,095,"Lake County, TN",May-22,1648,1567,81,4.90000000
CN4709700000000,47,097,"Lauderdale County, TN",May-22,9659,9201,458,4.70000000
CN4709900000000,47,099,"Lawrence County, TN",May-22,19682,19020,662,3.40000000
CN4710100000000,47,101,"Lewis County, TN",May-22,5782,5581,201,3.50000000
CN4710300000000,47,103,"Lincoln County, TN",May-22,16343,15791,552,3.40000000
CN4710500000000,47,105,"Loudon County, TN",May-22,24821,24051,770,3.10000000
CN4710700000000,47,107,"McMinn County, TN",May-22,22224,21387,837,3.80000000
CN4710900000000,47,109,"McNairy County, TN",May-22,8350,7968,382,4.60000000
CN4711100000000,47,111,"Macon County, TN",May-22,11811,11455,356,3.00000000
CN4711300000000,47,113,"Madison County, TN",May-22,49634,47926,1708,3.40000000
CN4711500000000,47,115,"Marion County, TN",May-22,12461,11999,462,3.70000000
CN4711700000000,47,117,"Marshall County, TN",May-22,15689,15170,519,3.30000000
CN4711900000000,47,119,"Maury County, TN",May-22,53737,52077,1660,3.10000000
CN4712100000000,47,121,"Meigs County, TN",May-22,5248,5036,212,4.00000000
CN4712300000000,47,123,"Monroe County, TN",May-22,21247,20558,689,3.20000000
CN4712500000000,47,125,"Montgomery County, TN",May-22,89186,85902,3284,3.70000000
CN4712700000000,47,127,"Moore County, TN",May-22,3673,3582,91,2.50000000
CN4712900000000,47,129,"Morgan County, TN",May-22,7976,7687,289,3.60000000
CN4713100000000,47,131,"Obion County, TN",May-22,12414,11933,481,3.90000000
CN4713300000000,47,133,"Overton County, TN",May-22,10149,9824,325,3.20000000
CN4713500000000,47,135,"Perry County, TN",May-22,2815,2660,155,5.50000000
CN4713700000000,47,137,"Pickett County, TN",May-22,2214,2137,77,3.50000000
CN4713900000000,47,139,"Polk County, TN",May-22,7168,6912,256,3.60000000
CN4714100000000,47,141,"Putnam County, TN",May-22,35701,34506,1195,3.30000000
CN4714300000000,47,143,"Rhea County, TN",May-22,14105,13541,564,4.00000000
CN4714500000000,47,145,"Roane County, TN",May-22,24189,23333,856,3.50000000
CN4714700000000,47,147,"Robertson County, TN",May-22,39718,38617,1101,2.80000000
CN4714900000000,47,149,"Rutherford County, TN",May-22,198228,192834,5394,2.70000000
CN4715100000000,47,151,"Scott County, TN",May-22,8127,7743,384,4.70000000
CN4715300000000,47,153,"Sequatchie County, TN",May-22,6257,6020,237,3.80000000
CN4715500000000,47,155,"Sevier County, TN",May-22,57129,55553,1576,2.80000000
CN4715700000000,47,157,"Shelby County, TN",May-22,450722,428552,22170,4.90000000
CN4715900000000,47,159,"Smith County, TN",May-22,9891,9604,287,2.90000000
CN4716100000000,47,161,"Stewart County, TN",May-22,5428,5225,203,3.70000000
CN4716300000000,47,163,"Sullivan County, TN",May-22,70300,67893,2407,3.40000000
CN4716500000000,47,165,"Sumner County, TN",May-22,110352,107363,2989,2.70000000
CN4716700000000,47,167,"Tipton County, TN",May-22,28250,27252,998,3.50000000
CN4716900000000,47,169,"Trousdale County, TN",May-22,5805,5631,174,3.00000000
CN4717100000000,47,171,"Unicoi County, TN",May-22,7197,6915,282,3.90000000
CN4717300000000,47,173,"Union County, TN",May-22,8018,7731,287,3.60000000
CN4717500000000,47,175,"Van Buren County, TN",May-22,2084,1997,87,4.20000000
CN4717700000000,47,177,"Warren County, TN",May-22,16774,16096,678,4.00000000
CN4717900000000,47,179,"Washington County, TN",May-22,62757,60791,1966,3.10000000
CN4718100000000,47,181,"Wayne County, TN",May-22,6389,6128,261,4.10000000
CN4718300000000,47,183,"Weakley County, TN",May-22,15511,15006,505,3.30000000
CN4718500000000,47,185,"White County, TN",May-22,11748,11332,416,3.50000000
CN4718700000000,47,187,"Williamson County, TN",May-22,140104,136887,3217,2.30000000
CN4718900000000,47,189,"Wilson County, TN",May-22,83050,80880,2170,2.60000000
CN4800100000000,48,001,"Anderson County, TX",May-22,23254,22529,725,3.10000000
CN4800300000000,48,003,"Andrews County, TX",May-22,8737,8420,317,3.60000000
CN4800500000000,48,005,"Angelina County, TX",May-22,35469,33850,1619,4.60000000
CN4800700000000,48,007,"Aransas County, TX",May-22,9264,8784,480,5.20000000
CN4800900000000,48,009,"Archer County, TX",May-22,4009,3886,123,3.10000000
CN4801100000000,48,011,"Armstrong County, TX",May-22,933,911,22,2.40000000
CN4801300000000,48,013,"Atascosa County, TX",May-22,22176,21271,905,4.10000000
CN4801500000000,48,015,"Austin County, TX",May-22,14042,13510,532,3.80000000
CN4801700000000,48,017,"Bailey County, TX",May-22,2409,2315,94,3.90000000
CN4801900000000,48,019,"Bandera County, TX",May-22,10425,10074,351,3.40000000
CN4802100000000,48,021,"Bastrop County, TX",May-22,46446,45007,1439,3.10000000
CN4802300000000,48,023,"Baylor County, TX",May-22,1841,1794,47,2.60000000
CN4802500000000,48,025,"Bee County, TX",May-22,8875,8290,585,6.60000000
CN4802700000000,48,027,"Bell County, TX",May-22,148188,141988,6200,4.20000000
CN4802900000000,48,029,"Bexar County, TX",May-22,959186,924912,34274,3.60000000
CN4803100000000,48,031,"Blanco County, TX",May-22,7027,6846,181,2.60000000
CN4803300000000,48,033,"Borden County, TX",May-22,697,685,12,1.70000000
CN4803500000000,48,035,"Bosque County, TX",May-22,8615,8327,288,3.30000000
CN4803700000000,48,037,"Bowie County, TX",May-22,39235,37517,1718,4.40000000
CN4803900000000,48,039,"Brazoria County, TX",May-22,183614,174995,8619,4.70000000
CN4804100000000,48,041,"Brazos County, TX",May-22,122646,119154,3492,2.80000000
CN4804300000000,48,043,"Brewster County, TX",May-22,4180,4043,137,3.30000000
CN4804500000000,48,045,"Briscoe County, TX",May-22,599,581,18,3.00000000
CN4804700000000,48,047,"Brooks County, TX",May-22,2469,2319,150,6.10000000
CN4804900000000,48,049,"Brown County, TX",May-22,15035,14474,561,3.70000000
CN4805100000000,48,051,"Burleson County, TX",May-22,8485,8201,284,3.30000000
CN4805300000000,48,053,"Burnet County, TX",May-22,24892,24212,680,2.70000000
CN4805500000000,48,055,"Caldwell County, TX",May-22,20524,19855,669,3.30000000
CN4805700000000,48,057,"Calhoun County, TX",May-22,12117,11689,428,3.50000000
CN4805900000000,48,059,"Callahan County, TX",May-22,6128,5927,201,3.30000000
CN4806100000000,48,061,"Cameron County, TX",May-22,174917,164370,10547,6.00000000
CN4806300000000,48,063,"Camp County, TX",May-22,5159,4944,215,4.20000000
CN4806500000000,48,065,"Carson County, TX",May-22,2997,2917,80,2.70000000
CN4806700000000,48,067,"Cass County, TX",May-22,12217,11653,564,4.60000000
CN4806900000000,48,069,"Castro County, TX",May-22,3446,3352,94,2.70000000
CN4807100000000,48,071,"Chambers County, TX",May-22,20930,19770,1160,5.50000000
CN4807300000000,48,073,"Cherokee County, TX",May-22,20544,19655,889,4.30000000
CN4807500000000,48,075,"Childress County, TX",May-22,3011,2926,85,2.80000000
CN4807700000000,48,077,"Clay County, TX",May-22,4866,4697,169,3.50000000
CN4807900000000,48,079,"Cochran County, TX",May-22,1098,1041,57,5.20000000
CN4808100000000,48,081,"Coke County, TX",May-22,1350,1299,51,3.80000000
CN4808300000000,48,083,"Coleman County, TX",May-22,2917,2792,125,4.30000000
CN4808500000000,48,085,"Collin County, TX",May-22,626675,608856,17819,2.80000000
CN4808700000000,48,087,"Collingsworth County, TX",May-22,1093,1060,33,3.00000000
CN4808900000000,48,089,"Colorado County, TX",May-22,10135,9806,329,3.20000000
CN4809100000000,48,091,"Comal County, TX",May-22,80496,77954,2542,3.20000000
CN4809300000000,48,093,"Comanche County, TX",May-22,6287,6085,202,3.20000000
CN4809500000000,48,095,"Concho County, TX",May-22,1387,1345,42,3.00000000
CN4809700000000,48,097,"Cooke County, TX",May-22,19629,19020,609,3.10000000
CN4809900000000,48,099,"Coryell County, TX",May-22,24472,23458,1014,4.10000000
CN4810100000000,48,101,"Cottle County, TX",May-22,629,608,21,3.30000000
CN4810300000000,48,103,"Crane County, TX",May-22,1543,1456,87,5.60000000
CN4810500000000,48,105,"Crockett County, TX",May-22,1429,1366,63,4.40000000
CN4810700000000,48,107,"Crosby County, TX",May-22,2442,2351,91,3.70000000
CN4810900000000,48,109,"Culberson County, TX",May-22,1071,1037,34,3.20000000
CN4811100000000,48,111,"Dallam County, TX",May-22,3806,3732,74,1.90000000
CN4811300000000,48,113,"Dallas County, TX",May-22,1426273,1375210,51063,3.60000000
CN4811500000000,48,115,"Dawson County, TX",May-22,4496,4284,212,4.70000000
CN4811700000000,48,117,"Deaf Smith County, TX",May-22,8977,8742,235,2.60000000
CN4811900000000,48,119,"Delta County, TX",May-22,2461,2374,87,3.50000000
CN4812100000000,48,121,"Denton County, TX",May-22,552851,536885,15966,2.90000000
CN4812300000000,48,123,"DeWitt County, TX",May-22,9443,9155,288,3.00000000
CN4812500000000,48,125,"Dickens County, TX",May-22,772,743,29,3.80000000
CN4812700000000,48,127,"Dimmit County, TX",May-22,5612,5375,237,4.20000000
CN4812900000000,48,129,"Donley County, TX",May-22,1498,1452,46,3.10000000
CN4813100000000,48,131,"Duval County, TX",May-22,5480,5201,279,5.10000000
CN4813300000000,48,133,"Eastland County, TX",May-22,7010,6706,304,4.30000000
CN4813500000000,48,135,"Ector County, TX",May-22,81187,77284,3903,4.80000000
CN4813700000000,48,137,"Edwards County, TX",May-22,1280,1245,35,2.70000000
CN4813900000000,48,139,"Ellis County, TX",May-22,103543,100284,3259,3.10000000
CN4814100000000,48,141,"El Paso County, TX",May-22,359062,343456,15606,4.30000000
CN4814300000000,48,143,"Erath County, TX",May-22,21372,20723,649,3.00000000
CN4814500000000,48,145,"Falls County, TX",May-22,6749,6487,262,3.90000000
CN4814700000000,48,147,"Fannin County, TX",May-22,17383,16875,508,2.90000000
CN4814900000000,48,149,"Fayette County, TX",May-22,11708,11334,374,3.20000000
CN4815100000000,48,151,"Fisher County, TX",May-22,1595,1544,51,3.20000000
CN4815300000000,48,153,"Floyd County, TX",May-22,2504,2400,104,4.20000000
CN4815500000000,48,155,"Foard County, TX",May-22,594,581,13,2.20000000
CN4815700000000,48,157,"Fort Bend County, TX",May-22,415730,399453,16277,3.90000000
CN4815900000000,48,159,"Franklin County, TX",May-22,5170,5021,149,2.90000000
CN4816100000000,48,161,"Freestone County, TX",May-22,6247,5904,343,5.50000000
CN4816300000000,48,163,"Frio County, TX",May-22,9443,9133,310,3.30000000
CN4816500000000,48,165,"Gaines County, TX",May-22,9803,9519,284,2.90000000
CN4816700000000,48,167,"Galveston County, TX",May-22,168088,160587,7501,4.50000000
CN4816900000000,48,169,"Garza County, TX",May-22,1965,1900,65,3.30000000
CN4817100000000,48,171,"Gillespie County, TX",May-22,14548,14199,349,2.40000000
CN4817300000000,48,173,"Glasscock County, TX",May-22,849,828,21,2.50000000
CN4817500000000,48,175,"Goliad County, TX",May-22,3120,2984,136,4.40000000
CN4817700000000,48,177,"Gonzales County, TX",May-22,9678,9399,279,2.90000000
CN4817900000000,48,179,"Gray County, TX",May-22,7730,7383,347,4.50000000
CN4818100000000,48,181,"Grayson County, TX",May-22,66843,64654,2189,3.30000000
CN4818300000000,48,183,"Gregg County, TX",May-22,56244,53800,2444,4.30000000
CN4818500000000,48,185,"Grimes County, TX",May-22,11100,10576,524,4.70000000
CN4818700000000,48,187,"Guadalupe County, TX",May-22,83821,81237,2584,3.10000000
CN4818900000000,48,189,"Hale County, TX",May-22,11995,11477,518,4.30000000
CN4819100000000,48,191,"Hall County, TX",May-22,1104,1062,42,3.80000000
CN4819300000000,48,193,"Hamilton County, TX",May-22,3760,3649,111,3.00000000
CN4819500000000,48,195,"Hansford County, TX",May-22,2605,2548,57,2.20000000
CN4819700000000,48,197,"Hardeman County, TX",May-22,1712,1657,55,3.20000000
CN4819900000000,48,199,"Hardin County, TX",May-22,24772,23436,1336,5.40000000
CN4820100000000,48,201,"Harris County, TX",May-22,2324944,2224953,99991,4.30000000
CN4820300000000,48,203,"Harrison County, TX",May-22,28340,26992,1348,4.80000000
CN4820500000000,48,205,"Hartley County, TX",May-22,2776,2732,44,1.60000000
CN4820700000000,48,207,"Haskell County, TX",May-22,2801,2724,77,2.70000000
CN4820900000000,48,209,"Hays County, TX",May-22,133450,129743,3707,2.80000000
CN4821100000000,48,211,"Hemphill County, TX",May-22,1535,1488,47,3.10000000
CN4821300000000,48,213,"Henderson County, TX",May-22,38922,37557,1365,3.50000000
CN4821500000000,48,215,"Hidalgo County, TX",May-22,367917,342509,25408,6.90000000
CN4821700000000,48,217,"Hill County, TX",May-22,17046,16442,604,3.50000000
CN4821900000000,48,219,"Hockley County, TX",May-22,11053,10649,404,3.70000000
CN4822100000000,48,221,"Hood County, TX",May-22,29576,28541,1035,3.50000000
CN4822300000000,48,223,"Hopkins County, TX",May-22,18103,17545,558,3.10000000
CN4822500000000,48,225,"Houston County, TX",May-22,10658,10311,347,3.30000000
CN4822700000000,48,227,"Howard County, TX",May-22,13416,12756,660,4.90000000
CN4822900000000,48,229,"Hudspeth County, TX",May-22,1860,1786,74,4.00000000
CN4823100000000,48,231,"Hunt County, TX",May-22,46867,45244,1623,3.50000000
CN4823300000000,48,233,"Hutchinson County, TX",May-22,8201,7828,373,4.50000000
CN4823500000000,48,235,"Irion County, TX",May-22,779,754,25,3.20000000
CN4823700000000,48,237,"Jack County, TX",May-22,3463,3338,125,3.60000000
CN4823900000000,48,239,"Jackson County, TX",May-22,7055,6827,228,3.20000000
CN4824100000000,48,241,"Jasper County, TX",May-22,12786,11910,876,6.90000000
CN4824300000000,48,243,"Jeff Davis County, TX",May-22,1063,1030,33,3.10000000
CN4824500000000,48,245,"Jefferson County, TX",May-22,101009,94113,6896,6.80000000
CN4824700000000,48,247,"Jim Hogg County, TX",May-22,1821,1711,110,6.00000000
CN4824900000000,48,249,"Jim Wells County, TX",May-22,15358,14366,992,6.50000000
CN4825100000000,48,251,"Johnson County, TX",May-22,87951,85126,2825,3.20000000
CN4825300000000,48,253,"Jones County, TX",May-22,5726,5484,242,4.20000000
CN4825500000000,48,255,"Karnes County, TX",May-22,6910,6692,218,3.20000000
CN4825700000000,48,257,"Kaufman County, TX",May-22,75266,72720,2546,3.40000000
CN4825900000000,48,259,"Kendall County, TX",May-22,23299,22656,643,2.80000000
CN4826100000000,48,261,"Kenedy County, TX",May-22,187,179,8,4.30000000
CN4826300000000,48,263,"Kent County, TX",May-22,467,455,12,2.60000000
CN4826500000000,48,265,"Kerr County, TX",May-22,21777,21052,725,3.30000000
CN4826700000000,48,267,"Kimble County, TX",May-22,1914,1858,56,2.90000000
CN4826900000000,48,269,"King County, TX",May-22,630,626,4,0.60000000
CN4827100000000,48,271,"Kinney County, TX",May-22,1196,1141,55,4.60000000
CN4827300000000,48,273,"Kleberg County, TX",May-22,13578,12930,648,4.80000000
CN4827500000000,48,275,"Knox County, TX",May-22,1502,1451,51,3.40000000
CN4827700000000,48,277,"Lamar County, TX",May-22,24114,23155,959,4.00000000
CN4827900000000,48,279,"Lamb County, TX",May-22,5256,5062,194,3.70000000
CN4828100000000,48,281,"Lampasas County, TX",May-22,9358,9045,313,3.30000000
CN4828300000000,48,283,"La Salle County, TX",May-22,3738,3622,116,3.10000000
CN4828500000000,48,285,"Lavaca County, TX",May-22,8519,8234,285,3.30000000
CN4828700000000,48,287,"Lee County, TX",May-22,9041,8761,280,3.10000000
CN4828900000000,48,289,"Leon County, TX",May-22,6201,5888,313,5.00000000
CN4829100000000,48,291,"Liberty County, TX",May-22,35204,33036,2168,6.20000000
CN4829300000000,48,293,"Limestone County, TX",May-22,8622,8239,383,4.40000000
CN4829500000000,48,295,"Lipscomb County, TX",May-22,1493,1455,38,2.50000000
CN4829700000000,48,297,"Live Oak County, TX",May-22,4778,4563,215,4.50000000
CN4829900000000,48,299,"Llano County, TX",May-22,9022,8699,323,3.60000000
CN4830100000000,48,301,"Loving County, TX",May-22,503,499,4,0.80000000
CN4830300000000,48,303,"Lubbock County, TX",May-22,162387,157474,4913,3.00000000
CN4830500000000,48,305,"Lynn County, TX",May-22,2898,2798,100,3.50000000
CN4830700000000,48,307,"McCulloch County, TX",May-22,3044,2912,132,4.30000000
CN4830900000000,48,309,"McLennan County, TX",May-22,124539,120369,4170,3.30000000
CN4831100000000,48,311,"McMullen County, TX",May-22,778,764,14,1.80000000
CN4831300000000,48,313,"Madison County, TX",May-22,4764,4558,206,4.30000000
CN4831500000000,48,315,"Marion County, TX",May-22,4229,4020,209,4.90000000
CN4831700000000,48,317,"Martin County, TX",May-22,2690,2605,85,3.20000000
CN4831900000000,48,319,"Mason County, TX",May-22,1839,1782,57,3.10000000
CN4832100000000,48,321,"Matagorda County, TX",May-22,16310,15229,1081,6.60000000
CN4832300000000,48,323,"Maverick County, TX",May-22,23019,20855,2164,9.40000000
CN4832500000000,48,325,"Medina County, TX",May-22,22284,21491,793,3.60000000
CN4832700000000,48,327,"Menard County, TX",May-22,808,777,31,3.80000000
CN4832900000000,48,329,"Midland County, TX",May-22,100902,97567,3335,3.30000000
CN4833100000000,48,331,"Milam County, TX",May-22,10299,9896,403,3.90000000
CN4833300000000,48,333,"Mills County, TX",May-22,1884,1812,72,3.80000000
CN4833500000000,48,335,"Mitchell County, TX",May-22,2312,2199,113,4.90000000
CN4833700000000,48,337,"Montague County, TX",May-22,9356,9047,309,3.30000000
CN4833900000000,48,339,"Montgomery County, TX",May-22,299586,288044,11542,3.90000000
CN4834100000000,48,341,"Moore County, TX",May-22,10907,10646,261,2.40000000
CN4834300000000,48,343,"Morris County, TX",May-22,4388,4075,313,7.10000000
CN4834500000000,48,345,"Motley County, TX",May-22,468,448,20,4.30000000
CN4834700000000,48,347,"Nacogdoches County, TX",May-22,28306,27201,1105,3.90000000
CN4834900000000,48,349,"Navarro County, TX",May-22,23756,22893,863,3.60000000
CN4835100000000,48,351,"Newton County, TX",May-22,4879,4522,357,7.30000000
CN4835300000000,48,353,"Nolan County, TX",May-22,6915,6684,231,3.30000000
CN4835500000000,48,355,"Nueces County, TX",May-22,163914,155926,7988,4.90000000
CN4835700000000,48,357,"Ochiltree County, TX",May-22,3962,3841,121,3.10000000
CN4835900000000,48,359,"Oldham County, TX",May-22,937,911,26,2.80000000
CN4836100000000,48,361,"Orange County, TX",May-22,34747,32593,2154,6.20000000
CN4836300000000,48,363,"Palo Pinto County, TX",May-22,12674,12198,476,3.80000000
CN4836500000000,48,365,"Panola County, TX",May-22,9680,9222,458,4.70000000
CN4836700000000,48,367,"Parker County, TX",May-22,73729,71525,2204,3.00000000
CN4836900000000,48,369,"Parmer County, TX",May-22,4983,4880,103,2.10000000
CN4837100000000,48,371,"Pecos County, TX",May-22,5786,5507,279,4.80000000
CN4837300000000,48,373,"Polk County, TX",May-22,18194,17116,1078,5.90000000
CN4837500000000,48,375,"Potter County, TX",May-22,54359,52746,1613,3.00000000
CN4837700000000,48,377,"Presidio County, TX",May-22,3134,2918,216,6.90000000
CN4837900000000,48,379,"Rains County, TX",May-22,6652,6456,196,2.90000000
CN4838100000000,48,381,"Randall County, TX",May-22,75171,73239,1932,2.60000000
CN4838300000000,48,383,"Reagan County, TX",May-22,1564,1496,68,4.30000000
CN4838500000000,48,385,"Real County, TX",May-22,1170,1119,51,4.40000000
CN4838700000000,48,387,"Red River County, TX",May-22,5343,5098,245,4.60000000
CN4838900000000,48,389,"Reeves County, TX",May-22,9188,8913,275,3.00000000
CN4839100000000,48,391,"Refugio County, TX",May-22,3035,2884,151,5.00000000
CN4839300000000,48,393,"Roberts County, TX",May-22,396,382,14,3.50000000
CN4839500000000,48,395,"Robertson County, TX",May-22,7671,7378,293,3.80000000
CN4839700000000,48,397,"Rockwall County, TX",May-22,59289,57563,1726,2.90000000
CN4839900000000,48,399,"Runnels County, TX",May-22,4654,4517,137,2.90000000
CN4840100000000,48,401,"Rusk County, TX",May-22,22120,21231,889,4.00000000
CN4840300000000,48,403,"Sabine County, TX",May-22,3995,3712,283,7.10000000
CN4840500000000,48,405,"San Augustine County, TX",May-22,2963,2771,192,6.50000000
CN4840700000000,48,407,"San Jacinto County, TX",May-22,11933,11339,594,5.00000000
CN4840900000000,48,409,"San Patricio County, TX",May-22,29391,27492,1899,6.50000000
CN4841100000000,48,411,"San Saba County, TX",May-22,2135,2062,73,3.40000000
CN4841300000000,48,413,"Schleicher County, TX",May-22,1164,1122,42,3.60000000
CN4841500000000,48,415,"Scurry County, TX",May-22,5803,5545,258,4.40000000
CN4841700000000,48,417,"Shackelford County, TX",May-22,1839,1792,47,2.60000000
CN4841900000000,48,419,"Shelby County, TX",May-22,11670,11233,437,3.70000000
CN4842100000000,48,421,"Sherman County, TX",May-22,1511,1478,33,2.20000000
CN4842300000000,48,423,"Smith County, TX",May-22,110338,106462,3876,3.50000000
CN4842500000000,48,425,"Somervell County, TX",May-22,4515,4356,159,3.50000000
CN4842700000000,48,427,"Starr County, TX",May-22,24332,21284,3048,12.50000000
CN4842900000000,48,429,"Stephens County, TX",May-22,4282,4145,137,3.20000000
CN4843100000000,48,431,"Sterling County, TX",May-22,595,574,21,3.50000000
CN4843300000000,48,433,"Stonewall County, TX",May-22,600,583,17,2.80000000
CN4843500000000,48,435,"Sutton County, TX",May-22,1106,1045,61,5.50000000
CN4843700000000,48,437,"Swisher County, TX",May-22,2607,2520,87,3.30000000
CN4843900000000,48,439,"Tarrant County, TX",May-22,1127250,1088582,38668,3.40000000
CN4844100000000,48,441,"Taylor County, TX",May-22,67151,65076,2075,3.10000000
CN4844300000000,48,443,"Terrell County, TX",May-22,433,420,13,3.00000000
CN4844500000000,48,445,"Terry County, TX",May-22,4725,4524,201,4.30000000
CN4844700000000,48,447,"Throckmorton County, TX",May-22,1370,1350,20,1.50000000
CN4844900000000,48,449,"Titus County, TX",May-22,13570,13049,521,3.80000000
CN4845100000000,48,451,"Tom Green County, TX",May-22,53974,52232,1742,3.20000000
CN4845300000000,48,453,"Travis County, TX",May-22,792570,771691,20879,2.60000000
CN4845500000000,48,455,"Trinity County, TX",May-22,5286,5003,283,5.40000000
CN4845700000000,48,457,"Tyler County, TX",May-22,7479,7036,443,5.90000000
CN4845900000000,48,459,"Upshur County, TX",May-22,17610,16860,750,4.30000000
CN4846100000000,48,461,"Upton County, TX",May-22,1776,1712,64,3.60000000
CN4846300000000,48,463,"Uvalde County, TX",May-22,11201,10762,439,3.90000000
CN4846500000000,48,465,"Val Verde County, TX",May-22,21813,20880,933,4.30000000
CN4846700000000,48,467,"Van Zandt County, TX",May-22,27490,26598,892,3.20000000
CN4846900000000,48,469,"Victoria County, TX",May-22,40333,38573,1760,4.40000000
CN4847100000000,48,471,"Walker County, TX",May-22,23704,22622,1082,4.60000000
CN4847300000000,48,473,"Waller County, TX",May-22,25297,24242,1055,4.20000000
CN4847500000000,48,475,"Ward County, TX",May-22,6125,5868,257,4.20000000
CN4847700000000,48,477,"Washington County, TX",May-22,14848,14298,550,3.70000000
CN4847900000000,48,479,"Webb County, TX",May-22,117330,112320,5010,4.30000000
CN4848100000000,48,481,"Wharton County, TX",May-22,21033,20248,785,3.70000000
CN4848300000000,48,483,"Wheeler County, TX",May-22,1941,1864,77,4.00000000
CN4848500000000,48,485,"Wichita County, TX",May-22,55194,53173,2021,3.70000000
CN4848700000000,48,487,"Wilbarger County, TX",May-22,4751,4519,232,4.90000000
CN4848900000000,48,489,"Willacy County, TX",May-22,7290,6621,669,9.20000000
CN4849100000000,48,491,"Williamson County, TX",May-22,351038,341548,9490,2.70000000
CN4849300000000,48,493,"Wilson County, TX",May-22,25481,24714,767,3.00000000
CN4849500000000,48,495,"Winkler County, TX",May-22,3668,3491,177,4.80000000
CN4849700000000,48,497,"Wise County, TX",May-22,33901,32827,1074,3.20000000
CN4849900000000,48,499,"Wood County, TX",May-22,17751,16995,756,4.30000000
CN4850100000000,48,501,"Yoakum County, TX",May-22,3168,3015,153,4.80000000
CN4850300000000,48,503,"Young County, TX",May-22,8110,7849,261,3.20000000
CN4850500000000,48,505,"Zapata County, TX",May-22,4364,3994,370,8.50000000
CN4850700000000,48,507,"Zavala County, TX",May-22,3239,2926,313,9.70000000
CN4900100000000,49,001,"Beaver County, UT",May-22,3100,3025,75,2.40000000
CN4900300000000,49,003,"Box Elder County, UT",May-22,27638,27088,550,2.00000000
CN4900500000000,49,005,"Cache County, UT",May-22,71601,70281,1320,1.80000000
CN4900700000000,49,007,"Carbon County, UT",May-22,8573,8301,272,3.20000000
CN4900900000000,49,009,"Daggett County, UT",May-22,453,435,18,4.00000000
CN4901100000000,49,011,"Davis County, UT",May-22,182694,178984,3710,2.00000000
CN4901300000000,49,013,"Duchesne County, UT",May-22,8113,7864,249,3.10000000
CN4901500000000,49,015,"Emery County, UT",May-22,4625,4499,126,2.70000000
CN4901700000000,49,017,"Garfield County, UT",May-22,3083,2945,138,4.50000000
CN4901900000000,49,019,"Grand County, UT",May-22,7272,7114,158,2.20000000
CN4902100000000,49,021,"Iron County, UT",May-22,27965,27310,655,2.30000000
CN4902300000000,49,023,"Juab County, UT",May-22,6410,6296,114,1.80000000
CN4902500000000,49,025,"Kane County, UT",May-22,4322,4240,82,1.90000000
CN4902700000000,49,027,"Millard County, UT",May-22,6489,6358,131,2.00000000
CN4902900000000,49,029,"Morgan County, UT",May-22,5915,5806,109,1.80000000
CN4903100000000,49,031,"Piute County, UT",May-22,514,496,18,3.50000000
CN4903300000000,49,033,"Rich County, UT",May-22,1298,1270,28,2.20000000
CN4903500000000,49,035,"Salt Lake County, UT",May-22,664512,650076,14436,2.20000000
CN4903700000000,49,037,"San Juan County, UT",May-22,5864,5624,240,4.10000000
CN4903900000000,49,039,"Sanpete County, UT",May-22,13837,13502,335,2.40000000
CN4904100000000,49,041,"Sevier County, UT",May-22,10222,9976,246,2.40000000
CN4904300000000,49,043,"Summit County, UT",May-22,24900,24234,666,2.70000000
CN4904500000000,49,045,"Tooele County, UT",May-22,37427,36556,871,2.30000000
CN4904700000000,49,047,"Uintah County, UT",May-22,14117,13592,525,3.70000000
CN4904900000000,49,049,"Utah County, UT",May-22,345087,338193,6894,2.00000000
CN4905100000000,49,051,"Wasatch County, UT",May-22,17579,17156,423,2.40000000
CN4905300000000,49,053,"Washington County, UT",May-22,85864,83935,1929,2.20000000
CN4905500000000,49,055,"Wayne County, UT",May-22,1648,1592,56,3.40000000
CN4905700000000,49,057,"Weber County, UT",May-22,134097,131052,3045,2.30000000
CN5000100000000,50,001,"Addison County, VT",May-22,20722,20329,393,1.90000000
CN5000300000000,50,003,"Bennington County, VT",May-22,16945,16471,474,2.80000000
CN5000500000000,50,005,"Caledonia County, VT",May-22,14228,13900,328,2.30000000
CN5000700000000,50,007,"Chittenden County, VT",May-22,94759,93256,1503,1.60000000
CN5000900000000,50,009,"Essex County, VT",May-22,2593,2530,63,2.40000000
CN5001100000000,50,011,"Franklin County, VT",May-22,27428,26844,584,2.10000000
CN5001300000000,50,013,"Grand Isle County, VT",May-22,4003,3912,91,2.30000000
CN5001500000000,50,015,"Lamoille County, VT",May-22,13562,13124,438,3.20000000
CN5001700000000,50,017,"Orange County, VT",May-22,15372,15080,292,1.90000000
CN5001900000000,50,019,"Orleans County, VT",May-22,12768,12352,416,3.30000000
CN5002100000000,50,021,"Rutland County, VT",May-22,28496,27688,808,2.80000000
CN5002300000000,50,023,"Washington County, VT",May-22,32724,32093,631,1.90000000
CN5002500000000,50,025,"Windham County, VT",May-22,20091,19519,572,2.80000000
CN5002700000000,50,027,"Windsor County, VT",May-22,27732,27212,520,1.90000000
CN5100100000000,51,001,"Accomack County, VA",May-22,15616,15123,493,3.20000000
CN5100300000000,51,003,"Albemarle County, VA",May-22,56150,54620,1530,2.70000000
CN5100500000000,51,005,"Alleghany County, VA",May-22,6899,6684,215,3.10000000
CN5100700000000,51,007,"Amelia County, VA",May-22,5961,5784,177,3.00000000
CN5100900000000,51,009,"Amherst County, VA",May-22,14467,14016,451,3.10000000
CN5101100000000,51,011,"Appomattox County, VA",May-22,6945,6719,226,3.30000000
CN5101300000000,51,013,"Arlington County, VA",May-22,153371,150071,3300,2.20000000
CN5101500000000,51,015,"Augusta County, VA",May-22,36926,35942,984,2.70000000
CN5101700000000,51,017,"Bath County, VA",May-22,2312,2249,63,2.70000000
CN5101900000000,51,019,"Bedford County, VA",May-22,37654,36567,1087,2.90000000
CN5102100000000,51,021,"Bland County, VA",May-22,2831,2755,76,2.70000000
CN5102300000000,51,023,"Botetourt County, VA",May-22,17143,16698,445,2.60000000
CN5102500000000,51,025,"Brunswick County, VA",May-22,6015,5739,276,4.60000000
CN5102700000000,51,027,"Buchanan County, VA",May-22,6582,6250,332,5.00000000
CN5102900000000,51,029,"Buckingham County, VA",May-22,6208,5954,254,4.10000000
CN5103100000000,51,031,"Campbell County, VA",May-22,25234,24451,783,3.10000000
CN5103300000000,51,033,"Caroline County, VA",May-22,14685,14192,493,3.40000000
CN5103500000000,51,035,"Carroll County, VA",May-22,13641,13198,443,3.20000000
CN5103600000000,51,036,"Charles City County, VA",May-22,3415,3300,115,3.40000000
CN5103700000000,51,037,"Charlotte County, VA",May-22,5678,5518,160,2.80000000
CN5104100000000,51,041,"Chesterfield County, VA",May-22,185414,180003,5411,2.90000000
CN5104300000000,51,043,"Clarke County, VA",May-22,7434,7237,197,2.60000000
CN5104500000000,51,045,"Craig County, VA",May-22,2246,2178,68,3.00000000
CN5104700000000,51,047,"Culpeper County, VA",May-22,24902,24187,715,2.90000000
CN5104900000000,51,049,"Cumberland County, VA",May-22,4732,4583,149,3.10000000
CN5105100000000,51,051,"Dickenson County, VA",May-22,5183,4977,206,4.00000000
CN5105300000000,51,053,"Dinwiddie County, VA",May-22,13180,12731,449,3.40000000
CN5105700000000,51,057,"Essex County, VA",May-22,5394,5209,185,3.40000000
CN5105900000000,51,059,"Fairfax County, VA",May-22,625176,609047,16129,2.60000000
CN5106100000000,51,061,"Fauquier County, VA",May-22,36603,35651,952,2.60000000
CN5106300000000,51,063,"Floyd County, VA",May-22,8203,7994,209,2.50000000
CN5106500000000,51,065,"Fluvanna County, VA",May-22,13771,13416,355,2.60000000
CN5106700000000,51,067,"Franklin County, VA",May-22,25677,24899,778,3.00000000
CN5106900000000,51,069,"Frederick County, VA",May-22,49999,48773,1226,2.50000000
CN5107100000000,51,071,"Giles County, VA",May-22,7923,7688,235,3.00000000
CN5107300000000,51,073,"Gloucester County, VA",May-22,18942,18422,520,2.70000000
CN5107500000000,51,075,"Goochland County, VA",May-22,11321,11008,313,2.80000000
CN5107700000000,51,077,"Grayson County, VA",May-22,8857,8646,211,2.40000000
CN5107900000000,51,079,"Greene County, VA",May-22,10301,10044,257,2.50000000
CN5108100000000,51,081,"Greensville County, VA",May-22,4480,4334,146,3.30000000
CN5108300000000,51,083,"Halifax County, VA",May-22,16081,15489,592,3.70000000
CN5108500000000,51,085,"Hanover County, VA",May-22,57433,55949,1484,2.60000000
CN5108700000000,51,087,"Henrico County, VA",May-22,177636,172294,5342,3.00000000
CN5108900000000,51,089,"Henry County, VA",May-22,25490,24662,828,3.20000000
CN5109100000000,51,091,"Highland County, VA",May-22,1213,1183,30,2.50000000
CN5109300000000,51,093,"Isle of Wight County, VA",May-22,19116,18573,543,2.80000000
CN5109500000000,51,095,"James City County, VA",May-22,36084,34981,1103,3.10000000
CN5109700000000,51,097,"King and Queen County, VA",May-22,3953,3853,100,2.50000000
CN5109900000000,51,099,"King George County, VA",May-22,14892,14535,357,2.40000000
CN5110100000000,51,101,"King William County, VA",May-22,9163,8906,257,2.80000000
CN5110300000000,51,103,"Lancaster County, VA",May-22,5705,5516,189,3.30000000
CN5110500000000,51,105,"Lee County, VA",May-22,8794,8499,295,3.40000000
CN5110700000000,51,107,"Loudoun County, VA",May-22,226744,221150,5594,2.50000000
CN5110900000000,51,109,"Louisa County, VA",May-22,21290,20718,572,2.70000000
CN5111100000000,51,111,"Lunenburg County, VA",May-22,5271,5108,163,3.10000000
CN5111300000000,51,113,"Madison County, VA",May-22,7608,7442,166,2.20000000
CN5111500000000,51,115,"Mathews County, VA",May-22,3983,3866,117,2.90000000
CN5111700000000,51,117,"Mecklenburg County, VA",May-22,13496,13032,464,3.40000000
CN5111900000000,51,119,"Middlesex County, VA",May-22,5359,5213,146,2.70000000
CN5112100000000,51,121,"Montgomery County, VA",May-22,50969,49546,1423,2.80000000
CN5112500000000,51,125,"Nelson County, VA",May-22,7127,6915,212,3.00000000
CN5112700000000,51,127,"New Kent County, VA",May-22,12660,12339,321,2.50000000
CN5113100000000,51,131,"Northampton County, VA",May-22,5464,5264,200,3.70000000
CN5113300000000,51,133,"Northumberland County, VA",May-22,5840,5643,197,3.40000000
CN5113500000000,51,135,"Nottoway County, VA",May-22,7441,7226,215,2.90000000
CN5113700000000,51,137,"Orange County, VA",May-22,17611,17087,524,3.00000000
CN5113900000000,51,139,"Page County, VA",May-22,12588,12202,386,3.10000000
CN5114100000000,51,141,"Patrick County, VA",May-22,7402,7137,265,3.60000000
CN5114300000000,51,143,"Pittsylvania County, VA",May-22,31423,30465,958,3.00000000
CN5114500000000,51,145,"Powhatan County, VA",May-22,14050,13685,365,2.60000000
CN5114700000000,51,147,"Prince Edward County, VA",May-22,11018,10619,399,3.60000000
CN5114900000000,51,149,"Prince George County, VA",May-22,14705,14198,507,3.40000000
CN5115300000000,51,153,"Prince William County, VA",May-22,245335,238315,7020,2.90000000
CN5115500000000,51,155,"Pulaski County, VA",May-22,16335,15834,501,3.10000000
CN5115700000000,51,157,"Rappahannock County, VA",May-22,3608,3515,93,2.60000000
CN5115900000000,51,159,"Richmond County, VA",May-22,4142,4033,109,2.60000000
CN5116100000000,51,161,"Roanoke County, VA",May-22,48533,47253,1280,2.60000000
CN5116300000000,51,163,"Rockbridge County, VA",May-22,11307,10998,309,2.70000000
CN5116500000000,51,165,"Rockingham County, VA",May-22,41635,40559,1076,2.60000000
CN5116700000000,51,167,"Russell County, VA",May-22,11402,11021,381,3.30000000
CN5116900000000,51,169,"Scott County, VA",May-22,8955,8678,277,3.10000000
CN5117100000000,51,171,"Shenandoah County, VA",May-22,22908,22285,623,2.70000000
CN5117300000000,51,173,"Smyth County, VA",May-22,15387,14963,424,2.80000000
CN5117500000000,51,175,"Southampton County, VA",May-22,8985,8724,261,2.90000000
CN5117700000000,51,177,"Spotsylvania County, VA",May-22,67741,65731,2010,3.00000000
CN5117900000000,51,179,"Stafford County, VA",May-22,73831,71695,2136,2.90000000
CN5118100000000,51,181,"Surry County, VA",May-22,3650,3534,116,3.20000000
CN5118300000000,51,183,"Sussex County, VA",May-22,3461,3287,174,5.00000000
CN5118500000000,51,185,"Tazewell County, VA",May-22,16294,15677,617,3.80000000
CN5118700000000,51,187,"Warren County, VA",May-22,20248,19674,574,2.80000000
CN5119100000000,51,191,"Washington County, VA",May-22,25752,24986,766,3.00000000
CN5119300000000,51,193,"Westmoreland County, VA",May-22,10063,9765,298,3.00000000
CN5119500000000,51,195,"Wise County, VA",May-22,14495,13956,539,3.70000000
CN5119700000000,51,197,"Wythe County, VA",May-22,14536,14117,419,2.90000000
CN5119900000000,51,199,"York County, VA",May-22,32364,31432,932,2.90000000
CN5151000000000,51,510,"Alexandria city, VA",May-22,98614,96149,2465,2.50000000
CN5152000000000,51,520,"Bristol city, VA",May-22,7444,7177,267,3.60000000
CN5153000000000,51,530,"Buena Vista city, VA",May-22,3119,3031,88,2.80000000
CN5154000000000,51,540,"Charlottesville city, VA",May-22,24931,24244,687,2.80000000
CN5155000000000,51,550,"Chesapeake city, VA",May-22,120785,117111,3674,3.00000000
CN5157000000000,51,570,"Colonial Heights city, VA",May-22,8175,7903,272,3.30000000
CN5158000000000,51,580,"Covington city, VA",May-22,2415,2321,94,3.90000000
CN5159000000000,51,590,"Danville city, VA",May-22,19573,18594,979,5.00000000
CN5159500000000,51,595,"Emporia city, VA",May-22,2458,2329,129,5.20000000
CN5160000000000,51,600,"Fairfax city, VA",May-22,12640,12319,321,2.50000000
CN5161000000000,51,610,"Falls Church city, VA",May-22,8371,8191,180,2.20000000
CN5162000000000,51,620,"Franklin city, VA",May-22,3549,3394,155,4.40000000
CN5163000000000,51,630,"Fredericksburg city, VA",May-22,14062,13566,496,3.50000000
CN5164000000000,51,640,"Galax city, VA",May-22,3034,2946,88,2.90000000
CN5165000000000,51,650,"Hampton city, VA",May-22,62974,60328,2646,4.20000000
CN5166000000000,51,660,"Harrisonburg city, VA",May-22,24374,23528,846,3.50000000
CN5167000000000,51,670,"Hopewell city, VA",May-22,9289,8799,490,5.30000000
CN5167800000000,51,678,"Lexington city, VA",May-22,2264,2170,94,4.20000000
CN5168000000000,51,680,"Lynchburg city, VA",May-22,34978,33557,1421,4.10000000
CN5168300000000,51,683,"Manassas city, VA",May-22,21285,20698,587,2.80000000
CN5168500000000,51,685,"Manassas Park city, VA",May-22,9595,9338,257,2.70000000
CN5169000000000,51,690,"Martinsville city, VA",May-22,5912,5608,304,5.10000000
CN5170000000000,51,700,"Newport News city, VA",May-22,86545,83016,3529,4.10000000
CN5171000000000,51,710,"Norfolk city, VA",May-22,107881,103561,4320,4.00000000
CN5172000000000,51,720,"Norton city, VA",May-22,1795,1726,69,3.80000000
CN5173000000000,51,730,"Petersburg city, VA",May-22,12239,11388,851,7.00000000
CN5173500000000,51,735,"Poquoson city, VA",May-22,6181,6022,159,2.60000000
CN5174000000000,51,740,"Portsmouth city, VA",May-22,43318,41316,2002,4.60000000
CN5175000000000,51,750,"Radford city, VA",May-22,8821,8503,318,3.60000000
CN5176000000000,51,760,"Richmond city, VA",May-22,116160,111640,4520,3.90000000
CN5177000000000,51,770,"Roanoke city, VA",May-22,47825,46215,1610,3.40000000
CN5177500000000,51,775,"Salem city, VA",May-22,12561,12185,376,3.00000000
CN5179000000000,51,790,"Staunton city, VA",May-22,12084,11739,345,2.90000000
CN5180000000000,51,800,"Suffolk city, VA",May-22,44448,42990,1458,3.30000000
CN5181000000000,51,810,"Virginia Beach city, VA",May-22,226192,219698,6494,2.90000000
CN5182000000000,51,820,"Waynesboro city, VA",May-22,10505,10188,317,3.00000000
CN5183000000000,51,830,"Williamsburg city, VA",May-22,6652,6374,278,4.20000000
CN5184000000000,51,840,"Winchester city, VA",May-22,14615,14214,401,2.70000000
CN5300100000000,53,001,"Adams County, WA",May-22,10385,9980,405,3.90000000
CN5300300000000,53,003,"Asotin County, WA",May-22,10682,10330,352,3.30000000
CN5300500000000,53,005,"Benton County, WA",May-22,107029,102339,4690,4.40000000
CN5300700000000,53,007,"Chelan County, WA",May-22,43084,41251,1833,4.30000000
CN5300900000000,53,009,"Clallam County, WA",May-22,29885,28307,1578,5.30000000
CN5301100000000,53,011,"Clark County, WA",May-22,251281,240619,10662,4.20000000
CN5301300000000,53,013,"Columbia County, WA",May-22,1803,1719,84,4.70000000
CN5301500000000,53,015,"Cowlitz County, WA",May-22,49448,46892,2556,5.20000000
CN5301700000000,53,017,"Douglas County, WA",May-22,21548,20591,957,4.40000000
CN5301900000000,53,019,"Ferry County, WA",May-22,2339,2160,179,7.70000000
CN5302100000000,53,021,"Franklin County, WA",May-22,45417,43013,2404,5.30000000
CN5302300000000,53,023,"Garfield County, WA",May-22,813,765,48,5.90000000
CN5302500000000,53,025,"Grant County, WA",May-22,46917,44368,2549,5.40000000
CN5302700000000,53,027,"Grays Harbor County, WA",May-22,28934,27036,1898,6.60000000
CN5302900000000,53,029,"Island County, WA",May-22,36424,34793,1631,4.50000000
CN5303100000000,53,031,"Jefferson County, WA",May-22,12917,12264,653,5.10000000
CN5303300000000,53,033,"King County, WA",May-22,1332686,1303679,29007,2.20000000
CN5303500000000,53,035,"Kitsap County, WA",May-22,129772,124570,5202,4.00000000
CN5303700000000,53,037,"Kittitas County, WA",May-22,22222,21057,1165,5.20000000
CN5303900000000,53,039,"Klickitat County, WA",May-22,9752,9257,495,5.10000000
CN5304100000000,53,041,"Lewis County, WA",May-22,35410,33531,1879,5.30000000
CN5304300000000,53,043,"Lincoln County, WA",May-22,4481,4280,201,4.50000000
CN5304500000000,53,045,"Mason County, WA",May-22,25709,24239,1470,5.70000000
CN5304700000000,53,047,"Okanogan County, WA",May-22,19424,18362,1062,5.50000000
CN5304900000000,53,049,"Pacific County, WA",May-22,8465,7912,553,6.50000000
CN5305100000000,53,051,"Pend Oreille County, WA",May-22,5202,4888,314,6.00000000
CN5305300000000,53,053,"Pierce County, WA",May-22,452227,430463,21764,4.80000000
CN5305500000000,53,055,"San Juan County, WA",May-22,7986,7677,309,3.90000000
CN5305700000000,53,057,"Skagit County, WA",May-22,62612,59535,3077,4.90000000
CN5305900000000,53,059,"Skamania County, WA",May-22,5584,5316,268,4.80000000
CN5306100000000,53,061,"Snohomish County, WA",May-22,454356,442949,11407,2.50000000
CN5306300000000,53,063,"Spokane County, WA",May-22,266276,255440,10836,4.10000000
CN5306500000000,53,065,"Stevens County, WA",May-22,19345,18275,1070,5.50000000
CN5306700000000,53,067,"Thurston County, WA",May-22,146724,140471,6253,4.30000000
CN5306900000000,53,069,"Wahkiakum County, WA",May-22,1348,1262,86,6.40000000
CN5307100000000,53,071,"Walla Walla County, WA",May-22,31216,30027,1189,3.80000000
CN5307300000000,53,073,"Whatcom County, WA",May-22,116588,111355,5233,4.50000000
CN5307500000000,53,075,"Whitman County, WA",May-22,23644,22703,941,4.00000000
CN5307700000000,53,077,"Yakima County, WA",May-22,130624,123058,7566,5.80000000
CN5400100000000,54,001,"Barbour County, WV",May-22,7415,7132,283,3.80000000
CN5400300000000,54,003,"Berkeley County, WV",May-22,60243,58739,1504,2.50000000
CN5400500000000,54,005,"Boone County, WV",May-22,7248,6939,309,4.30000000
CN5400700000000,54,007,"Braxton County, WV",May-22,5129,4857,272,5.30000000
CN5400900000000,54,009,"Brooke County, WV",May-22,9968,9534,434,4.40000000
CN5401100000000,54,011,"Cabell County, WV",May-22,41605,40295,1310,3.10000000
CN5401300000000,54,013,"Calhoun County, WV",May-22,2668,2499,169,6.30000000
CN5401500000000,54,015,"Clay County, WV",May-22,3022,2865,157,5.20000000
CN5401700000000,54,017,"Doddridge County, WV",May-22,3869,3771,98,2.50000000
CN5401900000000,54,019,"Fayette County, WV",May-22,16244,15574,670,4.10000000
CN5402100000000,54,021,"Gilmer County, WV",May-22,2431,2322,109,4.50000000
CN5402300000000,54,023,"Grant County, WV",May-22,6081,5916,165,2.70000000
CN5402500000000,54,025,"Greenbrier County, WV",May-22,15709,15253,456,2.90000000
CN5402700000000,54,027,"Hampshire County, WV",May-22,11165,10924,241,2.20000000
CN5402900000000,54,029,"Hancock County, WV",May-22,13131,12538,593,4.50000000
CN5403100000000,54,031,"Hardy County, WV",May-22,5765,5574,191,3.30000000
CN5403300000000,54,033,"Harrison County, WV",May-22,33794,32724,1070,3.20000000
CN5403500000000,54,035,"Jackson County, WV",May-22,12276,11834,442,3.60000000
CN5403700000000,54,037,"Jefferson County, WV",May-22,30864,30197,667,2.20000000
CN5403900000000,54,039,"Kanawha County, WV",May-22,81701,78950,2751,3.40000000
CN5404100000000,54,041,"Lewis County, WV",May-22,6189,5906,283,4.60000000
CN5404300000000,54,043,"Lincoln County, WV",May-22,7079,6754,325,4.60000000
CN5404500000000,54,045,"Logan County, WV",May-22,11228,10744,484,4.30000000
CN5404700000000,54,047,"McDowell County, WV",May-22,4403,4142,261,5.90000000
CN5404900000000,54,049,"Marion County, WV",May-22,25508,24537,971,3.80000000
CN5405100000000,54,051,"Marshall County, WV",May-22,13467,12868,599,4.40000000
CN5405300000000,54,053,"Mason County, WV",May-22,10248,9877,371,3.60000000
CN5405500000000,54,055,"Mercer County, WV",May-22,21025,20129,896,4.30000000
CN5405700000000,54,057,"Mineral County, WV",May-22,12236,11834,402,3.30000000
CN5405900000000,54,059,"Mingo County, WV",May-22,6169,5809,360,5.80000000
CN5406100000000,54,061,"Monongalia County, WV",May-22,57136,55434,1702,3.00000000
CN5406300000000,54,063,"Monroe County, WV",May-22,6228,6072,156,2.50000000
CN5406500000000,54,065,"Morgan County, WV",May-22,8661,8447,214,2.50000000
CN5406700000000,54,067,"Nicholas County, WV",May-22,9310,8940,370,4.00000000
CN5406900000000,54,069,"Ohio County, WV",May-22,20543,19810,733,3.60000000
CN5407100000000,54,071,"Pendleton County, WV",May-22,3870,3791,79,2.00000000
CN5407300000000,54,073,"Pleasants County, WV",May-22,2722,2585,137,5.00000000
CN5407500000000,54,075,"Pocahontas County, WV",May-22,4175,3986,189,4.50000000
CN5407700000000,54,077,"Preston County, WV",May-22,15943,15425,518,3.20000000
CN5407900000000,54,079,"Putnam County, WV",May-22,27040,26276,764,2.80000000
CN5408100000000,54,081,"Raleigh County, WV",May-22,30631,29631,1000,3.30000000
CN5408300000000,54,083,"Randolph County, WV",May-22,12105,11621,484,4.00000000
CN5408500000000,54,085,"Ritchie County, WV",May-22,4372,4220,152,3.50000000
CN5408700000000,54,087,"Roane County, WV",May-22,5130,4829,301,5.90000000
CN5408900000000,54,089,"Summers County, WV",May-22,4646,4495,151,3.30000000
CN5409100000000,54,091,"Taylor County, WV",May-22,7983,7724,259,3.20000000
CN5409300000000,54,093,"Tucker County, WV",May-22,3410,3293,117,3.40000000
CN5409500000000,54,095,"Tyler County, WV",May-22,3057,2892,165,5.40000000
CN5409700000000,54,097,"Upshur County, WV",May-22,9913,9487,426,4.30000000
CN5409900000000,54,099,"Wayne County, WV",May-22,15599,15070,529,3.40000000
CN5410100000000,54,101,"Webster County, WV",May-22,3300,3174,126,3.80000000
CN5410300000000,54,103,"Wetzel County, WV",May-22,7014,6699,315,4.50000000
CN5410500000000,54,105,"Wirt County, WV",May-22,2292,2174,118,5.10000000
CN5410700000000,54,107,"Wood County, WV",May-22,37179,35877,1302,3.50000000
CN5410900000000,54,109,"Wyoming County, WV",May-22,7487,7195,292,3.90000000
CN5500100000000,55,001,"Adams County, WI",May-22,7853,7494,359,4.60000000
CN5500300000000,55,003,"Ashland County, WI",May-22,7570,7265,305,4.00000000
CN5500500000000,55,005,"Barron County, WI",May-22,24350,23635,715,2.90000000
CN5500700000000,55,007,"Bayfield County, WI",May-22,7497,7133,364,4.90000000
CN5500900000000,55,009,"Brown County, WI",May-22,141754,138087,3667,2.60000000
CN5501100000000,55,011,"Buffalo County, WI",May-22,6237,6049,188,3.00000000
CN5501300000000,55,013,"Burnett County, WI",May-22,7467,7159,308,4.10000000
CN5501500000000,55,015,"Calumet County, WI",May-22,27812,27193,619,2.20000000
CN5501700000000,55,017,"Chippewa County, WI",May-22,33527,32620,907,2.70000000
CN5501900000000,55,019,"Clark County, WI",May-22,17946,17564,382,2.10000000
CN5502100000000,55,021,"Columbia County, WI",May-22,31859,31099,760,2.40000000
CN5502300000000,55,023,"Crawford County, WI",May-22,7248,7024,224,3.10000000
CN5502500000000,55,025,"Dane County, WI",May-22,331350,324214,7136,2.20000000
CN5502700000000,55,027,"Dodge County, WI",May-22,47827,46687,1140,2.40000000
CN5502900000000,55,029,"Door County, WI",May-22,15563,15111,452,2.90000000
CN5503100000000,55,031,"Douglas County, WI",May-22,23576,22645,931,3.90000000
CN5503300000000,55,033,"Dunn County, WI",May-22,24076,23407,669,2.80000000
CN5503500000000,55,035,"Eau Claire County, WI",May-22,59687,58299,1388,2.30000000
CN5503700000000,55,037,"Florence County, WI",May-22,2205,2133,72,3.30000000
CN5503900000000,55,039,"Fond du Lac County, WI",May-22,57447,56081,1366,2.40000000
CN5504100000000,55,041,"Forest County, WI",May-22,3831,3627,204,5.30000000
CN5504300000000,55,043,"Grant County, WI",May-22,27562,26929,633,2.30000000
CN5504500000000,55,045,"Green County, WI",May-22,20896,20448,448,2.10000000
CN5504700000000,55,047,"Green Lake County, WI",May-22,9387,9106,281,3.00000000
CN5504900000000,55,049,"Iowa County, WI",May-22,13681,13369,312,2.30000000
CN5505100000000,55,051,"Iron County, WI",May-22,2515,2377,138,5.50000000
CN5505300000000,55,053,"Jackson County, WI",May-22,9438,9119,319,3.40000000
CN5505500000000,55,055,"Jefferson County, WI",May-22,46064,44900,1164,2.50000000
CN5505700000000,55,057,"Juneau County, WI",May-22,13307,12914,393,3.00000000
CN5505900000000,55,059,"Kenosha County, WI",May-22,92118,89079,3039,3.30000000
CN5506100000000,55,061,"Kewaunee County, WI",May-22,10868,10631,237,2.20000000
CN5506300000000,55,063,"La Crosse County, WI",May-22,67014,65458,1556,2.30000000
CN5506500000000,55,065,"Lafayette County, WI",May-22,10326,10131,195,1.90000000
CN5506700000000,55,067,"Langlade County, WI",May-22,9410,9089,321,3.40000000
CN5506900000000,55,069,"Lincoln County, WI",May-22,14731,14337,394,2.70000000
CN5507100000000,55,071,"Manitowoc County, WI",May-22,40579,39505,1074,2.60000000
CN5507300000000,55,073,"Marathon County, WI",May-22,74320,72627,1693,2.30000000
CN5507500000000,55,075,"Marinette County, WI",May-22,19017,18348,669,3.50000000
CN5507700000000,55,077,"Marquette County, WI",May-22,7691,7458,233,3.00000000
CN5507800000000,55,078,"Menominee County, WI",May-22,1536,1428,108,7.00000000
CN5507900000000,55,079,"Milwaukee County, WI",May-22,465336,445741,19595,4.20000000
CN5508100000000,55,081,"Monroe County, WI",May-22,23763,23205,558,2.30000000
CN5508300000000,55,083,"Oconto County, WI",May-22,20709,20132,577,2.80000000
CN5508500000000,55,085,"Oneida County, WI",May-22,17927,17425,502,2.80000000
CN5508700000000,55,087,"Outagamie County, WI",May-22,104928,102452,2476,2.40000000
CN5508900000000,55,089,"Ozaukee County, WI",May-22,49372,48173,1199,2.40000000
CN5509100000000,55,091,"Pepin County, WI",May-22,4147,4052,95,2.30000000
CN5509300000000,55,093,"Pierce County, WI",May-22,25507,24810,697,2.70000000
CN5509500000000,55,095,"Polk County, WI",May-22,24829,24031,798,3.20000000
CN5509700000000,55,097,"Portage County, WI",May-22,37798,36737,1061,2.80000000
CN5509900000000,55,099,"Price County, WI",May-22,6216,6012,204,3.30000000
CN5510100000000,55,101,"Racine County, WI",May-22,97639,94060,3579,3.70000000
CN5510300000000,55,103,"Richland County, WI",May-22,8912,8686,226,2.50000000
CN5510500000000,55,105,"Rock County, WI",May-22,86683,83529,3154,3.60000000
CN5510700000000,55,107,"Rusk County, WI",May-22,6407,6176,231,3.60000000
CN5510900000000,55,109,"St. Croix County, WI",May-22,51808,50488,1320,2.50000000
CN5511100000000,55,111,"Sauk County, WI",May-22,33451,32483,968,2.90000000
CN5511300000000,55,113,"Sawyer County, WI",May-22,8169,7877,292,3.60000000
CN5511500000000,55,115,"Shawano County, WI",May-22,20611,20046,565,2.70000000
CN5511700000000,55,117,"Sheboygan County, WI",May-22,62304,60802,1502,2.40000000
CN5511900000000,55,119,"Taylor County, WI",May-22,10906,10623,283,2.60000000
CN5512100000000,55,121,"Trempealeau County, WI",May-22,15227,14824,403,2.60000000
CN5512300000000,55,123,"Vernon County, WI",May-22,15614,15252,362,2.30000000
CN5512500000000,55,125,"Vilas County, WI",May-22,10492,10133,359,3.40000000
CN5512700000000,55,127,"Walworth County, WI",May-22,56992,55395,1597,2.80000000
CN5512900000000,55,129,"Washburn County, WI",May-22,7888,7650,238,3.00000000
CN5513100000000,55,131,"Washington County, WI",May-22,76952,75147,1805,2.30000000
CN5513300000000,55,133,"Waukesha County, WI",May-22,225109,219612,5497,2.40000000
CN5513500000000,55,135,"Waupaca County, WI",May-22,25554,24846,708,2.80000000
CN5513700000000,55,137,"Waushara County, WI",May-22,11312,10959,353,3.10000000
CN5513900000000,55,139,"Winnebago County, WI",May-22,92348,90049,2299,2.50000000
CN5514100000000,55,141,"Wood County, WI",May-22,33542,32495,1047,3.10000000
CN5600100000000,56,001,"Albany County, WY",May-22,20950,20423,527,2.50000000
CN5600300000000,56,003,"Big Horn County, WY",May-22,5424,5250,174,3.20000000
CN5600500000000,56,005,"Campbell County, WY",May-22,21563,20853,710,3.30000000
CN5600700000000,56,007,"Carbon County, WY",May-22,7520,7306,214,2.80000000
CN5600900000000,56,009,"Converse County, WY",May-22,7719,7505,214,2.80000000
CN5601100000000,56,011,"Crook County, WY",May-22,4109,4018,91,2.20000000
CN5601300000000,56,013,"Fremont County, WY",May-22,18726,18116,610,3.30000000
CN5601500000000,56,015,"Goshen County, WY",May-22,6725,6572,153,2.30000000
CN5601700000000,56,017,"Hot Springs County, WY",May-22,2218,2163,55,2.50000000
CN5601900000000,56,019,"Johnson County, WY",May-22,4433,4318,115,2.60000000
CN5602100000000,56,021,"Laramie County, WY",May-22,48876,47489,1387,2.80000000
CN5602300000000,56,023,"Lincoln County, WY",May-22,9474,9201,273,2.90000000
CN5602500000000,56,025,"Natrona County, WY",May-22,38226,36768,1458,3.80000000
CN5602700000000,56,027,"Niobrara County, WY",May-22,1293,1270,23,1.80000000
CN5602900000000,56,029,"Park County, WY",May-22,15907,15453,454,2.90000000
CN5603100000000,56,031,"Platte County, WY",May-22,4653,4530,123,2.60000000
CN5603300000000,56,033,"Sheridan County, WY",May-22,16166,15739,427,2.60000000
CN5603500000000,56,035,"Sublette County, WY",May-22,3961,3824,137,3.50000000
CN5603700000000,56,037,"Sweetwater County, WY",May-22,18725,18043,682,3.60000000
CN5603900000000,56,039,"Teton County, WY",May-22,15458,14954,504,3.30000000
CN5604100000000,56,041,"Uinta County, WY",May-22,8635,8351,284,3.30000000
CN5604300000000,56,043,"Washakie County, WY",May-22,3927,3792,135,3.40000000
CN5604500000000,56,045,"Weston County, WY",May-22,3726,3642,84,2.30000000
CN7200100000000,72,001,"Adjuntas Municipio, PR",May-22,4259,3929,330,7.70000000
CN7200300000000,72,003,"Aguada Municipio, PR",May-22,13118,12201,917,7.00000000
CN7200500000000,72,005,"Aguadilla Municipio, PR",May-22,15827,14662,1165,7.40000000
CN7200700000000,72,007,"Aguas Buenas Municipio, PR",May-22,7143,6688,455,6.40000000
CN7200900000000,72,009,"Aibonito Municipio, PR",May-22,6838,6380,458,6.70000000
CN7201100000000,72,011,"Anasco Municipio, PR",May-22,9849,9256,593,6.00000000
CN7201300000000,72,013,"Arecibo Municipio, PR",May-22,25926,24214,1712,6.60000000
CN7201500000000,72,015,"Arroyo Municipio, PR",May-22,5076,4684,392,7.70000000
CN7201700000000,72,017,"Barceloneta Municipio, PR",May-22,6478,5962,516,8.00000000
CN7201900000000,72,019,"Barranquitas Municipio, PR",May-22,7883,7358,525,6.70000000
CN7202100000000,72,021,"Bayamon Municipio, PR",May-22,71306,67732,3574,5.00000000
CN7202300000000,72,023,"Cabo Rojo Municipio, PR",May-22,15307,14313,994,6.50000000
CN7202500000000,72,025,"Caguas Municipio, PR",May-22,52249,49900,2349,4.50000000
CN7202700000000,72,027,"Camuy Municipio, PR",May-22,10360,9758,602,5.80000000
CN7202900000000,72,029,"Canovanas Municipio, PR",May-22,17889,17053,836,4.70000000
CN7203100000000,72,031,"Carolina Municipio, PR",May-22,67446,64182,3264,4.80000000
CN7203300000000,72,033,"Catano Municipio, PR",May-22,8552,8086,466,5.40000000
CN7203500000000,72,035,"Cayey Municipio, PR",May-22,17688,16900,788,4.50000000
CN7203700000000,72,037,"Ceiba Municipio, PR",May-22,3950,3672,278,7.00000000
CN7203900000000,72,039,"Ciales Municipio, PR",May-22,3974,3628,346,8.70000000
CN7204100000000,72,041,"Cidra Municipio, PR",May-22,16843,16169,674,4.00000000
CN7204300000000,72,043,"Coamo Municipio, PR",May-22,11048,10253,795,7.20000000
CN7204500000000,72,045,"Comerio Municipio, PR",May-22,5325,4977,348,6.50000000
CN7204700000000,72,047,"Corozal Municipio, PR",May-22,9676,8941,735,7.60000000
CN7204900000000,72,049,"Culebra Municipio, PR",May-22,979,950,29,3.00000000
CN7205100000000,72,051,"Dorado Municipio, PR",May-22,14776,14178,598,4.00000000
CN7205300000000,72,053,"Fajardo Municipio, PR",May-22,11597,10802,795,6.90000000
CN7205400000000,72,054,"Florida Municipio, PR",May-22,3578,3296,282,7.90000000
CN7205500000000,72,055,"Guanica Municipio, PR",May-22,4174,3716,458,11.00000000
CN7205700000000,72,057,"Guayama Municipio, PR",May-22,11892,11198,694,5.80000000
CN7205900000000,72,059,"Guayanilla Municipio, PR",May-22,5417,4896,521,9.60000000
CN7206100000000,72,061,"Guaynabo Municipio, PR",May-22,41717,40548,1169,2.80000000
CN7206300000000,72,063,"Gurabo Municipio, PR",May-22,20537,19823,714,3.50000000
CN7206500000000,72,065,"Hatillo Municipio, PR",May-22,14789,13579,1210,8.20000000
CN7206700000000,72,067,"Hormigueros Municipio, PR",May-22,6062,5642,420,6.90000000
CN7206900000000,72,069,"Humacao Municipio, PR",May-22,19023,17777,1246,6.50000000
CN7207100000000,72,071,"Isabela Municipio, PR",May-22,12932,12151,781,6.00000000
CN7207300000000,72,073,"Jayuya Municipio, PR",May-22,4423,4035,388,8.80000000
CN7207500000000,72,075,"Juana Diaz Municipio, PR",May-22,17017,15940,1077,6.30000000
CN7207700000000,72,077,"Juncos Municipio, PR",May-22,13600,12781,819,6.00000000
CN7207900000000,72,079,"Lajas Municipio, PR",May-22,5655,5088,567,10.00000000
CN7208100000000,72,081,"Lares Municipio, PR",May-22,7341,6487,854,11.60000000
CN7208300000000,72,083,"Las Marias Municipio, PR",May-22,2744,2497,247,9.00000000
CN7208500000000,72,085,"Las Piedras Municipio, PR",May-22,12533,11822,711,5.70000000
CN7208700000000,72,087,"Loiza Municipio, PR",May-22,9146,8573,573,6.30000000
CN7208900000000,72,089,"Luquillo Municipio, PR",May-22,6737,6317,420,6.20000000
CN7209100000000,72,091,"Manati Municipio, PR",May-22,12275,11555,720,5.90000000
CN7209300000000,72,093,"Maricao Municipio, PR",May-22,2084,1837,247,11.90000000
CN7209500000000,72,095,"Maunabo Municipio, PR",May-22,3150,2774,376,11.90000000
CN7209700000000,72,097,"Mayaguez Municipio, PR",May-22,23824,22215,1609,6.80000000
CN7209900000000,72,099,"Moca Municipio, PR",May-22,11459,10601,858,7.50000000
CN7210100000000,72,101,"Morovis Municipio, PR",May-22,8814,8206,608,6.90000000
CN7210300000000,72,103,"Naguabo Municipio, PR",May-22,9056,8511,545,6.00000000
CN7210500000000,72,105,"Naranjito Municipio, PR",May-22,7777,7206,571,7.30000000
CN7210700000000,72,107,"Orocovis Municipio, PR",May-22,5245,4860,385,7.30000000
CN7210900000000,72,109,"Patillas Municipio, PR",May-22,4584,4133,451,9.80000000
CN7211100000000,72,111,"Penuelas Municipio, PR",May-22,6273,5669,604,9.60000000
CN7211300000000,72,113,"Ponce Municipio, PR",May-22,49669,46165,3504,7.10000000
CN7211500000000,72,115,"Quebradillas Municipio, PR",May-22,6556,6099,457,7.00000000
CN7211700000000,72,117,"Rincon Municipio, PR",May-22,5121,4710,411,8.00000000
CN7211900000000,72,119,"Rio Grande Municipio, PR",May-22,18724,17612,1112,5.90000000
CN7212100000000,72,121,"Sabana Grande Municipio, PR",May-22,6434,5935,499,7.80000000
CN7212300000000,72,123,"Salinas Municipio, PR",May-22,7501,6869,632,8.40000000
CN7212500000000,72,125,"San German Municipio, PR",May-22,10624,9783,841,7.90000000
CN7212700000000,72,127,"San Juan Municipio, PR",May-22,146943,140703,6240,4.20000000
CN7212900000000,72,129,"San Lorenzo Municipio, PR",May-22,12611,11904,707,5.60000000
CN7213100000000,72,131,"San Sebastian Municipio, PR",May-22,10900,9816,1084,9.90000000
CN7213300000000,72,133,"Santa Isabel Municipio, PR",May-22,8835,8134,701,7.90000000
CN7213500000000,72,135,"Toa Alta Municipio, PR",May-22,30603,29290,1313,4.30000000
CN7213700000000,72,137,"Toa Baja Municipio, PR",May-22,31871,30391,1480,4.60000000
CN7213900000000,72,139,"Trujillo Alto Municipio, PR",May-22,29812,28759,1053,3.50000000
CN7214100000000,72,141,"Utuado Municipio, PR",May-22,7134,6556,578,8.10000000
CN7214300000000,72,143,"Vega Alta Municipio, PR",May-22,10843,10048,795,7.30000000
CN7214500000000,72,145,"Vega Baja Municipio, PR",May-22,14349,13241,1108,7.70000000
CN7214700000000,72,147,"Vieques Municipio, PR",May-22,2811,2575,236,8.40000000
CN7214900000000,72,149,"Villalba Municipio, PR",May-22,7831,7098,733,9.40000000
CN7215100000000,72,151,"Yabucoa Municipio, PR",May-22,9346,8578,768,8.20000000
CN7215300000000,72,153,"Yauco Municipio, PR",May-22,10417,9345,1072,10.30000000
CN0100100000000,01,001,"Autauga County, AL",Jun-22,27186,26405,781,2.90000000
CN0100300000000,01,003,"Baldwin County, AL",Jun-22,102912,99858,3054,3.00000000
CN0100500000000,01,005,"Barbour County, AL",Jun-22,8176,7759,417,5.10000000
CN0100700000000,01,007,"Bibb County, AL",Jun-22,8877,8601,276,3.10000000
CN0100900000000,01,009,"Blount County, AL",Jun-22,26238,25497,741,2.80000000
CN0101100000000,01,011,"Bullock County, AL",Jun-22,4360,4198,162,3.70000000
CN0101300000000,01,013,"Butler County, AL",Jun-22,8731,8337,394,4.50000000
CN0101500000000,01,015,"Calhoun County, AL",Jun-22,46832,45022,1810,3.90000000
CN0101700000000,01,017,"Chambers County, AL",Jun-22,16004,15491,513,3.20000000
CN0101900000000,01,019,"Cherokee County, AL",Jun-22,11750,11419,331,2.80000000
CN0102100000000,01,021,"Chilton County, AL",Jun-22,20556,19982,574,2.80000000
CN0102300000000,01,023,"Choctaw County, AL",Jun-22,4346,4142,204,4.70000000
CN0102500000000,01,025,"Clarke County, AL",Jun-22,7775,7312,463,6.00000000
CN0102700000000,01,027,"Clay County, AL",Jun-22,6103,5934,169,2.80000000
CN0102900000000,01,029,"Cleburne County, AL",Jun-22,6198,6015,183,3.00000000
CN0103100000000,01,031,"Coffee County, AL",Jun-22,21507,20819,688,3.20000000
CN0103300000000,01,033,"Colbert County, AL",Jun-22,23887,22955,932,3.90000000
CN0103500000000,01,035,"Conecuh County, AL",Jun-22,4189,3995,194,4.60000000
CN0103700000000,01,037,"Coosa County, AL",Jun-22,4414,4275,139,3.10000000
CN0103900000000,01,039,"Covington County, AL",Jun-22,15270,14781,489,3.20000000
CN0104100000000,01,041,"Crenshaw County, AL",Jun-22,6031,5827,204,3.40000000
CN0104300000000,01,043,"Cullman County, AL",Jun-22,39443,38402,1041,2.60000000
CN0104500000000,01,045,"Dale County, AL",Jun-22,20932,20247,685,3.30000000
CN0104700000000,01,047,"Dallas County, AL",Jun-22,13837,12901,936,6.80000000
CN0104900000000,01,049,"DeKalb County, AL",Jun-22,31199,30258,941,3.00000000
CN0105100000000,01,051,"Elmore County, AL",Jun-22,38802,37747,1055,2.70000000
CN0105300000000,01,053,"Escambia County, AL",Jun-22,14230,13696,534,3.80000000
CN0105500000000,01,055,"Etowah County, AL",Jun-22,40104,38566,1538,3.80000000
CN0105700000000,01,057,"Fayette County, AL",Jun-22,6697,6468,229,3.40000000
CN0105900000000,01,059,"Franklin County, AL",Jun-22,14501,14069,432,3.00000000
CN0106100000000,01,061,"Geneva County, AL",Jun-22,11244,10900,344,3.10000000
CN0106300000000,01,063,"Greene County, AL",Jun-22,2757,2584,173,6.30000000
CN0106500000000,01,065,"Hale County, AL",Jun-22,5943,5619,324,5.50000000
CN0106700000000,01,067,"Henry County, AL",Jun-22,7075,6832,243,3.40000000
CN0106900000000,01,069,"Houston County, AL",Jun-22,48115,46551,1564,3.30000000
CN0107100000000,01,071,"Jackson County, AL",Jun-22,23195,22446,749,3.20000000
CN0107300000000,01,073,"Jefferson County, AL",Jun-22,329444,318887,10557,3.20000000
CN0107500000000,01,075,"Lamar County, AL",Jun-22,5789,5598,191,3.30000000
CN0107700000000,01,077,"Lauderdale County, AL",Jun-22,43037,41555,1482,3.40000000
CN0107900000000,01,079,"Lawrence County, AL",Jun-22,14759,14303,456,3.10000000
CN0108100000000,01,081,"Lee County, AL",Jun-22,79271,76871,2400,3.00000000
CN0108300000000,01,083,"Limestone County, AL",Jun-22,48084,46794,1290,2.70000000
CN0108500000000,01,085,"Lowndes County, AL",Jun-22,3607,3337,270,7.50000000
CN0108700000000,01,087,"Macon County, AL",Jun-22,7939,7505,434,5.50000000
CN0108900000000,01,089,"Madison County, AL",Jun-22,198434,192994,5440,2.70000000
CN0109100000000,01,091,"Marengo County, AL",Jun-22,7558,7253,305,4.00000000
CN0109300000000,01,093,"Marion County, AL",Jun-22,14021,13610,411,2.90000000
CN0109500000000,01,095,"Marshall County, AL",Jun-22,45737,44544,1193,2.60000000
CN0109700000000,01,097,"Mobile County, AL",Jun-22,192646,184703,7943,4.10000000
CN0109900000000,01,099,"Monroe County, AL",Jun-22,7406,7026,380,5.10000000
CN0110100000000,01,101,"Montgomery County, AL",Jun-22,108963,104766,4197,3.90000000
CN0110300000000,01,103,"Morgan County, AL",Jun-22,60916,59261,1655,2.70000000
CN0110500000000,01,105,"Perry County, AL",Jun-22,3080,2823,257,8.30000000
CN0110700000000,01,107,"Pickens County, AL",Jun-22,7674,7333,341,4.40000000
CN0110900000000,01,109,"Pike County, AL",Jun-22,16380,15844,536,3.30000000
CN0111100000000,01,111,"Randolph County, AL",Jun-22,9801,9506,295,3.00000000
CN0111300000000,01,113,"Russell County, AL",Jun-22,24052,23309,743,3.10000000
CN0111500000000,01,115,"St. Clair County, AL",Jun-22,42985,41799,1186,2.80000000
CN0111700000000,01,117,"Shelby County, AL",Jun-22,123452,120637,2815,2.30000000
CN0111900000000,01,119,"Sumter County, AL",Jun-22,4551,4323,228,5.00000000
CN0112100000000,01,121,"Talladega County, AL",Jun-22,36076,34672,1404,3.90000000
CN0112300000000,01,123,"Tallapoosa County, AL",Jun-22,17892,17254,638,3.60000000
CN0112500000000,01,125,"Tuscaloosa County, AL",Jun-22,103393,99873,3520,3.40000000
CN0112700000000,01,127,"Walker County, AL",Jun-22,26081,25191,890,3.40000000
CN0112900000000,01,129,"Washington County, AL",Jun-22,6583,6287,296,4.50000000
CN0113100000000,01,131,"Wilcox County, AL",Jun-22,2572,2309,263,10.20000000
CN0113300000000,01,133,"Winston County, AL",Jun-22,10450,10145,305,2.90000000
CN0201300000000,02,013,"Aleutians East Borough, AK",Jun-22,3093,3041,52,1.70000000
CN0201600000000,02,016,"Aleutians West Census Area, AK",Jun-22,3290,3168,122,3.70000000
CN0202000000000,02,020,"Anchorage Borough/municipality, AK",Jun-22,152721,146898,5823,3.80000000
CN0205000000000,02,050,"Bethel Census Area, AK",Jun-22,7128,6295,833,11.70000000
CN0206000000000,02,060,"Bristol Bay Borough, AK",Jun-22,717,698,19,2.60000000
CN0206300000000,02,063,"Chugach Census Area, AK",Jun-22,3870,3732,138,3.60000000
CN0206600000000,02,066,"Copper River Census Area, AK",Jun-22,1578,1444,134,8.50000000
CN0206800000000,02,068,"Denali Borough, AK",Jun-22,1179,1116,63,5.30000000
CN0207000000000,02,070,"Dillingham Census Area, AK",Jun-22,1905,1777,128,6.70000000
CN0209000000000,02,090,"Fairbanks North Star Borough, AK",Jun-22,46375,44570,1805,3.90000000
CN0210000000000,02,100,"Haines Borough, AK",Jun-22,1150,1070,80,7.00000000
CN0210500000000,02,105,"Hoonah-Angoon Census Area, AK",Jun-22,1324,1254,70,5.30000000
CN0211000000000,02,110,"Juneau Borough/city, AK",Jun-22,17262,16716,546,3.20000000
CN0212200000000,02,122,"Kenai Peninsula Borough, AK",Jun-22,29739,28261,1478,5.00000000
CN0213000000000,02,130,"Ketchikan Gateway Borough, AK",Jun-22,6730,6416,314,4.70000000
CN0215000000000,02,150,"Kodiak Island Borough, AK",Jun-22,6234,5964,270,4.30000000
CN0215800000000,02,158,"Kusilvak Census Area, AK",Jun-22,2239,1832,407,18.20000000
CN0216400000000,02,164,"Lake and Peninsula Borough, AK",Jun-22,710,663,47,6.60000000
CN0217000000000,02,170,"Matanuska-Susitna Borough, AK",Jun-22,50563,47905,2658,5.30000000
CN0218000000000,02,180,"Nome Census Area, AK",Jun-22,4091,3712,379,9.30000000
CN0218500000000,02,185,"North Slope Borough, AK",Jun-22,2910,2732,178,6.10000000
CN0218800000000,02,188,"Northwest Arctic Borough, AK",Jun-22,2810,2492,318,11.30000000
CN0219500000000,02,195,"Petersburg Borough, AK",Jun-22,1809,1715,94,5.20000000
CN0219800000000,02,198,"Prince of Wales-Hyder Census Area, AK",Jun-22,3073,2892,181,5.90000000
CN0222000000000,02,220,"Sitka Borough/city, AK",Jun-22,4660,4514,146,3.10000000
CN0223000000000,02,230,"Skagway Municipality, AK",Jun-22,652,611,41,6.30000000
CN0224000000000,02,240,"Southeast Fairbanks Census Area, AK",Jun-22,3410,3229,181,5.30000000
CN0227500000000,02,275,"Wrangell Borough/city, AK",Jun-22,976,923,53,5.40000000
CN0228200000000,02,282,"Yakutat Borough/city, AK",Jun-22,393,375,18,4.60000000
CN0229000000000,02,290,"Yukon-Koyukuk Census Area, AK",Jun-22,2580,2352,228,8.80000000
CN0400100000000,04,001,"Apache County, AZ",Jun-22,18308,16615,1693,9.20000000
CN0400300000000,04,003,"Cochise County, AZ",Jun-22,48962,46866,2096,4.30000000
CN0400500000000,04,005,"Coconino County, AZ",Jun-22,75539,71911,3628,4.80000000
CN0400700000000,04,007,"Gila County, AZ",Jun-22,20401,19522,879,4.30000000
CN0400900000000,04,009,"Graham County, AZ",Jun-22,15657,15104,553,3.50000000
CN0401100000000,04,011,"Greenlee County, AZ",Jun-22,4438,4305,133,3.00000000
CN0401200000000,04,012,"La Paz County, AZ",Jun-22,8279,7842,437,5.30000000
CN0401300000000,04,013,"Maricopa County, AZ",Jun-22,2360061,2281198,78863,3.30000000
CN0401500000000,04,015,"Mohave County, AZ",Jun-22,90869,86645,4224,4.60000000
CN0401700000000,04,017,"Navajo County, AZ",Jun-22,39896,37531,2365,5.90000000
CN0401900000000,04,019,"Pima County, AZ",Jun-22,484661,465605,19056,3.90000000
CN0402100000000,04,021,"Pinal County, AZ",Jun-22,194926,187291,7635,3.90000000
CN0402300000000,04,023,"Santa Cruz County, AZ",Jun-22,19097,17574,1523,8.00000000
CN0402500000000,04,025,"Yavapai County, AZ",Jun-22,107724,104085,3639,3.40000000
CN0402700000000,04,027,"Yuma County, AZ",Jun-22,97465,80697,16768,17.20000000
CN0500100000000,05,001,"Arkansas County, AR",Jun-22,9189,8845,344,3.70000000
CN0500300000000,05,003,"Ashley County, AR",Jun-22,6908,6454,454,6.60000000
CN0500500000000,05,005,"Baxter County, AR",Jun-22,16980,16313,667,3.90000000
CN0500700000000,05,007,"Benton County, AR",Jun-22,149202,145057,4145,2.80000000
CN0500900000000,05,009,"Boone County, AR",Jun-22,16109,15602,507,3.10000000
CN0501100000000,05,011,"Bradley County, AR",Jun-22,4163,3971,192,4.60000000
CN0501300000000,05,013,"Calhoun County, AR",Jun-22,2263,2181,82,3.60000000
CN0501500000000,05,015,"Carroll County, AR",Jun-22,12989,12605,384,3.00000000
CN0501700000000,05,017,"Chicot County, AR",Jun-22,2955,2716,239,8.10000000
CN0501900000000,05,019,"Clark County, AR",Jun-22,8465,7982,483,5.70000000
CN0502100000000,05,021,"Clay County, AR",Jun-22,5474,5233,241,4.40000000
CN0502300000000,05,023,"Cleburne County, AR",Jun-22,9222,8805,417,4.50000000
CN0502500000000,05,025,"Cleveland County, AR",Jun-22,3164,3027,137,4.30000000
CN0502700000000,05,027,"Columbia County, AR",Jun-22,8772,8323,449,5.10000000
CN0502900000000,05,029,"Conway County, AR",Jun-22,8526,8171,355,4.20000000
CN0503100000000,05,031,"Craighead County, AR",Jun-22,57260,55418,1842,3.20000000
CN0503300000000,05,033,"Crawford County, AR",Jun-22,26626,25658,968,3.60000000
CN0503500000000,05,035,"Crittenden County, AR",Jun-22,21179,20180,999,4.70000000
CN0503700000000,05,037,"Cross County, AR",Jun-22,7105,6814,291,4.10000000
CN0503900000000,05,039,"Dallas County, AR",Jun-22,2781,2659,122,4.40000000
CN0504100000000,05,041,"Desha County, AR",Jun-22,4890,4587,303,6.20000000
CN0504300000000,05,043,"Drew County, AR",Jun-22,7514,7145,369,4.90000000
CN0504500000000,05,045,"Faulkner County, AR",Jun-22,62982,60895,2087,3.30000000
CN0504700000000,05,047,"Franklin County, AR",Jun-22,7447,7160,287,3.90000000
CN0504900000000,05,049,"Fulton County, AR",Jun-22,5256,5059,197,3.70000000
CN0505100000000,05,051,"Garland County, AR",Jun-22,42069,40183,1886,4.50000000
CN0505300000000,05,053,"Grant County, AR",Jun-22,8410,8112,298,3.50000000
CN0505500000000,05,055,"Greene County, AR",Jun-22,19734,19028,706,3.60000000
CN0505700000000,05,057,"Hempstead County, AR",Jun-22,9327,8988,339,3.60000000
CN0505900000000,05,059,"Hot Spring County, AR",Jun-22,13723,13154,569,4.10000000
CN0506100000000,05,061,"Howard County, AR",Jun-22,5403,5202,201,3.70000000
CN0506300000000,05,063,"Independence County, AR",Jun-22,16490,15835,655,4.00000000
CN0506500000000,05,065,"Izard County, AR",Jun-22,4343,4083,260,6.00000000
CN0506700000000,05,067,"Jackson County, AR",Jun-22,5546,5251,295,5.30000000
CN0506900000000,05,069,"Jefferson County, AR",Jun-22,26732,25110,1622,6.10000000
CN0507100000000,05,071,"Johnson County, AR",Jun-22,10097,9611,486,4.80000000
CN0507300000000,05,073,"Lafayette County, AR",Jun-22,2326,2194,132,5.70000000
CN0507500000000,05,075,"Lawrence County, AR",Jun-22,6578,6298,280,4.30000000
CN0507700000000,05,077,"Lee County, AR",Jun-22,2569,2433,136,5.30000000
CN0507900000000,05,079,"Lincoln County, AR",Jun-22,3787,3597,190,5.00000000
CN0508100000000,05,081,"Little River County, AR",Jun-22,5447,5227,220,4.00000000
CN0508300000000,05,083,"Logan County, AR",Jun-22,8427,8059,368,4.40000000
CN0508500000000,05,085,"Lonoke County, AR",Jun-22,34057,32941,1116,3.30000000
CN0508700000000,05,087,"Madison County, AR",Jun-22,7577,7350,227,3.00000000
CN0508900000000,05,089,"Marion County, AR",Jun-22,6445,6190,255,4.00000000
CN0509100000000,05,091,"Miller County, AR",Jun-22,19665,18826,839,4.30000000
CN0509300000000,05,093,"Mississippi County, AR",Jun-22,16273,15111,1162,7.10000000
CN0509500000000,05,095,"Monroe County, AR",Jun-22,2570,2443,127,4.90000000
CN0509700000000,05,097,"Montgomery County, AR",Jun-22,2897,2748,149,5.10000000
CN0509900000000,05,099,"Nevada County, AR",Jun-22,3461,3305,156,4.50000000
CN0510100000000,05,101,"Newton County, AR",Jun-22,3220,3115,105,3.30000000
CN0510300000000,05,103,"Ouachita County, AR",Jun-22,9306,8898,408,4.40000000
CN0510500000000,05,105,"Perry County, AR",Jun-22,4207,4029,178,4.20000000
CN0510700000000,05,107,"Phillips County, AR",Jun-22,5588,5168,420,7.50000000
CN0510900000000,05,109,"Pike County, AR",Jun-22,4172,3989,183,4.40000000
CN0511100000000,05,111,"Poinsett County, AR",Jun-22,9833,9448,385,3.90000000
CN0511300000000,05,113,"Polk County, AR",Jun-22,7834,7515,319,4.10000000
CN0511500000000,05,115,"Pope County, AR",Jun-22,27776,26546,1230,4.40000000
CN0511700000000,05,117,"Prairie County, AR",Jun-22,3476,3356,120,3.50000000
CN0511900000000,05,119,"Pulaski County, AR",Jun-22,189747,182047,7700,4.10000000
CN0512100000000,05,121,"Randolph County, AR",Jun-22,7348,7064,284,3.90000000
CN0512300000000,05,123,"St. Francis County, AR",Jun-22,7746,7316,430,5.60000000
CN0512500000000,05,125,"Saline County, AR",Jun-22,59966,58065,1901,3.20000000
CN0512700000000,05,127,"Scott County, AR",Jun-22,4178,4035,143,3.40000000
CN0512900000000,05,129,"Searcy County, AR",Jun-22,2935,2799,136,4.60000000
CN0513100000000,05,131,"Sebastian County, AR",Jun-22,56105,54136,1969,3.50000000
CN0513300000000,05,133,"Sevier County, AR",Jun-22,5403,5171,232,4.30000000
CN0513500000000,05,135,"Sharp County, AR",Jun-22,5826,5541,285,4.90000000
CN0513700000000,05,137,"Stone County, AR",Jun-22,4618,4391,227,4.90000000
CN0513900000000,05,139,"Union County, AR",Jun-22,15054,14208,846,5.60000000
CN0514100000000,05,141,"Van Buren County, AR",Jun-22,6058,5765,293,4.80000000
CN0514300000000,05,143,"Washington County, AR",Jun-22,131913,128296,3617,2.70000000
CN0514500000000,05,145,"White County, AR",Jun-22,34297,32926,1371,4.00000000
CN0514700000000,05,147,"Woodruff County, AR",Jun-22,2774,2659,115,4.10000000
CN0514900000000,05,149,"Yell County, AR",Jun-22,7868,7514,354,4.50000000
CN0600100000000,06,001,"Alameda County, CA",Jun-22,821780,797413,24367,3.00000000
CN0600300000000,06,003,"Alpine County, CA",Jun-22,451,425,26,5.80000000
CN0600500000000,06,005,"Amador County, CA",Jun-22,14533,13984,549,3.80000000
CN0600700000000,06,007,"Butte County, CA",Jun-22,91493,87808,3685,4.00000000
CN0600900000000,06,009,"Calaveras County, CA",Jun-22,21903,21230,673,3.10000000
CN0601100000000,06,011,"Colusa County, CA",Jun-22,11216,10237,979,8.70000000
CN0601300000000,06,013,"Contra Costa County, CA",Jun-22,549230,531640,17590,3.20000000
CN0601500000000,06,015,"Del Norte County, CA",Jun-22,9372,8933,439,4.70000000
CN0601700000000,06,017,"El Dorado County, CA",Jun-22,91991,89365,2626,2.90000000
CN0601900000000,06,019,"Fresno County, CA",Jun-22,452365,425869,26496,5.90000000
CN0602100000000,06,021,"Glenn County, CA",Jun-22,12607,12004,603,4.80000000
CN0602300000000,06,023,"Humboldt County, CA",Jun-22,59524,57486,2038,3.40000000
CN0602500000000,06,025,"Imperial County, CA",Jun-22,69107,59932,9175,13.30000000
CN0602700000000,06,027,"Inyo County, CA",Jun-22,8262,8011,251,3.00000000
CN0602900000000,06,029,"Kern County, CA",Jun-22,383598,357370,26228,6.80000000
CN0603100000000,06,031,"Kings County, CA",Jun-22,55623,52038,3585,6.40000000
CN0603300000000,06,033,"Lake County, CA",Jun-22,28565,27311,1254,4.40000000
CN0603500000000,06,035,"Lassen County, CA",Jun-22,9022,8721,301,3.30000000
CN0603700000000,06,037,"Los Angeles County, CA",Jun-22,4935287,4694769,240518,4.90000000
CN0603900000000,06,039,"Madera County, CA",Jun-22,62673,59123,3550,5.70000000
CN0604100000000,06,041,"Marin County, CA",Jun-22,129652,126770,2882,2.20000000
CN0604300000000,06,043,"Mariposa County, CA",Jun-22,7387,7101,286,3.90000000
CN0604500000000,06,045,"Mendocino County, CA",Jun-22,37635,36379,1256,3.30000000
CN0604700000000,06,047,"Merced County, CA",Jun-22,115584,107445,8139,7.00000000
CN0604900000000,06,049,"Modoc County, CA",Jun-22,3360,3231,129,3.80000000
CN0605100000000,06,051,"Mono County, CA",Jun-22,8838,8553,285,3.20000000
CN0605300000000,06,053,"Monterey County, CA",Jun-22,220897,211018,9879,4.50000000
CN0605500000000,06,055,"Napa County, CA",Jun-22,70434,68522,1912,2.70000000
CN0605700000000,06,057,"Nevada County, CA",Jun-22,47806,46435,1371,2.90000000
CN0605900000000,06,059,"Orange County, CA",Jun-22,1574917,1529544,45373,2.90000000
CN0606100000000,06,061,"Placer County, CA",Jun-22,190953,186029,4924,2.60000000
CN0606300000000,06,063,"Plumas County, CA",Jun-22,7847,7473,374,4.80000000
CN0606500000000,06,065,"Riverside County, CA",Jun-22,1148051,1102298,45753,4.00000000
CN0606700000000,06,067,"Sacramento County, CA",Jun-22,718203,691925,26278,3.70000000
CN0606900000000,06,069,"San Benito County, CA",Jun-22,32713,31333,1380,4.20000000
CN0607100000000,06,071,"San Bernardino County, CA",Jun-22,1003002,962872,40130,4.00000000
CN0607300000000,06,073,"San Diego County, CA",Jun-22,1565684,1515784,49900,3.20000000
CN0607500000000,06,075,"San Francisco County/city, CA",Jun-22,566906,554356,12550,2.20000000
CN0607700000000,06,077,"San Joaquin County, CA",Jun-22,335214,318320,16894,5.00000000
CN0607900000000,06,079,"San Luis Obispo County, CA",Jun-22,137811,134236,3575,2.60000000
CN0608100000000,06,081,"San Mateo County, CA",Jun-22,448696,439497,9199,2.10000000
CN0608300000000,06,083,"Santa Barbara County, CA",Jun-22,223985,217647,6338,2.80000000
CN0608500000000,06,085,"Santa Clara County, CA",Jun-22,1039962,1016778,23184,2.20000000
CN0608700000000,06,087,"Santa Cruz County, CA",Jun-22,136531,131280,5251,3.80000000
CN0608900000000,06,089,"Shasta County, CA",Jun-22,73598,70697,2901,3.90000000
CN0609100000000,06,091,"Sierra County, CA",Jun-22,1398,1355,43,3.10000000
CN0609300000000,06,093,"Siskiyou County, CA",Jun-22,16543,15762,781,4.70000000
CN0609500000000,06,095,"Solano County, CA",Jun-22,199512,191485,8027,4.00000000
CN0609700000000,06,097,"Sonoma County, CA",Jun-22,247670,241072,6598,2.70000000
CN0609900000000,06,099,"Stanislaus County, CA",Jun-22,238614,226080,12534,5.30000000
CN0610100000000,06,101,"Sutter County, CA",Jun-22,46621,43888,2733,5.90000000
CN0610300000000,06,103,"Tehama County, CA",Jun-22,25630,24529,1101,4.30000000
CN0610500000000,06,105,"Trinity County, CA",Jun-22,4596,4436,160,3.50000000
CN0610700000000,06,107,"Tulare County, CA",Jun-22,207155,191845,15310,7.40000000
CN0610900000000,06,109,"Tuolumne County, CA",Jun-22,19863,19073,790,4.00000000
CN0611100000000,06,111,"Ventura County, CA",Jun-22,408651,395649,13002,3.20000000
CN0611300000000,06,113,"Yolo County, CA",Jun-22,108227,104551,3676,3.40000000
CN0611500000000,06,115,"Yuba County, CA",Jun-22,31227,29654,1573,5.00000000
CN0800100000000,08,001,"Adams County, CO",Jun-22,284140,273558,10582,3.70000000
CN0800300000000,08,003,"Alamosa County, CO",Jun-22,8795,8478,317,3.60000000
CN0800500000000,08,005,"Arapahoe County, CO",Jun-22,377892,365031,12861,3.40000000
CN0800700000000,08,007,"Archuleta County, CO",Jun-22,7582,7345,237,3.10000000
CN0800900000000,08,009,"Baca County, CO",Jun-22,2185,2145,40,1.80000000
CN0801100000000,08,011,"Bent County, CO",Jun-22,1953,1880,73,3.70000000
CN0801300000000,08,013,"Boulder County, CO",Jun-22,199948,194391,5557,2.80000000
CN0801400000000,08,014,"Broomfield County/city, CO",Jun-22,42685,41521,1164,2.70000000
CN0801500000000,08,015,"Chaffee County, CO",Jun-22,11208,10930,278,2.50000000
CN0801700000000,08,017,"Cheyenne County, CO",Jun-22,1163,1142,21,1.80000000
CN0801900000000,08,019,"Clear Creek County, CO",Jun-22,6195,6001,194,3.10000000
CN0802100000000,08,021,"Conejos County, CO",Jun-22,4254,4116,138,3.20000000
CN0802300000000,08,023,"Costilla County, CO",Jun-22,1988,1911,77,3.90000000
CN0802500000000,08,025,"Crowley County, CO",Jun-22,1485,1429,56,3.80000000
CN0802700000000,08,027,"Custer County, CO",Jun-22,2612,2538,74,2.80000000
CN0802900000000,08,029,"Delta County, CO",Jun-22,14592,14087,505,3.50000000
CN0803100000000,08,031,"Denver County/city, CO",Jun-22,439200,424336,14864,3.40000000
CN0803300000000,08,033,"Dolores County, CO",Jun-22,1217,1185,32,2.60000000
CN0803500000000,08,035,"Douglas County, CO",Jun-22,208854,203238,5616,2.70000000
CN0803700000000,08,037,"Eagle County, CO",Jun-22,38704,37704,1000,2.60000000
CN0803900000000,08,039,"Elbert County, CO",Jun-22,16131,15712,419,2.60000000
CN0804100000000,08,041,"El Paso County, CO",Jun-22,358735,346002,12733,3.50000000
CN0804300000000,08,043,"Fremont County, CO",Jun-22,16373,15610,763,4.70000000
CN0804500000000,08,045,"Garfield County, CO",Jun-22,33523,32570,953,2.80000000
CN0804700000000,08,047,"Gilpin County, CO",Jun-22,3965,3839,126,3.20000000
CN0804900000000,08,049,"Grand County, CO",Jun-22,10388,10135,253,2.40000000
CN0805100000000,08,051,"Gunnison County, CO",Jun-22,12324,12035,289,2.30000000
CN0805300000000,08,053,"Hinsdale County, CO",Jun-22,541,530,11,2.00000000
CN0805500000000,08,055,"Huerfano County, CO",Jun-22,2709,2551,158,5.80000000
CN0805700000000,08,057,"Jackson County, CO",Jun-22,1067,1048,19,1.80000000
CN0805900000000,08,059,"Jefferson County, CO",Jun-22,345020,334719,10301,3.00000000
CN0806100000000,08,061,"Kiowa County, CO",Jun-22,973,954,19,2.00000000
CN0806300000000,08,063,"Kit Carson County, CO",Jun-22,4365,4277,88,2.00000000
CN0806500000000,08,065,"Lake County, CO",Jun-22,5080,4948,132,2.60000000
CN0806700000000,08,067,"La Plata County, CO",Jun-22,33005,32027,978,3.00000000
CN0806900000000,08,069,"Larimer County, CO",Jun-22,212720,206594,6126,2.90000000
CN0807100000000,08,071,"Las Animas County, CO",Jun-22,6461,6151,310,4.80000000
CN0807300000000,08,073,"Lincoln County, CO",Jun-22,2409,2342,67,2.80000000
CN0807500000000,08,075,"Logan County, CO",Jun-22,10990,10675,315,2.90000000
CN0807700000000,08,077,"Mesa County, CO",Jun-22,78037,75174,2863,3.70000000
CN0807900000000,08,079,"Mineral County, CO",Jun-22,469,457,12,2.60000000
CN0808100000000,08,081,"Moffat County, CO",Jun-22,7343,7129,214,2.90000000
CN0808300000000,08,083,"Montezuma County, CO",Jun-22,14025,13553,472,3.40000000
CN0808500000000,08,085,"Montrose County, CO",Jun-22,23420,22692,728,3.10000000
CN0808700000000,08,087,"Morgan County, CO",Jun-22,16451,15910,541,3.30000000
CN0808900000000,08,089,"Otero County, CO",Jun-22,8456,8105,351,4.20000000
CN0809100000000,08,091,"Ouray County, CO",Jun-22,3114,3035,79,2.50000000
CN0809300000000,08,093,"Park County, CO",Jun-22,11682,11378,304,2.60000000
CN0809500000000,08,095,"Phillips County, CO",Jun-22,2602,2547,55,2.10000000
CN0809700000000,08,097,"Pitkin County, CO",Jun-22,11458,11116,342,3.00000000
CN0809900000000,08,099,"Prowers County, CO",Jun-22,6445,6249,196,3.00000000
CN0810100000000,08,101,"Pueblo County, CO",Jun-22,78726,74739,3987,5.10000000
CN0810300000000,08,103,"Rio Blanco County, CO",Jun-22,2958,2842,116,3.90000000
CN0810500000000,08,105,"Rio Grande County, CO",Jun-22,5764,5528,236,4.10000000
CN0810700000000,08,107,"Routt County, CO",Jun-22,16286,15860,426,2.60000000
CN0810900000000,08,109,"Saguache County, CO",Jun-22,3628,3496,132,3.60000000
CN0811100000000,08,111,"San Juan County, CO",Jun-22,772,757,15,1.90000000
CN0811300000000,08,113,"San Miguel County, CO",Jun-22,6540,6393,147,2.20000000
CN0811500000000,08,115,"Sedgwick County, CO",Jun-22,1254,1223,31,2.50000000
CN0811700000000,08,117,"Summit County, CO",Jun-22,22214,21701,513,2.30000000
CN0811900000000,08,119,"Teller County, CO",Jun-22,13405,12973,432,3.20000000
CN0812100000000,08,121,"Washington County, CO",Jun-22,2869,2798,71,2.50000000
CN0812300000000,08,123,"Weld County, CO",Jun-22,168101,162089,6012,3.60000000
CN0812500000000,08,125,"Yuma County, CO",Jun-22,6049,5921,128,2.10000000
CN0900100000000,09,001,"Fairfield County, CT",Jun-22,484482,464957,19525,4.00000000
CN0900300000000,09,003,"Hartford County, CT",Jun-22,481208,460950,20258,4.20000000
CN0900500000000,09,005,"Litchfield County, CT",Jun-22,105373,101619,3754,3.60000000
CN0900700000000,09,007,"Middlesex County, CT",Jun-22,94198,90949,3249,3.40000000
CN0900900000000,09,009,"New Haven County, CT",Jun-22,468902,448581,20321,4.30000000
CN0901100000000,09,011,"New London County, CT",Jun-22,134570,128578,5992,4.50000000
CN0901300000000,09,013,"Tolland County, CT",Jun-22,86760,83679,3081,3.60000000
CN0901500000000,09,015,"Windham County, CT",Jun-22,64080,61293,2787,4.30000000
CN1000100000000,10,001,"Kent County, DE",Jun-22,81408,76513,4895,6.00000000
CN1000300000000,10,003,"New Castle County, DE",Jun-22,303414,288627,14787,4.90000000
CN1000500000000,10,005,"Sussex County, DE",Jun-22,116908,112248,4660,4.00000000
CN1100100000000,11,001,District of Columbia,Jun-22,392180,372959,19221,4.90000000
CN1200100000000,12,001,"Alachua County, FL",Jun-22,139802,135751,4051,2.90000000
CN1200300000000,12,003,"Baker County, FL",Jun-22,12725,12373,352,2.80000000
CN1200500000000,12,005,"Bay County, FL",Jun-22,89524,87138,2386,2.70000000
CN1200700000000,12,007,"Bradford County, FL",Jun-22,10992,10646,346,3.10000000
CN1200900000000,12,009,"Brevard County, FL",Jun-22,299555,291014,8541,2.90000000
CN1201100000000,12,011,"Broward County, FL",Jun-22,1068191,1036315,31876,3.00000000
CN1201300000000,12,013,"Calhoun County, FL",Jun-22,5047,4881,166,3.30000000
CN1201500000000,12,015,"Charlotte County, FL",Jun-22,76072,73626,2446,3.20000000
CN1201700000000,12,017,"Citrus County, FL",Jun-22,47895,45804,2091,4.40000000
CN1201900000000,12,019,"Clay County, FL",Jun-22,113654,110642,3012,2.70000000
CN1202100000000,12,021,"Collier County, FL",Jun-22,187034,181717,5317,2.80000000
CN1202300000000,12,023,"Columbia County, FL",Jun-22,29846,28866,980,3.30000000
CN1202700000000,12,027,"DeSoto County, FL",Jun-22,15302,14855,447,2.90000000
CN1202900000000,12,029,"Dixie County, FL",Jun-22,5846,5655,191,3.30000000
CN1203100000000,12,031,"Duval County, FL",Jun-22,517106,500596,16510,3.20000000
CN1203300000000,12,033,"Escambia County, FL",Jun-22,151255,146608,4647,3.10000000
CN1203500000000,12,035,"Flagler County, FL",Jun-22,50203,48485,1718,3.40000000
CN1203700000000,12,037,"Franklin County, FL",Jun-22,5011,4882,129,2.60000000
CN1203900000000,12,039,"Gadsden County, FL",Jun-22,20569,19821,748,3.60000000
CN1204100000000,12,041,"Gilchrist County, FL",Jun-22,7279,7059,220,3.00000000
CN1204300000000,12,043,"Glades County, FL",Jun-22,5038,4857,181,3.60000000
CN1204500000000,12,045,"Gulf County, FL",Jun-22,5509,5366,143,2.60000000
CN1204700000000,12,047,"Hamilton County, FL",Jun-22,4129,3954,175,4.20000000
CN1204900000000,12,049,"Hardee County, FL",Jun-22,8816,8455,361,4.10000000
CN1205100000000,12,051,"Hendry County, FL",Jun-22,15741,14905,836,5.30000000
CN1205300000000,12,053,"Hernando County, FL",Jun-22,76630,73824,2806,3.70000000
CN1205500000000,12,055,"Highlands County, FL",Jun-22,34926,33319,1607,4.60000000
CN1205700000000,12,057,"Hillsborough County, FL",Jun-22,800604,777943,22661,2.80000000
CN1205900000000,12,059,"Holmes County, FL",Jun-22,7079,6853,226,3.20000000
CN1206100000000,12,061,"Indian River County, FL",Jun-22,67129,64698,2431,3.60000000
CN1206300000000,12,063,"Jackson County, FL",Jun-22,16984,16419,565,3.30000000
CN1206500000000,12,065,"Jefferson County, FL",Jun-22,5730,5527,203,3.50000000
CN1206700000000,12,067,"Lafayette County, FL",Jun-22,2755,2670,85,3.10000000
CN1206900000000,12,069,"Lake County, FL",Jun-22,168103,162849,5254,3.10000000
CN1207100000000,12,071,"Lee County, FL",Jun-22,370286,359457,10829,2.90000000
CN1207300000000,12,073,"Leon County, FL",Jun-22,157007,152151,4856,3.10000000
CN1207500000000,12,075,"Levy County, FL",Jun-22,16974,16389,585,3.40000000
CN1207700000000,12,077,"Liberty County, FL",Jun-22,2601,2521,80,3.10000000
CN1207900000000,12,079,"Madison County, FL",Jun-22,7922,7659,263,3.30000000
CN1208100000000,12,081,"Manatee County, FL",Jun-22,193240,187808,5432,2.80000000
CN1208300000000,12,083,"Marion County, FL",Jun-22,144369,139138,5231,3.60000000
CN1208500000000,12,085,"Martin County, FL",Jun-22,76080,73964,2116,2.80000000
CN1208600000000,12,086,"Miami-Dade County, FL",Jun-22,1363068,1327233,35835,2.60000000
CN1208700000000,12,087,"Monroe County, FL",Jun-22,50537,49610,927,1.80000000
CN1208900000000,12,089,"Nassau County, FL",Jun-22,44992,43883,1109,2.50000000
CN1209100000000,12,091,"Okaloosa County, FL",Jun-22,103944,101385,2559,2.50000000
CN1209300000000,12,093,"Okeechobee County, FL",Jun-22,17200,16627,573,3.30000000
CN1209500000000,12,095,"Orange County, FL",Jun-22,776696,752421,24275,3.10000000
CN1209700000000,12,097,"Osceola County, FL",Jun-22,194077,186587,7490,3.90000000
CN1209900000000,12,099,"Palm Beach County, FL",Jun-22,764101,741209,22892,3.00000000
CN1210100000000,12,101,"Pasco County, FL",Jun-22,257323,249360,7963,3.10000000
CN1210300000000,12,103,"Pinellas County, FL",Jun-22,507976,494314,13662,2.70000000
CN1210500000000,12,105,"Polk County, FL",Jun-22,337256,324774,12482,3.70000000
CN1210700000000,12,107,"Putnam County, FL",Jun-22,27438,26238,1200,4.40000000
CN1210900000000,12,109,"St. Johns County, FL",Jun-22,150146,146670,3476,2.30000000
CN1211100000000,12,111,"St. Lucie County, FL",Jun-22,154813,149349,5464,3.50000000
CN1211300000000,12,113,"Santa Rosa County, FL",Jun-22,88557,86149,2408,2.70000000
CN1211500000000,12,115,"Sarasota County, FL",Jun-22,202910,197270,5640,2.80000000
CN1211700000000,12,117,"Seminole County, FL",Jun-22,258298,251145,7153,2.80000000
CN1211900000000,12,119,"Sumter County, FL",Jun-22,36198,34672,1526,4.20000000
CN1212100000000,12,121,"Suwannee County, FL",Jun-22,17774,17193,581,3.30000000
CN1212300000000,12,123,"Taylor County, FL",Jun-22,8176,7889,287,3.50000000
CN1212500000000,12,125,"Union County, FL",Jun-22,4594,4462,132,2.90000000
CN1212700000000,12,127,"Volusia County, FL",Jun-22,264658,256174,8484,3.20000000
CN1212900000000,12,129,"Wakulla County, FL",Jun-22,15809,15405,404,2.60000000
CN1213100000000,12,131,"Walton County, FL",Jun-22,35270,34382,888,2.50000000
CN1213300000000,12,133,"Washington County, FL",Jun-22,9706,9388,318,3.30000000
CN1300100000000,13,001,"Appling County, GA",Jun-22,9117,8755,362,4.00000000
CN1300300000000,13,003,"Atkinson County, GA",Jun-22,4627,4503,124,2.70000000
CN1300500000000,13,005,"Bacon County, GA",Jun-22,4833,4683,150,3.10000000
CN1300700000000,13,007,"Baker County, GA",Jun-22,1146,1097,49,4.30000000
CN1300900000000,13,009,"Baldwin County, GA",Jun-22,17609,16815,794,4.50000000
CN1301100000000,13,011,"Banks County, GA",Jun-22,10195,9937,258,2.50000000
CN1301300000000,13,013,"Barrow County, GA",Jun-22,43510,42381,1129,2.60000000
CN1301500000000,13,015,"Bartow County, GA",Jun-22,52833,51265,1568,3.00000000
CN1301700000000,13,017,"Ben Hill County, GA",Jun-22,5517,5269,248,4.50000000
CN1301900000000,13,019,"Berrien County, GA",Jun-22,7642,7390,252,3.30000000
CN1302100000000,13,021,"Bibb County, GA",Jun-22,68290,65594,2696,3.90000000
CN1302300000000,13,023,"Bleckley County, GA",Jun-22,4613,4386,227,4.90000000
CN1302500000000,13,025,"Brantley County, GA",Jun-22,7469,7200,269,3.60000000
CN1302700000000,13,027,"Brooks County, GA",Jun-22,6755,6536,219,3.20000000
CN1302900000000,13,029,"Bryan County, GA",Jun-22,20505,19947,558,2.70000000
CN1303100000000,13,031,"Bulloch County, GA",Jun-22,37665,36154,1511,4.00000000
CN1303300000000,13,033,"Burke County, GA",Jun-22,9160,8610,550,6.00000000
CN1303500000000,13,035,"Butts County, GA",Jun-22,11452,11122,330,2.90000000
CN1303700000000,13,037,"Calhoun County, GA",Jun-22,2231,2161,70,3.10000000
CN1303900000000,13,039,"Camden County, GA",Jun-22,21752,21089,663,3.00000000
CN1304300000000,13,043,"Candler County, GA",Jun-22,6124,5969,155,2.50000000
CN1304500000000,13,045,"Carroll County, GA",Jun-22,57912,56001,1911,3.30000000
CN1304700000000,13,047,"Catoosa County, GA",Jun-22,33408,32515,893,2.70000000
CN1304900000000,13,049,"Charlton County, GA",Jun-22,4952,4800,152,3.10000000
CN1305100000000,13,051,"Chatham County, GA",Jun-22,146906,142159,4747,3.20000000
CN1305300000000,13,053,"Chattahoochee County, GA",Jun-22,1932,1847,85,4.40000000
CN1305500000000,13,055,"Chattooga County, GA",Jun-22,9298,8928,370,4.00000000
CN1305700000000,13,057,"Cherokee County, GA",Jun-22,144094,140592,3502,2.40000000
CN1305900000000,13,059,"Clarke County, GA",Jun-22,61121,58976,2145,3.50000000
CN1306100000000,13,061,"Clay County, GA",Jun-22,859,791,68,7.90000000
CN1306300000000,13,063,"Clayton County, GA",Jun-22,142970,135956,7014,4.90000000
CN1306500000000,13,065,"Clinch County, GA",Jun-22,3076,2987,89,2.90000000
CN1306700000000,13,067,"Cobb County, GA",Jun-22,435825,423997,11828,2.70000000
CN1306900000000,13,069,"Coffee County, GA",Jun-22,18360,17692,668,3.60000000
CN1307100000000,13,071,"Colquitt County, GA",Jun-22,22292,21650,642,2.90000000
CN1307300000000,13,073,"Columbia County, GA",Jun-22,76312,74103,2209,2.90000000
CN1307500000000,13,075,"Cook County, GA",Jun-22,8201,7934,267,3.30000000
CN1307700000000,13,077,"Coweta County, GA",Jun-22,78542,76350,2192,2.80000000
CN1307900000000,13,079,"Crawford County, GA",Jun-22,5591,5417,174,3.10000000
CN1308100000000,13,081,"Crisp County, GA",Jun-22,9466,8961,505,5.30000000
CN1308300000000,13,083,"Dade County, GA",Jun-22,8032,7818,214,2.70000000
CN1308500000000,13,085,"Dawson County, GA",Jun-22,13539,13201,338,2.50000000
CN1308700000000,13,087,"Decatur County, GA",Jun-22,11356,10952,404,3.60000000
CN1308900000000,13,089,"DeKalb County, GA",Jun-22,409964,396000,13964,3.40000000
CN1309100000000,13,091,"Dodge County, GA",Jun-22,6995,6728,267,3.80000000
CN1309300000000,13,093,"Dooly County, GA",Jun-22,4675,4461,214,4.60000000
CN1309500000000,13,095,"Dougherty County, GA",Jun-22,37139,35283,1856,5.00000000
CN1309700000000,13,097,"Douglas County, GA",Jun-22,76063,73327,2736,3.60000000
CN1309900000000,13,099,"Early County, GA",Jun-22,4238,4070,168,4.00000000
CN1310100000000,13,101,"Echols County, GA",Jun-22,1895,1846,49,2.60000000
CN1310300000000,13,103,"Effingham County, GA",Jun-22,34284,33373,911,2.70000000
CN1310500000000,13,105,"Elbert County, GA",Jun-22,7718,7402,316,4.10000000
CN1310700000000,13,107,"Emanuel County, GA",Jun-22,8591,8184,407,4.70000000
CN1310900000000,13,109,"Evans County, GA",Jun-22,5176,5020,156,3.00000000
CN1311100000000,13,111,"Fannin County, GA",Jun-22,12035,11724,311,2.60000000
CN1311300000000,13,113,"Fayette County, GA",Jun-22,60205,58542,1663,2.80000000
CN1311500000000,13,115,"Floyd County, GA",Jun-22,44079,42579,1500,3.40000000
CN1311700000000,13,117,"Forsyth County, GA",Jun-22,131548,128347,3201,2.40000000
CN1311900000000,13,119,"Franklin County, GA",Jun-22,10046,9705,341,3.40000000
CN1312100000000,13,121,"Fulton County, GA",Jun-22,582649,562321,20328,3.50000000
CN1312300000000,13,123,"Gilmer County, GA",Jun-22,12327,11958,369,3.00000000
CN1312500000000,13,125,"Glascock County, GA",Jun-22,1269,1226,43,3.40000000
CN1312700000000,13,127,"Glynn County, GA",Jun-22,39928,38736,1192,3.00000000
CN1312900000000,13,129,"Gordon County, GA",Jun-22,29262,28376,886,3.00000000
CN1313100000000,13,131,"Grady County, GA",Jun-22,11095,10745,350,3.20000000
CN1313300000000,13,133,"Greene County, GA",Jun-22,7403,7166,237,3.20000000
CN1313500000000,13,135,"Gwinnett County, GA",Jun-22,506524,491887,14637,2.90000000
CN1313700000000,13,137,"Habersham County, GA",Jun-22,18537,17935,602,3.20000000
CN1313900000000,13,139,"Hall County, GA",Jun-22,106232,103578,2654,2.50000000
CN1314100000000,13,141,"Hancock County, GA",Jun-22,2512,2374,138,5.50000000
CN1314300000000,13,143,"Haralson County, GA",Jun-22,13151,12735,416,3.20000000
CN1314500000000,13,145,"Harris County, GA",Jun-22,17017,16555,462,2.70000000
CN1314700000000,13,147,"Hart County, GA",Jun-22,11774,11392,382,3.20000000
CN1314900000000,13,149,"Heard County, GA",Jun-22,5381,5218,163,3.00000000
CN1315100000000,13,151,"Henry County, GA",Jun-22,122149,117962,4187,3.40000000
CN1315300000000,13,153,"Houston County, GA",Jun-22,71558,69262,2296,3.20000000
CN1315500000000,13,155,"Irwin County, GA",Jun-22,3526,3384,142,4.00000000
CN1315700000000,13,157,"Jackson County, GA",Jun-22,43992,43023,969,2.20000000
CN1315900000000,13,159,"Jasper County, GA",Jun-22,7276,7082,194,2.70000000
CN1316100000000,13,161,"Jeff Davis County, GA",Jun-22,6234,6006,228,3.70000000
CN1316300000000,13,163,"Jefferson County, GA",Jun-22,7021,6726,295,4.20000000
CN1316500000000,13,165,"Jenkins County, GA",Jun-22,3133,2988,145,4.60000000
CN1316700000000,13,167,"Johnson County, GA",Jun-22,4069,3949,120,2.90000000
CN1316900000000,13,169,"Jones County, GA",Jun-22,13845,13458,387,2.80000000
CN1317100000000,13,171,"Lamar County, GA",Jun-22,8483,8179,304,3.60000000
CN1317300000000,13,173,"Lanier County, GA",Jun-22,3794,3663,131,3.50000000
CN1317500000000,13,175,"Laurens County, GA",Jun-22,19450,18681,769,4.00000000
CN1317700000000,13,177,"Lee County, GA",Jun-22,15223,14780,443,2.90000000
CN1317900000000,13,179,"Liberty County, GA",Jun-22,26328,25414,914,3.50000000
CN1318100000000,13,181,"Lincoln County, GA",Jun-22,3542,3414,128,3.60000000
CN1318300000000,13,183,"Long County, GA",Jun-22,8537,8258,279,3.30000000
CN1318500000000,13,185,"Lowndes County, GA",Jun-22,50800,49025,1775,3.50000000
CN1318700000000,13,187,"Lumpkin County, GA",Jun-22,17478,16975,503,2.90000000
CN1318900000000,13,189,"McDuffie County, GA",Jun-22,8476,8078,398,4.70000000
CN1319100000000,13,191,"McIntosh County, GA",Jun-22,6268,6070,198,3.20000000
CN1319300000000,13,193,"Macon County, GA",Jun-22,4587,4380,207,4.50000000
CN1319500000000,13,195,"Madison County, GA",Jun-22,14033,13638,395,2.80000000
CN1319700000000,13,197,"Marion County, GA",Jun-22,3279,3169,110,3.40000000
CN1319900000000,13,199,"Meriwether County, GA",Jun-22,9094,8725,369,4.10000000
CN1320100000000,13,201,"Miller County, GA",Jun-22,2763,2681,82,3.00000000
CN1320500000000,13,205,"Mitchell County, GA",Jun-22,8049,7713,336,4.20000000
CN1320700000000,13,207,"Monroe County, GA",Jun-22,13309,12930,379,2.80000000
CN1320900000000,13,209,"Montgomery County, GA",Jun-22,3812,3641,171,4.50000000
CN1321100000000,13,211,"Morgan County, GA",Jun-22,9798,9526,272,2.80000000
CN1321300000000,13,213,"Murray County, GA",Jun-22,15542,14928,614,4.00000000
CN1321500000000,13,215,"Muscogee County, GA",Jun-22,76627,73214,3413,4.50000000
CN1321700000000,13,217,"Newton County, GA",Jun-22,54960,52928,2032,3.70000000
CN1321900000000,13,219,"Oconee County, GA",Jun-22,21019,20527,492,2.30000000
CN1322100000000,13,221,"Oglethorpe County, GA",Jun-22,7267,7073,194,2.70000000
CN1322300000000,13,223,"Paulding County, GA",Jun-22,92391,89855,2536,2.70000000
CN1322500000000,13,225,"Peach County, GA",Jun-22,12026,11534,492,4.10000000
CN1322700000000,13,227,"Pickens County, GA",Jun-22,16058,15646,412,2.60000000
CN1322900000000,13,229,"Pierce County, GA",Jun-22,8612,8346,266,3.10000000
CN1323100000000,13,231,"Pike County, GA",Jun-22,9288,9035,253,2.70000000
CN1323300000000,13,233,"Polk County, GA",Jun-22,18435,17850,585,3.20000000
CN1323500000000,13,235,"Pulaski County, GA",Jun-22,4057,3916,141,3.50000000
CN1323700000000,13,237,"Putnam County, GA",Jun-22,8732,8423,309,3.50000000
CN1323900000000,13,239,"Quitman County, GA",Jun-22,739,701,38,5.10000000
CN1324100000000,13,241,"Rabun County, GA",Jun-22,7704,7477,227,2.90000000
CN1324300000000,13,243,"Randolph County, GA",Jun-22,2336,2227,109,4.70000000
CN1324500000000,13,245,"Richmond County, GA",Jun-22,83463,79589,3874,4.60000000
CN1324700000000,13,247,"Rockdale County, GA",Jun-22,45768,44066,1702,3.70000000
CN1324900000000,13,249,"Schley County, GA",Jun-22,2113,2029,84,4.00000000
CN1325100000000,13,251,"Screven County, GA",Jun-22,5014,4787,227,4.50000000
CN1325300000000,13,253,"Seminole County, GA",Jun-22,3026,2917,109,3.60000000
CN1325500000000,13,255,"Spalding County, GA",Jun-22,29670,28631,1039,3.50000000
CN1325700000000,13,257,"Stephens County, GA",Jun-22,10358,9972,386,3.70000000
CN1325900000000,13,259,"Stewart County, GA",Jun-22,2539,2440,99,3.90000000
CN1326100000000,13,261,"Sumter County, GA",Jun-22,12054,11490,564,4.70000000
CN1326300000000,13,263,"Talbot County, GA",Jun-22,2801,2705,96,3.40000000
CN1326500000000,13,265,"Taliaferro County, GA",Jun-22,542,523,19,3.50000000
CN1326700000000,13,267,"Tattnall County, GA",Jun-22,9833,9532,301,3.10000000
CN1326900000000,13,269,"Taylor County, GA",Jun-22,2889,2755,134,4.60000000
CN1327100000000,13,271,"Telfair County, GA",Jun-22,3634,3408,226,6.20000000
CN1327300000000,13,273,"Terrell County, GA",Jun-22,3545,3367,178,5.00000000
CN1327500000000,13,275,"Thomas County, GA",Jun-22,17448,16799,649,3.70000000
CN1327700000000,13,277,"Tift County, GA",Jun-22,21342,20711,631,3.00000000
CN1327900000000,13,279,"Toombs County, GA",Jun-22,11955,11441,514,4.30000000
CN1328100000000,13,281,"Towns County, GA",Jun-22,4234,4056,178,4.20000000
CN1328300000000,13,283,"Treutlen County, GA",Jun-22,2588,2474,114,4.40000000
CN1328500000000,13,285,"Troup County, GA",Jun-22,37592,36394,1198,3.20000000
CN1328700000000,13,287,"Turner County, GA",Jun-22,3246,3098,148,4.60000000
CN1328900000000,13,289,"Twiggs County, GA",Jun-22,2848,2714,134,4.70000000
CN1329100000000,13,291,"Union County, GA",Jun-22,11386,11096,290,2.50000000
CN1329300000000,13,293,"Upson County, GA",Jun-22,11755,11369,386,3.30000000
CN1329500000000,13,295,"Walker County, GA",Jun-22,31223,30307,916,2.90000000
CN1329700000000,13,297,"Walton County, GA",Jun-22,48509,47115,1394,2.90000000
CN1329900000000,13,299,"Ware County, GA",Jun-22,15310,14823,487,3.20000000
CN1330100000000,13,301,"Warren County, GA",Jun-22,2634,2525,109,4.10000000
CN1330300000000,13,303,"Washington County, GA",Jun-22,6709,6410,299,4.50000000
CN1330500000000,13,305,"Wayne County, GA",Jun-22,11939,11549,390,3.30000000
CN1330700000000,13,307,"Webster County, GA",Jun-22,977,938,39,4.00000000
CN1330900000000,13,309,"Wheeler County, GA",Jun-22,1623,1539,84,5.20000000
CN1331100000000,13,311,"White County, GA",Jun-22,16679,16261,418,2.50000000
CN1331300000000,13,313,"Whitfield County, GA",Jun-22,43552,41970,1582,3.60000000
CN1331500000000,13,315,"Wilcox County, GA",Jun-22,2741,2632,109,4.00000000
CN1331700000000,13,317,"Wilkes County, GA",Jun-22,3747,3592,155,4.10000000
CN1331900000000,13,319,"Wilkinson County, GA",Jun-22,3654,3513,141,3.90000000
CN1332100000000,13,321,"Worth County, GA",Jun-22,8887,8596,291,3.30000000
CN1500100000000,15,001,"Hawaii County, HI",Jun-22,92439,88441,3998,4.30000000
CN1500300000000,15,003,"Honolulu County/city, HI",Jun-22,453464,435653,17811,3.90000000
CN1500700000000,15,007,"Kauai County, HI",Jun-22,36488,34687,1801,4.90000000
CN1500900000000,15,009,"Maui County, HI",Jun-22,86652,82521,4131,4.80000000
CN1600100000000,16,001,"Ada County, ID",Jun-22,279093,272259,6834,2.40000000
CN1600300000000,16,003,"Adams County, ID",Jun-22,1927,1835,92,4.80000000
CN1600500000000,16,005,"Bannock County, ID",Jun-22,44567,43307,1260,2.80000000
CN1600700000000,16,007,"Bear Lake County, ID",Jun-22,3449,3355,94,2.70000000
CN1600900000000,16,009,"Benewah County, ID",Jun-22,4218,4062,156,3.70000000
CN1601100000000,16,011,"Bingham County, ID",Jun-22,25256,24607,649,2.60000000
CN1601300000000,16,013,"Blaine County, ID",Jun-22,13640,13299,341,2.50000000
CN1601500000000,16,015,"Boise County, ID",Jun-22,3877,3735,142,3.70000000
CN1601700000000,16,017,"Bonner County, ID",Jun-22,22920,22215,705,3.10000000
CN1601900000000,16,019,"Bonneville County, ID",Jun-22,63641,62109,1532,2.40000000
CN1602100000000,16,021,"Boundary County, ID",Jun-22,5984,5793,191,3.20000000
CN1602300000000,16,023,"Butte County, ID",Jun-22,1510,1471,39,2.60000000
CN1602500000000,16,025,"Camas County, ID",Jun-22,737,717,20,2.70000000
CN1602700000000,16,027,"Canyon County, ID",Jun-22,115493,111852,3641,3.20000000
CN1602900000000,16,029,"Caribou County, ID",Jun-22,4337,4230,107,2.50000000
CN1603100000000,16,031,"Cassia County, ID",Jun-22,13243,12881,362,2.70000000
CN1603300000000,16,033,"Clark County, ID",Jun-22,396,385,11,2.80000000
CN1603500000000,16,035,"Clearwater County, ID",Jun-22,3088,2935,153,5.00000000
CN1603700000000,16,037,"Custer County, ID",Jun-22,2591,2521,70,2.70000000
CN1603900000000,16,039,"Elmore County, ID",Jun-22,12680,12298,382,3.00000000
CN1604100000000,16,041,"Franklin County, ID",Jun-22,7612,7447,165,2.20000000
CN1604300000000,16,043,"Fremont County, ID",Jun-22,8746,8559,187,2.10000000
CN1604500000000,16,045,"Gem County, ID",Jun-22,9105,8844,261,2.90000000
CN1604700000000,16,047,"Gooding County, ID",Jun-22,8635,8410,225,2.60000000
CN1604900000000,16,049,"Idaho County, ID",Jun-22,7237,6965,272,3.80000000
CN1605100000000,16,051,"Jefferson County, ID",Jun-22,15452,15086,366,2.40000000
CN1605300000000,16,053,"Jerome County, ID",Jun-22,13008,12672,336,2.60000000
CN1605500000000,16,055,"Kootenai County, ID",Jun-22,87219,84698,2521,2.90000000
CN1605700000000,16,057,"Latah County, ID",Jun-22,20643,20063,580,2.80000000
CN1605900000000,16,059,"Lemhi County, ID",Jun-22,4016,3884,132,3.30000000
CN1606100000000,16,061,"Lewis County, ID",Jun-22,1764,1688,76,4.30000000
CN1606300000000,16,063,"Lincoln County, ID",Jun-22,2795,2708,87,3.10000000
CN1606500000000,16,065,"Madison County, ID",Jun-22,25169,24631,538,2.10000000
CN1606700000000,16,067,"Minidoka County, ID",Jun-22,12370,12039,331,2.70000000
CN1606900000000,16,069,"Nez Perce County, ID",Jun-22,21608,21068,540,2.50000000
CN1607100000000,16,071,"Oneida County, ID",Jun-22,2867,2808,59,2.10000000
CN1607300000000,16,073,"Owyhee County, ID",Jun-22,5989,5792,197,3.30000000
CN1607500000000,16,075,"Payette County, ID",Jun-22,12538,12145,393,3.10000000
CN1607700000000,16,077,"Power County, ID",Jun-22,4246,4122,124,2.90000000
CN1607900000000,16,079,"Shoshone County, ID",Jun-22,5574,5314,260,4.70000000
CN1608100000000,16,081,"Teton County, ID",Jun-22,8213,8048,165,2.00000000
CN1608300000000,16,083,"Twin Falls County, ID",Jun-22,44369,43145,1224,2.80000000
CN1608500000000,16,085,"Valley County, ID",Jun-22,6342,6136,206,3.20000000
CN1608700000000,16,087,"Washington County, ID",Jun-22,5038,4865,173,3.40000000
CN1700100000000,17,001,"Adams County, IL",Jun-22,30860,29839,1021,3.30000000
CN1700300000000,17,003,"Alexander County, IL",Jun-22,1849,1700,149,8.10000000
CN1700500000000,17,005,"Bond County, IL",Jun-22,7532,7250,282,3.70000000
CN1700700000000,17,007,"Boone County, IL",Jun-22,25522,23860,1662,6.50000000
CN1700900000000,17,009,"Brown County, IL",Jun-22,3117,3046,71,2.30000000
CN1701100000000,17,011,"Bureau County, IL",Jun-22,16487,15810,677,4.10000000
CN1701300000000,17,013,"Calhoun County, IL",Jun-22,2196,2106,90,4.10000000
CN1701500000000,17,015,"Carroll County, IL",Jun-22,7743,7482,261,3.40000000
CN1701700000000,17,017,"Cass County, IL",Jun-22,5655,5418,237,4.20000000
CN1701900000000,17,019,"Champaign County, IL",Jun-22,104890,100394,4496,4.30000000
CN1702100000000,17,021,"Christian County, IL",Jun-22,13492,12868,624,4.60000000
CN1702300000000,17,023,"Clark County, IL",Jun-22,7182,6886,296,4.10000000
CN1702500000000,17,025,"Clay County, IL",Jun-22,5809,5544,265,4.60000000
CN1702700000000,17,027,"Clinton County, IL",Jun-22,20082,19505,577,2.90000000
CN1702900000000,17,029,"Coles County, IL",Jun-22,21542,20497,1045,4.90000000
CN1703100000000,17,031,"Cook County, IL",Jun-22,2682650,2538055,144595,5.40000000
CN1703300000000,17,033,"Crawford County, IL",Jun-22,8610,8246,364,4.20000000
CN1703500000000,17,035,"Cumberland County, IL",Jun-22,5880,5677,203,3.50000000
CN1703700000000,17,037,"DeKalb County, IL",Jun-22,54504,52144,2360,4.30000000
CN1703900000000,17,039,"De Witt County, IL",Jun-22,7164,6882,282,3.90000000
CN1704100000000,17,041,"Douglas County, IL",Jun-22,10175,9833,342,3.40000000
CN1704300000000,17,043,"DuPage County, IL",Jun-22,520242,502201,18041,3.50000000
CN1704500000000,17,045,"Edgar County, IL",Jun-22,8892,8574,318,3.60000000
CN1704700000000,17,047,"Edwards County, IL",Jun-22,2543,2434,109,4.30000000
CN1704900000000,17,049,"Effingham County, IL",Jun-22,19869,19299,570,2.90000000
CN1705100000000,17,051,"Fayette County, IL",Jun-22,9827,9425,402,4.10000000
CN1705300000000,17,053,"Ford County, IL",Jun-22,6042,5789,253,4.20000000
CN1705500000000,17,055,"Franklin County, IL",Jun-22,15607,14707,900,5.80000000
CN1705700000000,17,057,"Fulton County, IL",Jun-22,14425,13716,709,4.90000000
CN1705900000000,17,059,"Gallatin County, IL",Jun-22,1986,1879,107,5.40000000
CN1706100000000,17,061,"Greene County, IL",Jun-22,5978,5747,231,3.90000000
CN1706300000000,17,063,"Grundy County, IL",Jun-22,26171,25047,1124,4.30000000
CN1706500000000,17,065,"Hamilton County, IL",Jun-22,4287,4146,141,3.30000000
CN1706700000000,17,067,"Hancock County, IL",Jun-22,8273,7976,297,3.60000000
CN1706900000000,17,069,"Hardin County, IL",Jun-22,1334,1248,86,6.40000000
CN1707100000000,17,071,"Henderson County, IL",Jun-22,3640,3507,133,3.70000000
CN1707300000000,17,073,"Henry County, IL",Jun-22,24580,23599,981,4.00000000
CN1707500000000,17,075,"Iroquois County, IL",Jun-22,13065,12553,512,3.90000000
CN1707700000000,17,077,"Jackson County, IL",Jun-22,26827,25594,1233,4.60000000
CN1707900000000,17,079,"Jasper County, IL",Jun-22,4870,4690,180,3.70000000
CN1708100000000,17,081,"Jefferson County, IL",Jun-22,16326,15494,832,5.10000000
CN1708300000000,17,083,"Jersey County, IL",Jun-22,10709,10312,397,3.70000000
CN1708500000000,17,085,"Jo Daviess County, IL",Jun-22,10927,10590,337,3.10000000
CN1708700000000,17,087,"Johnson County, IL",Jun-22,4111,3881,230,5.60000000
CN1708900000000,17,089,"Kane County, IL",Jun-22,267284,255174,12110,4.50000000
CN1709100000000,17,091,"Kankakee County, IL",Jun-22,53005,50181,2824,5.30000000
CN1709300000000,17,093,"Kendall County, IL",Jun-22,72574,69876,2698,3.70000000
CN1709500000000,17,095,"Knox County, IL",Jun-22,20400,19311,1089,5.30000000
CN1709700000000,17,097,"Lake County, IL",Jun-22,377412,362551,14861,3.90000000
CN1709900000000,17,099,"LaSalle County, IL",Jun-22,52952,50460,2492,4.70000000
CN1710100000000,17,101,"Lawrence County, IL",Jun-22,5622,5329,293,5.20000000
CN1710300000000,17,103,"Lee County, IL",Jun-22,16740,16071,669,4.00000000
CN1710500000000,17,105,"Livingston County, IL",Jun-22,15474,14881,593,3.80000000
CN1710700000000,17,107,"Logan County, IL",Jun-22,11660,11166,494,4.20000000
CN1710900000000,17,109,"McDonough County, IL",Jun-22,11812,11215,597,5.10000000
CN1711100000000,17,111,"McHenry County, IL",Jun-22,169701,163520,6181,3.60000000
CN1711300000000,17,113,"McLean County, IL",Jun-22,86812,83460,3352,3.90000000
CN1711500000000,17,115,"Macon County, IL",Jun-22,46945,43907,3038,6.50000000
CN1711700000000,17,117,"Macoupin County, IL",Jun-22,22317,21469,848,3.80000000
CN1711900000000,17,119,"Madison County, IL",Jun-22,132730,127376,5354,4.00000000
CN1712100000000,17,121,"Marion County, IL",Jun-22,16665,15854,811,4.90000000
CN1712300000000,17,123,"Marshall County, IL",Jun-22,5161,4929,232,4.50000000
CN1712500000000,17,125,"Mason County, IL",Jun-22,5879,5601,278,4.70000000
CN1712700000000,17,127,"Massac County, IL",Jun-22,5398,5095,303,5.60000000
CN1712900000000,17,129,"Menard County, IL",Jun-22,6315,6112,203,3.20000000
CN1713100000000,17,131,"Mercer County, IL",Jun-22,7802,7528,274,3.50000000
CN1713300000000,17,133,"Monroe County, IL",Jun-22,18856,18312,544,2.90000000
CN1713500000000,17,135,"Montgomery County, IL",Jun-22,11436,10935,501,4.40000000
CN1713700000000,17,137,"Morgan County, IL",Jun-22,15851,15197,654,4.10000000
CN1713900000000,17,139,"Moultrie County, IL",Jun-22,7482,7244,238,3.20000000
CN1714100000000,17,141,"Ogle County, IL",Jun-22,24049,22949,1100,4.60000000
CN1714300000000,17,143,"Peoria County, IL",Jun-22,83748,78939,4809,5.70000000
CN1714500000000,17,145,"Perry County, IL",Jun-22,7932,7525,407,5.10000000
CN1714700000000,17,147,"Piatt County, IL",Jun-22,8243,7941,302,3.70000000
CN1714900000000,17,149,"Pike County, IL",Jun-22,6904,6648,256,3.70000000
CN1715100000000,17,151,"Pope County, IL",Jun-22,1727,1631,96,5.60000000
CN1715300000000,17,153,"Pulaski County, IL",Jun-22,1704,1573,131,7.70000000
CN1715500000000,17,155,"Putnam County, IL",Jun-22,2998,2870,128,4.30000000
CN1715700000000,17,157,"Randolph County, IL",Jun-22,13671,13176,495,3.60000000
CN1715900000000,17,159,"Richland County, IL",Jun-22,7197,6909,288,4.00000000
CN1716100000000,17,161,"Rock Island County, IL",Jun-22,70069,67146,2923,4.20000000
CN1716300000000,17,163,"St. Clair County, IL",Jun-22,125086,118965,6121,4.90000000
CN1716500000000,17,165,"Saline County, IL",Jun-22,9122,8597,525,5.80000000
CN1716700000000,17,167,"Sangamon County, IL",Jun-22,100220,95951,4269,4.30000000
CN1716900000000,17,169,"Schuyler County, IL",Jun-22,3384,3271,113,3.30000000
CN1717100000000,17,171,"Scott County, IL",Jun-22,2331,2243,88,3.80000000
CN1717300000000,17,173,"Shelby County, IL",Jun-22,10430,10036,394,3.80000000
CN1717500000000,17,175,"Stark County, IL",Jun-22,2395,2291,104,4.30000000
CN1717700000000,17,177,"Stephenson County, IL",Jun-22,20898,19984,914,4.40000000
CN1717900000000,17,179,"Tazewell County, IL",Jun-22,62529,59952,2577,4.10000000
CN1718100000000,17,181,"Union County, IL",Jun-22,7274,6927,347,4.80000000
CN1718300000000,17,183,"Vermilion County, IL",Jun-22,31458,29733,1725,5.50000000
CN1718500000000,17,185,"Wabash County, IL",Jun-22,5542,5341,201,3.60000000
CN1718700000000,17,187,"Warren County, IL",Jun-22,7567,7253,314,4.10000000
CN1718900000000,17,189,"Washington County, IL",Jun-22,9866,9633,233,2.40000000
CN1719100000000,17,191,"Wayne County, IL",Jun-22,6994,6725,269,3.80000000
CN1719300000000,17,193,"White County, IL",Jun-22,6033,5784,249,4.10000000
CN1719500000000,17,195,"Whiteside County, IL",Jun-22,28092,26952,1140,4.10000000
CN1719700000000,17,197,"Will County, IL",Jun-22,368855,352503,16352,4.40000000
CN1719900000000,17,199,"Williamson County, IL",Jun-22,30639,29265,1374,4.50000000
CN1720100000000,17,201,"Winnebago County, IL",Jun-22,136564,127591,8973,6.60000000
CN1720300000000,17,203,"Woodford County, IL",Jun-22,18365,17768,597,3.30000000
CN1800100000000,18,001,"Adams County, IN",Jun-22,17474,17066,408,2.30000000
CN1800300000000,18,003,"Allen County, IN",Jun-22,189636,183788,5848,3.10000000
CN1800500000000,18,005,"Bartholomew County, IN",Jun-22,43742,42603,1139,2.60000000
CN1800700000000,18,007,"Benton County, IN",Jun-22,4414,4298,116,2.60000000
CN1800900000000,18,009,"Blackford County, IN",Jun-22,4806,4639,167,3.50000000
CN1801100000000,18,011,"Boone County, IN",Jun-22,38558,37719,839,2.20000000
CN1801300000000,18,013,"Brown County, IN",Jun-22,7912,7670,242,3.10000000
CN1801500000000,18,015,"Carroll County, IN",Jun-22,9873,9577,296,3.00000000
CN1801700000000,18,017,"Cass County, IN",Jun-22,17758,17107,651,3.70000000
CN1801900000000,18,019,"Clark County, IN",Jun-22,63856,62045,1811,2.80000000
CN1802100000000,18,021,"Clay County, IN",Jun-22,11759,11337,422,3.60000000
CN1802300000000,18,023,"Clinton County, IN",Jun-22,17287,16835,452,2.60000000
CN1802500000000,18,025,"Crawford County, IN",Jun-22,4897,4739,158,3.20000000
CN1802700000000,18,027,"Daviess County, IN",Jun-22,17066,16647,419,2.50000000
CN1802900000000,18,029,"Dearborn County, IN",Jun-22,25830,25106,724,2.80000000
CN1803100000000,18,031,"Decatur County, IN",Jun-22,14895,14495,400,2.70000000
CN1803300000000,18,033,"DeKalb County, IN",Jun-22,22476,21914,562,2.50000000
CN1803500000000,18,035,"Delaware County, IN",Jun-22,52784,50821,1963,3.70000000
CN1803700000000,18,037,"Dubois County, IN",Jun-22,22541,22028,513,2.30000000
CN1803900000000,18,039,"Elkhart County, IN",Jun-22,123033,120124,2909,2.40000000
CN1804100000000,18,041,"Fayette County, IN",Jun-22,8479,8073,406,4.80000000
CN1804300000000,18,043,"Floyd County, IN",Jun-22,43011,41913,1098,2.60000000
CN1804500000000,18,045,"Fountain County, IN",Jun-22,8118,7888,230,2.80000000
CN1804700000000,18,047,"Franklin County, IN",Jun-22,11583,11271,312,2.70000000
CN1804900000000,18,049,"Fulton County, IN",Jun-22,9970,9668,302,3.00000000
CN1805100000000,18,051,"Gibson County, IN",Jun-22,19941,19463,478,2.40000000
CN1805300000000,18,053,"Grant County, IN",Jun-22,31422,30321,1101,3.50000000
CN1805500000000,18,055,"Greene County, IN",Jun-22,13573,13086,487,3.60000000
CN1805700000000,18,057,"Hamilton County, IN",Jun-22,196543,191995,4548,2.30000000
CN1805900000000,18,059,"Hancock County, IN",Jun-22,43076,41937,1139,2.60000000
CN1806100000000,18,061,"Harrison County, IN",Jun-22,20870,20313,557,2.70000000
CN1806300000000,18,063,"Hendricks County, IN",Jun-22,95696,93269,2427,2.50000000
CN1806500000000,18,065,"Henry County, IN",Jun-22,22394,21693,701,3.10000000
CN1806700000000,18,067,"Howard County, IN",Jun-22,34590,32332,2258,6.50000000
CN1806900000000,18,069,"Huntington County, IN",Jun-22,18272,17785,487,2.70000000
CN1807100000000,18,071,"Jackson County, IN",Jun-22,23963,23302,661,2.80000000
CN1807300000000,18,073,"Jasper County, IN",Jun-22,16046,15525,521,3.20000000
CN1807500000000,18,075,"Jay County, IN",Jun-22,9011,8760,251,2.80000000
CN1807700000000,18,077,"Jefferson County, IN",Jun-22,15205,14743,462,3.00000000
CN1807900000000,18,079,"Jennings County, IN",Jun-22,13606,13173,433,3.20000000
CN1808100000000,18,081,"Johnson County, IN",Jun-22,87485,85318,2167,2.50000000
CN1808300000000,18,083,"Knox County, IN",Jun-22,18580,18057,523,2.80000000
CN1808500000000,18,085,"Kosciusko County, IN",Jun-22,41187,40140,1047,2.50000000
CN1808700000000,18,087,"LaGrange County, IN",Jun-22,21902,21420,482,2.20000000
CN1808900000000,18,089,"Lake County, IN",Jun-22,228780,216727,12053,5.30000000
CN1809100000000,18,091,"LaPorte County, IN",Jun-22,47209,45316,1893,4.00000000
CN1809300000000,18,093,"Lawrence County, IN",Jun-22,20777,20072,705,3.40000000
CN1809500000000,18,095,"Madison County, IN",Jun-22,60749,58618,2131,3.50000000
CN1809700000000,18,097,"Marion County, IN",Jun-22,511451,493517,17934,3.50000000
CN1809900000000,18,099,"Marshall County, IN",Jun-22,23406,22793,613,2.60000000
CN1810100000000,18,101,"Martin County, IN",Jun-22,5646,5502,144,2.60000000
CN1810300000000,18,103,"Miami County, IN",Jun-22,14640,13967,673,4.60000000
CN1810500000000,18,105,"Monroe County, IN",Jun-22,69058,66772,2286,3.30000000
CN1810700000000,18,107,"Montgomery County, IN",Jun-22,18997,18487,510,2.70000000
CN1810900000000,18,109,"Morgan County, IN",Jun-22,37652,36580,1072,2.80000000
CN1811100000000,18,111,"Newton County, IN",Jun-22,6803,6582,221,3.20000000
CN1811300000000,18,113,"Noble County, IN",Jun-22,21983,21326,657,3.00000000
CN1811500000000,18,115,"Ohio County, IN",Jun-22,3179,3109,70,2.20000000
CN1811700000000,18,117,"Orange County, IN",Jun-22,8240,7932,308,3.70000000
CN1811900000000,18,119,"Owen County, IN",Jun-22,9158,8834,324,3.50000000
CN1812100000000,18,121,"Parke County, IN",Jun-22,7433,7207,226,3.00000000
CN1812300000000,18,123,"Perry County, IN",Jun-22,8859,8608,251,2.80000000
CN1812500000000,18,125,"Pike County, IN",Jun-22,5970,5787,183,3.10000000
CN1812700000000,18,127,"Porter County, IN",Jun-22,85734,82829,2905,3.40000000
CN1812900000000,18,129,"Posey County, IN",Jun-22,13326,12974,352,2.60000000
CN1813100000000,18,131,"Pulaski County, IN",Jun-22,6722,6542,180,2.70000000
CN1813300000000,18,133,"Putnam County, IN",Jun-22,17082,16550,532,3.10000000
CN1813500000000,18,135,"Randolph County, IN",Jun-22,12164,11830,334,2.70000000
CN1813700000000,18,137,"Ripley County, IN",Jun-22,13029,12636,393,3.00000000
CN1813900000000,18,139,"Rush County, IN",Jun-22,9106,8873,233,2.60000000
CN1814100000000,18,141,"St. Joseph County, IN",Jun-22,134882,130102,4780,3.50000000
CN1814300000000,18,143,"Scott County, IN",Jun-22,10755,10387,368,3.40000000
CN1814500000000,18,145,"Shelby County, IN",Jun-22,23936,23285,651,2.70000000
CN1814700000000,18,147,"Spencer County, IN",Jun-22,11268,10981,287,2.50000000
CN1814900000000,18,149,"Starke County, IN",Jun-22,9681,9317,364,3.80000000
CN1815100000000,18,151,"Steuben County, IN",Jun-22,20987,20531,456,2.20000000
CN1815300000000,18,153,"Sullivan County, IN",Jun-22,8079,7773,306,3.80000000
CN1815500000000,18,155,"Switzerland County, IN",Jun-22,4710,4558,152,3.20000000
CN1815700000000,18,157,"Tippecanoe County, IN",Jun-22,95324,92223,3101,3.30000000
CN1815900000000,18,159,"Tipton County, IN",Jun-22,9272,8964,308,3.30000000
CN1816100000000,18,161,"Union County, IN",Jun-22,3596,3499,97,2.70000000
CN1816300000000,18,163,"Vanderburgh County, IN",Jun-22,93960,90966,2994,3.20000000
CN1816500000000,18,165,"Vermillion County, IN",Jun-22,6660,6405,255,3.80000000
CN1816700000000,18,167,"Vigo County, IN",Jun-22,46201,44403,1798,3.90000000
CN1816900000000,18,169,"Wabash County, IN",Jun-22,14507,14086,421,2.90000000
CN1817100000000,18,171,"Warren County, IN",Jun-22,4156,4043,113,2.70000000
CN1817300000000,18,173,"Warrick County, IN",Jun-22,32948,32023,925,2.80000000
CN1817500000000,18,175,"Washington County, IN",Jun-22,14172,13781,391,2.80000000
CN1817700000000,18,177,"Wayne County, IN",Jun-22,30186,29187,999,3.30000000
CN1817900000000,18,179,"Wells County, IN",Jun-22,14440,14103,337,2.30000000
CN1818100000000,18,181,"White County, IN",Jun-22,13757,13405,352,2.60000000
CN1818300000000,18,183,"Whitley County, IN",Jun-22,17928,17476,452,2.50000000
CN1900100000000,19,001,"Adair County, IA",Jun-22,4532,4453,79,1.70000000
CN1900300000000,19,003,"Adams County, IA",Jun-22,2078,2041,37,1.80000000
CN1900500000000,19,005,"Allamakee County, IA",Jun-22,7136,6937,199,2.80000000
CN1900700000000,19,007,"Appanoose County, IA",Jun-22,6176,6013,163,2.60000000
CN1900900000000,19,009,"Audubon County, IA",Jun-22,3113,3045,68,2.20000000
CN1901100000000,19,011,"Benton County, IA",Jun-22,12990,12631,359,2.80000000
CN1901300000000,19,013,"Black Hawk County, IA",Jun-22,68554,66594,1960,2.90000000
CN1901500000000,19,015,"Boone County, IA",Jun-22,14796,14459,337,2.30000000
CN1901700000000,19,017,"Bremer County, IA",Jun-22,14080,13785,295,2.10000000
CN1901900000000,19,019,"Buchanan County, IA",Jun-22,11465,11168,297,2.60000000
CN1902100000000,19,021,"Buena Vista County, IA",Jun-22,12071,11754,317,2.60000000
CN1902300000000,19,023,"Butler County, IA",Jun-22,8140,7938,202,2.50000000
CN1902500000000,19,025,"Calhoun County, IA",Jun-22,4132,4033,99,2.40000000
CN1902700000000,19,027,"Carroll County, IA",Jun-22,11021,10813,208,1.90000000
CN1902900000000,19,029,"Cass County, IA",Jun-22,6937,6778,159,2.30000000
CN1903100000000,19,031,"Cedar County, IA",Jun-22,10672,10416,256,2.40000000
CN1903300000000,19,033,"Cerro Gordo County, IA",Jun-22,22678,22050,628,2.80000000
CN1903500000000,19,035,"Cherokee County, IA",Jun-22,6186,6062,124,2.00000000
CN1903700000000,19,037,"Chickasaw County, IA",Jun-22,6587,6430,157,2.40000000
CN1903900000000,19,039,"Clarke County, IA",Jun-22,4920,4794,126,2.60000000
CN1904100000000,19,041,"Clay County, IA",Jun-22,8707,8488,219,2.50000000
CN1904300000000,19,043,"Clayton County, IA",Jun-22,9852,9572,280,2.80000000
CN1904500000000,19,045,"Clinton County, IA",Jun-22,22366,21578,788,3.50000000
CN1904700000000,19,047,"Crawford County, IA",Jun-22,7978,7708,270,3.40000000
CN1904900000000,19,049,"Dallas County, IA",Jun-22,54064,52990,1074,2.00000000
CN1905100000000,19,051,"Davis County, IA",Jun-22,4313,4223,90,2.10000000
CN1905300000000,19,053,"Decatur County, IA",Jun-22,4283,4179,104,2.40000000
CN1905500000000,19,055,"Delaware County, IA",Jun-22,10833,10611,222,2.00000000
CN1905700000000,19,057,"Des Moines County, IA",Jun-22,18508,17697,811,4.40000000
CN1905900000000,19,059,"Dickinson County, IA",Jun-22,11889,11640,249,2.10000000
CN1906100000000,19,061,"Dubuque County, IA",Jun-22,55718,54256,1462,2.60000000
CN1906300000000,19,063,"Emmet County, IA",Jun-22,5103,4988,115,2.30000000
CN1906500000000,19,065,"Fayette County, IA",Jun-22,10024,9727,297,3.00000000
CN1906700000000,19,067,"Floyd County, IA",Jun-22,8308,8073,235,2.80000000
CN1906900000000,19,069,"Franklin County, IA",Jun-22,5710,5578,132,2.30000000
CN1907100000000,19,071,"Fremont County, IA",Jun-22,3739,3660,79,2.10000000
CN1907300000000,19,073,"Greene County, IA",Jun-22,5382,5273,109,2.00000000
CN1907500000000,19,075,"Grundy County, IA",Jun-22,6408,6268,140,2.20000000
CN1907700000000,19,077,"Guthrie County, IA",Jun-22,5612,5469,143,2.50000000
CN1907900000000,19,079,"Hamilton County, IA",Jun-22,6952,6766,186,2.70000000
CN1908100000000,19,081,"Hancock County, IA",Jun-22,5810,5675,135,2.30000000
CN1908300000000,19,083,"Hardin County, IA",Jun-22,8041,7823,218,2.70000000
CN1908500000000,19,085,"Harrison County, IA",Jun-22,7194,7001,193,2.70000000
CN1908700000000,19,087,"Henry County, IA",Jun-22,9574,9314,260,2.70000000
CN1908900000000,19,089,"Howard County, IA",Jun-22,5273,5136,137,2.60000000
CN1909100000000,19,091,"Humboldt County, IA",Jun-22,5023,4913,110,2.20000000
CN1909300000000,19,093,"Ida County, IA",Jun-22,4069,3993,76,1.90000000
CN1909500000000,19,095,"Iowa County, IA",Jun-22,10104,9883,221,2.20000000
CN1909700000000,19,097,"Jackson County, IA",Jun-22,10899,10596,303,2.80000000
CN1909900000000,19,099,"Jasper County, IA",Jun-22,19193,18671,522,2.70000000
CN1910100000000,19,101,"Jefferson County, IA",Jun-22,10179,9923,256,2.50000000
CN1910300000000,19,103,"Johnson County, IA",Jun-22,87130,85114,2016,2.30000000
CN1910500000000,19,105,"Jones County, IA",Jun-22,10282,9990,292,2.80000000
CN1910700000000,19,107,"Keokuk County, IA",Jun-22,5242,5097,145,2.80000000
CN1910900000000,19,109,"Kossuth County, IA",Jun-22,8393,8213,180,2.10000000
CN1911100000000,19,111,"Lee County, IA",Jun-22,15367,14646,721,4.70000000
CN1911300000000,19,113,"Linn County, IA",Jun-22,120502,116769,3733,3.10000000
CN1911500000000,19,115,"Louisa County, IA",Jun-22,5932,5767,165,2.80000000
CN1911700000000,19,117,"Lucas County, IA",Jun-22,4830,4727,103,2.10000000
CN1911900000000,19,119,"Lyon County, IA",Jun-22,7277,7162,115,1.60000000
CN1912100000000,19,121,"Madison County, IA",Jun-22,8738,8502,236,2.70000000
CN1912300000000,19,123,"Mahaska County, IA",Jun-22,12154,11862,292,2.40000000
CN1912500000000,19,125,"Marion County, IA",Jun-22,19319,18943,376,1.90000000
CN1912700000000,19,127,"Marshall County, IA",Jun-22,17288,16516,772,4.50000000
CN1912900000000,19,129,"Mills County, IA",Jun-22,7171,7014,157,2.20000000
CN1913100000000,19,131,"Mitchell County, IA",Jun-22,5872,5759,113,1.90000000
CN1913300000000,19,133,"Monona County, IA",Jun-22,4527,4403,124,2.70000000
CN1913500000000,19,135,"Monroe County, IA",Jun-22,4010,3909,101,2.50000000
CN1913700000000,19,137,"Montgomery County, IA",Jun-22,5004,4878,126,2.50000000
CN1913900000000,19,139,"Muscatine County, IA",Jun-22,21059,20458,601,2.90000000
CN1914100000000,19,141,"O'Brien County, IA",Jun-22,8371,8211,160,1.90000000
CN1914300000000,19,143,"Osceola County, IA",Jun-22,3702,3640,62,1.70000000
CN1914500000000,19,145,"Page County, IA",Jun-22,6504,6350,154,2.40000000
CN1914700000000,19,147,"Palo Alto County, IA",Jun-22,4639,4522,117,2.50000000
CN1914900000000,19,149,"Plymouth County, IA",Jun-22,14757,14443,314,2.10000000
CN1915100000000,19,151,"Pocahontas County, IA",Jun-22,4478,4389,89,2.00000000
CN1915300000000,19,153,"Polk County, IA",Jun-22,277054,269706,7348,2.70000000
CN1915500000000,19,155,"Pottawattamie County, IA",Jun-22,48312,47021,1291,2.70000000
CN1915700000000,19,157,"Poweshiek County, IA",Jun-22,10196,9946,250,2.50000000
CN1915900000000,19,159,"Ringgold County, IA",Jun-22,2450,2394,56,2.30000000
CN1916100000000,19,161,"Sac County, IA",Jun-22,5407,5294,113,2.10000000
CN1916300000000,19,163,"Scott County, IA",Jun-22,91553,88493,3060,3.30000000
CN1916500000000,19,165,"Shelby County, IA",Jun-22,6388,6261,127,2.00000000
CN1916700000000,19,167,"Sioux County, IA",Jun-22,22248,21880,368,1.70000000
CN1916900000000,19,169,"Story County, IA",Jun-22,56713,55484,1229,2.20000000
CN1917100000000,19,171,"Tama County, IA",Jun-22,9223,8996,227,2.50000000
CN1917300000000,19,173,"Taylor County, IA",Jun-22,3148,3089,59,1.90000000
CN1917500000000,19,175,"Union County, IA",Jun-22,6173,6014,159,2.60000000
CN1917700000000,19,177,"Van Buren County, IA",Jun-22,3753,3660,93,2.50000000
CN1917900000000,19,179,"Wapello County, IA",Jun-22,17116,16544,572,3.30000000
CN1918100000000,19,181,"Warren County, IA",Jun-22,29383,28699,684,2.30000000
CN1918300000000,19,183,"Washington County, IA",Jun-22,11729,11463,266,2.30000000
CN1918500000000,19,185,"Wayne County, IA",Jun-22,2884,2806,78,2.70000000
CN1918700000000,19,187,"Webster County, IA",Jun-22,18655,18024,631,3.40000000
CN1918900000000,19,189,"Winnebago County, IA",Jun-22,4972,4841,131,2.60000000
CN1919100000000,19,191,"Winneshiek County, IA",Jun-22,11378,11086,292,2.60000000
CN1919300000000,19,193,"Woodbury County, IA",Jun-22,55998,54431,1567,2.80000000
CN1919500000000,19,195,"Worth County, IA",Jun-22,4093,3997,96,2.30000000
CN1919700000000,19,197,"Wright County, IA",Jun-22,6795,6638,157,2.30000000
CN2000100000000,20,001,"Allen County, KS",Jun-22,6628,6433,195,2.90000000
CN2000300000000,20,003,"Anderson County, KS",Jun-22,4816,4715,101,2.10000000
CN2000500000000,20,005,"Atchison County, KS",Jun-22,6761,6504,257,3.80000000
CN2000700000000,20,007,"Barber County, KS",Jun-22,2299,2251,48,2.10000000
CN2000900000000,20,009,"Barton County, KS",Jun-22,13267,12915,352,2.70000000
CN2001100000000,20,011,"Bourbon County, KS",Jun-22,6429,6209,220,3.40000000
CN2001300000000,20,013,"Brown County, KS",Jun-22,5095,4970,125,2.50000000
CN2001500000000,20,015,"Butler County, KS",Jun-22,33430,32481,949,2.80000000
CN2001700000000,20,017,"Chase County, KS",Jun-22,1414,1381,33,2.30000000
CN2001900000000,20,019,"Chautauqua County, KS",Jun-22,1440,1393,47,3.30000000
CN2002100000000,20,021,"Cherokee County, KS",Jun-22,9894,9616,278,2.80000000
CN2002300000000,20,023,"Cheyenne County, KS",Jun-22,1325,1295,30,2.30000000
CN2002500000000,20,025,"Clark County, KS",Jun-22,1145,1122,23,2.00000000
CN2002700000000,20,027,"Clay County, KS",Jun-22,3801,3690,111,2.90000000
CN2002900000000,20,029,"Cloud County, KS",Jun-22,3964,3852,112,2.80000000
CN2003100000000,20,031,"Coffey County, KS",Jun-22,3732,3596,136,3.60000000
CN2003300000000,20,033,"Comanche County, KS",Jun-22,908,890,18,2.00000000
CN2003500000000,20,035,"Cowley County, KS",Jun-22,16389,15878,511,3.10000000
CN2003700000000,20,037,"Crawford County, KS",Jun-22,18857,18269,588,3.10000000
CN2003900000000,20,039,"Decatur County, KS",Jun-22,1208,1174,34,2.80000000
CN2004100000000,20,041,"Dickinson County, KS",Jun-22,9052,8806,246,2.70000000
CN2004300000000,20,043,"Doniphan County, KS",Jun-22,4180,4064,116,2.80000000
CN2004500000000,20,045,"Douglas County, KS",Jun-22,62122,60317,1805,2.90000000
CN2004700000000,20,047,"Edwards County, KS",Jun-22,1481,1450,31,2.10000000
CN2004900000000,20,049,"Elk County, KS",Jun-22,1181,1151,30,2.50000000
CN2005100000000,20,051,"Ellis County, KS",Jun-22,17099,16740,359,2.10000000
CN2005300000000,20,053,"Ellsworth County, KS",Jun-22,2775,2713,62,2.20000000
CN2005500000000,20,055,"Finney County, KS",Jun-22,20133,19684,449,2.20000000
CN2005700000000,20,057,"Ford County, KS",Jun-22,17491,17100,391,2.20000000
CN2005900000000,20,059,"Franklin County, KS",Jun-22,14702,14307,395,2.70000000
CN2006100000000,20,061,"Geary County, KS",Jun-22,11230,10800,430,3.80000000
CN2006300000000,20,063,"Gove County, KS",Jun-22,1500,1473,27,1.80000000
CN2006500000000,20,065,"Graham County, KS",Jun-22,1136,1106,30,2.60000000
CN2006700000000,20,067,"Grant County, KS",Jun-22,2885,2790,95,3.30000000
CN2006900000000,20,069,"Gray County, KS",Jun-22,3255,3187,68,2.10000000
CN2007100000000,20,071,"Greeley County, KS",Jun-22,813,802,11,1.40000000
CN2007300000000,20,073,"Greenwood County, KS",Jun-22,2949,2877,72,2.40000000
CN2007500000000,20,075,"Hamilton County, KS",Jun-22,1623,1595,28,1.70000000
CN2007700000000,20,077,"Harper County, KS",Jun-22,2860,2796,64,2.20000000
CN2007900000000,20,079,"Harvey County, KS",Jun-22,17477,17014,463,2.60000000
CN2008100000000,20,081,"Haskell County, KS",Jun-22,2245,2204,41,1.80000000
CN2008300000000,20,083,"Hodgeman County, KS",Jun-22,1060,1039,21,2.00000000
CN2008500000000,20,085,"Jackson County, KS",Jun-22,7344,7168,176,2.40000000
CN2008700000000,20,087,"Jefferson County, KS",Jun-22,10456,10176,280,2.70000000
CN2008900000000,20,089,"Jewell County, KS",Jun-22,1231,1200,31,2.50000000
CN2009100000000,20,091,"Johnson County, KS",Jun-22,352888,344611,8277,2.30000000
CN2009300000000,20,093,"Kearny County, KS",Jun-22,2113,2073,40,1.90000000
CN2009500000000,20,095,"Kingman County, KS",Jun-22,3352,3265,87,2.60000000
CN2009700000000,20,097,"Kiowa County, KS",Jun-22,1167,1139,28,2.40000000
CN2009900000000,20,099,"Labette County, KS",Jun-22,9223,8892,331,3.60000000
CN2010100000000,20,101,"Lane County, KS",Jun-22,748,728,20,2.70000000
CN2010300000000,20,103,"Leavenworth County, KS",Jun-22,37788,36721,1067,2.80000000
CN2010500000000,20,105,"Lincoln County, KS",Jun-22,1636,1598,38,2.30000000
CN2010700000000,20,107,"Linn County, KS",Jun-22,4416,4243,173,3.90000000
CN2010900000000,20,109,"Logan County, KS",Jun-22,1667,1639,28,1.70000000
CN2011100000000,20,111,"Lyon County, KS",Jun-22,16985,16529,456,2.70000000
CN2011300000000,20,113,"McPherson County, KS",Jun-22,17363,16999,364,2.10000000
CN2011500000000,20,115,"Marion County, KS",Jun-22,6026,5868,158,2.60000000
CN2011700000000,20,117,"Marshall County, KS",Jun-22,5408,5296,112,2.10000000
CN2011900000000,20,119,"Meade County, KS",Jun-22,2195,2154,41,1.90000000
CN2012100000000,20,121,"Miami County, KS",Jun-22,18207,17743,464,2.50000000
CN2012300000000,20,123,"Mitchell County, KS",Jun-22,3459,3389,70,2.00000000
CN2012500000000,20,125,"Montgomery County, KS",Jun-22,14666,14184,482,3.30000000
CN2012700000000,20,127,"Morris County, KS",Jun-22,3050,2979,71,2.30000000
CN2012900000000,20,129,"Morton County, KS",Jun-22,1112,1082,30,2.70000000
CN2013100000000,20,131,"Nemaha County, KS",Jun-22,5633,5524,109,1.90000000
CN2013300000000,20,133,"Neosho County, KS",Jun-22,6092,5860,232,3.80000000
CN2013500000000,20,135,"Ness County, KS",Jun-22,1330,1302,28,2.10000000
CN2013700000000,20,137,"Norton County, KS",Jun-22,2666,2618,48,1.80000000
CN2013900000000,20,139,"Osage County, KS",Jun-22,8077,7860,217,2.70000000
CN2014100000000,20,141,"Osborne County, KS",Jun-22,1965,1924,41,2.10000000
CN2014300000000,20,143,"Ottawa County, KS",Jun-22,2944,2857,87,3.00000000
CN2014500000000,20,145,"Pawnee County, KS",Jun-22,2807,2743,64,2.30000000
CN2014700000000,20,147,"Phillips County, KS",Jun-22,2679,2619,60,2.20000000
CN2014900000000,20,149,"Pottawatomie County, KS",Jun-22,11836,11516,320,2.70000000
CN2015100000000,20,151,"Pratt County, KS",Jun-22,5003,4892,111,2.20000000
CN2015300000000,20,153,"Rawlins County, KS",Jun-22,1705,1675,30,1.80000000
CN2015500000000,20,155,"Reno County, KS",Jun-22,29853,28987,866,2.90000000
CN2015700000000,20,157,"Republic County, KS",Jun-22,2333,2280,53,2.30000000
CN2015900000000,20,159,"Rice County, KS",Jun-22,5488,5359,129,2.40000000
CN2016100000000,20,161,"Riley County, KS",Jun-22,32656,31669,987,3.00000000
CN2016300000000,20,163,"Rooks County, KS",Jun-22,2400,2339,61,2.50000000
CN2016500000000,20,165,"Rush County, KS",Jun-22,1556,1522,34,2.20000000
CN2016700000000,20,167,"Russell County, KS",Jun-22,3369,3291,78,2.30000000
CN2016900000000,20,169,"Saline County, KS",Jun-22,28469,27720,749,2.60000000
CN2017100000000,20,171,"Scott County, KS",Jun-22,2867,2813,54,1.90000000
CN2017300000000,20,173,"Sedgwick County, KS",Jun-22,261291,252597,8694,3.30000000
CN2017500000000,20,175,"Seward County, KS",Jun-22,9696,9428,268,2.80000000
CN2017700000000,20,177,"Shawnee County, KS",Jun-22,92521,89959,2562,2.80000000
CN2017900000000,20,179,"Sheridan County, KS",Jun-22,1496,1469,27,1.80000000
CN2018100000000,20,181,"Sherman County, KS",Jun-22,2873,2798,75,2.60000000
CN2018300000000,20,183,"Smith County, KS",Jun-22,2025,1984,41,2.00000000
CN2018500000000,20,185,"Stafford County, KS",Jun-22,2019,1971,48,2.40000000
CN2018700000000,20,187,"Stanton County, KS",Jun-22,1211,1190,21,1.70000000
CN2018900000000,20,189,"Stevens County, KS",Jun-22,3017,2956,61,2.00000000
CN2019100000000,20,191,"Sumner County, KS",Jun-22,11019,10672,347,3.10000000
CN2019300000000,20,193,"Thomas County, KS",Jun-22,4273,4191,82,1.90000000
CN2019500000000,20,195,"Trego County, KS",Jun-22,1461,1430,31,2.10000000
CN2019700000000,20,197,"Wabaunsee County, KS",Jun-22,3771,3683,88,2.30000000
CN2019900000000,20,199,"Wallace County, KS",Jun-22,901,884,17,1.90000000
CN2020100000000,20,201,"Washington County, KS",Jun-22,3078,3016,62,2.00000000
CN2020300000000,20,203,"Wichita County, KS",Jun-22,1238,1214,24,1.90000000
CN2020500000000,20,205,"Wilson County, KS",Jun-22,3801,3682,119,3.10000000
CN2020700000000,20,207,"Woodson County, KS",Jun-22,1558,1501,57,3.70000000
CN2020900000000,20,209,"Wyandotte County, KS",Jun-22,79045,76228,2817,3.60000000
CN2100100000000,21,001,"Adair County, KY",Jun-22,7146,6784,362,5.10000000
CN2100300000000,21,003,"Allen County, KY",Jun-22,8887,8492,395,4.40000000
CN2100500000000,21,005,"Anderson County, KY",Jun-22,12189,11767,422,3.50000000
CN2100700000000,21,007,"Ballard County, KY",Jun-22,3459,3272,187,5.40000000
CN2100900000000,21,009,"Barren County, KY",Jun-22,17967,17148,819,4.60000000
CN2101100000000,21,011,"Bath County, KY",Jun-22,4710,4452,258,5.50000000
CN2101300000000,21,013,"Bell County, KY",Jun-22,8301,7828,473,5.70000000
CN2101500000000,21,015,"Boone County, KY",Jun-22,72931,70428,2503,3.40000000
CN2101700000000,21,017,"Bourbon County, KY",Jun-22,9630,9260,370,3.80000000
CN2101900000000,21,019,"Boyd County, KY",Jun-22,17474,16465,1009,5.80000000
CN2102100000000,21,021,"Boyle County, KY",Jun-22,12787,12211,576,4.50000000
CN2102300000000,21,023,"Bracken County, KY",Jun-22,3796,3636,160,4.20000000
CN2102500000000,21,025,"Breathitt County, KY",Jun-22,3312,3012,300,9.10000000
CN2102700000000,21,027,"Breckinridge County, KY",Jun-22,8105,7711,394,4.90000000
CN2102900000000,21,029,"Bullitt County, KY",Jun-22,44116,42527,1589,3.60000000
CN2103100000000,21,031,"Butler County, KY",Jun-22,4934,4713,221,4.50000000
CN2103300000000,21,033,"Caldwell County, KY",Jun-22,6012,5775,237,3.90000000
CN2103500000000,21,035,"Calloway County, KY",Jun-22,16825,16019,806,4.80000000
CN2103700000000,21,037,"Campbell County, KY",Jun-22,51247,49365,1882,3.70000000
CN2103900000000,21,039,"Carlisle County, KY",Jun-22,2249,2153,96,4.30000000
CN2104100000000,21,041,"Carroll County, KY",Jun-22,5511,5309,202,3.70000000
CN2104300000000,21,043,"Carter County, KY",Jun-22,9973,9148,825,8.30000000
CN2104500000000,21,045,"Casey County, KY",Jun-22,6820,6545,275,4.00000000
CN2104700000000,21,047,"Christian County, KY",Jun-22,25362,23986,1376,5.40000000
CN2104900000000,21,049,"Clark County, KY",Jun-22,17441,16742,699,4.00000000
CN2105100000000,21,051,"Clay County, KY",Jun-22,5236,4887,349,6.70000000
CN2105300000000,21,053,"Clinton County, KY",Jun-22,3992,3796,196,4.90000000
CN2105500000000,21,055,"Crittenden County, KY",Jun-22,3830,3658,172,4.50000000
CN2105700000000,21,057,"Cumberland County, KY",Jun-22,3430,3318,112,3.30000000
CN2105900000000,21,059,"Daviess County, KY",Jun-22,47334,45386,1948,4.10000000
CN2106100000000,21,061,"Edmonson County, KY",Jun-22,4709,4458,251,5.30000000
CN2106300000000,21,063,"Elliott County, KY",Jun-22,1871,1692,179,9.60000000
CN2106500000000,21,065,"Estill County, KY",Jun-22,5239,4950,289,5.50000000
CN2106700000000,21,067,"Fayette County, KY",Jun-22,177682,171431,6251,3.50000000
CN2106900000000,21,069,"Fleming County, KY",Jun-22,6067,5757,310,5.10000000
CN2107100000000,21,071,"Floyd County, KY",Jun-22,11101,10352,749,6.70000000
CN2107300000000,21,073,"Franklin County, KY",Jun-22,25588,24611,977,3.80000000
CN2107500000000,21,075,"Fulton County, KY",Jun-22,2075,1972,103,5.00000000
CN2107700000000,21,077,"Gallatin County, KY",Jun-22,4043,3882,161,4.00000000
CN2107900000000,21,079,"Garrard County, KY",Jun-22,7815,7477,338,4.30000000
CN2108100000000,21,081,"Grant County, KY",Jun-22,11796,11322,474,4.00000000
CN2108300000000,21,083,"Graves County, KY",Jun-22,15724,14979,745,4.70000000
CN2108500000000,21,085,"Grayson County, KY",Jun-22,10671,10130,541,5.10000000
CN2108700000000,21,087,"Green County, KY",Jun-22,5309,5097,212,4.00000000
CN2108900000000,21,089,"Greenup County, KY",Jun-22,13160,12303,857,6.50000000
CN2109100000000,21,091,"Hancock County, KY",Jun-22,3942,3773,169,4.30000000
CN2109300000000,21,093,"Hardin County, KY",Jun-22,48036,45955,2081,4.30000000
CN2109500000000,21,095,"Harlan County, KY",Jun-22,6651,6140,511,7.70000000
CN2109700000000,21,097,"Harrison County, KY",Jun-22,8967,8633,334,3.70000000
CN2109900000000,21,099,"Hart County, KY",Jun-22,7617,7274,343,4.50000000
CN2110100000000,21,101,"Henderson County, KY",Jun-22,21229,20351,878,4.10000000
CN2110300000000,21,103,"Henry County, KY",Jun-22,8321,8032,289,3.50000000
CN2110500000000,21,105,"Hickman County, KY",Jun-22,1699,1615,84,4.90000000
CN2110700000000,21,107,"Hopkins County, KY",Jun-22,18221,17317,904,5.00000000
CN2110900000000,21,109,"Jackson County, KY",Jun-22,4209,3931,278,6.60000000
CN2111100000000,21,111,"Jefferson County, KY",Jun-22,406084,390849,15235,3.80000000
CN2111300000000,21,113,"Jessamine County, KY",Jun-22,26852,25875,977,3.60000000
CN2111500000000,21,115,"Johnson County, KY",Jun-22,6776,6311,465,6.90000000
CN2111700000000,21,117,"Kenton County, KY",Jun-22,88748,85505,3243,3.70000000
CN2111900000000,21,119,"Knott County, KY",Jun-22,4346,4036,310,7.10000000
CN2112100000000,21,121,"Knox County, KY",Jun-22,10338,9715,623,6.00000000
CN2112300000000,21,123,"Larue County, KY",Jun-22,5840,5565,275,4.70000000
CN2112500000000,21,125,"Laurel County, KY",Jun-22,26044,24860,1184,4.50000000
CN2112700000000,21,127,"Lawrence County, KY",Jun-22,5525,5193,332,6.00000000
CN2112900000000,21,129,"Lee County, KY",Jun-22,2054,1916,138,6.70000000
CN2113100000000,21,131,"Leslie County, KY",Jun-22,2570,2364,206,8.00000000
CN2113300000000,21,133,"Letcher County, KY",Jun-22,6216,5780,436,7.00000000
CN2113500000000,21,135,"Lewis County, KY",Jun-22,4752,4391,361,7.60000000
CN2113700000000,21,137,"Lincoln County, KY",Jun-22,9384,8889,495,5.30000000
CN2113900000000,21,139,"Livingston County, KY",Jun-22,3628,3438,190,5.20000000
CN2114100000000,21,141,"Logan County, KY",Jun-22,12513,12034,479,3.80000000
CN2114300000000,21,143,"Lyon County, KY",Jun-22,3264,3123,141,4.30000000
CN2114500000000,21,145,"McCracken County, KY",Jun-22,29737,28383,1354,4.60000000
CN2114700000000,21,147,"McCreary County, KY",Jun-22,4835,4561,274,5.70000000
CN2114900000000,21,149,"McLean County, KY",Jun-22,4085,3894,191,4.70000000
CN2115100000000,21,151,"Madison County, KY",Jun-22,47999,46045,1954,4.10000000
CN2115300000000,21,153,"Magoffin County, KY",Jun-22,3371,2963,408,12.10000000
CN2115500000000,21,155,"Marion County, KY",Jun-22,9313,8971,342,3.70000000
CN2115700000000,21,157,"Marshall County, KY",Jun-22,14494,13854,640,4.40000000
CN2115900000000,21,159,"Martin County, KY",Jun-22,2322,2120,202,8.70000000
CN2116100000000,21,161,"Mason County, KY",Jun-22,6662,6316,346,5.20000000
CN2116300000000,21,163,"Meade County, KY",Jun-22,11867,11306,561,4.70000000
CN2116500000000,21,165,"Menifee County, KY",Jun-22,2388,2241,147,6.20000000
CN2116700000000,21,167,"Mercer County, KY",Jun-22,10037,9621,416,4.10000000
CN2116900000000,21,169,"Metcalfe County, KY",Jun-22,3922,3721,201,5.10000000
CN2117100000000,21,171,"Monroe County, KY",Jun-22,4627,4453,174,3.80000000
CN2117300000000,21,173,"Montgomery County, KY",Jun-22,11956,11360,596,5.00000000
CN2117500000000,21,175,"Morgan County, KY",Jun-22,4379,4132,247,5.60000000
CN2117700000000,21,177,"Muhlenberg County, KY",Jun-22,9701,9064,637,6.60000000
CN2117900000000,21,179,"Nelson County, KY",Jun-22,24041,23176,865,3.60000000
CN2118100000000,21,181,"Nicholas County, KY",Jun-22,3301,3148,153,4.60000000
CN2118300000000,21,183,"Ohio County, KY",Jun-22,9111,8645,466,5.10000000
CN2118500000000,21,185,"Oldham County, KY",Jun-22,34221,33130,1091,3.20000000
CN2118700000000,21,187,"Owen County, KY",Jun-22,5155,4961,194,3.80000000
CN2118900000000,21,189,"Owsley County, KY",Jun-22,1053,971,82,7.80000000
CN2119100000000,21,191,"Pendleton County, KY",Jun-22,6966,6710,256,3.70000000
CN2119300000000,21,193,"Perry County, KY",Jun-22,8114,7638,476,5.90000000
CN2119500000000,21,195,"Pike County, KY",Jun-22,19058,17916,1142,6.00000000
CN2119700000000,21,197,"Powell County, KY",Jun-22,5265,5023,242,4.60000000
CN2119900000000,21,199,"Pulaski County, KY",Jun-22,26059,24797,1262,4.80000000
CN2120100000000,21,201,"Robertson County, KY",Jun-22,806,765,41,5.10000000
CN2120300000000,21,203,"Rockcastle County, KY",Jun-22,6650,6308,342,5.10000000
CN2120500000000,21,205,"Rowan County, KY",Jun-22,9765,9213,552,5.70000000
CN2120700000000,21,207,"Russell County, KY",Jun-22,6241,5903,338,5.40000000
CN2120900000000,21,209,"Scott County, KY",Jun-22,30671,29637,1034,3.40000000
CN2121100000000,21,211,"Shelby County, KY",Jun-22,26546,25649,897,3.40000000
CN2121300000000,21,213,"Simpson County, KY",Jun-22,9006,8661,345,3.80000000
CN2121500000000,21,215,"Spencer County, KY",Jun-22,10829,10467,362,3.30000000
CN2121700000000,21,217,"Taylor County, KY",Jun-22,12432,11934,498,4.00000000
CN2121900000000,21,219,"Todd County, KY",Jun-22,5591,5385,206,3.70000000
CN2122100000000,21,221,"Trigg County, KY",Jun-22,6164,5867,297,4.80000000
CN2122300000000,21,223,"Trimble County, KY",Jun-22,3922,3762,160,4.10000000
CN2122500000000,21,225,"Union County, KY",Jun-22,6060,5775,285,4.70000000
CN2122700000000,21,227,"Warren County, KY",Jun-22,65289,62653,2636,4.00000000
CN2122900000000,21,229,"Washington County, KY",Jun-22,6202,5982,220,3.50000000
CN2123100000000,21,231,"Wayne County, KY",Jun-22,7222,6835,387,5.40000000
CN2123300000000,21,233,"Webster County, KY",Jun-22,5342,5114,228,4.30000000
CN2123500000000,21,235,"Whitley County, KY",Jun-22,14476,13776,700,4.80000000
CN2123700000000,21,237,"Wolfe County, KY",Jun-22,2304,2157,147,6.40000000
CN2123900000000,21,239,"Woodford County, KY",Jun-22,15041,14544,497,3.30000000
CN2200100000000,22,001,"Acadia Parish, LA",Jun-22,24543,23509,1034,4.20000000
CN2200300000000,22,003,"Allen Parish, LA",Jun-22,8056,7621,435,5.40000000
CN2200500000000,22,005,"Ascension Parish, LA",Jun-22,65997,63637,2360,3.60000000
CN2200700000000,22,007,"Assumption Parish, LA",Jun-22,8837,8283,554,6.30000000
CN2200900000000,22,009,"Avoyelles Parish, LA",Jun-22,14648,13890,758,5.20000000
CN2201100000000,22,011,"Beauregard Parish, LA",Jun-22,15156,14577,579,3.80000000
CN2201300000000,22,013,"Bienville Parish, LA",Jun-22,5416,5152,264,4.90000000
CN2201500000000,22,015,"Bossier Parish, LA",Jun-22,59602,57574,2028,3.40000000
CN2201700000000,22,017,"Caddo Parish, LA",Jun-22,105439,99839,5600,5.30000000
CN2201900000000,22,019,"Calcasieu Parish, LA",Jun-22,101148,96848,4300,4.30000000
CN2202100000000,22,021,"Caldwell Parish, LA",Jun-22,3733,3574,159,4.30000000
CN2202300000000,22,023,"Cameron Parish, LA",Jun-22,3727,3621,106,2.80000000
CN2202500000000,22,025,"Catahoula Parish, LA",Jun-22,3577,3409,168,4.70000000
CN2202700000000,22,027,"Claiborne Parish, LA",Jun-22,5442,5199,243,4.50000000
CN2202900000000,22,029,"Concordia Parish, LA",Jun-22,7152,6763,389,5.40000000
CN2203100000000,22,031,"De Soto Parish, LA",Jun-22,11217,10734,483,4.30000000
CN2203300000000,22,033,"East Baton Rouge Parish, LA",Jun-22,231258,220954,10304,4.50000000
CN2203500000000,22,035,"East Carroll Parish, LA",Jun-22,1678,1503,175,10.40000000
CN2203700000000,22,037,"East Feliciana Parish, LA",Jun-22,7812,7512,300,3.80000000
CN2203900000000,22,039,"Evangeline Parish, LA",Jun-22,12198,11579,619,5.10000000
CN2204100000000,22,041,"Franklin Parish, LA",Jun-22,7581,7167,414,5.50000000
CN2204300000000,22,043,"Grant Parish, LA",Jun-22,8577,8245,332,3.90000000
CN2204500000000,22,045,"Iberia Parish, LA",Jun-22,28699,27078,1621,5.60000000
CN2204700000000,22,047,"Iberville Parish, LA",Jun-22,13900,13031,869,6.30000000
CN2204900000000,22,049,"Jackson Parish, LA",Jun-22,6871,6621,250,3.60000000
CN2205100000000,22,051,"Jefferson Parish, LA",Jun-22,213650,203618,10032,4.70000000
CN2205300000000,22,053,"Jefferson Davis Parish, LA",Jun-22,13059,12539,520,4.00000000
CN2205500000000,22,055,"Lafayette Parish, LA",Jun-22,119562,115166,4396,3.70000000
CN2205700000000,22,057,"Lafourche Parish, LA",Jun-22,41288,39685,1603,3.90000000
CN2205900000000,22,059,"LaSalle Parish, LA",Jun-22,6829,6618,211,3.10000000
CN2206100000000,22,061,"Lincoln Parish, LA",Jun-22,20081,19157,924,4.60000000
CN2206300000000,22,063,"Livingston Parish, LA",Jun-22,70758,68407,2351,3.30000000
CN2206500000000,22,065,"Madison Parish, LA",Jun-22,3461,3238,223,6.40000000
CN2206700000000,22,067,"Morehouse Parish, LA",Jun-22,10134,9448,686,6.80000000
CN2206900000000,22,069,"Natchitoches Parish, LA",Jun-22,16174,15376,798,4.90000000
CN2207100000000,22,071,"Orleans Parish, LA",Jun-22,181220,169382,11838,6.50000000
CN2207300000000,22,073,"Ouachita Parish, LA",Jun-22,71148,68079,3069,4.30000000
CN2207500000000,22,075,"Plaquemines Parish, LA",Jun-22,9895,9534,361,3.60000000
CN2207700000000,22,077,"Pointe Coupee Parish, LA",Jun-22,9783,9293,490,5.00000000
CN2207900000000,22,079,"Rapides Parish, LA",Jun-22,57675,55600,2075,3.60000000
CN2208100000000,22,081,"Red River Parish, LA",Jun-22,3839,3692,147,3.80000000
CN2208300000000,22,083,"Richland Parish, LA",Jun-22,8417,8024,393,4.70000000
CN2208500000000,22,085,"Sabine Parish, LA",Jun-22,9433,9084,349,3.70000000
CN2208700000000,22,087,"St. Bernard Parish, LA",Jun-22,20478,19323,1155,5.60000000
CN2208900000000,22,089,"St. Charles Parish, LA",Jun-22,25063,24051,1012,4.00000000
CN2209100000000,22,091,"St. Helena Parish, LA",Jun-22,4315,3978,337,7.80000000
CN2209300000000,22,093,"St. James Parish, LA",Jun-22,9087,8515,572,6.30000000
CN2209500000000,22,095,"St. John the Baptist Parish, LA",Jun-22,19531,18186,1345,6.90000000
CN2209700000000,22,097,"St. Landry Parish, LA",Jun-22,32689,30828,1861,5.70000000
CN2209900000000,22,099,"St. Martin Parish, LA",Jun-22,22675,21665,1010,4.50000000
CN2210100000000,22,101,"St. Mary Parish, LA",Jun-22,19781,18640,1141,5.80000000
CN2210300000000,22,103,"St. Tammany Parish, LA",Jun-22,120975,116801,4174,3.50000000
CN2210500000000,22,105,"Tangipahoa Parish, LA",Jun-22,57289,53989,3300,5.80000000
CN2210700000000,22,107,"Tensas Parish, LA",Jun-22,1352,1274,78,5.80000000
CN2210900000000,22,109,"Terrebonne Parish, LA",Jun-22,45561,43405,2156,4.70000000
CN2211100000000,22,111,"Union Parish, LA",Jun-22,9278,8888,390,4.20000000
CN2211300000000,22,113,"Vermilion Parish, LA",Jun-22,24833,23800,1033,4.20000000
CN2211500000000,22,115,"Vernon Parish, LA",Jun-22,16356,15518,838,5.10000000
CN2211700000000,22,117,"Washington Parish, LA",Jun-22,16935,16008,927,5.50000000
CN2211900000000,22,119,"Webster Parish, LA",Jun-22,14589,13890,699,4.80000000
CN2212100000000,22,121,"West Baton Rouge Parish, LA",Jun-22,13829,13272,557,4.00000000
CN2212300000000,22,123,"West Carroll Parish, LA",Jun-22,3687,3470,217,5.90000000
CN2212500000000,22,125,"West Feliciana Parish, LA",Jun-22,5372,5209,163,3.00000000
CN2212700000000,22,127,"Winn Parish, LA",Jun-22,4675,4454,221,4.70000000
CN2300100000000,23,001,"Androscoggin County, ME",Jun-22,53705,52024,1681,3.10000000
CN2300300000000,23,003,"Aroostook County, ME",Jun-22,28671,27382,1289,4.50000000
CN2300500000000,23,005,"Cumberland County, ME",Jun-22,165052,160904,4148,2.50000000
CN2300700000000,23,007,"Franklin County, ME",Jun-22,13790,13257,533,3.90000000
CN2300900000000,23,009,"Hancock County, ME",Jun-22,30378,29538,840,2.80000000
CN2301100000000,23,011,"Kennebec County, ME",Jun-22,61034,59256,1778,2.90000000
CN2301300000000,23,013,"Knox County, ME",Jun-22,20870,20313,557,2.70000000
CN2301500000000,23,015,"Lincoln County, ME",Jun-22,17563,17116,447,2.50000000
CN2301700000000,23,017,"Oxford County, ME",Jun-22,25930,25007,923,3.60000000
CN2301900000000,23,019,"Penobscot County, ME",Jun-22,75028,72664,2364,3.20000000
CN2302100000000,23,021,"Piscataquis County, ME",Jun-22,7508,7217,291,3.90000000
CN2302300000000,23,023,"Sagadahoc County, ME",Jun-22,19143,18692,451,2.40000000
CN2302500000000,23,025,"Somerset County, ME",Jun-22,22372,21431,941,4.20000000
CN2302700000000,23,027,"Waldo County, ME",Jun-22,20696,20025,671,3.20000000
CN2302900000000,23,029,"Washington County, ME",Jun-22,13640,13038,602,4.40000000
CN2303100000000,23,031,"York County, ME",Jun-22,113127,110144,2983,2.60000000
CN2400100000000,24,001,"Allegany County, MD",Jun-22,30583,28768,1815,5.90000000
CN2400300000000,24,003,"Anne Arundel County, MD",Jun-22,322987,309860,13127,4.10000000
CN2400500000000,24,005,"Baltimore County, MD",Jun-22,458280,436803,21477,4.70000000
CN2400900000000,24,009,"Calvert County, MD",Jun-22,49664,47506,2158,4.30000000
CN2401100000000,24,011,"Caroline County, MD",Jun-22,17863,17116,747,4.20000000
CN2401300000000,24,013,"Carroll County, MD",Jun-22,97134,93308,3826,3.90000000
CN2401500000000,24,015,"Cecil County, MD",Jun-22,53609,50944,2665,5.00000000
CN2401700000000,24,017,"Charles County, MD",Jun-22,87038,82869,4169,4.80000000
CN2401900000000,24,019,"Dorchester County, MD",Jun-22,16403,15605,798,4.90000000
CN2402100000000,24,021,"Frederick County, MD",Jun-22,138852,132788,6064,4.40000000
CN2402300000000,24,023,"Garrett County, MD",Jun-22,15776,15039,737,4.70000000
CN2402500000000,24,025,"Harford County, MD",Jun-22,143978,137856,6122,4.30000000
CN2402700000000,24,027,"Howard County, MD",Jun-22,193249,185782,7467,3.90000000
CN2402900000000,24,029,"Kent County, MD",Jun-22,9666,9179,487,5.00000000
CN2403100000000,24,031,"Montgomery County, MD",Jun-22,561952,537426,24526,4.40000000
CN2403300000000,24,033,"Prince George's County, MD",Jun-22,501541,474961,26580,5.30000000
CN2403500000000,24,035,"Queen Anne's County, MD",Jun-22,28586,27450,1136,4.00000000
CN2403700000000,24,037,"St. Mary's County, MD",Jun-22,58406,55766,2640,4.50000000
CN2403900000000,24,039,"Somerset County, MD",Jun-22,9320,8695,625,6.70000000
CN2404100000000,24,041,"Talbot County, MD",Jun-22,17999,17152,847,4.70000000
CN2404300000000,24,043,"Washington County, MD",Jun-22,73508,69960,3548,4.80000000
CN2404500000000,24,045,"Wicomico County, MD",Jun-22,53564,50797,2767,5.20000000
CN2404700000000,24,047,"Worcester County, MD",Jun-22,26202,24699,1503,5.70000000
CN2451000000000,24,510,"Baltimore city, MD",Jun-22,283956,266675,17281,6.10000000
CN2500100000000,25,001,"Barnstable County, MA",Jun-22,116835,112634,4201,3.60000000
CN2500300000000,25,003,"Berkshire County, MA",Jun-22,61924,59416,2508,4.10000000
CN2500500000000,25,005,"Bristol County, MA",Jun-22,300109,287479,12630,4.20000000
CN2500700000000,25,007,"Dukes County, MA",Jun-22,11078,10722,356,3.20000000
CN2500900000000,25,009,"Essex County, MA",Jun-22,423984,407856,16128,3.80000000
CN2501100000000,25,011,"Franklin County, MA",Jun-22,41036,39815,1221,3.00000000
CN2501300000000,25,013,"Hampden County, MA",Jun-22,225757,214934,10823,4.80000000
CN2501500000000,25,015,"Hampshire County, MA",Jun-22,90169,87263,2906,3.20000000
CN2501700000000,25,017,"Middlesex County, MA",Jun-22,921087,894855,26232,2.80000000
CN2501900000000,25,019,"Nantucket County/town, MA",Jun-22,9140,8859,281,3.10000000
CN2502100000000,25,021,"Norfolk County, MA",Jun-22,396251,383899,12352,3.10000000
CN2502300000000,25,023,"Plymouth County, MA",Jun-22,285240,274770,10470,3.70000000
CN2502500000000,25,025,"Suffolk County, MA",Jun-22,458256,441882,16374,3.60000000
CN2502700000000,25,027,"Worcester County, MA",Jun-22,439670,423286,16384,3.70000000
CN2600100000000,26,001,"Alcona County, MI",Jun-22,4065,3777,288,7.10000000
CN2600300000000,26,003,"Alger County, MI",Jun-22,3433,3186,247,7.20000000
CN2600500000000,26,005,"Allegan County, MI",Jun-22,63401,60925,2476,3.90000000
CN2600700000000,26,007,"Alpena County, MI",Jun-22,13776,13076,700,5.10000000
CN2600900000000,26,009,"Antrim County, MI",Jun-22,10743,10120,623,5.80000000
CN2601100000000,26,011,"Arenac County, MI",Jun-22,6070,5614,456,7.50000000
CN2601300000000,26,013,"Baraga County, MI",Jun-22,3177,2932,245,7.70000000
CN2601500000000,26,015,"Barry County, MI",Jun-22,32076,30756,1320,4.10000000
CN2601700000000,26,017,"Bay County, MI",Jun-22,49262,46507,2755,5.60000000
CN2601900000000,26,019,"Benzie County, MI",Jun-22,9205,8746,459,5.00000000
CN2602100000000,26,021,"Berrien County, MI",Jun-22,72425,68743,3682,5.10000000
CN2602300000000,26,023,"Branch County, MI",Jun-22,19614,18729,885,4.50000000
CN2602500000000,26,025,"Calhoun County, MI",Jun-22,60789,57368,3421,5.60000000
CN2602700000000,26,027,"Cass County, MI",Jun-22,23918,22763,1155,4.80000000
CN2602900000000,26,029,"Charlevoix County, MI",Jun-22,13349,12742,607,4.50000000
CN2603100000000,26,031,"Cheboygan County, MI",Jun-22,10987,10473,514,4.70000000
CN2603300000000,26,033,"Chippewa County, MI",Jun-22,16521,15477,1044,6.30000000
CN2603500000000,26,035,"Clare County, MI",Jun-22,11561,10703,858,7.40000000
CN2603700000000,26,037,"Clinton County, MI",Jun-22,40042,38443,1599,4.00000000
CN2603900000000,26,039,"Crawford County, MI",Jun-22,5615,5223,392,7.00000000
CN2604100000000,26,041,"Delta County, MI",Jun-22,16862,15904,958,5.70000000
CN2604300000000,26,043,"Dickinson County, MI",Jun-22,12476,11922,554,4.40000000
CN2604500000000,26,045,"Eaton County, MI",Jun-22,55394,52904,2490,4.50000000
CN2604700000000,26,047,"Emmet County, MI",Jun-22,17950,17051,899,5.00000000
CN2604900000000,26,049,"Genesee County, MI",Jun-22,179577,167899,11678,6.50000000
CN2605100000000,26,051,"Gladwin County, MI",Jun-22,9993,9357,636,6.40000000
CN2605300000000,26,053,"Gogebic County, MI",Jun-22,5653,5346,307,5.40000000
CN2605500000000,26,055,"Grand Traverse County, MI",Jun-22,52124,50119,2005,3.80000000
CN2605700000000,26,057,"Gratiot County, MI",Jun-22,17246,16388,858,5.00000000
CN2605900000000,26,059,"Hillsdale County, MI",Jun-22,20343,19336,1007,5.00000000
CN2606100000000,26,061,"Houghton County, MI",Jun-22,15366,14537,829,5.40000000
CN2606300000000,26,063,"Huron County, MI",Jun-22,15319,14565,754,4.90000000
CN2606500000000,26,065,"Ingham County, MI",Jun-22,145276,138150,7126,4.90000000
CN2606700000000,26,067,"Ionia County, MI",Jun-22,30529,29279,1250,4.10000000
CN2606900000000,26,069,"Iosco County, MI",Jun-22,10670,9956,714,6.70000000
CN2607100000000,26,071,"Iron County, MI",Jun-22,5090,4808,282,5.50000000
CN2607300000000,26,073,"Isabella County, MI",Jun-22,32328,30588,1740,5.40000000
CN2607500000000,26,075,"Jackson County, MI",Jun-22,73812,70130,3682,5.00000000
CN2607700000000,26,077,"Kalamazoo County, MI",Jun-22,132445,126576,5869,4.40000000
CN2607900000000,26,079,"Kalkaska County, MI",Jun-22,8278,7792,486,5.90000000
CN2608100000000,26,081,"Kent County, MI",Jun-22,361509,347220,14289,4.00000000
CN2608300000000,26,083,"Keweenaw County, MI",Jun-22,868,809,59,6.80000000
CN2608500000000,26,085,"Lake County, MI",Jun-22,4116,3816,300,7.30000000
CN2608700000000,26,087,"Lapeer County, MI",Jun-22,40363,38516,1847,4.60000000
CN2608900000000,26,089,"Leelanau County, MI",Jun-22,10922,10470,452,4.10000000
CN2609100000000,26,091,"Lenawee County, MI",Jun-22,44815,42514,2301,5.10000000
CN2609300000000,26,093,"Livingston County, MI",Jun-22,103065,99750,3315,3.20000000
CN2609500000000,26,095,"Luce County, MI",Jun-22,2208,2068,140,6.30000000
CN2609700000000,26,097,"Mackinac County, MI",Jun-22,5848,5645,203,3.50000000
CN2609900000000,26,099,"Macomb County, MI",Jun-22,441637,422535,19102,4.30000000
CN2610100000000,26,101,"Manistee County, MI",Jun-22,10818,10193,625,5.80000000
CN2610300000000,26,103,"Marquette County, MI",Jun-22,31121,29481,1640,5.30000000
CN2610500000000,26,105,"Mason County, MI",Jun-22,13796,13075,721,5.20000000
CN2610700000000,26,107,"Mecosta County, MI",Jun-22,18157,17077,1080,5.90000000
CN2610900000000,26,109,"Menominee County, MI",Jun-22,10880,10380,500,4.60000000
CN2611100000000,26,111,"Midland County, MI",Jun-22,39381,37494,1887,4.80000000
CN2611300000000,26,113,"Missaukee County, MI",Jun-22,7119,6765,354,5.00000000
CN2611500000000,26,115,"Monroe County, MI",Jun-22,75002,70843,4159,5.50000000
CN2611700000000,26,117,"Montcalm County, MI",Jun-22,28024,26666,1358,4.80000000
CN2611900000000,26,119,"Montmorency County, MI",Jun-22,3169,2903,266,8.40000000
CN2612100000000,26,121,"Muskegon County, MI",Jun-22,78201,73390,4811,6.20000000
CN2612300000000,26,123,"Newaygo County, MI",Jun-22,24280,23099,1181,4.90000000
CN2612500000000,26,125,"Oakland County, MI",Jun-22,666625,643153,23472,3.50000000
CN2612700000000,26,127,"Oceana County, MI",Jun-22,12713,11892,821,6.50000000
CN2612900000000,26,129,"Ogemaw County, MI",Jun-22,8543,7944,599,7.00000000
CN2613100000000,26,131,"Ontonagon County, MI",Jun-22,2175,2004,171,7.90000000
CN2613300000000,26,133,"Osceola County, MI",Jun-22,11887,11327,560,4.70000000
CN2613500000000,26,135,"Oscoda County, MI",Jun-22,2806,2570,236,8.40000000
CN2613700000000,26,137,"Otsego County, MI",Jun-22,12044,11310,734,6.10000000
CN2613900000000,26,139,"Ottawa County, MI",Jun-22,162824,156909,5915,3.60000000
CN2614100000000,26,141,"Presque Isle County, MI",Jun-22,5161,4809,352,6.80000000
CN2614300000000,26,143,"Roscommon County, MI",Jun-22,7765,7063,702,9.00000000
CN2614500000000,26,145,"Saginaw County, MI",Jun-22,82538,77142,5396,6.50000000
CN2614700000000,26,147,"St. Clair County, MI",Jun-22,74609,71382,3227,4.30000000
CN2614900000000,26,149,"St. Joseph County, MI",Jun-22,28533,27182,1351,4.70000000
CN2615100000000,26,151,"Sanilac County, MI",Jun-22,19749,18698,1051,5.30000000
CN2615300000000,26,153,"Schoolcraft County, MI",Jun-22,3290,3056,234,7.10000000
CN2615500000000,26,155,"Shiawassee County, MI",Jun-22,32834,31225,1609,4.90000000
CN2615700000000,26,157,"Tuscola County, MI",Jun-22,23440,22063,1377,5.90000000
CN2615900000000,26,159,"Van Buren County, MI",Jun-22,34821,32966,1855,5.30000000
CN2616100000000,26,161,"Washtenaw County, MI",Jun-22,195041,187002,8039,4.10000000
CN2616300000000,26,163,"Wayne County, MI",Jun-22,792335,745673,46662,5.90000000
CN2616500000000,26,165,"Wexford County, MI",Jun-22,15200,14429,771,5.10000000
CN2700100000000,27,001,"Aitkin County, MN",Jun-22,7438,7225,213,2.90000000
CN2700300000000,27,003,"Anoka County, MN",Jun-22,202067,197631,4436,2.20000000
CN2700500000000,27,005,"Becker County, MN",Jun-22,18575,18143,432,2.30000000
CN2700700000000,27,007,"Beltrami County, MN",Jun-22,23949,23314,635,2.70000000
CN2700900000000,27,009,"Benton County, MN",Jun-22,21449,20913,536,2.50000000
CN2701100000000,27,011,"Big Stone County, MN",Jun-22,2372,2317,55,2.30000000
CN2701300000000,27,013,"Blue Earth County, MN",Jun-22,39947,39130,817,2.00000000
CN2701500000000,27,015,"Brown County, MN",Jun-22,13320,13025,295,2.20000000
CN2701700000000,27,017,"Carlton County, MN",Jun-22,17527,17062,465,2.70000000
CN2701900000000,27,019,"Carver County, MN",Jun-22,60284,59164,1120,1.90000000
CN2702100000000,27,021,"Cass County, MN",Jun-22,17722,17302,420,2.40000000
CN2702300000000,27,023,"Chippewa County, MN",Jun-22,6369,6239,130,2.00000000
CN2702500000000,27,025,"Chisago County, MN",Jun-22,30263,29594,669,2.20000000
CN2702700000000,27,027,"Clay County, MN",Jun-22,36567,35847,720,2.00000000
CN2702900000000,27,029,"Clearwater County, MN",Jun-22,4336,4147,189,4.40000000
CN2703100000000,27,031,"Cook County, MN",Jun-22,2836,2766,70,2.50000000
CN2703300000000,27,033,"Cottonwood County, MN",Jun-22,6568,6416,152,2.30000000
CN2703500000000,27,035,"Crow Wing County, MN",Jun-22,32722,31963,759,2.30000000
CN2703700000000,27,037,"Dakota County, MN",Jun-22,246689,241605,5084,2.10000000
CN2703900000000,27,039,"Dodge County, MN",Jun-22,11947,11705,242,2.00000000
CN2704100000000,27,041,"Douglas County, MN",Jun-22,21282,20889,393,1.80000000
CN2704300000000,27,043,"Faribault County, MN",Jun-22,6779,6607,172,2.50000000
CN2704500000000,27,045,"Fillmore County, MN",Jun-22,11379,11151,228,2.00000000
CN2704700000000,27,047,"Freeborn County, MN",Jun-22,15079,14723,356,2.40000000
CN2704900000000,27,049,"Goodhue County, MN",Jun-22,25966,25417,549,2.10000000
CN2705100000000,27,051,"Grant County, MN",Jun-22,3175,3112,63,2.00000000
CN2705300000000,27,053,"Hennepin County, MN",Jun-22,717646,701691,15955,2.20000000
CN2705500000000,27,055,"Houston County, MN",Jun-22,9925,9746,179,1.80000000
CN2705700000000,27,057,"Hubbard County, MN",Jun-22,10458,10153,305,2.90000000
CN2705900000000,27,059,"Isanti County, MN",Jun-22,21914,21430,484,2.20000000
CN2706100000000,27,061,"Itasca County, MN",Jun-22,21073,20356,717,3.40000000
CN2706300000000,27,063,"Jackson County, MN",Jun-22,5246,5143,103,2.00000000
CN2706500000000,27,065,"Kanabec County, MN",Jun-22,9040,8808,232,2.60000000
CN2706700000000,27,067,"Kandiyohi County, MN",Jun-22,22509,21997,512,2.30000000
CN2706900000000,27,069,"Kittson County, MN",Jun-22,2185,2134,51,2.30000000
CN2707100000000,27,071,"Koochiching County, MN",Jun-22,5645,5438,207,3.70000000
CN2707300000000,27,073,"Lac qui Parle County, MN",Jun-22,3275,3200,75,2.30000000
CN2707500000000,27,075,"Lake County, MN",Jun-22,5553,5277,276,5.00000000
CN2707700000000,27,077,"Lake of the Woods County, MN",Jun-22,2384,2320,64,2.70000000
CN2707900000000,27,079,"Le Sueur County, MN",Jun-22,15929,15579,350,2.20000000
CN2708100000000,27,081,"Lincoln County, MN",Jun-22,2856,2795,61,2.10000000
CN2708300000000,27,083,"Lyon County, MN",Jun-22,13837,13539,298,2.20000000
CN2708500000000,27,085,"McLeod County, MN",Jun-22,18754,18323,431,2.30000000
CN2708700000000,27,087,"Mahnomen County, MN",Jun-22,2114,2031,83,3.90000000
CN2708900000000,27,089,"Marshall County, MN",Jun-22,5181,5052,129,2.50000000
CN2709100000000,27,091,"Martin County, MN",Jun-22,9280,9053,227,2.40000000
CN2709300000000,27,093,"Meeker County, MN",Jun-22,12960,12704,256,2.00000000
CN2709500000000,27,095,"Mille Lacs County, MN",Jun-22,12663,12334,329,2.60000000
CN2709700000000,27,097,"Morrison County, MN",Jun-22,17142,16683,459,2.70000000
CN2709900000000,27,099,"Mower County, MN",Jun-22,20306,19866,440,2.20000000
CN2710100000000,27,101,"Murray County, MN",Jun-22,4492,4399,93,2.10000000
CN2710300000000,27,103,"Nicollet County, MN",Jun-22,20430,20077,353,1.70000000
CN2710500000000,27,105,"Nobles County, MN",Jun-22,10872,10656,216,2.00000000
CN2710700000000,27,107,"Norman County, MN",Jun-22,3149,3058,91,2.90000000
CN2710900000000,27,109,"Olmsted County, MN",Jun-22,92381,90624,1757,1.90000000
CN2711100000000,27,111,"Otter Tail County, MN",Jun-22,31325,30662,663,2.10000000
CN2711300000000,27,113,"Pennington County, MN",Jun-22,8575,8383,192,2.20000000
CN2711500000000,27,115,"Pine County, MN",Jun-22,14018,13634,384,2.70000000
CN2711700000000,27,117,"Pipestone County, MN",Jun-22,4417,4338,79,1.80000000
CN2711900000000,27,119,"Polk County, MN",Jun-22,15670,15250,420,2.70000000
CN2712100000000,27,121,"Pope County, MN",Jun-22,6309,6202,107,1.70000000
CN2712300000000,27,123,"Ramsey County, MN",Jun-22,290792,283707,7085,2.40000000
CN2712500000000,27,125,"Red Lake County, MN",Jun-22,2142,2087,55,2.60000000
CN2712700000000,27,127,"Redwood County, MN",Jun-22,7370,7208,162,2.20000000
CN2712900000000,27,129,"Renville County, MN",Jun-22,7820,7588,232,3.00000000
CN2713100000000,27,131,"Rice County, MN",Jun-22,36799,36018,781,2.10000000
CN2713300000000,27,133,"Rock County, MN",Jun-22,5906,5823,83,1.40000000
CN2713500000000,27,135,"Roseau County, MN",Jun-22,7793,7624,169,2.20000000
CN2713700000000,27,137,"St. Louis County, MN",Jun-22,100578,97790,2788,2.80000000
CN2713900000000,27,139,"Scott County, MN",Jun-22,85864,84206,1658,1.90000000
CN2714100000000,27,141,"Sherburne County, MN",Jun-22,53826,52707,1119,2.10000000
CN2714300000000,27,143,"Sibley County, MN",Jun-22,8023,7844,179,2.20000000
CN2714500000000,27,145,"Stearns County, MN",Jun-22,89090,87130,1960,2.20000000
CN2714700000000,27,147,"Steele County, MN",Jun-22,19115,18670,445,2.30000000
CN2714900000000,27,149,"Stevens County, MN",Jun-22,5127,5039,88,1.70000000
CN2715100000000,27,151,"Swift County, MN",Jun-22,4598,4482,116,2.50000000
CN2715300000000,27,153,"Todd County, MN",Jun-22,12990,12685,305,2.30000000
CN2715500000000,27,155,"Traverse County, MN",Jun-22,1600,1572,28,1.80000000
CN2715700000000,27,157,"Wabasha County, MN",Jun-22,12151,11895,256,2.10000000
CN2715900000000,27,159,"Wadena County, MN",Jun-22,5821,5650,171,2.90000000
CN2716100000000,27,161,"Waseca County, MN",Jun-22,8553,8314,239,2.80000000
CN2716300000000,27,163,"Washington County, MN",Jun-22,147504,144584,2920,2.00000000
CN2716500000000,27,165,"Watonwan County, MN",Jun-22,6330,6190,140,2.20000000
CN2716700000000,27,167,"Wilkin County, MN",Jun-22,3251,3183,68,2.10000000
CN2716900000000,27,169,"Winona County, MN",Jun-22,26678,26122,556,2.10000000
CN2717100000000,27,171,"Wright County, MN",Jun-22,77563,76084,1479,1.90000000
CN2717300000000,27,173,"Yellow Medicine County, MN",Jun-22,4840,4725,115,2.40000000
CN2800100000000,28,001,"Adams County, MS",Jun-22,10612,9938,674,6.40000000
CN2800300000000,28,003,"Alcorn County, MS",Jun-22,15175,14588,587,3.90000000
CN2800500000000,28,005,"Amite County, MS",Jun-22,4499,4240,259,5.80000000
CN2800700000000,28,007,"Attala County, MS",Jun-22,7201,6869,332,4.60000000
CN2800900000000,28,009,"Benton County, MS",Jun-22,3167,2978,189,6.00000000
CN2801100000000,28,011,"Bolivar County, MS",Jun-22,11554,10887,667,5.80000000
CN2801300000000,28,013,"Calhoun County, MS",Jun-22,5646,5406,240,4.30000000
CN2801500000000,28,015,"Carroll County, MS",Jun-22,3609,3446,163,4.50000000
CN2801700000000,28,017,"Chickasaw County, MS",Jun-22,6936,6575,361,5.20000000
CN2801900000000,28,019,"Choctaw County, MS",Jun-22,3668,3523,145,4.00000000
CN2802100000000,28,021,"Claiborne County, MS",Jun-22,3006,2691,315,10.50000000
CN2802300000000,28,023,"Clarke County, MS",Jun-22,5671,5376,295,5.20000000
CN2802500000000,28,025,"Clay County, MS",Jun-22,8321,7892,429,5.20000000
CN2802700000000,28,027,"Coahoma County, MS",Jun-22,7957,7420,537,6.70000000
CN2802900000000,28,029,"Copiah County, MS",Jun-22,10826,10273,553,5.10000000
CN2803100000000,28,031,"Covington County, MS",Jun-22,8321,7989,332,4.00000000
CN2803300000000,28,033,"DeSoto County, MS",Jun-22,96095,92743,3352,3.50000000
CN2803500000000,28,035,"Forrest County, MS",Jun-22,33476,32039,1437,4.30000000
CN2803700000000,28,037,"Franklin County, MS",Jun-22,2695,2545,150,5.60000000
CN2803900000000,28,039,"George County, MS",Jun-22,8898,8341,557,6.30000000
CN2804100000000,28,041,"Greene County, MS",Jun-22,4303,3988,315,7.30000000
CN2804300000000,28,043,"Grenada County, MS",Jun-22,9349,8990,359,3.80000000
CN2804500000000,28,045,"Hancock County, MS",Jun-22,19367,18508,859,4.40000000
CN2804700000000,28,047,"Harrison County, MS",Jun-22,89286,85541,3745,4.20000000
CN2804900000000,28,049,"Hinds County, MS",Jun-22,101595,96748,4847,4.80000000
CN2805100000000,28,051,"Holmes County, MS",Jun-22,5094,4679,415,8.10000000
CN2805300000000,28,053,"Humphreys County, MS",Jun-22,2053,1863,190,9.30000000
CN2805500000000,28,055,"Issaquena County, MS",Jun-22,334,310,24,7.20000000
CN2805700000000,28,057,"Itawamba County, MS",Jun-22,10473,10087,386,3.70000000
CN2805900000000,28,059,"Jackson County, MS",Jun-22,60019,57077,2942,4.90000000
CN2806100000000,28,061,"Jasper County, MS",Jun-22,5893,5545,348,5.90000000
CN2806300000000,28,063,"Jefferson County, MS",Jun-22,1974,1646,328,16.60000000
CN2806500000000,28,065,"Jefferson Davis County, MS",Jun-22,3885,3653,232,6.00000000
CN2806700000000,28,067,"Jones County, MS",Jun-22,24877,23725,1152,4.60000000
CN2806900000000,28,069,"Kemper County, MS",Jun-22,3351,3113,238,7.10000000
CN2807100000000,28,071,"Lafayette County, MS",Jun-22,28277,27251,1026,3.60000000
CN2807300000000,28,073,"Lamar County, MS",Jun-22,31712,30648,1064,3.40000000
CN2807500000000,28,075,"Lauderdale County, MS",Jun-22,28991,27694,1297,4.50000000
CN2807700000000,28,077,"Lawrence County, MS",Jun-22,4748,4496,252,5.30000000
CN2807900000000,28,079,"Leake County, MS",Jun-22,8221,7852,369,4.50000000
CN2808100000000,28,081,"Lee County, MS",Jun-22,41402,39903,1499,3.60000000
CN2808300000000,28,083,"Leflore County, MS",Jun-22,10228,9611,617,6.00000000
CN2808500000000,28,085,"Lincoln County, MS",Jun-22,14939,14333,606,4.10000000
CN2808700000000,28,087,"Lowndes County, MS",Jun-22,25101,23919,1182,4.70000000
CN2808900000000,28,089,"Madison County, MS",Jun-22,53050,51150,1900,3.60000000
CN2809100000000,28,091,"Marion County, MS",Jun-22,10456,10038,418,4.00000000
CN2809300000000,28,093,"Marshall County, MS",Jun-22,14683,13989,694,4.70000000
CN2809500000000,28,095,"Monroe County, MS",Jun-22,16146,15476,670,4.10000000
CN2809700000000,28,097,"Montgomery County, MS",Jun-22,4017,3825,192,4.80000000
CN2809900000000,28,099,"Neshoba County, MS",Jun-22,10271,9777,494,4.80000000
CN2810100000000,28,101,"Newton County, MS",Jun-22,8425,7991,434,5.20000000
CN2810300000000,28,103,"Noxubee County, MS",Jun-22,3594,3333,261,7.30000000
CN2810500000000,28,105,"Oktibbeha County, MS",Jun-22,22473,21364,1109,4.90000000
CN2810700000000,28,107,"Panola County, MS",Jun-22,12775,12066,709,5.50000000
CN2810900000000,28,109,"Pearl River County, MS",Jun-22,23789,22763,1026,4.30000000
CN2811100000000,28,111,"Perry County, MS",Jun-22,4297,4062,235,5.50000000
CN2811300000000,28,113,"Pike County, MS",Jun-22,14576,13763,813,5.60000000
CN2811500000000,28,115,"Pontotoc County, MS",Jun-22,15114,14582,532,3.50000000
CN2811700000000,28,117,"Prentiss County, MS",Jun-22,11588,11189,399,3.40000000
CN2811900000000,28,119,"Quitman County, MS",Jun-22,2394,2229,165,6.90000000
CN2812100000000,28,121,"Rankin County, MS",Jun-22,75981,73568,2413,3.20000000
CN2812300000000,28,123,"Scott County, MS",Jun-22,12981,12288,693,5.30000000
CN2812500000000,28,125,"Sharkey County, MS",Jun-22,1434,1337,97,6.80000000
CN2812700000000,28,127,"Simpson County, MS",Jun-22,10595,10151,444,4.20000000
CN2812900000000,28,129,"Smith County, MS",Jun-22,6683,6414,269,4.00000000
CN2813100000000,28,131,"Stone County, MS",Jun-22,7069,6748,321,4.50000000
CN2813300000000,28,133,"Sunflower County, MS",Jun-22,7709,7192,517,6.70000000
CN2813500000000,28,135,"Tallahatchie County, MS",Jun-22,4742,4493,249,5.30000000
CN2813700000000,28,137,"Tate County, MS",Jun-22,12571,11996,575,4.60000000
CN2813900000000,28,139,"Tippah County, MS",Jun-22,9960,9591,369,3.70000000
CN2814100000000,28,141,"Tishomingo County, MS",Jun-22,8439,8097,342,4.10000000
CN2814300000000,28,143,"Tunica County, MS",Jun-22,4394,4128,266,6.10000000
CN2814500000000,28,145,"Union County, MS",Jun-22,14612,14141,471,3.20000000
CN2814700000000,28,147,"Walthall County, MS",Jun-22,4981,4706,275,5.50000000
CN2814900000000,28,149,"Warren County, MS",Jun-22,19522,18563,959,4.90000000
CN2815100000000,28,151,"Washington County, MS",Jun-22,15814,14806,1008,6.40000000
CN2815300000000,28,153,"Wayne County, MS",Jun-22,7538,7141,397,5.30000000
CN2815500000000,28,155,"Webster County, MS",Jun-22,3967,3795,172,4.30000000
CN2815700000000,28,157,"Wilkinson County, MS",Jun-22,2628,2432,196,7.50000000
CN2815900000000,28,159,"Winston County, MS",Jun-22,7212,6853,359,5.00000000
CN2816100000000,28,161,"Yalobusha County, MS",Jun-22,4885,4665,220,4.50000000
CN2816300000000,28,163,"Yazoo County, MS",Jun-22,9012,8512,500,5.50000000
CN2900100000000,29,001,"Adair County, MO",Jun-22,9849,9568,281,2.90000000
CN2900300000000,29,003,"Andrew County, MO",Jun-22,9671,9479,192,2.00000000
CN2900500000000,29,005,"Atchison County, MO",Jun-22,2797,2737,60,2.10000000
CN2900700000000,29,007,"Audrain County, MO",Jun-22,10246,9970,276,2.70000000
CN2900900000000,29,009,"Barry County, MO",Jun-22,14895,14532,363,2.40000000
CN2901100000000,29,011,"Barton County, MO",Jun-22,5430,5314,116,2.10000000
CN2901300000000,29,013,"Bates County, MO",Jun-22,7729,7542,187,2.40000000
CN2901500000000,29,015,"Benton County, MO",Jun-22,7426,7197,229,3.10000000
CN2901700000000,29,017,"Bollinger County, MO",Jun-22,5374,5249,125,2.30000000
CN2901900000000,29,019,"Boone County, MO",Jun-22,99107,97276,1831,1.80000000
CN2902100000000,29,021,"Buchanan County, MO",Jun-22,42902,41973,929,2.20000000
CN2902300000000,29,023,"Butler County, MO",Jun-22,18110,17602,508,2.80000000
CN2902500000000,29,025,"Caldwell County, MO",Jun-22,4321,4213,108,2.50000000
CN2902700000000,29,027,"Callaway County, MO",Jun-22,21262,20797,465,2.20000000
CN2902900000000,29,029,"Camden County, MO",Jun-22,20714,20220,494,2.40000000
CN2903100000000,29,031,"Cape Girardeau County, MO",Jun-22,40334,39449,885,2.20000000
CN2903300000000,29,033,"Carroll County, MO",Jun-22,4428,4320,108,2.40000000
CN2903500000000,29,035,"Carter County, MO",Jun-22,2620,2537,83,3.20000000
CN2903700000000,29,037,"Cass County, MO",Jun-22,54254,53089,1165,2.10000000
CN2903900000000,29,039,"Cedar County, MO",Jun-22,5886,5734,152,2.60000000
CN2904100000000,29,041,"Chariton County, MO",Jun-22,3880,3809,71,1.80000000
CN2904300000000,29,043,"Christian County, MO",Jun-22,46504,45644,860,1.80000000
CN2904500000000,29,045,"Clark County, MO",Jun-22,3171,3090,81,2.60000000
CN2904700000000,29,047,"Clay County, MO",Jun-22,136463,133341,3122,2.30000000
CN2904900000000,29,049,"Clinton County, MO",Jun-22,10603,10328,275,2.60000000
CN2905100000000,29,051,"Cole County, MO",Jun-22,38356,37663,693,1.80000000
CN2905300000000,29,053,"Cooper County, MO",Jun-22,7275,7121,154,2.10000000
CN2905500000000,29,055,"Crawford County, MO",Jun-22,11062,10788,274,2.50000000
CN2905700000000,29,057,"Dade County, MO",Jun-22,3646,3578,68,1.90000000
CN2905900000000,29,059,"Dallas County, MO",Jun-22,7231,7054,177,2.40000000
CN2906100000000,29,061,"Daviess County, MO",Jun-22,4318,4230,88,2.00000000
CN2906300000000,29,063,"DeKalb County, MO",Jun-22,4211,4109,102,2.40000000
CN2906500000000,29,065,"Dent County, MO",Jun-22,6344,6160,184,2.90000000
CN2906700000000,29,067,"Douglas County, MO",Jun-22,5222,5091,131,2.50000000
CN2906900000000,29,069,"Dunklin County, MO",Jun-22,11797,11377,420,3.60000000
CN2907100000000,29,071,"Franklin County, MO",Jun-22,52929,51817,1112,2.10000000
CN2907300000000,29,073,"Gasconade County, MO",Jun-22,7813,7656,157,2.00000000
CN2907500000000,29,075,"Gentry County, MO",Jun-22,3513,3435,78,2.20000000
CN2907700000000,29,077,"Greene County, MO",Jun-22,151951,149064,2887,1.90000000
CN2907900000000,29,079,"Grundy County, MO",Jun-22,4271,4174,97,2.30000000
CN2908100000000,29,081,"Harrison County, MO",Jun-22,3946,3874,72,1.80000000
CN2908300000000,29,083,"Henry County, MO",Jun-22,10285,10050,235,2.30000000
CN2908500000000,29,085,"Hickory County, MO",Jun-22,4236,4136,100,2.40000000
CN2908700000000,29,087,"Holt County, MO",Jun-22,2624,2576,48,1.80000000
CN2908900000000,29,089,"Howard County, MO",Jun-22,4800,4698,102,2.10000000
CN2909100000000,29,091,"Howell County, MO",Jun-22,16108,15649,459,2.80000000
CN2909300000000,29,093,"Iron County, MO",Jun-22,3516,3381,135,3.80000000
CN2909500000000,29,095,"Jackson County, MO",Jun-22,353930,344249,9681,2.70000000
CN2909700000000,29,097,"Jasper County, MO",Jun-22,57035,55796,1239,2.20000000
CN2909900000000,29,099,"Jefferson County, MO",Jun-22,117546,115023,2523,2.10000000
CN2910100000000,29,101,"Johnson County, MO",Jun-22,22913,22347,566,2.50000000
CN2910300000000,29,103,"Knox County, MO",Jun-22,1793,1754,39,2.20000000
CN2910500000000,29,105,"Laclede County, MO",Jun-22,16748,16377,371,2.20000000
CN2910700000000,29,107,"Lafayette County, MO",Jun-22,16755,16363,392,2.30000000
CN2910900000000,29,109,"Lawrence County, MO",Jun-22,17409,17026,383,2.20000000
CN2911100000000,29,111,"Lewis County, MO",Jun-22,4910,4819,91,1.90000000
CN2911300000000,29,113,"Lincoln County, MO",Jun-22,29326,28668,658,2.20000000
CN2911500000000,29,115,"Linn County, MO",Jun-22,5219,5091,128,2.50000000
CN2911700000000,29,117,"Livingston County, MO",Jun-22,7481,7357,124,1.70000000
CN2911900000000,29,119,"McDonald County, MO",Jun-22,10901,10632,269,2.50000000
CN2912100000000,29,121,"Macon County, MO",Jun-22,7393,7232,161,2.20000000
CN2912300000000,29,123,"Madison County, MO",Jun-22,5421,5275,146,2.70000000
CN2912500000000,29,125,"Maries County, MO",Jun-22,3962,3876,86,2.20000000
CN2912700000000,29,127,"Marion County, MO",Jun-22,14065,13763,302,2.10000000
CN2912900000000,29,129,"Mercer County, MO",Jun-22,1942,1909,33,1.70000000
CN2913100000000,29,131,"Miller County, MO",Jun-22,13120,12844,276,2.10000000
CN2913300000000,29,133,"Mississippi County, MO",Jun-22,5427,5260,167,3.10000000
CN2913500000000,29,135,"Moniteau County, MO",Jun-22,7133,6989,144,2.00000000
CN2913700000000,29,137,"Monroe County, MO",Jun-22,3893,3797,96,2.50000000
CN2913900000000,29,139,"Montgomery County, MO",Jun-22,5980,5853,127,2.10000000
CN2914100000000,29,141,"Morgan County, MO",Jun-22,8817,8604,213,2.40000000
CN2914300000000,29,143,"New Madrid County, MO",Jun-22,8570,8319,251,2.90000000
CN2914500000000,29,145,"Newton County, MO",Jun-22,27238,26605,633,2.30000000
CN2914700000000,29,147,"Nodaway County, MO",Jun-22,11069,10832,237,2.10000000
CN2914900000000,29,149,"Oregon County, MO",Jun-22,3766,3651,115,3.10000000
CN2915100000000,29,151,"Osage County, MO",Jun-22,7055,6931,124,1.80000000
CN2915300000000,29,153,"Ozark County, MO",Jun-22,3625,3521,104,2.90000000
CN2915500000000,29,155,"Pemiscot County, MO",Jun-22,5962,5709,253,4.20000000
CN2915700000000,29,157,"Perry County, MO",Jun-22,9725,9538,187,1.90000000
CN2915900000000,29,159,"Pettis County, MO",Jun-22,20026,19511,515,2.60000000
CN2916100000000,29,161,"Phelps County, MO",Jun-22,20004,19544,460,2.30000000
CN2916300000000,29,163,"Pike County, MO",Jun-22,7358,7194,164,2.20000000
CN2916500000000,29,165,"Platte County, MO",Jun-22,59059,57862,1197,2.00000000
CN2916700000000,29,167,"Polk County, MO",Jun-22,14696,14371,325,2.20000000
CN2916900000000,29,169,"Pulaski County, MO",Jun-22,14495,14102,393,2.70000000
CN2917100000000,29,171,"Putnam County, MO",Jun-22,2339,2300,39,1.70000000
CN2917300000000,29,173,"Ralls County, MO",Jun-22,5579,5471,108,1.90000000
CN2917500000000,29,175,"Randolph County, MO",Jun-22,10269,10031,238,2.30000000
CN2917700000000,29,177,"Ray County, MO",Jun-22,10799,10451,348,3.20000000
CN2917900000000,29,179,"Reynolds County, MO",Jun-22,3058,2980,78,2.60000000
CN2918100000000,29,181,"Ripley County, MO",Jun-22,5129,4976,153,3.00000000
CN2918300000000,29,183,"St. Charles County, MO",Jun-22,228719,224421,4298,1.90000000
CN2918500000000,29,185,"St. Clair County, MO",Jun-22,3948,3843,105,2.70000000
CN2918600000000,29,186,"Ste. Genevieve County, MO",Jun-22,9445,9240,205,2.20000000
CN2918700000000,29,187,"St. Francois County, MO",Jun-22,25798,25002,796,3.10000000
CN2918900000000,29,189,"St. Louis County, MO",Jun-22,525035,512824,12211,2.30000000
CN2919500000000,29,195,"Saline County, MO",Jun-22,10562,10326,236,2.20000000
CN2919700000000,29,197,"Schuyler County, MO",Jun-22,1877,1831,46,2.50000000
CN2919900000000,29,199,"Scotland County, MO",Jun-22,2448,2401,47,1.90000000
CN2920100000000,29,201,"Scott County, MO",Jun-22,20282,19793,489,2.40000000
CN2920300000000,29,203,"Shannon County, MO",Jun-22,3565,3449,116,3.30000000
CN2920500000000,29,205,"Shelby County, MO",Jun-22,3112,3053,59,1.90000000
CN2920700000000,29,207,"Stoddard County, MO",Jun-22,13570,13196,374,2.80000000
CN2920900000000,29,209,"Stone County, MO",Jun-22,14230,13825,405,2.80000000
CN2921100000000,29,211,"Sullivan County, MO",Jun-22,2639,2579,60,2.30000000
CN2921300000000,29,213,"Taney County, MO",Jun-22,27353,26506,847,3.10000000
CN2921500000000,29,215,"Texas County, MO",Jun-22,9295,9055,240,2.60000000
CN2921700000000,29,217,"Vernon County, MO",Jun-22,9389,9171,218,2.30000000
CN2921900000000,29,219,"Warren County, MO",Jun-22,18795,18392,403,2.10000000
CN2922100000000,29,221,"Washington County, MO",Jun-22,10196,9897,299,2.90000000
CN2922300000000,29,223,"Wayne County, MO",Jun-22,4838,4688,150,3.10000000
CN2922500000000,29,225,"Webster County, MO",Jun-22,17560,17204,356,2.00000000
CN2922700000000,29,227,"Worth County, MO",Jun-22,1265,1245,20,1.60000000
CN2922900000000,29,229,"Wright County, MO",Jun-22,7957,7755,202,2.50000000
CN2951000000000,29,510,"St. Louis city, MO",Jun-22,148731,143887,4844,3.30000000
CN3000100000000,30,001,"Beaverhead County, MT",Jun-22,5266,5132,134,2.50000000
CN3000300000000,30,003,"Big Horn County, MT",Jun-22,4759,4481,278,5.80000000
CN3000500000000,30,005,"Blaine County, MT",Jun-22,2149,2075,74,3.40000000
CN3000700000000,30,007,"Broadwater County, MT",Jun-22,2782,2686,96,3.50000000
CN3000900000000,30,009,"Carbon County, MT",Jun-22,5831,5658,173,3.00000000
CN3001100000000,30,011,"Carter County, MT",Jun-22,615,602,13,2.10000000
CN3001300000000,30,013,"Cascade County, MT",Jun-22,39154,38034,1120,2.90000000
CN3001500000000,30,015,"Chouteau County, MT",Jun-22,2415,2348,67,2.80000000
CN3001700000000,30,017,"Custer County, MT",Jun-22,6408,6238,170,2.70000000
CN3001900000000,30,019,"Daniels County, MT",Jun-22,867,852,15,1.70000000
CN3002100000000,30,021,"Dawson County, MT",Jun-22,4466,4338,128,2.90000000
CN3002300000000,30,023,"Deer Lodge County, MT",Jun-22,5530,5392,138,2.50000000
CN3002500000000,30,025,"Fallon County, MT",Jun-22,1648,1619,29,1.80000000
CN3002700000000,30,027,"Fergus County, MT",Jun-22,6043,5873,170,2.80000000
CN3002900000000,30,029,"Flathead County, MT",Jun-22,54230,52584,1646,3.00000000
CN3003100000000,30,031,"Gallatin County, MT",Jun-22,78487,76929,1558,2.00000000
CN3003300000000,30,033,"Garfield County, MT",Jun-22,698,676,22,3.20000000
CN3003500000000,30,035,"Glacier County, MT",Jun-22,5019,4602,417,8.30000000
CN3003700000000,30,037,"Golden Valley County, MT",Jun-22,372,359,13,3.50000000
CN3003900000000,30,039,"Granite County, MT",Jun-22,1717,1656,61,3.60000000
CN3004100000000,30,041,"Hill County, MT",Jun-22,7374,7141,233,3.20000000
CN3004300000000,30,043,"Jefferson County, MT",Jun-22,6099,5939,160,2.60000000
CN3004500000000,30,045,"Judith Basin County, MT",Jun-22,896,874,22,2.50000000
CN3004700000000,30,047,"Lake County, MT",Jun-22,14633,14192,441,3.00000000
CN3004900000000,30,049,"Lewis and Clark County, MT",Jun-22,38867,37848,1019,2.60000000
CN3005100000000,30,051,"Liberty County, MT",Jun-22,919,896,23,2.50000000
CN3005300000000,30,053,"Lincoln County, MT",Jun-22,9042,8587,455,5.00000000
CN3005500000000,30,055,"McCone County, MT",Jun-22,953,934,19,2.00000000
CN3005700000000,30,057,"Madison County, MT",Jun-22,4760,4644,116,2.40000000
CN3005900000000,30,059,"Meagher County, MT",Jun-22,951,926,25,2.60000000
CN3006100000000,30,061,"Mineral County, MT",Jun-22,1948,1852,96,4.90000000
CN3006300000000,30,063,"Missoula County, MT",Jun-22,68027,66132,1895,2.80000000
CN3006500000000,30,065,"Musselshell County, MT",Jun-22,2387,2320,67,2.80000000
CN3006700000000,30,067,"Park County, MT",Jun-22,10383,10102,281,2.70000000
CN3006900000000,30,069,"Petroleum County, MT",Jun-22,259,253,6,2.30000000
CN3007100000000,30,071,"Phillips County, MT",Jun-22,1815,1750,65,3.60000000
CN3007300000000,30,073,"Pondera County, MT",Jun-22,2653,2574,79,3.00000000
CN3007500000000,30,075,"Powder River County, MT",Jun-22,977,954,23,2.40000000
CN3007700000000,30,077,"Powell County, MT",Jun-22,3114,3030,84,2.70000000
CN3007900000000,30,079,"Prairie County, MT",Jun-22,493,481,12,2.40000000
CN3008100000000,30,081,"Ravalli County, MT",Jun-22,22364,21728,636,2.80000000
CN3008300000000,30,083,"Richland County, MT",Jun-22,5784,5592,192,3.30000000
CN3008500000000,30,085,"Roosevelt County, MT",Jun-22,4457,4269,188,4.20000000
CN3008700000000,30,087,"Rosebud County, MT",Jun-22,3785,3624,161,4.30000000
CN3008900000000,30,089,"Sanders County, MT",Jun-22,5445,5224,221,4.10000000
CN3009100000000,30,091,"Sheridan County, MT",Jun-22,1775,1739,36,2.00000000
CN3009300000000,30,093,"Silver Bow County, MT",Jun-22,18347,17774,573,3.10000000
CN3009500000000,30,095,"Stillwater County, MT",Jun-22,5485,5353,132,2.40000000
CN3009700000000,30,097,"Sweet Grass County, MT",Jun-22,2029,1990,39,1.90000000
CN3009900000000,30,099,"Teton County, MT",Jun-22,2795,2718,77,2.80000000
CN3010100000000,30,101,"Toole County, MT",Jun-22,2121,2074,47,2.20000000
CN3010300000000,30,103,"Treasure County, MT",Jun-22,331,322,9,2.70000000
CN3010500000000,30,105,"Valley County, MT",Jun-22,4086,3984,102,2.50000000
CN3010700000000,30,107,"Wheatland County, MT",Jun-22,712,686,26,3.70000000
CN3010900000000,30,109,"Wibaux County, MT",Jun-22,436,424,12,2.80000000
CN3011100000000,30,111,"Yellowstone County, MT",Jun-22,88193,85712,2481,2.80000000
CN3100100000000,31,001,"Adams County, NE",Jun-22,17327,16882,445,2.60000000
CN3100300000000,31,003,"Antelope County, NE",Jun-22,3736,3665,71,1.90000000
CN3100500000000,31,005,"Arthur County, NE",Jun-22,235,230,5,2.10000000
CN3100700000000,31,007,"Banner County, NE",Jun-22,392,381,11,2.80000000
CN3100900000000,31,009,"Blaine County, NE",Jun-22,257,247,10,3.90000000
CN3101100000000,31,011,"Boone County, NE",Jun-22,3015,2951,64,2.10000000
CN3101300000000,31,013,"Box Butte County, NE",Jun-22,5481,5329,152,2.80000000
CN3101500000000,31,015,"Boyd County, NE",Jun-22,1046,1021,25,2.40000000
CN3101700000000,31,017,"Brown County, NE",Jun-22,1450,1406,44,3.00000000
CN3101900000000,31,019,"Buffalo County, NE",Jun-22,28147,27493,654,2.30000000
CN3102100000000,31,021,"Burt County, NE",Jun-22,3680,3587,93,2.50000000
CN3102300000000,31,023,"Butler County, NE",Jun-22,4734,4639,95,2.00000000
CN3102500000000,31,025,"Cass County, NE",Jun-22,13913,13543,370,2.70000000
CN3102700000000,31,027,"Cedar County, NE",Jun-22,4849,4745,104,2.10000000
CN3102900000000,31,029,"Chase County, NE",Jun-22,2300,2252,48,2.10000000
CN3103100000000,31,031,"Cherry County, NE",Jun-22,3576,3509,67,1.90000000
CN3103300000000,31,033,"Cheyenne County, NE",Jun-22,4259,4138,121,2.80000000
CN3103500000000,31,035,"Clay County, NE",Jun-22,3331,3254,77,2.30000000
CN3103700000000,31,037,"Colfax County, NE",Jun-22,5857,5730,127,2.20000000
CN3103900000000,31,039,"Cuming County, NE",Jun-22,5088,4985,103,2.00000000
CN3104100000000,31,041,"Custer County, NE",Jun-22,6569,6442,127,1.90000000
CN3104300000000,31,043,"Dakota County, NE",Jun-22,11061,10727,334,3.00000000
CN3104500000000,31,045,"Dawes County, NE",Jun-22,5110,4980,130,2.50000000
CN3104700000000,31,047,"Dawson County, NE",Jun-22,13753,13408,345,2.50000000
CN3104900000000,31,049,"Deuel County, NE",Jun-22,1019,994,25,2.50000000
CN3105100000000,31,051,"Dixon County, NE",Jun-22,3039,2972,67,2.20000000
CN3105300000000,31,053,"Dodge County, NE",Jun-22,20837,20346,491,2.40000000
CN3105500000000,31,055,"Douglas County, NE",Jun-22,311265,302513,8752,2.80000000
CN3105700000000,31,057,"Dundy County, NE",Jun-22,1152,1133,19,1.60000000
CN3105900000000,31,059,"Fillmore County, NE",Jun-22,3395,3324,71,2.10000000
CN3106100000000,31,061,"Franklin County, NE",Jun-22,1543,1505,38,2.50000000
CN3106300000000,31,063,"Frontier County, NE",Jun-22,1577,1544,33,2.10000000
CN3106500000000,31,065,"Furnas County, NE",Jun-22,2657,2598,59,2.20000000
CN3106700000000,31,067,"Gage County, NE",Jun-22,11277,10980,297,2.60000000
CN3106900000000,31,069,"Garden County, NE",Jun-22,1173,1148,25,2.10000000
CN3107100000000,31,071,"Garfield County, NE",Jun-22,1196,1164,32,2.70000000
CN3107300000000,31,073,"Gosper County, NE",Jun-22,1239,1214,25,2.00000000
CN3107500000000,31,075,"Grant County, NE",Jun-22,425,418,7,1.60000000
CN3107700000000,31,077,"Greeley County, NE",Jun-22,1280,1251,29,2.30000000
CN3107900000000,31,079,"Hall County, NE",Jun-22,32391,31548,843,2.60000000
CN3108100000000,31,081,"Hamilton County, NE",Jun-22,4866,4748,118,2.40000000
CN3108300000000,31,083,"Harlan County, NE",Jun-22,1872,1835,37,2.00000000
CN3108500000000,31,085,"Hayes County, NE",Jun-22,624,614,10,1.60000000
CN3108700000000,31,087,"Hitchcock County, NE",Jun-22,1357,1324,33,2.40000000
CN3108900000000,31,089,"Holt County, NE",Jun-22,5811,5695,116,2.00000000
CN3109100000000,31,091,"Hooker County, NE",Jun-22,474,463,11,2.30000000
CN3109300000000,31,093,"Howard County, NE",Jun-22,3439,3360,79,2.30000000
CN3109500000000,31,095,"Jefferson County, NE",Jun-22,4226,4137,89,2.10000000
CN3109700000000,31,097,"Johnson County, NE",Jun-22,2053,1995,58,2.80000000
CN3109900000000,31,099,"Kearney County, NE",Jun-22,3865,3786,79,2.00000000
CN3110100000000,31,101,"Keith County, NE",Jun-22,4941,4842,99,2.00000000
CN3110300000000,31,103,"Keya Paha County, NE",Jun-22,592,580,12,2.00000000
CN3110500000000,31,105,"Kimball County, NE",Jun-22,1991,1951,40,2.00000000
CN3110700000000,31,107,"Knox County, NE",Jun-22,4829,4714,115,2.40000000
CN3110900000000,31,109,"Lancaster County, NE",Jun-22,182955,178514,4441,2.40000000
CN3111100000000,31,111,"Lincoln County, NE",Jun-22,18876,18405,471,2.50000000
CN3111300000000,31,113,"Logan County, NE",Jun-22,487,476,11,2.30000000
CN3111500000000,31,115,"Loup County, NE",Jun-22,424,412,12,2.80000000
CN3111700000000,31,117,"McPherson County, NE",Jun-22,429,421,8,1.90000000
CN3111900000000,31,119,"Madison County, NE",Jun-22,20142,19665,477,2.40000000
CN3112100000000,31,121,"Merrick County, NE",Jun-22,4141,4045,96,2.30000000
CN3112300000000,31,123,"Morrill County, NE",Jun-22,2706,2647,59,2.20000000
CN3112500000000,31,125,"Nance County, NE",Jun-22,1999,1950,49,2.50000000
CN3112700000000,31,127,"Nemaha County, NE",Jun-22,3628,3532,96,2.60000000
CN3112900000000,31,129,"Nuckolls County, NE",Jun-22,2535,2475,60,2.40000000
CN3113100000000,31,131,"Otoe County, NE",Jun-22,8771,8544,227,2.60000000
CN3113300000000,31,133,"Pawnee County, NE",Jun-22,1551,1519,32,2.10000000
CN3113500000000,31,135,"Perkins County, NE",Jun-22,1894,1861,33,1.70000000
CN3113700000000,31,137,"Phelps County, NE",Jun-22,5087,4972,115,2.30000000
CN3113900000000,31,139,"Pierce County, NE",Jun-22,4254,4165,89,2.10000000
CN3114100000000,31,141,"Platte County, NE",Jun-22,18758,18332,426,2.30000000
CN3114300000000,31,143,"Polk County, NE",Jun-22,3010,2948,62,2.10000000
CN3114500000000,31,145,"Red Willow County, NE",Jun-22,6021,5878,143,2.40000000
CN3114700000000,31,147,"Richardson County, NE",Jun-22,4368,4268,100,2.30000000
CN3114900000000,31,149,"Rock County, NE",Jun-22,905,889,16,1.80000000
CN3115100000000,31,151,"Saline County, NE",Jun-22,7392,7195,197,2.70000000
CN3115300000000,31,153,"Sarpy County, NE",Jun-22,101411,98939,2472,2.40000000
CN3115500000000,31,155,"Saunders County, NE",Jun-22,11770,11506,264,2.20000000
CN3115700000000,31,157,"Scotts Bluff County, NE",Jun-22,18218,17684,534,2.90000000
CN3115900000000,31,159,"Seward County, NE",Jun-22,9064,8811,253,2.80000000
CN3116100000000,31,161,"Sheridan County, NE",Jun-22,2837,2774,63,2.20000000
CN3116300000000,31,163,"Sherman County, NE",Jun-22,1725,1680,45,2.60000000
CN3116500000000,31,165,"Sioux County, NE",Jun-22,785,770,15,1.90000000
CN3116700000000,31,167,"Stanton County, NE",Jun-22,3675,3598,77,2.10000000
CN3116900000000,31,169,"Thayer County, NE",Jun-22,2771,2716,55,2.00000000
CN3117100000000,31,171,"Thomas County, NE",Jun-22,429,419,10,2.30000000
CN3117300000000,31,173,"Thurston County, NE",Jun-22,3249,3117,132,4.10000000
CN3117500000000,31,175,"Valley County, NE",Jun-22,2208,2152,56,2.50000000
CN3117700000000,31,177,"Washington County, NE",Jun-22,11684,11400,284,2.40000000
CN3117900000000,31,179,"Wayne County, NE",Jun-22,5541,5381,160,2.90000000
CN3118100000000,31,181,"Webster County, NE",Jun-22,1701,1657,44,2.60000000
CN3118300000000,31,183,"Wheeler County, NE",Jun-22,573,565,8,1.40000000
CN3118500000000,31,185,"York County, NE",Jun-22,7523,7328,195,2.60000000
CN3200100000000,32,001,"Churchill County, NV",Jun-22,11050,10674,376,3.40000000
CN3200300000000,32,003,"Clark County, NV",Jun-22,1122290,1058380,63910,5.70000000
CN3200500000000,32,005,"Douglas County, NV",Jun-22,21509,20644,865,4.00000000
CN3200700000000,32,007,"Elko County, NV",Jun-22,26019,25202,817,3.10000000
CN3200900000000,32,009,"Esmeralda County, NV",Jun-22,407,395,12,2.90000000
CN3201100000000,32,011,"Eureka County, NV",Jun-22,974,946,28,2.90000000
CN3201300000000,32,013,"Humboldt County, NV",Jun-22,7879,7632,247,3.10000000
CN3201500000000,32,015,"Lander County, NV",Jun-22,3089,2991,98,3.20000000
CN3201700000000,32,017,"Lincoln County, NV",Jun-22,2108,2026,82,3.90000000
CN3201900000000,32,019,"Lyon County, NV",Jun-22,23578,22515,1063,4.50000000
CN3202100000000,32,021,"Mineral County, NV",Jun-22,2041,1967,74,3.60000000
CN3202300000000,32,023,"Nye County, NV",Jun-22,17372,16433,939,5.40000000
CN3202700000000,32,027,"Pershing County, NV",Jun-22,2448,2353,95,3.90000000
CN3202900000000,32,029,"Storey County, NV",Jun-22,2079,1994,85,4.10000000
CN3203100000000,32,031,"Washoe County, NV",Jun-22,254042,245656,8386,3.30000000
CN3203300000000,32,033,"White Pine County, NV",Jun-22,4602,4471,131,2.80000000
CN3251000000000,32,510,"Carson City, NV",Jun-22,25630,24670,960,3.70000000
CN3300100000000,33,001,"Belknap County, NH",Jun-22,32411,31791,620,1.90000000
CN3300300000000,33,003,"Carroll County, NH",Jun-22,23503,23030,473,2.00000000
CN3300500000000,33,005,"Cheshire County, NH",Jun-22,38773,37879,894,2.30000000
CN3300700000000,33,007,"Coos County, NH",Jun-22,14440,14104,336,2.30000000
CN3300900000000,33,009,"Grafton County, NH",Jun-22,48318,47345,973,2.00000000
CN3301100000000,33,011,"Hillsborough County, NH",Jun-22,244739,239824,4915,2.00000000
CN3301300000000,33,013,"Merrimack County, NH",Jun-22,82682,81134,1548,1.90000000
CN3301500000000,33,015,"Rockingham County, NH",Jun-22,191048,187298,3750,2.00000000
CN3301700000000,33,017,"Strafford County, NH",Jun-22,73691,72223,1468,2.00000000
CN3301900000000,33,019,"Sullivan County, NH",Jun-22,22891,22436,455,2.00000000
CN3400100000000,34,001,"Atlantic County, NJ",Jun-22,130059,123726,6333,4.90000000
CN3400300000000,34,003,"Bergen County, NJ",Jun-22,492225,475365,16860,3.40000000
CN3400500000000,34,005,"Burlington County, NJ",Jun-22,245010,237486,7524,3.10000000
CN3400700000000,34,007,"Camden County, NJ",Jun-22,268471,257788,10683,4.00000000
CN3400900000000,34,009,"Cape May County, NJ",Jun-22,54045,51690,2355,4.40000000
CN3401100000000,34,011,"Cumberland County, NJ",Jun-22,66726,63457,3269,4.90000000
CN3401300000000,34,013,"Essex County, NJ",Jun-22,383787,365742,18045,4.70000000
CN3401500000000,34,015,"Gloucester County, NJ",Jun-22,159777,154162,5615,3.50000000
CN3401700000000,34,017,"Hudson County, NJ",Jun-22,369005,354933,14072,3.80000000
CN3401900000000,34,019,"Hunterdon County, NJ",Jun-22,66864,65058,1806,2.70000000
CN3402100000000,34,021,"Mercer County, NJ",Jun-22,207776,201268,6508,3.10000000
CN3402300000000,34,023,"Middlesex County, NJ",Jun-22,456777,441881,14896,3.30000000
CN3402500000000,34,025,"Monmouth County, NJ",Jun-22,342309,331681,10628,3.10000000
CN3402700000000,34,027,"Morris County, NJ",Jun-22,264639,257058,7581,2.90000000
CN3402900000000,34,029,"Ocean County, NJ",Jun-22,293422,283244,10178,3.50000000
CN3403100000000,34,031,"Passaic County, NJ",Jun-22,247421,235587,11834,4.80000000
CN3403300000000,34,033,"Salem County, NJ",Jun-22,29235,27854,1381,4.70000000
CN3403500000000,34,035,"Somerset County, NJ",Jun-22,176598,171407,5191,2.90000000
CN3403700000000,34,037,"Sussex County, NJ",Jun-22,76229,73622,2607,3.40000000
CN3403900000000,34,039,"Union County, NJ",Jun-22,285769,274715,11054,3.90000000
CN3404100000000,34,041,"Warren County, NJ",Jun-22,57900,55984,1916,3.30000000
CN3500100000000,35,001,"Bernalillo County, NM",Jun-22,337760,322819,14941,4.40000000
CN3500300000000,35,003,"Catron County, NM",Jun-22,1109,1049,60,5.40000000
CN3500500000000,35,005,"Chaves County, NM",Jun-22,26816,25298,1518,5.70000000
CN3500600000000,35,006,"Cibola County, NM",Jun-22,8941,8362,579,6.50000000
CN3500700000000,35,007,"Colfax County, NM",Jun-22,5135,4891,244,4.80000000
CN3500900000000,35,009,"Curry County, NM",Jun-22,21398,20573,825,3.90000000
CN3501100000000,35,011,"De Baca County, NM",Jun-22,670,646,24,3.60000000
CN3501300000000,35,013,"Dona Ana County, NM",Jun-22,100073,94747,5326,5.30000000
CN3501500000000,35,015,"Eddy County, NM",Jun-22,31840,30518,1322,4.20000000
CN3501700000000,35,017,"Grant County, NM",Jun-22,11557,10979,578,5.00000000
CN3501900000000,35,019,"Guadalupe County, NM",Jun-22,1711,1604,107,6.30000000
CN3502100000000,35,021,"Harding County, NM",Jun-22,284,275,9,3.20000000
CN3502300000000,35,023,"Hidalgo County, NM",Jun-22,1820,1748,72,4.00000000
CN3502500000000,35,025,"Lea County, NM",Jun-22,27869,26034,1835,6.60000000
CN3502700000000,35,027,"Lincoln County, NM",Jun-22,8444,7995,449,5.30000000
CN3502800000000,35,028,"Los Alamos County, NM",Jun-22,10205,9955,250,2.40000000
CN3502900000000,35,029,"Luna County, NM",Jun-22,9951,8812,1139,11.40000000
CN3503100000000,35,031,"McKinley County, NM",Jun-22,24697,23000,1697,6.90000000
CN3503300000000,35,033,"Mora County, NM",Jun-22,2058,1924,134,6.50000000
CN3503500000000,35,035,"Otero County, NM",Jun-22,25357,24084,1273,5.00000000
CN3503700000000,35,037,"Quay County, NM",Jun-22,2934,2782,152,5.20000000
CN3503900000000,35,039,"Rio Arriba County, NM",Jun-22,16752,15851,901,5.40000000
CN3504100000000,35,041,"Roosevelt County, NM",Jun-22,8349,7977,372,4.50000000
CN3504300000000,35,043,"Sandoval County, NM",Jun-22,68425,65162,3263,4.80000000
CN3504500000000,35,045,"San Juan County, NM",Jun-22,48880,45892,2988,6.10000000
CN3504700000000,35,047,"San Miguel County, NM",Jun-22,10808,10168,640,5.90000000
CN3504900000000,35,049,"Santa Fe County, NM",Jun-22,74124,70984,3140,4.20000000
CN3505100000000,35,051,"Sierra County, NM",Jun-22,4129,3873,256,6.20000000
CN3505300000000,35,053,"Socorro County, NM",Jun-22,6070,5763,307,5.10000000
CN3505500000000,35,055,"Taos County, NM",Jun-22,13969,13052,917,6.60000000
CN3505700000000,35,057,"Torrance County, NM",Jun-22,5446,5086,360,6.60000000
CN3505900000000,35,059,"Union County, NM",Jun-22,1548,1498,50,3.20000000
CN3506100000000,35,061,"Valencia County, NM",Jun-22,31294,29629,1665,5.30000000
CN3600100000000,36,001,"Albany County, NY",Jun-22,161078,156212,4866,3.00000000
CN3600300000000,36,003,"Allegany County, NY",Jun-22,19311,18608,703,3.60000000
CN3600500000000,36,005,"Bronx County, NY",Jun-22,586032,537350,48682,8.30000000
CN3600700000000,36,007,"Broome County, NY",Jun-22,83859,80760,3099,3.70000000
CN3600900000000,36,009,"Cattaraugus County, NY",Jun-22,33253,32010,1243,3.70000000
CN3601100000000,36,011,"Cayuga County, NY",Jun-22,35834,34702,1132,3.20000000
CN3601300000000,36,013,"Chautauqua County, NY",Jun-22,53510,51538,1972,3.70000000
CN3601500000000,36,015,"Chemung County, NY",Jun-22,35305,34033,1272,3.60000000
CN3601700000000,36,017,"Chenango County, NY",Jun-22,22320,21665,655,2.90000000
CN3601900000000,36,019,"Clinton County, NY",Jun-22,35399,34266,1133,3.20000000
CN3602100000000,36,021,"Columbia County, NY",Jun-22,30771,29960,811,2.60000000
CN3602300000000,36,023,"Cortland County, NY",Jun-22,22062,21268,794,3.60000000
CN3602500000000,36,025,"Delaware County, NY",Jun-22,19025,18371,654,3.40000000
CN3602700000000,36,027,"Dutchess County, NY",Jun-22,147244,142782,4462,3.00000000
CN3602900000000,36,029,"Erie County, NY",Jun-22,451771,435754,16017,3.50000000
CN3603100000000,36,031,"Essex County, NY",Jun-22,17400,16889,511,2.90000000
CN3603300000000,36,033,"Franklin County, NY",Jun-22,19522,18896,626,3.20000000
CN3603500000000,36,035,"Fulton County, NY",Jun-22,22977,22122,855,3.70000000
CN3603700000000,36,037,"Genesee County, NY",Jun-22,30645,29790,855,2.80000000
CN3603900000000,36,039,"Greene County, NY",Jun-22,20483,19807,676,3.30000000
CN3604100000000,36,041,"Hamilton County, NY",Jun-22,2476,2405,71,2.90000000
CN3604300000000,36,043,"Herkimer County, NY",Jun-22,27782,26772,1010,3.60000000
CN3604500000000,36,045,"Jefferson County, NY",Jun-22,45626,44060,1566,3.40000000
CN3604700000000,36,047,"Kings County, NY",Jun-22,1171436,1098897,72539,6.20000000
CN3604900000000,36,049,"Lewis County, NY",Jun-22,12021,11637,384,3.20000000
CN3605100000000,36,051,"Livingston County, NY",Jun-22,30340,29414,926,3.10000000
CN3605300000000,36,053,"Madison County, NY",Jun-22,33006,31991,1015,3.10000000
CN3605500000000,36,055,"Monroe County, NY",Jun-22,366340,353554,12786,3.50000000
CN3605700000000,36,057,"Montgomery County, NY",Jun-22,22389,21523,866,3.90000000
CN3605900000000,36,059,"Nassau County, NY",Jun-22,738465,717389,21076,2.90000000
CN3606100000000,36,061,"New York County, NY",Jun-22,889721,847027,42694,4.80000000
CN3606300000000,36,063,"Niagara County, NY",Jun-22,99551,95955,3596,3.60000000
CN3606500000000,36,065,"Oneida County, NY",Jun-22,101870,98357,3513,3.40000000
CN3606700000000,36,067,"Onondaga County, NY",Jun-22,225648,218227,7421,3.30000000
CN3606900000000,36,069,"Ontario County, NY",Jun-22,55985,54356,1629,2.90000000
CN3607100000000,36,071,"Orange County, NY",Jun-22,191486,185438,6048,3.20000000
CN3607300000000,36,073,"Orleans County, NY",Jun-22,17201,16563,638,3.70000000
CN3607500000000,36,075,"Oswego County, NY",Jun-22,53224,51097,2127,4.00000000
CN3607700000000,36,077,"Otsego County, NY",Jun-22,27853,27006,847,3.00000000
CN3607900000000,36,079,"Putnam County, NY",Jun-22,52240,50747,1493,2.90000000
CN3608100000000,36,081,"Queens County, NY",Jun-22,1106676,1044288,62388,5.60000000
CN3608300000000,36,083,"Rensselaer County, NY",Jun-22,83014,80573,2441,2.90000000
CN3608500000000,36,085,"Richmond County, NY",Jun-22,219409,207055,12354,5.60000000
CN3608700000000,36,087,"Rockland County, NY",Jun-22,160329,155837,4492,2.80000000
CN3608900000000,36,089,"St. Lawrence County, NY",Jun-22,42837,41116,1721,4.00000000
CN3609100000000,36,091,"Saratoga County, NY",Jun-22,122866,119736,3130,2.50000000
CN3609300000000,36,093,"Schenectady County, NY",Jun-22,78743,76156,2587,3.30000000
CN3609500000000,36,095,"Schoharie County, NY",Jun-22,14875,14402,473,3.20000000
CN3609700000000,36,097,"Schuyler County, NY",Jun-22,8387,8123,264,3.10000000
CN3609900000000,36,099,"Seneca County, NY",Jun-22,15685,15235,450,2.90000000
CN3610100000000,36,101,"Steuben County, NY",Jun-22,42348,40955,1393,3.30000000
CN3610300000000,36,103,"Suffolk County, NY",Jun-22,809497,785400,24097,3.00000000
CN3610500000000,36,105,"Sullivan County, NY",Jun-22,38852,37684,1168,3.00000000
CN3610700000000,36,107,"Tioga County, NY",Jun-22,22626,21961,665,2.90000000
CN3610900000000,36,109,"Tompkins County, NY",Jun-22,48660,47309,1351,2.80000000
CN3611100000000,36,111,"Ulster County, NY",Jun-22,89477,86778,2699,3.00000000
CN3611300000000,36,113,"Warren County, NY",Jun-22,32501,31523,978,3.00000000
CN3611500000000,36,115,"Washington County, NY",Jun-22,28626,27781,845,3.00000000
CN3611700000000,36,117,"Wayne County, NY",Jun-22,43512,42190,1322,3.00000000
CN3611900000000,36,119,"Westchester County, NY",Jun-22,499914,484246,15668,3.10000000
CN3612100000000,36,121,"Wyoming County, NY",Jun-22,18475,17976,499,2.70000000
CN3612300000000,36,123,"Yates County, NY",Jun-22,11676,11371,305,2.60000000
CN3700100000000,37,001,"Alamance County, NC",Jun-22,83020,79583,3437,4.10000000
CN3700300000000,37,003,"Alexander County, NC",Jun-22,17914,17273,641,3.60000000
CN3700500000000,37,005,"Alleghany County, NC",Jun-22,4433,4252,181,4.10000000
CN3700700000000,37,007,"Anson County, NC",Jun-22,10187,9644,543,5.30000000
CN3700900000000,37,009,"Ashe County, NC",Jun-22,13139,12638,501,3.80000000
CN3701100000000,37,011,"Avery County, NC",Jun-22,7847,7567,280,3.60000000
CN3701300000000,37,013,"Beaufort County, NC",Jun-22,20094,19240,854,4.30000000
CN3701500000000,37,015,"Bertie County, NC",Jun-22,7360,6963,397,5.40000000
CN3701700000000,37,017,"Bladen County, NC",Jun-22,14128,13419,709,5.00000000
CN3701900000000,37,019,"Brunswick County, NC",Jun-22,58187,55194,2993,5.10000000
CN3702100000000,37,021,"Buncombe County, NC",Jun-22,141501,136819,4682,3.30000000
CN3702300000000,37,023,"Burke County, NC",Jun-22,40645,39085,1560,3.80000000
CN3702500000000,37,025,"Cabarrus County, NC",Jun-22,115562,111315,4247,3.70000000
CN3702700000000,37,027,"Caldwell County, NC",Jun-22,36227,34756,1471,4.10000000
CN3702900000000,37,029,"Camden County, NC",Jun-22,4651,4473,178,3.80000000
CN3703100000000,37,031,"Carteret County, NC",Jun-22,33092,31889,1203,3.60000000
CN3703300000000,37,033,"Caswell County, NC",Jun-22,9803,9374,429,4.40000000
CN3703500000000,37,035,"Catawba County, NC",Jun-22,78937,75922,3015,3.80000000
CN3703700000000,37,037,"Chatham County, NC",Jun-22,37965,36681,1284,3.40000000
CN3703900000000,37,039,"Cherokee County, NC",Jun-22,11034,10528,506,4.60000000
CN3704100000000,37,041,"Chowan County, NC",Jun-22,5771,5514,257,4.50000000
CN3704300000000,37,043,"Clay County, NC",Jun-22,4002,3818,184,4.60000000
CN3704500000000,37,045,"Cleveland County, NC",Jun-22,48632,46514,2118,4.40000000
CN3704700000000,37,047,"Columbus County, NC",Jun-22,23373,22176,1197,5.10000000
CN3704900000000,37,049,"Craven County, NC",Jun-22,41754,40061,1693,4.10000000
CN3705100000000,37,051,"Cumberland County, NC",Jun-22,129305,121659,7646,5.90000000
CN3705300000000,37,053,"Currituck County, NC",Jun-22,14633,14109,524,3.60000000
CN3705500000000,37,055,"Dare County, NC",Jun-22,22657,21818,839,3.70000000
CN3705700000000,37,057,"Davidson County, NC",Jun-22,80913,77774,3139,3.90000000
CN3705900000000,37,059,"Davie County, NC",Jun-22,20626,19861,765,3.70000000
CN3706100000000,37,061,"Duplin County, NC",Jun-22,24374,23380,994,4.10000000
CN3706300000000,37,063,"Durham County, NC",Jun-22,181120,174882,6238,3.40000000
CN3706500000000,37,065,"Edgecombe County, NC",Jun-22,20199,18597,1602,7.90000000
CN3706700000000,37,067,"Forsyth County, NC",Jun-22,187429,179656,7773,4.10000000
CN3706900000000,37,069,"Franklin County, NC",Jun-22,33654,32292,1362,4.00000000
CN3707100000000,37,071,"Gaston County, NC",Jun-22,114349,109620,4729,4.10000000
CN3707300000000,37,073,"Gates County, NC",Jun-22,5118,4924,194,3.80000000
CN3707500000000,37,075,"Graham County, NC",Jun-22,3098,2921,177,5.70000000
CN3707700000000,37,077,"Granville County, NC",Jun-22,30471,29416,1055,3.50000000
CN3707900000000,37,079,"Greene County, NC",Jun-22,9440,9110,330,3.50000000
CN3708100000000,37,081,"Guilford County, NC",Jun-22,260896,248831,12065,4.60000000
CN3708300000000,37,083,"Halifax County, NC",Jun-22,19225,17968,1257,6.50000000
CN3708500000000,37,085,"Harnett County, NC",Jun-22,54694,52176,2518,4.60000000
CN3708700000000,37,087,"Haywood County, NC",Jun-22,30086,29025,1061,3.50000000
CN3708900000000,37,089,"Henderson County, NC",Jun-22,55366,53413,1953,3.50000000
CN3709100000000,37,091,"Hertford County, NC",Jun-22,8509,8014,495,5.80000000
CN3709300000000,37,093,"Hoke County, NC",Jun-22,20514,19379,1135,5.50000000
CN3709500000000,37,095,"Hyde County, NC",Jun-22,1974,1876,98,5.00000000
CN3709700000000,37,097,"Iredell County, NC",Jun-22,94285,90757,3528,3.70000000
CN3709900000000,37,099,"Jackson County, NC",Jun-22,19473,18657,816,4.20000000
CN3710100000000,37,101,"Johnston County, NC",Jun-22,106966,103055,3911,3.70000000
CN3710300000000,37,103,"Jones County, NC",Jun-22,4294,4139,155,3.60000000
CN3710500000000,37,105,"Lee County, NC",Jun-22,26309,25120,1189,4.50000000
CN3710700000000,37,107,"Lenoir County, NC",Jun-22,27228,26119,1109,4.10000000
CN3710900000000,37,109,"Lincoln County, NC",Jun-22,46243,44636,1607,3.50000000
CN3711100000000,37,111,"McDowell County, NC",Jun-22,20054,19273,781,3.90000000
CN3711300000000,37,113,"Macon County, NC",Jun-22,15924,15324,600,3.80000000
CN3711500000000,37,115,"Madison County, NC",Jun-22,10047,9669,378,3.80000000
CN3711700000000,37,117,"Martin County, NC",Jun-22,8619,8202,417,4.80000000
CN3711900000000,37,119,"Mecklenburg County, NC",Jun-22,649807,624665,25142,3.90000000
CN3712100000000,37,121,"Mitchell County, NC",Jun-22,5973,5699,274,4.60000000
CN3712300000000,37,123,"Montgomery County, NC",Jun-22,11522,11056,466,4.00000000
CN3712500000000,37,125,"Moore County, NC",Jun-22,41281,39572,1709,4.10000000
CN3712700000000,37,127,"Nash County, NC",Jun-22,41923,39483,2440,5.80000000
CN3712900000000,37,129,"New Hanover County, NC",Jun-22,127296,122700,4596,3.60000000
CN3713100000000,37,131,"Northampton County, NC",Jun-22,7208,6834,374,5.20000000
CN3713300000000,37,133,"Onslow County, NC",Jun-22,67523,64343,3180,4.70000000
CN3713500000000,37,135,"Orange County, NC",Jun-22,82539,79820,2719,3.30000000
CN3713700000000,37,137,"Pamlico County, NC",Jun-22,5465,5245,220,4.00000000
CN3713900000000,37,139,"Pasquotank County, NC",Jun-22,16642,15838,804,4.80000000
CN3714100000000,37,141,"Pender County, NC",Jun-22,30279,29123,1156,3.80000000
CN3714300000000,37,143,"Perquimans County, NC",Jun-22,4968,4726,242,4.90000000
CN3714500000000,37,145,"Person County, NC",Jun-22,19060,18285,775,4.10000000
CN3714700000000,37,147,"Pitt County, NC",Jun-22,88156,84132,4024,4.60000000
CN3714900000000,37,149,"Polk County, NC",Jun-22,9400,9012,388,4.10000000
CN3715100000000,37,151,"Randolph County, NC",Jun-22,65424,62832,2592,4.00000000
CN3715300000000,37,153,"Richmond County, NC",Jun-22,16609,15592,1017,6.10000000
CN3715500000000,37,155,"Robeson County, NC",Jun-22,48561,45378,3183,6.60000000
CN3715700000000,37,157,"Rockingham County, NC",Jun-22,39576,37760,1816,4.60000000
CN3715900000000,37,159,"Rowan County, NC",Jun-22,67580,64846,2734,4.00000000
CN3716100000000,37,161,"Rutherford County, NC",Jun-22,24653,23271,1382,5.60000000
CN3716300000000,37,163,"Sampson County, NC",Jun-22,27934,26764,1170,4.20000000
CN3716500000000,37,165,"Scotland County, NC",Jun-22,11171,10292,879,7.90000000
CN3716700000000,37,167,"Stanly County, NC",Jun-22,30630,29521,1109,3.60000000
CN3716900000000,37,169,"Stokes County, NC",Jun-22,21525,20731,794,3.70000000
CN3717100000000,37,171,"Surry County, NC",Jun-22,32401,31149,1252,3.90000000
CN3717300000000,37,173,"Swain County, NC",Jun-22,7262,7012,250,3.40000000
CN3717500000000,37,175,"Transylvania County, NC",Jun-22,15081,14529,552,3.70000000
CN3717700000000,37,177,"Tyrrell County, NC",Jun-22,1477,1405,72,4.90000000
CN3717900000000,37,179,"Union County, NC",Jun-22,129895,125398,4497,3.50000000
CN3718100000000,37,181,"Vance County, NC",Jun-22,16910,15761,1149,6.80000000
CN3718300000000,37,183,"Wake County, NC",Jun-22,623883,602810,21073,3.40000000
CN3718500000000,37,185,"Warren County, NC",Jun-22,6615,6152,463,7.00000000
CN3718700000000,37,187,"Washington County, NC",Jun-22,4431,4179,252,5.70000000
CN3718900000000,37,189,"Watauga County, NC",Jun-22,29060,28003,1057,3.60000000
CN3719100000000,37,191,"Wayne County, NC",Jun-22,51783,49516,2267,4.40000000
CN3719300000000,37,193,"Wilkes County, NC",Jun-22,26893,25733,1160,4.30000000
CN3719500000000,37,195,"Wilson County, NC",Jun-22,33155,31148,2007,6.10000000
CN3719700000000,37,197,"Yadkin County, NC",Jun-22,17527,16886,641,3.70000000
CN3719900000000,37,199,"Yancey County, NC",Jun-22,8318,8000,318,3.80000000
CN3800100000000,38,001,"Adams County, ND",Jun-22,934,911,23,2.50000000
CN3800300000000,38,003,"Barnes County, ND",Jun-22,5249,5113,136,2.60000000
CN3800500000000,38,005,"Benson County, ND",Jun-22,2213,2135,78,3.50000000
CN3800700000000,38,007,"Billings County, ND",Jun-22,556,544,12,2.20000000
CN3800900000000,38,009,"Bottineau County, ND",Jun-22,3120,3012,108,3.50000000
CN3801100000000,38,011,"Bowman County, ND",Jun-22,1612,1584,28,1.70000000
CN3801300000000,38,013,"Burke County, ND",Jun-22,1038,1011,27,2.60000000
CN3801500000000,38,015,"Burleigh County, ND",Jun-22,53343,52145,1198,2.20000000
CN3801700000000,38,017,"Cass County, ND",Jun-22,110468,108162,2306,2.10000000
CN3801900000000,38,019,"Cavalier County, ND",Jun-22,1866,1815,51,2.70000000
CN3802100000000,38,021,"Dickey County, ND",Jun-22,2300,2250,50,2.20000000
CN3802300000000,38,023,"Divide County, ND",Jun-22,1429,1408,21,1.50000000
CN3802500000000,38,025,"Dunn County, ND",Jun-22,3076,3021,55,1.80000000
CN3802700000000,38,027,"Eddy County, ND",Jun-22,1238,1200,38,3.10000000
CN3802900000000,38,029,"Emmons County, ND",Jun-22,1451,1390,61,4.20000000
CN3803100000000,38,031,"Foster County, ND",Jun-22,1519,1484,35,2.30000000
CN3803300000000,38,033,"Golden Valley County, ND",Jun-22,858,842,16,1.90000000
CN3803500000000,38,035,"Grand Forks County, ND",Jun-22,38258,37359,899,2.30000000
CN3803700000000,38,037,"Grant County, ND",Jun-22,1158,1130,28,2.40000000
CN3803900000000,38,039,"Griggs County, ND",Jun-22,994,972,22,2.20000000
CN3804100000000,38,041,"Hettinger County, ND",Jun-22,1408,1381,27,1.90000000
CN3804300000000,38,043,"Kidder County, ND",Jun-22,1312,1262,50,3.80000000
CN3804500000000,38,045,"LaMoure County, ND",Jun-22,2047,2003,44,2.10000000
CN3804700000000,38,047,"Logan County, ND",Jun-22,854,838,16,1.90000000
CN3804900000000,38,049,"McHenry County, ND",Jun-22,3140,3039,101,3.20000000
CN3805100000000,38,051,"McIntosh County, ND",Jun-22,1074,1050,24,2.20000000
CN3805300000000,38,053,"McKenzie County, ND",Jun-22,8816,8568,248,2.80000000
CN3805500000000,38,055,"McLean County, ND",Jun-22,4854,4681,173,3.60000000
CN3805700000000,38,057,"Mercer County, ND",Jun-22,3865,3734,131,3.40000000
CN3805900000000,38,059,"Morton County, ND",Jun-22,17420,16956,464,2.70000000
CN3806100000000,38,061,"Mountrail County, ND",Jun-22,6363,6238,125,2.00000000
CN3806300000000,38,063,"Nelson County, ND",Jun-22,1449,1397,52,3.60000000
CN3806500000000,38,065,"Oliver County, ND",Jun-22,883,854,29,3.30000000
CN3806700000000,38,067,"Pembina County, ND",Jun-22,3249,3119,130,4.00000000
CN3806900000000,38,069,"Pierce County, ND",Jun-22,1691,1644,47,2.80000000
CN3807100000000,38,071,"Ramsey County, ND",Jun-22,5854,5705,149,2.50000000
CN3807300000000,38,073,"Ransom County, ND",Jun-22,2712,2659,53,2.00000000
CN3807500000000,38,075,"Renville County, ND",Jun-22,1163,1136,27,2.30000000
CN3807700000000,38,077,"Richland County, ND",Jun-22,8787,8575,212,2.40000000
CN3807900000000,38,079,"Rolette County, ND",Jun-22,5029,4474,555,11.00000000
CN3808100000000,38,081,"Sargent County, ND",Jun-22,2419,2369,50,2.10000000
CN3808300000000,38,083,"Sheridan County, ND",Jun-22,670,653,17,2.50000000
CN3808500000000,38,085,"Sioux County, ND",Jun-22,1258,1207,51,4.10000000
CN3808700000000,38,087,"Slope County, ND",Jun-22,332,323,9,2.70000000
CN3808900000000,38,089,"Stark County, ND",Jun-22,18092,17654,438,2.40000000
CN3809100000000,38,091,"Steele County, ND",Jun-22,919,896,23,2.50000000
CN3809300000000,38,093,"Stutsman County, ND",Jun-22,10517,10251,266,2.50000000
CN3809500000000,38,095,"Towner County, ND",Jun-22,1116,1087,29,2.60000000
CN3809700000000,38,097,"Traill County, ND",Jun-22,4422,4299,123,2.80000000
CN3809900000000,38,099,"Walsh County, ND",Jun-22,5358,5155,203,3.80000000
CN3810100000000,38,101,"Ward County, ND",Jun-22,32463,31574,889,2.70000000
CN3810300000000,38,103,"Wells County, ND",Jun-22,1898,1832,66,3.50000000
CN3810500000000,38,105,"Williams County, ND",Jun-22,21280,20570,710,3.30000000
CN3900100000000,39,001,"Adams County, OH",Jun-22,11062,10491,571,5.20000000
CN3900300000000,39,003,"Allen County, OH",Jun-22,47245,45199,2046,4.30000000
CN3900500000000,39,005,"Ashland County, OH",Jun-22,26886,25892,994,3.70000000
CN3900700000000,39,007,"Ashtabula County, OH",Jun-22,43906,41974,1932,4.40000000
CN3900900000000,39,009,"Athens County, OH",Jun-22,24455,23002,1453,5.90000000
CN3901100000000,39,011,"Auglaize County, OH",Jun-22,24893,24081,812,3.30000000
CN3901300000000,39,013,"Belmont County, OH",Jun-22,28207,26797,1410,5.00000000
CN3901500000000,39,015,"Brown County, OH",Jun-22,19363,18467,896,4.60000000
CN3901700000000,39,017,"Butler County, OH",Jun-22,196866,188837,8029,4.10000000
CN3901900000000,39,019,"Carroll County, OH",Jun-22,12711,12158,553,4.40000000
CN3902100000000,39,021,"Champaign County, OH",Jun-22,19552,18790,762,3.90000000
CN3902300000000,39,023,"Clark County, OH",Jun-22,62775,60037,2738,4.40000000
CN3902500000000,39,025,"Clermont County, OH",Jun-22,107762,103504,4258,4.00000000
CN3902700000000,39,027,"Clinton County, OH",Jun-22,18000,17148,852,4.70000000
CN3902900000000,39,029,"Columbiana County, OH",Jun-22,46309,44061,2248,4.90000000
CN3903100000000,39,031,"Coshocton County, OH",Jun-22,13817,13085,732,5.30000000
CN3903300000000,39,033,"Crawford County, OH",Jun-22,18036,17128,908,5.00000000
CN3903500000000,39,035,"Cuyahoga County, OH",Jun-22,612096,573259,38837,6.30000000
CN3903700000000,39,037,"Darke County, OH",Jun-22,26156,25183,973,3.70000000
CN3903900000000,39,039,"Defiance County, OH",Jun-22,17794,17052,742,4.20000000
CN3904100000000,39,041,"Delaware County, OH",Jun-22,116517,112627,3890,3.30000000
CN3904300000000,39,043,"Erie County, OH",Jun-22,38849,37149,1700,4.40000000
CN3904500000000,39,045,"Fairfield County, OH",Jun-22,80955,77885,3070,3.80000000
CN3904700000000,39,047,"Fayette County, OH",Jun-22,13784,13225,559,4.10000000
CN3904900000000,39,049,"Franklin County, OH",Jun-22,715332,688054,27278,3.80000000
CN3905100000000,39,051,"Fulton County, OH",Jun-22,22252,21415,837,3.80000000
CN3905300000000,39,053,"Gallia County, OH",Jun-22,12135,11548,587,4.80000000
CN3905500000000,39,055,"Geauga County, OH",Jun-22,48825,46437,2388,4.90000000
CN3905700000000,39,057,"Greene County, OH",Jun-22,83299,80042,3257,3.90000000
CN3905900000000,39,059,"Guernsey County, OH",Jun-22,18030,17183,847,4.70000000
CN3906100000000,39,061,"Hamilton County, OH",Jun-22,416674,399740,16934,4.10000000
CN3906300000000,39,063,"Hancock County, OH",Jun-22,41030,39630,1400,3.40000000
CN3906500000000,39,065,"Hardin County, OH",Jun-22,12796,12168,628,4.90000000
CN3906700000000,39,067,"Harrison County, OH",Jun-22,6580,6252,328,5.00000000
CN3906900000000,39,069,"Henry County, OH",Jun-22,13005,12474,531,4.10000000
CN3907100000000,39,071,"Highland County, OH",Jun-22,17319,16447,872,5.00000000
CN3907300000000,39,073,"Hocking County, OH",Jun-22,13017,12482,535,4.10000000
CN3907500000000,39,075,"Holmes County, OH",Jun-22,22083,21423,660,3.00000000
CN3907700000000,39,077,"Huron County, OH",Jun-22,28354,27103,1251,4.40000000
CN3907900000000,39,079,"Jackson County, OH",Jun-22,12514,11866,648,5.20000000
CN3908100000000,39,081,"Jefferson County, OH",Jun-22,27382,25806,1576,5.80000000
CN3908300000000,39,083,"Knox County, OH",Jun-22,31229,30038,1191,3.80000000
CN3908500000000,39,085,"Lake County, OH",Jun-22,126500,119875,6625,5.20000000
CN3908700000000,39,087,"Lawrence County, OH",Jun-22,23394,22193,1201,5.10000000
CN3908900000000,39,089,"Licking County, OH",Jun-22,92709,89251,3458,3.70000000
CN3909100000000,39,091,"Logan County, OH",Jun-22,22550,21713,837,3.70000000
CN3909300000000,39,093,"Lorain County, OH",Jun-22,156297,146864,9433,6.00000000
CN3909500000000,39,095,"Lucas County, OH",Jun-22,210098,200365,9733,4.60000000
CN3909700000000,39,097,"Madison County, OH",Jun-22,21136,20400,736,3.50000000
CN3909900000000,39,099,"Mahoning County, OH",Jun-22,99308,94130,5178,5.20000000
CN3910100000000,39,101,"Marion County, OH",Jun-22,28432,27245,1187,4.20000000
CN3910300000000,39,103,"Medina County, OH",Jun-22,98964,94124,4840,4.90000000
CN3910500000000,39,105,"Meigs County, OH",Jun-22,8747,8237,510,5.80000000
CN3910700000000,39,107,"Mercer County, OH",Jun-22,23495,22819,676,2.90000000
CN3910900000000,39,109,"Miami County, OH",Jun-22,54078,52065,2013,3.70000000
CN3911100000000,39,111,"Monroe County, OH",Jun-22,5212,4894,318,6.10000000
CN3911300000000,39,113,"Montgomery County, OH",Jun-22,249405,238264,11141,4.50000000
CN3911500000000,39,115,"Morgan County, OH",Jun-22,6845,6522,323,4.70000000
CN3911700000000,39,117,"Morrow County, OH",Jun-22,17101,16428,673,3.90000000
CN3911900000000,39,119,"Muskingum County, OH",Jun-22,40964,39216,1748,4.30000000
CN3912100000000,39,121,"Noble County, OH",Jun-22,4648,4386,262,5.60000000
CN3912300000000,39,123,"Ottawa County, OH",Jun-22,22063,21127,936,4.20000000
CN3912500000000,39,125,"Paulding County, OH",Jun-22,8791,8439,352,4.00000000
CN3912700000000,39,127,"Perry County, OH",Jun-22,16048,15339,709,4.40000000
CN3912900000000,39,129,"Pickaway County, OH",Jun-22,26986,25942,1044,3.90000000
CN3913100000000,39,131,"Pike County, OH",Jun-22,11195,10595,600,5.40000000
CN3913300000000,39,133,"Portage County, OH",Jun-22,84879,81392,3487,4.10000000
CN3913500000000,39,135,"Preble County, OH",Jun-22,22104,21327,777,3.50000000
CN3913700000000,39,137,"Putnam County, OH",Jun-22,19349,18779,570,2.90000000
CN3913900000000,39,139,"Richland County, OH",Jun-22,51507,49172,2335,4.50000000
CN3914100000000,39,141,"Ross County, OH",Jun-22,35377,33990,1387,3.90000000
CN3914300000000,39,143,"Sandusky County, OH",Jun-22,31010,29592,1418,4.60000000
CN3914500000000,39,145,"Scioto County, OH",Jun-22,29196,27628,1568,5.40000000
CN3914700000000,39,147,"Seneca County, OH",Jun-22,27162,26022,1140,4.20000000
CN3914900000000,39,149,"Shelby County, OH",Jun-22,24273,23341,932,3.80000000
CN3915100000000,39,151,"Stark County, OH",Jun-22,183072,175375,7697,4.20000000
CN3915300000000,39,153,"Summit County, OH",Jun-22,264571,252834,11737,4.40000000
CN3915500000000,39,155,"Trumbull County, OH",Jun-22,83830,79370,4460,5.30000000
CN3915700000000,39,157,"Tuscarawas County, OH",Jun-22,45356,43633,1723,3.80000000
CN3915900000000,39,159,"Union County, OH",Jun-22,30400,29405,995,3.30000000
CN3916100000000,39,161,"Van Wert County, OH",Jun-22,14970,14445,525,3.50000000
CN3916300000000,39,163,"Vinton County, OH",Jun-22,5494,5213,281,5.10000000
CN3916500000000,39,165,"Warren County, OH",Jun-22,122191,117740,4451,3.60000000
CN3916700000000,39,167,"Washington County, OH",Jun-22,27287,26009,1278,4.70000000
CN3916900000000,39,169,"Wayne County, OH",Jun-22,60558,58479,2079,3.40000000
CN3917100000000,39,171,"Williams County, OH",Jun-22,18134,17460,674,3.70000000
CN3917300000000,39,173,"Wood County, OH",Jun-22,71691,69025,2666,3.70000000
CN3917500000000,39,175,"Wyandot County, OH",Jun-22,13283,12891,392,3.00000000
CN4000100000000,40,001,"Adair County, OK",Jun-22,8383,8037,346,4.10000000
CN4000300000000,40,003,"Alfalfa County, OK",Jun-22,2554,2503,51,2.00000000
CN4000500000000,40,005,"Atoka County, OK",Jun-22,4972,4740,232,4.70000000
CN4000700000000,40,007,"Beaver County, OK",Jun-22,2598,2547,51,2.00000000
CN4000900000000,40,009,"Beckham County, OK",Jun-22,9240,8925,315,3.40000000
CN4001100000000,40,011,"Blaine County, OK",Jun-22,4449,4318,131,2.90000000
CN4001300000000,40,013,"Bryan County, OK",Jun-22,22793,22071,722,3.20000000
CN4001500000000,40,015,"Caddo County, OK",Jun-22,11581,11132,449,3.90000000
CN4001700000000,40,017,"Canadian County, OK",Jun-22,80015,77670,2345,2.90000000
CN4001900000000,40,019,"Carter County, OK",Jun-22,21774,20888,886,4.10000000
CN4002100000000,40,021,"Cherokee County, OK",Jun-22,19837,18974,863,4.40000000
CN4002300000000,40,023,"Choctaw County, OK",Jun-22,5890,5559,331,5.60000000
CN4002500000000,40,025,"Cimarron County, OK",Jun-22,1528,1503,25,1.60000000
CN4002700000000,40,027,"Cleveland County, OK",Jun-22,147618,143308,4310,2.90000000
CN4002900000000,40,029,"Coal County, OK",Jun-22,2205,2105,100,4.50000000
CN4003100000000,40,031,"Comanche County, OK",Jun-22,47413,45464,1949,4.10000000
CN4003300000000,40,033,"Cotton County, OK",Jun-22,2649,2565,84,3.20000000
CN4003500000000,40,035,"Craig County, OK",Jun-22,5882,5677,205,3.50000000
CN4003700000000,40,037,"Creek County, OK",Jun-22,32002,30728,1274,4.00000000
CN4003900000000,40,039,"Custer County, OK",Jun-22,14738,14241,497,3.40000000
CN4004100000000,40,041,"Delaware County, OK",Jun-22,19597,18953,644,3.30000000
CN4004300000000,40,043,"Dewey County, OK",Jun-22,2844,2776,68,2.40000000
CN4004500000000,40,045,"Ellis County, OK",Jun-22,2033,1976,57,2.80000000
CN4004700000000,40,047,"Garfield County, OK",Jun-22,26883,26001,882,3.30000000
CN4004900000000,40,049,"Garvin County, OK",Jun-22,12788,12377,411,3.20000000
CN4005100000000,40,051,"Grady County, OK",Jun-22,27157,26304,853,3.10000000
CN4005300000000,40,053,"Grant County, OK",Jun-22,2812,2755,57,2.00000000
CN4005500000000,40,055,"Greer County, OK",Jun-22,1825,1748,77,4.20000000
CN4005700000000,40,057,"Harmon County, OK",Jun-22,1169,1134,35,3.00000000
CN4005900000000,40,059,"Harper County, OK",Jun-22,1674,1638,36,2.20000000
CN4006100000000,40,061,"Haskell County, OK",Jun-22,3904,3683,221,5.70000000
CN4006300000000,40,063,"Hughes County, OK",Jun-22,4914,4674,240,4.90000000
CN4006500000000,40,065,"Jackson County, OK",Jun-22,10764,10442,322,3.00000000
CN4006700000000,40,067,"Jefferson County, OK",Jun-22,2414,2325,89,3.70000000
CN4006900000000,40,069,"Johnston County, OK",Jun-22,3665,3502,163,4.40000000
CN4007100000000,40,071,"Kay County, OK",Jun-22,18538,17771,767,4.10000000
CN4007300000000,40,073,"Kingfisher County, OK",Jun-22,8978,8772,206,2.30000000
CN4007500000000,40,075,"Kiowa County, OK",Jun-22,3590,3452,138,3.80000000
CN4007700000000,40,077,"Latimer County, OK",Jun-22,3126,2879,247,7.90000000
CN4007900000000,40,079,"Le Flore County, OK",Jun-22,19490,18597,893,4.60000000
CN4008100000000,40,081,"Lincoln County, OK",Jun-22,16119,15552,567,3.50000000
CN4008300000000,40,083,"Logan County, OK",Jun-22,23219,22497,722,3.10000000
CN4008500000000,40,085,"Love County, OK",Jun-22,5865,5704,161,2.70000000
CN4008700000000,40,087,"McClain County, OK",Jun-22,20765,20139,626,3.00000000
CN4008900000000,40,089,"McCurtain County, OK",Jun-22,15896,15125,771,4.90000000
CN4009100000000,40,091,"McIntosh County, OK",Jun-22,7242,6809,433,6.00000000
CN4009300000000,40,093,"Major County, OK",Jun-22,3663,3567,96,2.60000000
CN4009500000000,40,095,"Marshall County, OK",Jun-22,7505,7246,259,3.50000000
CN4009700000000,40,097,"Mayes County, OK",Jun-22,19636,18955,681,3.50000000
CN4009900000000,40,099,"Murray County, OK",Jun-22,6260,6041,219,3.50000000
CN4010100000000,40,101,"Muskogee County, OK",Jun-22,28077,26928,1149,4.10000000
CN4010300000000,40,103,"Noble County, OK",Jun-22,5691,5547,144,2.50000000
CN4010500000000,40,105,"Nowata County, OK",Jun-22,4683,4532,151,3.20000000
CN4010700000000,40,107,"Okfuskee County, OK",Jun-22,4369,4174,195,4.50000000
CN4010900000000,40,109,"Oklahoma County, OK",Jun-22,396767,383146,13621,3.40000000
CN4011100000000,40,111,"Okmulgee County, OK",Jun-22,15872,15099,773,4.90000000
CN4011300000000,40,113,"Osage County, OK",Jun-22,20875,20012,863,4.10000000
CN4011500000000,40,115,"Ottawa County, OK",Jun-22,14858,14377,481,3.20000000
CN4011700000000,40,117,"Pawnee County, OK",Jun-22,7482,7171,311,4.20000000
CN4011900000000,40,119,"Payne County, OK",Jun-22,37702,36421,1281,3.40000000
CN4012100000000,40,121,"Pittsburg County, OK",Jun-22,16004,15151,853,5.30000000
CN4012300000000,40,123,"Pontotoc County, OK",Jun-22,18833,18207,626,3.30000000
CN4012500000000,40,125,"Pottawatomie County, OK",Jun-22,32722,31425,1297,4.00000000
CN4012700000000,40,127,"Pushmataha County, OK",Jun-22,4451,4233,218,4.90000000
CN4012900000000,40,129,"Roger Mills County, OK",Jun-22,1682,1637,45,2.70000000
CN4013100000000,40,131,"Rogers County, OK",Jun-22,46253,44744,1509,3.30000000
CN4013300000000,40,133,"Seminole County, OK",Jun-22,9078,8626,452,5.00000000
CN4013500000000,40,135,"Sequoyah County, OK",Jun-22,16697,16039,658,3.90000000
CN4013700000000,40,137,"Stephens County, OK",Jun-22,18614,17914,700,3.80000000
CN4013900000000,40,139,"Texas County, OK",Jun-22,11530,11283,247,2.10000000
CN4014100000000,40,141,"Tillman County, OK",Jun-22,2747,2638,109,4.00000000
CN4014300000000,40,143,"Tulsa County, OK",Jun-22,332237,320750,11487,3.50000000
CN4014500000000,40,145,"Wagoner County, OK",Jun-22,39814,38473,1341,3.40000000
CN4014700000000,40,147,"Washington County, OK",Jun-22,22305,21474,831,3.70000000
CN4014900000000,40,149,"Washita County, OK",Jun-22,4869,4679,190,3.90000000
CN4015100000000,40,151,"Woods County, OK",Jun-22,4628,4529,99,2.10000000
CN4015300000000,40,153,"Woodward County, OK",Jun-22,8507,8173,334,3.90000000
CN4100100000000,41,001,"Baker County, OR",Jun-22,7673,7389,284,3.70000000
CN4100300000000,41,003,"Benton County, OR",Jun-22,49564,47937,1627,3.30000000
CN4100500000000,41,005,"Clackamas County, OR",Jun-22,229244,221649,7595,3.30000000
CN4100700000000,41,007,"Clatsop County, OR",Jun-22,20099,19355,744,3.70000000
CN4100900000000,41,009,"Columbia County, OR",Jun-22,25295,24230,1065,4.20000000
CN4101100000000,41,011,"Coos County, OR",Jun-22,26632,25361,1271,4.80000000
CN4101300000000,41,013,"Crook County, OR",Jun-22,11537,11014,523,4.50000000
CN4101500000000,41,015,"Curry County, OR",Jun-22,9332,8901,431,4.60000000
CN4101700000000,41,017,"Deschutes County, OR",Jun-22,105414,101794,3620,3.40000000
CN4101900000000,41,019,"Douglas County, OR",Jun-22,47816,45658,2158,4.50000000
CN4102100000000,41,021,"Gilliam County, OR",Jun-22,899,866,33,3.70000000
CN4102300000000,41,023,"Grant County, OR",Jun-22,3252,3104,148,4.60000000
CN4102500000000,41,025,"Harney County, OR",Jun-22,3735,3598,137,3.70000000
CN4102700000000,41,027,"Hood River County, OR",Jun-22,14782,14314,468,3.20000000
CN4102900000000,41,029,"Jackson County, OR",Jun-22,108067,103654,4413,4.10000000
CN4103100000000,41,031,"Jefferson County, OR",Jun-22,10807,10303,504,4.70000000
CN4103300000000,41,033,"Josephine County, OR",Jun-22,37588,35763,1825,4.90000000
CN4103500000000,41,035,"Klamath County, OR",Jun-22,30383,28851,1532,5.00000000
CN4103700000000,41,037,"Lake County, OR",Jun-22,3763,3605,158,4.20000000
CN4103900000000,41,039,"Lane County, OR",Jun-22,185141,177738,7403,4.00000000
CN4104100000000,41,041,"Lincoln County, OR",Jun-22,21499,20506,993,4.60000000
CN4104300000000,41,043,"Linn County, OR",Jun-22,61320,58823,2497,4.10000000
CN4104500000000,41,045,"Malheur County, OR",Jun-22,12749,12278,471,3.70000000
CN4104700000000,41,047,"Marion County, OR",Jun-22,170181,163838,6343,3.70000000
CN4104900000000,41,049,"Morrow County, OR",Jun-22,6116,5891,225,3.70000000
CN4105100000000,41,051,"Multnomah County, OR",Jun-22,473309,456563,16746,3.50000000
CN4105300000000,41,053,"Polk County, OR",Jun-22,42547,40955,1592,3.70000000
CN4105500000000,41,055,"Sherman County, OR",Jun-22,969,944,25,2.60000000
CN4105700000000,41,057,"Tillamook County, OR",Jun-22,12742,12277,465,3.60000000
CN4105900000000,41,059,"Umatilla County, OR",Jun-22,38858,37384,1474,3.80000000
CN4106100000000,41,061,"Union County, OR",Jun-22,12401,11913,488,3.90000000
CN4106300000000,41,063,"Wallowa County, OR",Jun-22,3845,3689,156,4.10000000
CN4106500000000,41,065,"Wasco County, OR",Jun-22,16430,15957,473,2.90000000
CN4106700000000,41,067,"Washington County, OR",Jun-22,337361,327157,10204,3.00000000
CN4106900000000,41,069,"Wheeler County, OR",Jun-22,748,729,19,2.50000000
CN4107100000000,41,071,"Yamhill County, OR",Jun-22,57052,55123,1929,3.40000000
CN4200100000000,42,001,"Adams County, PA",Jun-22,55455,53514,1941,3.50000000
CN4200300000000,42,003,"Allegheny County, PA",Jun-22,635088,607381,27707,4.40000000
CN4200500000000,42,005,"Armstrong County, PA",Jun-22,31472,29744,1728,5.50000000
CN4200700000000,42,007,"Beaver County, PA",Jun-22,82418,77865,4553,5.50000000
CN4200900000000,42,009,"Bedford County, PA",Jun-22,24147,23118,1029,4.30000000
CN4201100000000,42,011,"Berks County, PA",Jun-22,211997,201856,10141,4.80000000
CN4201300000000,42,013,"Blair County, PA",Jun-22,60006,57219,2787,4.60000000
CN4201500000000,42,015,"Bradford County, PA",Jun-22,28287,27107,1180,4.20000000
CN4201700000000,42,017,"Bucks County, PA",Jun-22,347559,334394,13165,3.80000000
CN4201900000000,42,019,"Butler County, PA",Jun-22,99304,95156,4148,4.20000000
CN4202100000000,42,021,"Cambria County, PA",Jun-22,55574,52291,3283,5.90000000
CN4202300000000,42,023,"Cameron County, PA",Jun-22,2008,1893,115,5.70000000
CN4202500000000,42,025,"Carbon County, PA",Jun-22,32938,31227,1711,5.20000000
CN4202700000000,42,027,"Centre County, PA",Jun-22,74523,71531,2992,4.00000000
CN4202900000000,42,029,"Chester County, PA",Jun-22,294716,285055,9661,3.30000000
CN4203100000000,42,031,"Clarion County, PA",Jun-22,16598,15731,867,5.20000000
CN4203300000000,42,033,"Clearfield County, PA",Jun-22,35129,33261,1868,5.30000000
CN4203500000000,42,035,"Clinton County, PA",Jun-22,17084,16171,913,5.30000000
CN4203700000000,42,037,"Columbia County, PA",Jun-22,32968,31388,1580,4.80000000
CN4203900000000,42,039,"Crawford County, PA",Jun-22,38148,36219,1929,5.10000000
CN4204100000000,42,041,"Cumberland County, PA",Jun-22,137661,132799,4862,3.50000000
CN4204300000000,42,043,"Dauphin County, PA",Jun-22,148829,142574,6255,4.20000000
CN4204500000000,42,045,"Delaware County, PA",Jun-22,296900,283666,13234,4.50000000
CN4204700000000,42,047,"Elk County, PA",Jun-22,14927,14115,812,5.40000000
CN4204900000000,42,049,"Erie County, PA",Jun-22,126797,120050,6747,5.30000000
CN4205100000000,42,051,"Fayette County, PA",Jun-22,55645,52056,3589,6.40000000
CN4205300000000,42,053,"Forest County, PA",Jun-22,1754,1643,111,6.30000000
CN4205500000000,42,055,"Franklin County, PA",Jun-22,78512,75533,2979,3.80000000
CN4205700000000,42,057,"Fulton County, PA",Jun-22,7242,6941,301,4.20000000
CN4205900000000,42,059,"Greene County, PA",Jun-22,15484,14555,929,6.00000000
CN4206100000000,42,061,"Huntingdon County, PA",Jun-22,19306,18206,1100,5.70000000
CN4206300000000,42,063,"Indiana County, PA",Jun-22,35909,33753,2156,6.00000000
CN4206500000000,42,065,"Jefferson County, PA",Jun-22,19759,18809,950,4.80000000
CN4206700000000,42,067,"Juniata County, PA",Jun-22,12909,12377,532,4.10000000
CN4206900000000,42,069,"Lackawanna County, PA",Jun-22,104348,99068,5280,5.10000000
CN4207100000000,42,071,"Lancaster County, PA",Jun-22,288831,277922,10909,3.80000000
CN4207300000000,42,073,"Lawrence County, PA",Jun-22,39498,37376,2122,5.40000000
CN4207500000000,42,075,"Lebanon County, PA",Jun-22,74198,71249,2949,4.00000000
CN4207700000000,42,077,"Lehigh County, PA",Jun-22,199771,190483,9288,4.60000000
CN4207900000000,42,079,"Luzerne County, PA",Jun-22,157402,148240,9162,5.80000000
CN4208100000000,42,081,"Lycoming County, PA",Jun-22,54319,51588,2731,5.00000000
CN4208300000000,42,083,"McKean County, PA",Jun-22,16806,15892,914,5.40000000
CN4208500000000,42,085,"Mercer County, PA",Jun-22,47879,45244,2635,5.50000000
CN4208700000000,42,087,"Mifflin County, PA",Jun-22,20954,19921,1033,4.90000000
CN4208900000000,42,089,"Monroe County, PA",Jun-22,83546,78420,5126,6.10000000
CN4209100000000,42,091,"Montgomery County, PA",Jun-22,462428,446049,16379,3.50000000
CN4209300000000,42,093,"Montour County, PA",Jun-22,8953,8629,324,3.60000000
CN4209500000000,42,095,"Northampton County, PA",Jun-22,166142,158927,7215,4.30000000
CN4209700000000,42,097,"Northumberland County, PA",Jun-22,42345,40173,2172,5.10000000
CN4209900000000,42,099,"Perry County, PA",Jun-22,25246,24363,883,3.50000000
CN4210100000000,42,101,"Philadelphia County/city, PA",Jun-22,720050,675661,44389,6.20000000
CN4210300000000,42,103,"Pike County, PA",Jun-22,26133,24697,1436,5.50000000
CN4210500000000,42,105,"Potter County, PA",Jun-22,7251,6869,382,5.30000000
CN4210700000000,42,107,"Schuylkill County, PA",Jun-22,65477,62002,3475,5.30000000
CN4210900000000,42,109,"Snyder County, PA",Jun-22,19647,18785,862,4.40000000
CN4211100000000,42,111,"Somerset County, PA",Jun-22,32475,30741,1734,5.30000000
CN4211300000000,42,113,"Sullivan County, PA",Jun-22,2628,2480,148,5.60000000
CN4211500000000,42,115,"Susquehanna County, PA",Jun-22,20584,19786,798,3.90000000
CN4211700000000,42,117,"Tioga County, PA",Jun-22,19057,18105,952,5.00000000
CN4211900000000,42,119,"Union County, PA",Jun-22,19578,18752,826,4.20000000
CN4212100000000,42,121,"Venango County, PA",Jun-22,21482,20379,1103,5.10000000
CN4212300000000,42,123,"Warren County, PA",Jun-22,17865,17037,828,4.60000000
CN4212500000000,42,125,"Washington County, PA",Jun-22,105558,100437,5121,4.90000000
CN4212700000000,42,127,"Wayne County, PA",Jun-22,22772,21681,1091,4.80000000
CN4212900000000,42,129,"Westmoreland County, PA",Jun-22,176893,168594,8299,4.70000000
CN4213100000000,42,131,"Wyoming County, PA",Jun-22,13472,12814,658,4.90000000
CN4213300000000,42,133,"York County, PA",Jun-22,238849,229139,9710,4.10000000
CN4400100000000,44,001,"Bristol County, RI",Jun-22,26957,26337,620,2.30000000
CN4400300000000,44,003,"Kent County, RI",Jun-22,95117,92694,2423,2.50000000
CN4400500000000,44,005,"Newport County, RI",Jun-22,45749,44690,1059,2.30000000
CN4400700000000,44,007,"Providence County, RI",Jun-22,339415,329052,10363,3.10000000
CN4400900000000,44,009,"Washington County, RI",Jun-22,71460,69805,1655,2.30000000
CN4500100000000,45,001,"Abbeville County, SC",Jun-22,9509,9105,404,4.20000000
CN4500300000000,45,003,"Aiken County, SC",Jun-22,74952,72523,2429,3.20000000
CN4500500000000,45,005,"Allendale County, SC",Jun-22,2400,2245,155,6.50000000
CN4500700000000,45,007,"Anderson County, SC",Jun-22,91961,89022,2939,3.20000000
CN4500900000000,45,009,"Bamberg County, SC",Jun-22,4525,4226,299,6.60000000
CN4501100000000,45,011,"Barnwell County, SC",Jun-22,7705,7298,407,5.30000000
CN4501300000000,45,013,"Beaufort County, SC",Jun-22,79217,76686,2531,3.20000000
CN4501500000000,45,015,"Berkeley County, SC",Jun-22,111888,108448,3440,3.10000000
CN4501700000000,45,017,"Calhoun County, SC",Jun-22,6443,6210,233,3.60000000
CN4501900000000,45,019,"Charleston County, SC",Jun-22,220065,213701,6364,2.90000000
CN4502100000000,45,021,"Cherokee County, SC",Jun-22,24665,23609,1056,4.30000000
CN4502300000000,45,023,"Chester County, SC",Jun-22,13721,13077,644,4.70000000
CN4502500000000,45,025,"Chesterfield County, SC",Jun-22,21746,20929,817,3.80000000
CN4502700000000,45,027,"Clarendon County, SC",Jun-22,12539,12024,515,4.10000000
CN4502900000000,45,029,"Colleton County, SC",Jun-22,16245,15657,588,3.60000000
CN4503100000000,45,031,"Darlington County, SC",Jun-22,29765,28611,1154,3.90000000
CN4503300000000,45,033,"Dillon County, SC",Jun-22,13108,12456,652,5.00000000
CN4503500000000,45,035,"Dorchester County, SC",Jun-22,81202,78780,2422,3.00000000
CN4503700000000,45,037,"Edgefield County, SC",Jun-22,10525,10192,333,3.20000000
CN4503900000000,45,039,"Fairfield County, SC",Jun-22,9289,8806,483,5.20000000
CN4504100000000,45,041,"Florence County, SC",Jun-22,65830,63569,2261,3.40000000
CN4504300000000,45,043,"Georgetown County, SC",Jun-22,26999,25962,1037,3.80000000
CN4504500000000,45,045,"Greenville County, SC",Jun-22,261200,253462,7738,3.00000000
CN4504700000000,45,047,"Greenwood County, SC",Jun-22,29838,28668,1170,3.90000000
CN4504900000000,45,049,"Hampton County, SC",Jun-22,8213,7966,247,3.00000000
CN4505100000000,45,051,"Horry County, SC",Jun-22,157424,151302,6122,3.90000000
CN4505300000000,45,053,"Jasper County, SC",Jun-22,13694,13261,433,3.20000000
CN4505500000000,45,055,"Kershaw County, SC",Jun-22,29480,28455,1025,3.50000000
CN4505700000000,45,057,"Lancaster County, SC",Jun-22,44678,43009,1669,3.70000000
CN4505900000000,45,059,"Laurens County, SC",Jun-22,30311,29209,1102,3.60000000
CN4506100000000,45,061,"Lee County, SC",Jun-22,6491,6162,329,5.10000000
CN4506300000000,45,063,"Lexington County, SC",Jun-22,151581,147273,4308,2.80000000
CN4506500000000,45,065,"McCormick County, SC",Jun-22,3406,3269,137,4.00000000
CN4506700000000,45,067,"Marion County, SC",Jun-22,13049,12323,726,5.60000000
CN4506900000000,45,069,"Marlboro County, SC",Jun-22,8636,8009,627,7.30000000
CN4507100000000,45,071,"Newberry County, SC",Jun-22,19483,18915,568,2.90000000
CN4507300000000,45,073,"Oconee County, SC",Jun-22,34774,33653,1121,3.20000000
CN4507500000000,45,075,"Orangeburg County, SC",Jun-22,33081,31072,2009,6.10000000
CN4507700000000,45,077,"Pickens County, SC",Jun-22,58294,56369,1925,3.30000000
CN4507900000000,45,079,"Richland County, SC",Jun-22,197502,190525,6977,3.50000000
CN4508100000000,45,081,"Saluda County, SC",Jun-22,8520,8269,251,2.90000000
CN4508300000000,45,083,"Spartanburg County, SC",Jun-22,159199,153846,5353,3.40000000
CN4508500000000,45,085,"Sumter County, SC",Jun-22,42165,40481,1684,4.00000000
CN4508700000000,45,087,"Union County, SC",Jun-22,11606,10995,611,5.30000000
CN4508900000000,45,089,"Williamsburg County, SC",Jun-22,11110,10506,604,5.40000000
CN4509100000000,45,091,"York County, SC",Jun-22,151773,146781,4992,3.30000000
CN4600300000000,46,003,"Aurora County, SD",Jun-22,1502,1472,30,2.00000000
CN4600500000000,46,005,"Beadle County, SD",Jun-22,9447,9234,213,2.30000000
CN4600700000000,46,007,"Bennett County, SD",Jun-22,1066,1029,37,3.50000000
CN4600900000000,46,009,"Bon Homme County, SD",Jun-22,2920,2854,66,2.30000000
CN4601100000000,46,011,"Brookings County, SD",Jun-22,18870,18351,519,2.80000000
CN4601300000000,46,013,"Brown County, SD",Jun-22,20384,19845,539,2.60000000
CN4601500000000,46,015,"Brule County, SD",Jun-22,2818,2759,59,2.10000000
CN4601700000000,46,017,"Buffalo County, SD",Jun-22,759,719,40,5.30000000
CN4601900000000,46,019,"Butte County, SD",Jun-22,5082,4962,120,2.40000000
CN4602100000000,46,021,"Campbell County, SD",Jun-22,797,774,23,2.90000000
CN4602300000000,46,023,"Charles Mix County, SD",Jun-22,3970,3856,114,2.90000000
CN4602500000000,46,025,"Clark County, SD",Jun-22,2030,1981,49,2.40000000
CN4602700000000,46,027,"Clay County, SD",Jun-22,6996,6794,202,2.90000000
CN4602900000000,46,029,"Codington County, SD",Jun-22,16328,15949,379,2.30000000
CN4603100000000,46,031,"Corson County, SD",Jun-22,1300,1243,57,4.40000000
CN4603300000000,46,033,"Custer County, SD",Jun-22,4310,4180,130,3.00000000
CN4603500000000,46,035,"Davison County, SD",Jun-22,11249,11000,249,2.20000000
CN4603700000000,46,037,"Day County, SD",Jun-22,2777,2688,89,3.20000000
CN4603900000000,46,039,"Deuel County, SD",Jun-22,2407,2341,66,2.70000000
CN4604100000000,46,041,"Dewey County, SD",Jun-22,2367,2149,218,9.20000000
CN4604300000000,46,043,"Douglas County, SD",Jun-22,1562,1529,33,2.10000000
CN4604500000000,46,045,"Edmunds County, SD",Jun-22,2001,1958,43,2.10000000
CN4604700000000,46,047,"Fall River County, SD",Jun-22,3263,3173,90,2.80000000
CN4604900000000,46,049,"Faulk County, SD",Jun-22,1100,1073,27,2.50000000
CN4605100000000,46,051,"Grant County, SD",Jun-22,4438,4338,100,2.30000000
CN4605300000000,46,053,"Gregory County, SD",Jun-22,2189,2143,46,2.10000000
CN4605500000000,46,055,"Haakon County, SD",Jun-22,1071,1050,21,2.00000000
CN4605700000000,46,057,"Hamlin County, SD",Jun-22,3663,3577,86,2.30000000
CN4605900000000,46,059,"Hand County, SD",Jun-22,1834,1795,39,2.10000000
CN4606100000000,46,061,"Hanson County, SD",Jun-22,1799,1750,49,2.70000000
CN4606300000000,46,063,"Harding County, SD",Jun-22,730,713,17,2.30000000
CN4606500000000,46,065,"Hughes County, SD",Jun-22,10214,10017,197,1.90000000
CN4606700000000,46,067,"Hutchinson County, SD",Jun-22,3678,3585,93,2.50000000
CN4606900000000,46,069,"Hyde County, SD",Jun-22,667,650,17,2.50000000
CN4607100000000,46,071,"Jackson County, SD",Jun-22,1326,1289,37,2.80000000
CN4607300000000,46,073,"Jerauld County, SD",Jun-22,1446,1423,23,1.60000000
CN4607500000000,46,075,"Jones County, SD",Jun-22,577,561,16,2.80000000
CN4607700000000,46,077,"Kingsbury County, SD",Jun-22,3001,2938,63,2.10000000
CN4607900000000,46,079,"Lake County, SD",Jun-22,6675,6499,176,2.60000000
CN4608100000000,46,081,"Lawrence County, SD",Jun-22,14512,14179,333,2.30000000
CN4608300000000,46,083,"Lincoln County, SD",Jun-22,38371,37618,753,2.00000000
CN4608500000000,46,085,"Lyman County, SD",Jun-22,1760,1703,57,3.20000000
CN4608700000000,46,087,"McCook County, SD",Jun-22,3157,3091,66,2.10000000
CN4608900000000,46,089,"McPherson County, SD",Jun-22,1005,974,31,3.10000000
CN4609100000000,46,091,"Marshall County, SD",Jun-22,2519,2447,72,2.90000000
CN4609300000000,46,093,"Meade County, SD",Jun-22,14981,14616,365,2.40000000
CN4609500000000,46,095,"Mellette County, SD",Jun-22,710,687,23,3.20000000
CN4609700000000,46,097,"Miner County, SD",Jun-22,1230,1204,26,2.10000000
CN4609900000000,46,099,"Minnehaha County, SD",Jun-22,119183,116663,2520,2.10000000
CN4610100000000,46,101,"Moody County, SD",Jun-22,4098,3965,133,3.20000000
CN4610200000000,46,102,"Oglala Lakota County, SD",Jun-22,3861,3626,235,6.10000000
CN4610300000000,46,103,"Pennington County, SD",Jun-22,61934,60439,1495,2.40000000
CN4610500000000,46,105,"Perkins County, SD",Jun-22,1467,1433,34,2.30000000
CN4610700000000,46,107,"Potter County, SD",Jun-22,1097,1068,29,2.60000000
CN4610900000000,46,109,"Roberts County, SD",Jun-22,4789,4627,162,3.40000000
CN4611100000000,46,111,"Sanborn County, SD",Jun-22,1218,1192,26,2.10000000
CN4611500000000,46,115,"Spink County, SD",Jun-22,3108,3026,82,2.60000000
CN4611700000000,46,117,"Stanley County, SD",Jun-22,1972,1929,43,2.20000000
CN4611900000000,46,119,"Sully County, SD",Jun-22,820,803,17,2.10000000
CN4612100000000,46,121,"Todd County, SD",Jun-22,3028,2879,149,4.90000000
CN4612300000000,46,123,"Tripp County, SD",Jun-22,3084,3028,56,1.80000000
CN4612500000000,46,125,"Turner County, SD",Jun-22,4811,4707,104,2.20000000
CN4612700000000,46,127,"Union County, SD",Jun-22,8740,8512,228,2.60000000
CN4612900000000,46,129,"Walworth County, SD",Jun-22,2240,2154,86,3.80000000
CN4613500000000,46,135,"Yankton County, SD",Jun-22,11969,11703,266,2.20000000
CN4613700000000,46,137,"Ziebach County, SD",Jun-22,970,911,59,6.10000000
CN4700100000000,47,001,"Anderson County, TN",Jun-22,36060,34547,1513,4.20000000
CN4700300000000,47,003,"Bedford County, TN",Jun-22,21771,20841,930,4.30000000
CN4700500000000,47,005,"Benton County, TN",Jun-22,6741,6396,345,5.10000000
CN4700700000000,47,007,"Bledsoe County, TN",Jun-22,4340,4053,287,6.60000000
CN4700900000000,47,009,"Blount County, TN",Jun-22,67004,64446,2558,3.80000000
CN4701100000000,47,011,"Bradley County, TN",Jun-22,51468,49226,2242,4.40000000
CN4701300000000,47,013,"Campbell County, TN",Jun-22,15354,14560,794,5.20000000
CN4701500000000,47,015,"Cannon County, TN",Jun-22,7036,6767,269,3.80000000
CN4701700000000,47,017,"Carroll County, TN",Jun-22,11406,10841,565,5.00000000
CN4701900000000,47,019,"Carter County, TN",Jun-22,24533,23431,1102,4.50000000
CN4702100000000,47,021,"Cheatham County, TN",Jun-22,23078,22342,736,3.20000000
CN4702300000000,47,023,"Chester County, TN",Jun-22,8687,8370,317,3.60000000
CN4702500000000,47,025,"Claiborne County, TN",Jun-22,13024,12382,642,4.90000000
CN4702700000000,47,027,"Clay County, TN",Jun-22,2749,2585,164,6.00000000
CN4702900000000,47,029,"Cocke County, TN",Jun-22,14981,14089,892,6.00000000
CN4703100000000,47,031,"Coffee County, TN",Jun-22,25408,24331,1077,4.20000000
CN4703300000000,47,033,"Crockett County, TN",Jun-22,7043,6775,268,3.80000000
CN4703500000000,47,035,"Cumberland County, TN",Jun-22,22560,21383,1177,5.20000000
CN4703700000000,47,037,"Davidson County, TN",Jun-22,420978,406166,14812,3.50000000
CN4703900000000,47,039,"Decatur County, TN",Jun-22,4317,4063,254,5.90000000
CN4704100000000,47,041,"DeKalb County, TN",Jun-22,8012,7619,393,4.90000000
CN4704300000000,47,043,"Dickson County, TN",Jun-22,28489,27469,1020,3.60000000
CN4704500000000,47,045,"Dyer County, TN",Jun-22,16010,15277,733,4.60000000
CN4704700000000,47,047,"Fayette County, TN",Jun-22,19945,19128,817,4.10000000
CN4704900000000,47,049,"Fentress County, TN",Jun-22,7605,7236,369,4.90000000
CN4705100000000,47,051,"Franklin County, TN",Jun-22,19656,18813,843,4.30000000
CN4705300000000,47,053,"Gibson County, TN",Jun-22,21502,20542,960,4.50000000
CN4705500000000,47,055,"Giles County, TN",Jun-22,14800,14158,642,4.30000000
CN4705700000000,47,057,"Grainger County, TN",Jun-22,10018,9541,477,4.80000000
CN4705900000000,47,059,"Greene County, TN",Jun-22,28609,27165,1444,5.00000000
CN4706100000000,47,061,"Grundy County, TN",Jun-22,5066,4765,301,5.90000000
CN4706300000000,47,063,"Hamblen County, TN",Jun-22,28776,27478,1298,4.50000000
CN4706500000000,47,065,"Hamilton County, TN",Jun-22,186326,178621,7705,4.10000000
CN4706700000000,47,067,"Hancock County, TN",Jun-22,2285,2157,128,5.60000000
CN4706900000000,47,069,"Hardeman County, TN",Jun-22,8979,8481,498,5.50000000
CN4707100000000,47,071,"Hardin County, TN",Jun-22,10064,9560,504,5.00000000
CN4707300000000,47,073,"Hawkins County, TN",Jun-22,23535,22365,1170,5.00000000
CN4707500000000,47,075,"Haywood County, TN",Jun-22,7697,7225,472,6.10000000
CN4707700000000,47,077,"Henderson County, TN",Jun-22,11975,11440,535,4.50000000
CN4707900000000,47,079,"Henry County, TN",Jun-22,14443,13806,637,4.40000000
CN4708100000000,47,081,"Hickman County, TN",Jun-22,12011,11597,414,3.40000000
CN4708300000000,47,083,"Houston County, TN",Jun-22,3218,3048,170,5.30000000
CN4708500000000,47,085,"Humphreys County, TN",Jun-22,8565,8203,362,4.20000000
CN4708700000000,47,087,"Jackson County, TN",Jun-22,4797,4559,238,5.00000000
CN4708900000000,47,089,"Jefferson County, TN",Jun-22,25533,24423,1110,4.30000000
CN4709100000000,47,091,"Johnson County, TN",Jun-22,7648,7337,311,4.10000000
CN4709300000000,47,093,"Knox County, TN",Jun-22,256098,246996,9102,3.60000000
CN4709500000000,47,095,"Lake County, TN",Jun-22,1654,1554,100,6.00000000
CN4709700000000,47,097,"Lauderdale County, TN",Jun-22,9663,9084,579,6.00000000
CN4709900000000,47,099,"Lawrence County, TN",Jun-22,19560,18717,843,4.30000000
CN4710100000000,47,101,"Lewis County, TN",Jun-22,5782,5530,252,4.40000000
CN4710300000000,47,103,"Lincoln County, TN",Jun-22,16248,15582,666,4.10000000
CN4710500000000,47,105,"Loudon County, TN",Jun-22,25041,24053,988,3.90000000
CN4710700000000,47,107,"McMinn County, TN",Jun-22,22207,21128,1079,4.90000000
CN4710900000000,47,109,"McNairy County, TN",Jun-22,8294,7799,495,6.00000000
CN4711100000000,47,111,"Macon County, TN",Jun-22,12071,11620,451,3.70000000
CN4711300000000,47,113,"Madison County, TN",Jun-22,49745,47646,2099,4.20000000
CN4711500000000,47,115,"Marion County, TN",Jun-22,12514,11923,591,4.70000000
CN4711700000000,47,117,"Marshall County, TN",Jun-22,15564,14910,654,4.20000000
CN4711900000000,47,119,"Maury County, TN",Jun-22,54131,52066,2065,3.80000000
CN4712100000000,47,121,"Meigs County, TN",Jun-22,5170,4902,268,5.20000000
CN4712300000000,47,123,"Monroe County, TN",Jun-22,21176,20295,881,4.20000000
CN4712500000000,47,125,"Montgomery County, TN",Jun-22,89750,85670,4080,4.50000000
CN4712700000000,47,127,"Moore County, TN",Jun-22,3627,3506,121,3.30000000
CN4712900000000,47,129,"Morgan County, TN",Jun-22,8043,7674,369,4.60000000
CN4713100000000,47,131,"Obion County, TN",Jun-22,12364,11755,609,4.90000000
CN4713300000000,47,133,"Overton County, TN",Jun-22,10216,9795,421,4.10000000
CN4713500000000,47,135,"Perry County, TN",Jun-22,2840,2648,192,6.80000000
CN4713700000000,47,137,"Pickett County, TN",Jun-22,2210,2103,107,4.80000000
CN4713900000000,47,139,"Polk County, TN",Jun-22,7225,6910,315,4.40000000
CN4714100000000,47,141,"Putnam County, TN",Jun-22,35244,33770,1474,4.20000000
CN4714300000000,47,143,"Rhea County, TN",Jun-22,13965,13234,731,5.20000000
CN4714500000000,47,145,"Roane County, TN",Jun-22,24334,23222,1112,4.60000000
CN4714700000000,47,147,"Robertson County, TN",Jun-22,40152,38783,1369,3.40000000
CN4714900000000,47,149,"Rutherford County, TN",Jun-22,199233,192600,6633,3.30000000
CN4715100000000,47,151,"Scott County, TN",Jun-22,8177,7670,507,6.20000000
CN4715300000000,47,153,"Sequatchie County, TN",Jun-22,6298,5990,308,4.90000000
CN4715500000000,47,155,"Sevier County, TN",Jun-22,58176,56237,1939,3.30000000
CN4715700000000,47,157,"Shelby County, TN",Jun-22,455322,427625,27697,6.10000000
CN4715900000000,47,159,"Smith County, TN",Jun-22,10003,9634,369,3.70000000
CN4716100000000,47,161,"Stewart County, TN",Jun-22,5444,5190,254,4.70000000
CN4716300000000,47,163,"Sullivan County, TN",Jun-22,69759,66644,3115,4.50000000
CN4716500000000,47,165,"Sumner County, TN",Jun-22,110865,107179,3686,3.30000000
CN4716700000000,47,167,"Tipton County, TN",Jun-22,28545,27293,1252,4.40000000
CN4716900000000,47,169,"Trousdale County, TN",Jun-22,5862,5645,217,3.70000000
CN4717100000000,47,171,"Unicoi County, TN",Jun-22,7272,6893,379,5.20000000
CN4717300000000,47,173,"Union County, TN",Jun-22,8065,7680,385,4.80000000
CN4717500000000,47,175,"Van Buren County, TN",Jun-22,2038,1914,124,6.10000000
CN4717700000000,47,177,"Warren County, TN",Jun-22,16809,15903,906,5.40000000
CN4717900000000,47,179,"Washington County, TN",Jun-22,62389,59928,2461,3.90000000
CN4718100000000,47,181,"Wayne County, TN",Jun-22,6403,6072,331,5.20000000
CN4718300000000,47,183,"Weakley County, TN",Jun-22,15133,14489,644,4.30000000
CN4718500000000,47,185,"White County, TN",Jun-22,11633,11089,544,4.70000000
CN4718700000000,47,187,"Williamson County, TN",Jun-22,140651,136685,3966,2.80000000
CN4718900000000,47,189,"Wilson County, TN",Jun-22,83597,80900,2697,3.20000000
CN4800100000000,48,001,"Anderson County, TX",Jun-22,23333,22481,852,3.70000000
CN4800300000000,48,003,"Andrews County, TX",Jun-22,8691,8340,351,4.00000000
CN4800500000000,48,005,"Angelina County, TX",Jun-22,35734,33885,1849,5.20000000
CN4800700000000,48,007,"Aransas County, TX",Jun-22,9316,8776,540,5.80000000
CN4800900000000,48,009,"Archer County, TX",Jun-22,4035,3887,148,3.70000000
CN4801100000000,48,011,"Armstrong County, TX",Jun-22,926,900,26,2.80000000
CN4801300000000,48,013,"Atascosa County, TX",Jun-22,22309,21274,1035,4.60000000
CN4801500000000,48,015,"Austin County, TX",Jun-22,14154,13537,617,4.40000000
CN4801700000000,48,017,"Bailey County, TX",Jun-22,2382,2266,116,4.90000000
CN4801900000000,48,019,"Bandera County, TX",Jun-22,10480,10084,396,3.80000000
CN4802100000000,48,021,"Bastrop County, TX",Jun-22,46911,45162,1749,3.70000000
CN4802300000000,48,023,"Baylor County, TX",Jun-22,1877,1825,52,2.80000000
CN4802500000000,48,025,"Bee County, TX",Jun-22,8803,8137,666,7.60000000
CN4802700000000,48,027,"Bell County, TX",Jun-22,148360,141223,7137,4.80000000
CN4802900000000,48,029,"Bexar County, TX",Jun-22,965949,926524,39425,4.10000000
CN4803100000000,48,031,"Blanco County, TX",Jun-22,7123,6917,206,2.90000000
CN4803300000000,48,033,"Borden County, TX",Jun-22,655,643,12,1.80000000
CN4803500000000,48,035,"Bosque County, TX",Jun-22,8659,8319,340,3.90000000
CN4803700000000,48,037,"Bowie County, TX",Jun-22,39434,37491,1943,4.90000000
CN4803900000000,48,039,"Brazoria County, TX",Jun-22,185584,175628,9956,5.40000000
CN4804100000000,48,041,"Brazos County, TX",Jun-22,120413,116124,4289,3.60000000
CN4804300000000,48,043,"Brewster County, TX",Jun-22,4143,3992,151,3.60000000
CN4804500000000,48,045,"Briscoe County, TX",Jun-22,590,570,20,3.40000000
CN4804700000000,48,047,"Brooks County, TX",Jun-22,2500,2317,183,7.30000000
CN4804900000000,48,049,"Brown County, TX",Jun-22,15127,14467,660,4.40000000
CN4805100000000,48,051,"Burleson County, TX",Jun-22,8322,7997,325,3.90000000
CN4805300000000,48,053,"Burnet County, TX",Jun-22,25033,24260,773,3.10000000
CN4805500000000,48,055,"Caldwell County, TX",Jun-22,20749,19926,823,4.00000000
CN4805700000000,48,057,"Calhoun County, TX",Jun-22,12078,11563,515,4.30000000
CN4805900000000,48,059,"Callahan County, TX",Jun-22,6144,5916,228,3.70000000
CN4806100000000,48,061,"Cameron County, TX",Jun-22,175459,163326,12133,6.90000000
CN4806300000000,48,063,"Camp County, TX",Jun-22,5183,4928,255,4.90000000
CN4806500000000,48,065,"Carson County, TX",Jun-22,2969,2880,89,3.00000000
CN4806700000000,48,067,"Cass County, TX",Jun-22,12235,11585,650,5.30000000
CN4806900000000,48,069,"Castro County, TX",Jun-22,3391,3281,110,3.20000000
CN4807100000000,48,071,"Chambers County, TX",Jun-22,21207,19849,1358,6.40000000
CN4807300000000,48,073,"Cherokee County, TX",Jun-22,20503,19476,1027,5.00000000
CN4807500000000,48,075,"Childress County, TX",Jun-22,2898,2804,94,3.20000000
CN4807700000000,48,077,"Clay County, TX",Jun-22,4886,4690,196,4.00000000
CN4807900000000,48,079,"Cochran County, TX",Jun-22,1076,1015,61,5.70000000
CN4808100000000,48,081,"Coke County, TX",Jun-22,1379,1322,57,4.10000000
CN4808300000000,48,083,"Coleman County, TX",Jun-22,2949,2813,136,4.60000000
CN4808500000000,48,085,"Collin County, TX",Jun-22,628876,607803,21073,3.40000000
CN4808700000000,48,087,"Collingsworth County, TX",Jun-22,1109,1070,39,3.50000000
CN4808900000000,48,089,"Colorado County, TX",Jun-22,10304,9931,373,3.60000000
CN4809100000000,48,091,"Comal County, TX",Jun-22,81207,78144,3063,3.80000000
CN4809300000000,48,093,"Comanche County, TX",Jun-22,6249,6018,231,3.70000000
CN4809500000000,48,095,"Concho County, TX",Jun-22,1367,1321,46,3.40000000
CN4809700000000,48,097,"Cooke County, TX",Jun-22,19771,18938,833,4.20000000
CN4809900000000,48,099,"Coryell County, TX",Jun-22,24512,23329,1183,4.80000000
CN4810100000000,48,101,"Cottle County, TX",Jun-22,646,621,25,3.90000000
CN4810300000000,48,103,"Crane County, TX",Jun-22,1552,1448,104,6.70000000
CN4810500000000,48,105,"Crockett County, TX",Jun-22,1414,1350,64,4.50000000
CN4810700000000,48,107,"Crosby County, TX",Jun-22,2412,2305,107,4.40000000
CN4810900000000,48,109,"Culberson County, TX",Jun-22,1079,1043,36,3.30000000
CN4811100000000,48,111,"Dallam County, TX",Jun-22,3791,3701,90,2.40000000
CN4811300000000,48,113,"Dallas County, TX",Jun-22,1431325,1373261,58064,4.10000000
CN4811500000000,48,115,"Dawson County, TX",Jun-22,4480,4245,235,5.20000000
CN4811700000000,48,117,"Deaf Smith County, TX",Jun-22,8975,8680,295,3.30000000
CN4811900000000,48,119,"Delta County, TX",Jun-22,2453,2347,106,4.30000000
CN4812100000000,48,121,"Denton County, TX",Jun-22,554749,535837,18912,3.40000000
CN4812300000000,48,123,"DeWitt County, TX",Jun-22,9496,9155,341,3.60000000
CN4812500000000,48,125,"Dickens County, TX",Jun-22,768,733,35,4.60000000
CN4812700000000,48,127,"Dimmit County, TX",Jun-22,5607,5321,286,5.10000000
CN4812900000000,48,129,"Donley County, TX",Jun-22,1499,1442,57,3.80000000
CN4813100000000,48,131,"Duval County, TX",Jun-22,5459,5157,302,5.50000000
CN4813300000000,48,133,"Eastland County, TX",Jun-22,6987,6637,350,5.00000000
CN4813500000000,48,135,"Ector County, TX",Jun-22,81030,76713,4317,5.30000000
CN4813700000000,48,137,"Edwards County, TX",Jun-22,1293,1257,36,2.80000000
CN4813900000000,48,139,"Ellis County, TX",Jun-22,103912,100109,3803,3.70000000
CN4814100000000,48,141,"El Paso County, TX",Jun-22,361868,344167,17701,4.90000000
CN4814300000000,48,143,"Erath County, TX",Jun-22,20701,19888,813,3.90000000
CN4814500000000,48,145,"Falls County, TX",Jun-22,6776,6476,300,4.40000000
CN4814700000000,48,147,"Fannin County, TX",Jun-22,17352,16766,586,3.40000000
CN4814900000000,48,149,"Fayette County, TX",Jun-22,11749,11315,434,3.70000000
CN4815100000000,48,151,"Fisher County, TX",Jun-22,1590,1529,61,3.80000000
CN4815300000000,48,153,"Floyd County, TX",Jun-22,2488,2373,115,4.60000000
CN4815500000000,48,155,"Foard County, TX",Jun-22,613,597,16,2.60000000
CN4815700000000,48,157,"Fort Bend County, TX",Jun-22,419709,401110,18599,4.40000000
CN4815900000000,48,159,"Franklin County, TX",Jun-22,5170,4987,183,3.50000000
CN4816100000000,48,161,"Freestone County, TX",Jun-22,6264,5869,395,6.30000000
CN4816300000000,48,163,"Frio County, TX",Jun-22,9400,9042,358,3.80000000
CN4816500000000,48,165,"Gaines County, TX",Jun-22,9755,9424,331,3.40000000
CN4816700000000,48,167,"Galveston County, TX",Jun-22,169858,161204,8654,5.10000000
CN4816900000000,48,169,"Garza County, TX",Jun-22,1983,1905,78,3.90000000
CN4817100000000,48,171,"Gillespie County, TX",Jun-22,14910,14512,398,2.70000000
CN4817300000000,48,173,"Glasscock County, TX",Jun-22,831,806,25,3.00000000
CN4817500000000,48,175,"Goliad County, TX",Jun-22,3122,2964,158,5.10000000
CN4817700000000,48,177,"Gonzales County, TX",Jun-22,9586,9257,329,3.40000000
CN4817900000000,48,179,"Gray County, TX",Jun-22,7779,7383,396,5.10000000
CN4818100000000,48,181,"Grayson County, TX",Jun-22,67007,64469,2538,3.80000000
CN4818300000000,48,183,"Gregg County, TX",Jun-22,56706,53943,2763,4.90000000
CN4818500000000,48,185,"Grimes County, TX",Jun-22,11032,10414,618,5.60000000
CN4818700000000,48,187,"Guadalupe County, TX",Jun-22,84388,81325,3063,3.60000000
CN4818900000000,48,189,"Hale County, TX",Jun-22,11970,11278,692,5.80000000
CN4819100000000,48,191,"Hall County, TX",Jun-22,1085,1040,45,4.10000000
CN4819300000000,48,193,"Hamilton County, TX",Jun-22,3775,3640,135,3.60000000
CN4819500000000,48,195,"Hansford County, TX",Jun-22,2633,2562,71,2.70000000
CN4819700000000,48,197,"Hardeman County, TX",Jun-22,1719,1654,65,3.80000000
CN4819900000000,48,199,"Hardin County, TX",Jun-22,24941,23388,1553,6.20000000
CN4820100000000,48,201,"Harris County, TX",Jun-22,2349000,2234804,114196,4.90000000
CN4820300000000,48,203,"Harrison County, TX",Jun-22,28390,26881,1509,5.30000000
CN4820500000000,48,205,"Hartley County, TX",Jun-22,2761,2710,51,1.80000000
CN4820700000000,48,207,"Haskell County, TX",Jun-22,2768,2682,86,3.10000000
CN4820900000000,48,209,"Hays County, TX",Jun-22,134721,130284,4437,3.30000000
CN4821100000000,48,211,"Hemphill County, TX",Jun-22,1578,1521,57,3.60000000
CN4821300000000,48,213,"Henderson County, TX",Jun-22,39094,37502,1592,4.10000000
CN4821500000000,48,215,"Hidalgo County, TX",Jun-22,371401,341457,29944,8.10000000
CN4821700000000,48,217,"Hill County, TX",Jun-22,17033,16326,707,4.20000000
CN4821900000000,48,219,"Hockley County, TX",Jun-22,10960,10491,469,4.30000000
CN4822100000000,48,221,"Hood County, TX",Jun-22,29625,28464,1161,3.90000000
CN4822300000000,48,223,"Hopkins County, TX",Jun-22,17975,17347,628,3.50000000
CN4822500000000,48,225,"Houston County, TX",Jun-22,10797,10388,409,3.80000000
CN4822700000000,48,227,"Howard County, TX",Jun-22,13516,12745,771,5.70000000
CN4822900000000,48,229,"Hudspeth County, TX",Jun-22,1847,1767,80,4.30000000
CN4823100000000,48,231,"Hunt County, TX",Jun-22,47081,45158,1923,4.10000000
CN4823300000000,48,233,"Hutchinson County, TX",Jun-22,8321,7910,411,4.90000000
CN4823500000000,48,235,"Irion County, TX",Jun-22,776,751,25,3.20000000
CN4823700000000,48,237,"Jack County, TX",Jun-22,3457,3316,141,4.10000000
CN4823900000000,48,239,"Jackson County, TX",Jun-22,7059,6792,267,3.80000000
CN4824100000000,48,241,"Jasper County, TX",Jun-22,12853,11859,994,7.70000000
CN4824300000000,48,243,"Jeff Davis County, TX",Jun-22,1059,1026,33,3.10000000
CN4824500000000,48,245,"Jefferson County, TX",Jun-22,101699,93924,7775,7.60000000
CN4824700000000,48,247,"Jim Hogg County, TX",Jun-22,1808,1688,120,6.60000000
CN4824900000000,48,249,"Jim Wells County, TX",Jun-22,15418,14285,1133,7.30000000
CN4825100000000,48,251,"Johnson County, TX",Jun-22,88201,84856,3345,3.80000000
CN4825300000000,48,253,"Jones County, TX",Jun-22,5736,5444,292,5.10000000
CN4825500000000,48,255,"Karnes County, TX",Jun-22,6879,6625,254,3.70000000
CN4825700000000,48,257,"Kaufman County, TX",Jun-22,75527,72564,2963,3.90000000
CN4825900000000,48,259,"Kendall County, TX",Jun-22,23443,22671,772,3.30000000
CN4826100000000,48,261,"Kenedy County, TX",Jun-22,189,179,10,5.30000000
CN4826300000000,48,263,"Kent County, TX",Jun-22,461,449,12,2.60000000
CN4826500000000,48,265,"Kerr County, TX",Jun-22,22066,21242,824,3.70000000
CN4826700000000,48,267,"Kimble County, TX",Jun-22,1926,1864,62,3.20000000
CN4826900000000,48,269,"King County, TX",Jun-22,627,621,6,1.00000000
CN4827100000000,48,271,"Kinney County, TX",Jun-22,1179,1117,62,5.30000000
CN4827300000000,48,273,"Kleberg County, TX",Jun-22,12905,12171,734,5.70000000
CN4827500000000,48,275,"Knox County, TX",Jun-22,1467,1408,59,4.00000000
CN4827700000000,48,277,"Lamar County, TX",Jun-22,24093,23010,1083,4.50000000
CN4827900000000,48,279,"Lamb County, TX",Jun-22,5290,5061,229,4.30000000
CN4828100000000,48,281,"Lampasas County, TX",Jun-22,9348,8991,357,3.80000000
CN4828300000000,48,283,"La Salle County, TX",Jun-22,3776,3635,141,3.70000000
CN4828500000000,48,285,"Lavaca County, TX",Jun-22,8631,8313,318,3.70000000
CN4828700000000,48,287,"Lee County, TX",Jun-22,9101,8766,335,3.70000000
CN4828900000000,48,289,"Leon County, TX",Jun-22,6181,5823,358,5.80000000
CN4829100000000,48,291,"Liberty County, TX",Jun-22,35685,33143,2542,7.10000000
CN4829300000000,48,293,"Limestone County, TX",Jun-22,8661,8220,441,5.10000000
CN4829500000000,48,295,"Lipscomb County, TX",Jun-22,1499,1453,46,3.10000000
CN4829700000000,48,297,"Live Oak County, TX",Jun-22,4752,4502,250,5.30000000
CN4829900000000,48,299,"Llano County, TX",Jun-22,9197,8833,364,4.00000000
CN4830100000000,48,301,"Loving County, TX",Jun-22,511,507,4,0.80000000
CN4830300000000,48,303,"Lubbock County, TX",Jun-22,162694,156473,6221,3.80000000
CN4830500000000,48,305,"Lynn County, TX",Jun-22,2863,2750,113,3.90000000
CN4830700000000,48,307,"McCulloch County, TX",Jun-22,3072,2921,151,4.90000000
CN4830900000000,48,309,"McLennan County, TX",Jun-22,125738,120768,4970,4.00000000
CN4831100000000,48,311,"McMullen County, TX",Jun-22,779,762,17,2.20000000
CN4831300000000,48,313,"Madison County, TX",Jun-22,4776,4535,241,5.00000000
CN4831500000000,48,315,"Marion County, TX",Jun-22,4263,4025,238,5.60000000
CN4831700000000,48,317,"Martin County, TX",Jun-22,2693,2594,99,3.70000000
CN4831900000000,48,319,"Mason County, TX",Jun-22,1859,1795,64,3.40000000
CN4832100000000,48,321,"Matagorda County, TX",Jun-22,16446,15182,1264,7.70000000
CN4832300000000,48,323,"Maverick County, TX",Jun-22,22959,20769,2190,9.50000000
CN4832500000000,48,325,"Medina County, TX",Jun-22,22410,21480,930,4.10000000
CN4832700000000,48,327,"Menard County, TX",Jun-22,809,779,30,3.70000000
CN4832900000000,48,329,"Midland County, TX",Jun-22,101570,97889,3681,3.60000000
CN4833100000000,48,331,"Milam County, TX",Jun-22,10321,9832,489,4.70000000
CN4833300000000,48,333,"Mills County, TX",Jun-22,1896,1819,77,4.10000000
CN4833500000000,48,335,"Mitchell County, TX",Jun-22,2301,2181,120,5.20000000
CN4833700000000,48,337,"Montague County, TX",Jun-22,9401,9028,373,4.00000000
CN4833900000000,48,339,"Montgomery County, TX",Jun-22,302483,289307,13176,4.40000000
CN4834100000000,48,341,"Moore County, TX",Jun-22,11067,10758,309,2.80000000
CN4834300000000,48,343,"Morris County, TX",Jun-22,4367,4023,344,7.90000000
CN4834500000000,48,345,"Motley County, TX",Jun-22,459,437,22,4.80000000
CN4834700000000,48,347,"Nacogdoches County, TX",Jun-22,28106,26816,1290,4.60000000
CN4834900000000,48,349,"Navarro County, TX",Jun-22,23610,22631,979,4.10000000
CN4835100000000,48,351,"Newton County, TX",Jun-22,4901,4505,396,8.10000000
CN4835300000000,48,353,"Nolan County, TX",Jun-22,6964,6691,273,3.90000000
CN4835500000000,48,355,"Nueces County, TX",Jun-22,164880,155796,9084,5.50000000
CN4835700000000,48,357,"Ochiltree County, TX",Jun-22,4010,3869,141,3.50000000
CN4835900000000,48,359,"Oldham County, TX",Jun-22,923,897,26,2.80000000
CN4836100000000,48,361,"Orange County, TX",Jun-22,34978,32545,2433,7.00000000
CN4836300000000,48,363,"Palo Pinto County, TX",Jun-22,12776,12241,535,4.20000000
CN4836500000000,48,365,"Panola County, TX",Jun-22,9630,9108,522,5.40000000
CN4836700000000,48,367,"Parker County, TX",Jun-22,73832,71297,2535,3.40000000
CN4836900000000,48,369,"Parmer County, TX",Jun-22,4969,4837,132,2.70000000
CN4837100000000,48,371,"Pecos County, TX",Jun-22,5791,5478,313,5.40000000
CN4837300000000,48,373,"Polk County, TX",Jun-22,18370,17154,1216,6.60000000
CN4837500000000,48,375,"Potter County, TX",Jun-22,54300,52405,1895,3.50000000
CN4837700000000,48,377,"Presidio County, TX",Jun-22,3106,2861,245,7.90000000
CN4837900000000,48,379,"Rains County, TX",Jun-22,6625,6402,223,3.40000000
CN4838100000000,48,381,"Randall County, TX",Jun-22,74886,72637,2249,3.00000000
CN4838300000000,48,383,"Reagan County, TX",Jun-22,1562,1487,75,4.80000000
CN4838500000000,48,385,"Real County, TX",Jun-22,1198,1141,57,4.80000000
CN4838700000000,48,387,"Red River County, TX",Jun-22,5372,5086,286,5.30000000
CN4838900000000,48,389,"Reeves County, TX",Jun-22,9166,8863,303,3.30000000
CN4839100000000,48,391,"Refugio County, TX",Jun-22,3051,2880,171,5.60000000
CN4839300000000,48,393,"Roberts County, TX",Jun-22,405,389,16,4.00000000
CN4839500000000,48,395,"Robertson County, TX",Jun-22,7525,7180,345,4.60000000
CN4839700000000,48,397,"Rockwall County, TX",Jun-22,59535,57480,2055,3.50000000
CN4839900000000,48,399,"Runnels County, TX",Jun-22,4670,4505,165,3.50000000
CN4840100000000,48,401,"Rusk County, TX",Jun-22,22310,21272,1038,4.70000000
CN4840300000000,48,403,"Sabine County, TX",Jun-22,4052,3711,341,8.40000000
CN4840500000000,48,405,"San Augustine County, TX",Jun-22,2971,2765,206,6.90000000
CN4840700000000,48,407,"San Jacinto County, TX",Jun-22,12008,11330,678,5.60000000
CN4840900000000,48,409,"San Patricio County, TX",Jun-22,29575,27423,2152,7.30000000
CN4841100000000,48,411,"San Saba County, TX",Jun-22,2118,2034,84,4.00000000
CN4841300000000,48,413,"Schleicher County, TX",Jun-22,1162,1113,49,4.20000000
CN4841500000000,48,415,"Scurry County, TX",Jun-22,5838,5535,303,5.20000000
CN4841700000000,48,417,"Shackelford County, TX",Jun-22,1861,1806,55,3.00000000
CN4841900000000,48,419,"Shelby County, TX",Jun-22,11744,11236,508,4.30000000
CN4842100000000,48,421,"Sherman County, TX",Jun-22,1492,1454,38,2.50000000
CN4842300000000,48,423,"Smith County, TX",Jun-22,110526,106045,4481,4.10000000
CN4842500000000,48,425,"Somervell County, TX",Jun-22,4534,4345,189,4.20000000
CN4842700000000,48,427,"Starr County, TX",Jun-22,24159,20707,3452,14.30000000
CN4842900000000,48,429,"Stephens County, TX",Jun-22,4312,4148,164,3.80000000
CN4843100000000,48,431,"Sterling County, TX",Jun-22,571,551,20,3.50000000
CN4843300000000,48,433,"Stonewall County, TX",Jun-22,604,585,19,3.10000000
CN4843500000000,48,435,"Sutton County, TX",Jun-22,1114,1044,70,6.30000000
CN4843700000000,48,437,"Swisher County, TX",Jun-22,2610,2503,107,4.10000000
CN4843900000000,48,439,"Tarrant County, TX",Jun-22,1130471,1085622,44849,4.00000000
CN4844100000000,48,441,"Taylor County, TX",Jun-22,67313,64901,2412,3.60000000
CN4844300000000,48,443,"Terrell County, TX",Jun-22,437,424,13,3.00000000
CN4844500000000,48,445,"Terry County, TX",Jun-22,4686,4458,228,4.90000000
CN4844700000000,48,447,"Throckmorton County, TX",Jun-22,1447,1421,26,1.80000000
CN4844900000000,48,449,"Titus County, TX",Jun-22,13632,12967,665,4.90000000
CN4845100000000,48,451,"Tom Green County, TX",Jun-22,54285,52242,2043,3.80000000
CN4845300000000,48,453,"Travis County, TX",Jun-22,799467,775283,24184,3.00000000
CN4845500000000,48,455,"Trinity County, TX",Jun-22,5286,4971,315,6.00000000
CN4845700000000,48,457,"Tyler County, TX",Jun-22,7489,6993,496,6.60000000
CN4845900000000,48,459,"Upshur County, TX",Jun-22,17755,16893,862,4.90000000
CN4846100000000,48,461,"Upton County, TX",Jun-22,1773,1698,75,4.20000000
CN4846300000000,48,463,"Uvalde County, TX",Jun-22,11319,10782,537,4.70000000
CN4846500000000,48,465,"Val Verde County, TX",Jun-22,21991,20972,1019,4.60000000
CN4846700000000,48,467,"Van Zandt County, TX",Jun-22,27743,26713,1030,3.70000000
CN4846900000000,48,469,"Victoria County, TX",Jun-22,40317,38329,1988,4.90000000
CN4847100000000,48,471,"Walker County, TX",Jun-22,23550,22257,1293,5.50000000
CN4847300000000,48,473,"Waller County, TX",Jun-22,25567,24294,1273,5.00000000
CN4847500000000,48,475,"Ward County, TX",Jun-22,6204,5914,290,4.70000000
CN4847700000000,48,477,"Washington County, TX",Jun-22,14888,14199,689,4.60000000
CN4847900000000,48,479,"Webb County, TX",Jun-22,118248,112625,5623,4.80000000
CN4848100000000,48,481,"Wharton County, TX",Jun-22,21214,20298,916,4.30000000
CN4848300000000,48,483,"Wheeler County, TX",Jun-22,1957,1870,87,4.40000000
CN4848500000000,48,485,"Wichita County, TX",Jun-22,55771,53394,2377,4.30000000
CN4848700000000,48,487,"Wilbarger County, TX",Jun-22,4734,4466,268,5.70000000
CN4848900000000,48,489,"Willacy County, TX",Jun-22,7259,6522,737,10.20000000
CN4849100000000,48,491,"Williamson County, TX",Jun-22,353998,342925,11073,3.10000000
CN4849300000000,48,493,"Wilson County, TX",Jun-22,25648,24737,911,3.60000000
CN4849500000000,48,495,"Winkler County, TX",Jun-22,3697,3500,197,5.30000000
CN4849700000000,48,497,"Wise County, TX",Jun-22,34049,32705,1344,3.90000000
CN4849900000000,48,499,"Wood County, TX",Jun-22,17877,17001,876,4.90000000
CN4850100000000,48,501,"Yoakum County, TX",Jun-22,3156,2986,170,5.40000000
CN4850300000000,48,503,"Young County, TX",Jun-22,8145,7859,286,3.50000000
CN4850500000000,48,505,"Zapata County, TX",Jun-22,4450,4055,395,8.90000000
CN4850700000000,48,507,"Zavala County, TX",Jun-22,3261,2910,351,10.80000000
CN4900100000000,49,001,"Beaver County, UT",Jun-22,2912,2833,79,2.70000000
CN4900300000000,49,003,"Box Elder County, UT",Jun-22,27705,27073,632,2.30000000
CN4900500000000,49,005,"Cache County, UT",Jun-22,70180,68639,1541,2.20000000
CN4900700000000,49,007,"Carbon County, UT",Jun-22,8522,8219,303,3.60000000
CN4900900000000,49,009,"Daggett County, UT",Jun-22,463,445,18,3.90000000
CN4901100000000,49,011,"Davis County, UT",Jun-22,185054,180875,4179,2.30000000
CN4901300000000,49,013,"Duchesne County, UT",Jun-22,8129,7842,287,3.50000000
CN4901500000000,49,015,"Emery County, UT",Jun-22,4615,4463,152,3.30000000
CN4901700000000,49,017,"Garfield County, UT",Jun-22,3238,3096,142,4.40000000
CN4901900000000,49,019,"Grand County, UT",Jun-22,7383,7215,168,2.30000000
CN4902100000000,49,021,"Iron County, UT",Jun-22,27259,26545,714,2.60000000
CN4902300000000,49,023,"Juab County, UT",Jun-22,6392,6260,132,2.10000000
CN4902500000000,49,025,"Kane County, UT",Jun-22,4398,4309,89,2.00000000
CN4902700000000,49,027,"Millard County, UT",Jun-22,6280,6139,141,2.20000000
CN4902900000000,49,029,"Morgan County, UT",Jun-22,5974,5847,127,2.10000000
CN4903100000000,49,031,"Piute County, UT",Jun-22,503,485,18,3.60000000
CN4903300000000,49,033,"Rich County, UT",Jun-22,1654,1613,41,2.50000000
CN4903500000000,49,035,"Salt Lake County, UT",Jun-22,671358,655245,16113,2.40000000
CN4903700000000,49,037,"San Juan County, UT",Jun-22,5916,5635,281,4.70000000
CN4903900000000,49,039,"Sanpete County, UT",Jun-22,13629,13226,403,3.00000000
CN4904100000000,49,041,"Sevier County, UT",Jun-22,10179,9886,293,2.90000000
CN4904300000000,49,043,"Summit County, UT",Jun-22,25764,25176,588,2.30000000
CN4904500000000,49,045,"Tooele County, UT",Jun-22,37864,36856,1008,2.70000000
CN4904700000000,49,047,"Uintah County, UT",Jun-22,14014,13408,606,4.30000000
CN4904900000000,49,049,"Utah County, UT",Jun-22,344284,336351,7933,2.30000000
CN4905100000000,49,051,"Wasatch County, UT",Jun-22,17780,17351,429,2.40000000
CN4905300000000,49,053,"Washington County, UT",Jun-22,84290,82146,2144,2.50000000
CN4905500000000,49,055,"Wayne County, UT",Jun-22,1634,1578,56,3.40000000
CN4905700000000,49,057,"Weber County, UT",Jun-22,135663,132311,3352,2.50000000
CN5000100000000,50,001,"Addison County, VT",Jun-22,21327,20862,465,2.20000000
CN5000300000000,50,003,"Bennington County, VT",Jun-22,17419,16875,544,3.10000000
CN5000500000000,50,005,"Caledonia County, VT",Jun-22,14556,14132,424,2.90000000
CN5000700000000,50,007,"Chittenden County, VT",Jun-22,97222,95134,2088,2.10000000
CN5000900000000,50,009,"Essex County, VT",Jun-22,2665,2589,76,2.90000000
CN5001100000000,50,011,"Franklin County, VT",Jun-22,28135,27427,708,2.50000000
CN5001300000000,50,013,"Grand Isle County, VT",Jun-22,4104,3992,112,2.70000000
CN5001500000000,50,015,"Lamoille County, VT",Jun-22,13942,13545,397,2.80000000
CN5001700000000,50,017,"Orange County, VT",Jun-22,15768,15417,351,2.20000000
CN5001900000000,50,019,"Orleans County, VT",Jun-22,13111,12641,470,3.60000000
CN5002100000000,50,021,"Rutland County, VT",Jun-22,29438,28494,944,3.20000000
CN5002300000000,50,023,"Washington County, VT",Jun-22,33522,32723,799,2.40000000
CN5002500000000,50,025,"Windham County, VT",Jun-22,20791,20191,600,2.90000000
CN5002700000000,50,027,"Windsor County, VT",Jun-22,28579,27944,635,2.20000000
CN5100100000000,51,001,"Accomack County, VA",Jun-22,16316,15823,493,3.00000000
CN5100300000000,51,003,"Albemarle County, VA",Jun-22,56161,54584,1577,2.80000000
CN5100500000000,51,005,"Alleghany County, VA",Jun-22,6942,6724,218,3.10000000
CN5100700000000,51,007,"Amelia County, VA",Jun-22,6143,5958,185,3.00000000
CN5100900000000,51,009,"Amherst County, VA",Jun-22,14644,14193,451,3.10000000
CN5101100000000,51,011,"Appomattox County, VA",Jun-22,7074,6845,229,3.20000000
CN5101300000000,51,013,"Arlington County, VA",Jun-22,154470,151182,3288,2.10000000
CN5101500000000,51,015,"Augusta County, VA",Jun-22,37201,36199,1002,2.70000000
CN5101700000000,51,017,"Bath County, VA",Jun-22,2394,2331,63,2.60000000
CN5101900000000,51,019,"Bedford County, VA",Jun-22,37971,36874,1097,2.90000000
CN5102100000000,51,021,"Bland County, VA",Jun-22,2827,2749,78,2.80000000
CN5102300000000,51,023,"Botetourt County, VA",Jun-22,17183,16729,454,2.60000000
CN5102500000000,51,025,"Brunswick County, VA",Jun-22,6081,5797,284,4.70000000
CN5102700000000,51,027,"Buchanan County, VA",Jun-22,6554,6217,337,5.10000000
CN5102900000000,51,029,"Buckingham County, VA",Jun-22,6258,5998,260,4.20000000
CN5103100000000,51,031,"Campbell County, VA",Jun-22,25454,24662,792,3.10000000
CN5103300000000,51,033,"Caroline County, VA",Jun-22,14902,14414,488,3.30000000
CN5103500000000,51,035,"Carroll County, VA",Jun-22,13846,13397,449,3.20000000
CN5103600000000,51,036,"Charles City County, VA",Jun-22,3523,3407,116,3.30000000
CN5103700000000,51,037,"Charlotte County, VA",Jun-22,5789,5625,164,2.80000000
CN5104100000000,51,041,"Chesterfield County, VA",Jun-22,187540,182153,5387,2.90000000
CN5104300000000,51,043,"Clarke County, VA",Jun-22,7634,7430,204,2.70000000
CN5104500000000,51,045,"Craig County, VA",Jun-22,2248,2178,70,3.10000000
CN5104700000000,51,047,"Culpeper County, VA",Jun-22,25231,24532,699,2.80000000
CN5104900000000,51,049,"Cumberland County, VA",Jun-22,4795,4641,154,3.20000000
CN5105100000000,51,051,"Dickenson County, VA",Jun-22,5253,5041,212,4.00000000
CN5105300000000,51,053,"Dinwiddie County, VA",Jun-22,13417,12968,449,3.30000000
CN5105700000000,51,057,"Essex County, VA",Jun-22,5514,5329,185,3.40000000
CN5105900000000,51,059,"Fairfax County, VA",Jun-22,629054,613028,16026,2.50000000
CN5106100000000,51,061,"Fauquier County, VA",Jun-22,37428,36470,958,2.60000000
CN5106300000000,51,063,"Floyd County, VA",Jun-22,8213,8008,205,2.50000000
CN5106500000000,51,065,"Fluvanna County, VA",Jun-22,13709,13336,373,2.70000000
CN5106700000000,51,067,"Franklin County, VA",Jun-22,25811,25030,781,3.00000000
CN5106900000000,51,069,"Frederick County, VA",Jun-22,50099,48875,1224,2.40000000
CN5107100000000,51,071,"Giles County, VA",Jun-22,7768,7524,244,3.10000000
CN5107300000000,51,073,"Gloucester County, VA",Jun-22,19217,18702,515,2.70000000
CN5107500000000,51,075,"Goochland County, VA",Jun-22,11485,11170,315,2.70000000
CN5107700000000,51,077,"Grayson County, VA",Jun-22,8906,8694,212,2.40000000
CN5107900000000,51,079,"Greene County, VA",Jun-22,10276,10021,255,2.50000000
CN5108100000000,51,081,"Greensville County, VA",Jun-22,4512,4363,149,3.30000000
CN5108300000000,51,083,"Halifax County, VA",Jun-22,16314,15708,606,3.70000000
CN5108500000000,51,085,"Hanover County, VA",Jun-22,58276,56792,1484,2.50000000
CN5108700000000,51,087,"Henrico County, VA",Jun-22,179551,174249,5302,3.00000000
CN5108900000000,51,089,"Henry County, VA",Jun-22,25563,24742,821,3.20000000
CN5109100000000,51,091,"Highland County, VA",Jun-22,1341,1313,28,2.10000000
CN5109300000000,51,093,"Isle of Wight County, VA",Jun-22,19429,18869,560,2.90000000
CN5109500000000,51,095,"James City County, VA",Jun-22,36410,35288,1122,3.10000000
CN5109700000000,51,097,"King and Queen County, VA",Jun-22,4020,3915,105,2.60000000
CN5109900000000,51,099,"King George County, VA",Jun-22,14987,14628,359,2.40000000
CN5110100000000,51,101,"King William County, VA",Jun-22,9299,9041,258,2.80000000
CN5110300000000,51,103,"Lancaster County, VA",Jun-22,5803,5628,175,3.00000000
CN5110500000000,51,105,"Lee County, VA",Jun-22,8787,8490,297,3.40000000
CN5110700000000,51,107,"Loudoun County, VA",Jun-22,229000,223374,5626,2.50000000
CN5110900000000,51,109,"Louisa County, VA",Jun-22,21364,20784,580,2.70000000
CN5111100000000,51,111,"Lunenburg County, VA",Jun-22,5365,5187,178,3.30000000
CN5111300000000,51,113,"Madison County, VA",Jun-22,7716,7548,168,2.20000000
CN5111500000000,51,115,"Mathews County, VA",Jun-22,4025,3909,116,2.90000000
CN5111700000000,51,117,"Mecklenburg County, VA",Jun-22,13782,13320,462,3.40000000
CN5111900000000,51,119,"Middlesex County, VA",Jun-22,5527,5378,149,2.70000000
CN5112100000000,51,121,"Montgomery County, VA",Jun-22,49579,48122,1457,2.90000000
CN5112500000000,51,125,"Nelson County, VA",Jun-22,7180,6972,208,2.90000000
CN5112700000000,51,127,"New Kent County, VA",Jun-22,12837,12525,312,2.40000000
CN5113100000000,51,131,"Northampton County, VA",Jun-22,5929,5731,198,3.30000000
CN5113300000000,51,133,"Northumberland County, VA",Jun-22,5994,5804,190,3.20000000
CN5113500000000,51,135,"Nottoway County, VA",Jun-22,7491,7269,222,3.00000000
CN5113700000000,51,137,"Orange County, VA",Jun-22,17992,17459,533,3.00000000
CN5113900000000,51,139,"Page County, VA",Jun-22,12897,12504,393,3.00000000
CN5114100000000,51,141,"Patrick County, VA",Jun-22,7519,7250,269,3.60000000
CN5114300000000,51,143,"Pittsylvania County, VA",Jun-22,31906,30917,989,3.10000000
CN5114500000000,51,145,"Powhatan County, VA",Jun-22,14212,13845,367,2.60000000
CN5114700000000,51,147,"Prince Edward County, VA",Jun-22,11171,10734,437,3.90000000
CN5114900000000,51,149,"Prince George County, VA",Jun-22,14927,14406,521,3.50000000
CN5115300000000,51,153,"Prince William County, VA",Jun-22,247241,240270,6971,2.80000000
CN5115500000000,51,155,"Pulaski County, VA",Jun-22,15866,15361,505,3.20000000
CN5115700000000,51,157,"Rappahannock County, VA",Jun-22,3682,3587,95,2.60000000
CN5115900000000,51,159,"Richmond County, VA",Jun-22,4220,4117,103,2.40000000
CN5116100000000,51,161,"Roanoke County, VA",Jun-22,48312,47024,1288,2.70000000
CN5116300000000,51,163,"Rockbridge County, VA",Jun-22,11384,11070,314,2.80000000
CN5116500000000,51,165,"Rockingham County, VA",Jun-22,41918,40775,1143,2.70000000
CN5116700000000,51,167,"Russell County, VA",Jun-22,11565,11183,382,3.30000000
CN5116900000000,51,169,"Scott County, VA",Jun-22,8951,8669,282,3.20000000
CN5117100000000,51,171,"Shenandoah County, VA",Jun-22,23360,22748,612,2.60000000
CN5117300000000,51,173,"Smyth County, VA",Jun-22,15517,15091,426,2.70000000
CN5117500000000,51,175,"Southampton County, VA",Jun-22,9328,9075,253,2.70000000
CN5117700000000,51,177,"Spotsylvania County, VA",Jun-22,68426,66387,2039,3.00000000
CN5117900000000,51,179,"Stafford County, VA",Jun-22,74528,72373,2155,2.90000000
CN5118100000000,51,181,"Surry County, VA",Jun-22,3624,3513,111,3.10000000
CN5118300000000,51,183,"Sussex County, VA",Jun-22,3687,3517,170,4.60000000
CN5118500000000,51,185,"Tazewell County, VA",Jun-22,16375,15760,615,3.80000000
CN5118700000000,51,187,"Warren County, VA",Jun-22,20443,19868,575,2.80000000
CN5119100000000,51,191,"Washington County, VA",Jun-22,25666,24871,795,3.10000000
CN5119300000000,51,193,"Westmoreland County, VA",Jun-22,10349,10042,307,3.00000000
CN5119500000000,51,195,"Wise County, VA",Jun-22,14542,13980,562,3.90000000
CN5119700000000,51,197,"Wythe County, VA",Jun-22,14835,14401,434,2.90000000
CN5119900000000,51,199,"York County, VA",Jun-22,32627,31698,929,2.80000000
CN5151000000000,51,510,"Alexandria city, VA",Jun-22,99269,96864,2405,2.40000000
CN5152000000000,51,520,"Bristol city, VA",Jun-22,7343,7078,265,3.60000000
CN5153000000000,51,530,"Buena Vista city, VA",Jun-22,3142,3037,105,3.30000000
CN5154000000000,51,540,"Charlottesville city, VA",Jun-22,24833,24113,720,2.90000000
CN5155000000000,51,550,"Chesapeake city, VA",Jun-22,121913,118235,3678,3.00000000
CN5157000000000,51,570,"Colonial Heights city, VA",Jun-22,8273,7991,282,3.40000000
CN5158000000000,51,580,"Covington city, VA",Jun-22,2419,2324,95,3.90000000
CN5159000000000,51,590,"Danville city, VA",Jun-22,19725,18748,977,5.00000000
CN5159500000000,51,595,"Emporia city, VA",Jun-22,2497,2366,131,5.20000000
CN5160000000000,51,600,"Fairfax city, VA",Jun-22,12708,12391,317,2.50000000
CN5161000000000,51,610,"Falls Church city, VA",Jun-22,8423,8234,189,2.20000000
CN5162000000000,51,620,"Franklin city, VA",Jun-22,3591,3429,162,4.50000000
CN5163000000000,51,630,"Fredericksburg city, VA",Jun-22,14164,13666,498,3.50000000
CN5164000000000,51,640,"Galax city, VA",Jun-22,3053,2958,95,3.10000000
CN5165000000000,51,650,"Hampton city, VA",Jun-22,63479,60867,2612,4.10000000
CN5166000000000,51,660,"Harrisonburg city, VA",Jun-22,24173,23263,910,3.80000000
CN5167000000000,51,670,"Hopewell city, VA",Jun-22,9392,8915,477,5.10000000
CN5167800000000,51,678,"Lexington city, VA",Jun-22,2244,2143,101,4.50000000
CN5168000000000,51,680,"Lynchburg city, VA",Jun-22,35279,33808,1471,4.20000000
CN5168300000000,51,683,"Manassas city, VA",Jun-22,21420,20835,585,2.70000000
CN5168500000000,51,685,"Manassas Park city, VA",Jun-22,9643,9395,248,2.60000000
CN5169000000000,51,690,"Martinsville city, VA",Jun-22,5915,5623,292,4.90000000
CN5170000000000,51,700,"Newport News city, VA",Jun-22,87168,83714,3454,4.00000000
CN5171000000000,51,710,"Norfolk city, VA",Jun-22,108614,104412,4202,3.90000000
CN5172000000000,51,720,"Norton city, VA",Jun-22,1801,1731,70,3.90000000
CN5173000000000,51,730,"Petersburg city, VA",Jun-22,12360,11525,835,6.80000000
CN5173500000000,51,735,"Poquoson city, VA",Jun-22,6295,6132,163,2.60000000
CN5174000000000,51,740,"Portsmouth city, VA",Jun-22,43597,41640,1957,4.50000000
CN5175000000000,51,750,"Radford city, VA",Jun-22,8572,8245,327,3.80000000
CN5176000000000,51,760,"Richmond city, VA",Jun-22,117282,112866,4416,3.80000000
CN5177000000000,51,770,"Roanoke city, VA",Jun-22,47595,45956,1639,3.40000000
CN5177500000000,51,775,"Salem city, VA",Jun-22,12497,12119,378,3.00000000
CN5179000000000,51,790,"Staunton city, VA",Jun-22,12039,11680,359,3.00000000
CN5180000000000,51,800,"Suffolk city, VA",Jun-22,44913,43456,1457,3.20000000
CN5181000000000,51,810,"Virginia Beach city, VA",Jun-22,227956,221429,6527,2.90000000
CN5182000000000,51,820,"Waynesboro city, VA",Jun-22,10440,10114,326,3.10000000
CN5183000000000,51,830,"Williamsburg city, VA",Jun-22,6709,6416,293,4.40000000
CN5184000000000,51,840,"Winchester city, VA",Jun-22,14736,14334,402,2.70000000
CN5300100000000,53,001,"Adams County, WA",Jun-22,10920,10517,403,3.70000000
CN5300300000000,53,003,"Asotin County, WA",Jun-22,10588,10205,383,3.60000000
CN5300500000000,53,005,"Benton County, WA",Jun-22,110618,105749,4869,4.40000000
CN5300700000000,53,007,"Chelan County, WA",Jun-22,46163,44300,1863,4.00000000
CN5300900000000,53,009,"Clallam County, WA",Jun-22,29742,28157,1585,5.30000000
CN5301100000000,53,011,"Clark County, WA",Jun-22,250723,239607,11116,4.40000000
CN5301300000000,53,013,"Columbia County, WA",Jun-22,1808,1728,80,4.40000000
CN5301500000000,53,015,"Cowlitz County, WA",Jun-22,49341,46717,2624,5.30000000
CN5301700000000,53,017,"Douglas County, WA",Jun-22,23182,22154,1028,4.40000000
CN5301900000000,53,019,"Ferry County, WA",Jun-22,2356,2168,188,8.00000000
CN5302100000000,53,021,"Franklin County, WA",Jun-22,47416,44929,2487,5.20000000
CN5302300000000,53,023,"Garfield County, WA",Jun-22,826,777,49,5.90000000
CN5302500000000,53,025,"Grant County, WA",Jun-22,49364,46821,2543,5.20000000
CN5302700000000,53,027,"Grays Harbor County, WA",Jun-22,28581,26676,1905,6.70000000
CN5302900000000,53,029,"Island County, WA",Jun-22,36529,34864,1665,4.60000000
CN5303100000000,53,031,"Jefferson County, WA",Jun-22,12964,12303,661,5.10000000
CN5303300000000,53,033,"King County, WA",Jun-22,1325794,1290557,35237,2.70000000
CN5303500000000,53,035,"Kitsap County, WA",Jun-22,129050,123662,5388,4.20000000
CN5303700000000,53,037,"Kittitas County, WA",Jun-22,21769,20548,1221,5.60000000
CN5303900000000,53,039,"Klickitat County, WA",Jun-22,10272,9753,519,5.10000000
CN5304100000000,53,041,"Lewis County, WA",Jun-22,35097,33170,1927,5.50000000
CN5304300000000,53,043,"Lincoln County, WA",Jun-22,4424,4217,207,4.70000000
CN5304500000000,53,045,"Mason County, WA",Jun-22,25506,23996,1510,5.90000000
CN5304700000000,53,047,"Okanogan County, WA",Jun-22,19851,18780,1071,5.40000000
CN5304900000000,53,049,"Pacific County, WA",Jun-22,8381,7828,553,6.60000000
CN5305100000000,53,051,"Pend Oreille County, WA",Jun-22,5173,4862,311,6.00000000
CN5305300000000,53,053,"Pierce County, WA",Jun-22,449881,427790,22091,4.90000000
CN5305500000000,53,055,"San Juan County, WA",Jun-22,7842,7525,317,4.00000000
CN5305700000000,53,057,"Skagit County, WA",Jun-22,62746,59623,3123,5.00000000
CN5305900000000,53,059,"Skamania County, WA",Jun-22,5571,5300,271,4.90000000
CN5306100000000,53,061,"Snohomish County, WA",Jun-22,452050,438280,13770,3.00000000
CN5306300000000,53,063,"Spokane County, WA",Jun-22,264652,253320,11332,4.30000000
CN5306500000000,53,065,"Stevens County, WA",Jun-22,19261,18173,1088,5.60000000
CN5306700000000,53,067,"Thurston County, WA",Jun-22,145666,139283,6383,4.40000000
CN5306900000000,53,069,"Wahkiakum County, WA",Jun-22,1351,1267,84,6.20000000
CN5307100000000,53,071,"Walla Walla County, WA",Jun-22,31719,30410,1309,4.10000000
CN5307300000000,53,073,"Whatcom County, WA",Jun-22,116113,110656,5457,4.70000000
CN5307500000000,53,075,"Whitman County, WA",Jun-22,20117,19020,1097,5.50000000
CN5307700000000,53,077,"Yakima County, WA",Jun-22,139236,131759,7477,5.40000000
CN5400100000000,54,001,"Barbour County, WV",Jun-22,7297,6944,353,4.80000000
CN5400300000000,54,003,"Berkeley County, WV",Jun-22,61929,59989,1940,3.10000000
CN5400500000000,54,005,"Boone County, WV",Jun-22,7458,7068,390,5.20000000
CN5400700000000,54,007,"Braxton County, WV",Jun-22,5163,4840,323,6.30000000
CN5400900000000,54,009,"Brooke County, WV",Jun-22,10159,9627,532,5.20000000
CN5401100000000,54,011,"Cabell County, WV",Jun-22,42217,40515,1702,4.00000000
CN5401300000000,54,013,"Calhoun County, WV",Jun-22,2640,2452,188,7.10000000
CN5401500000000,54,015,"Clay County, WV",Jun-22,3117,2912,205,6.60000000
CN5401700000000,54,017,"Doddridge County, WV",Jun-22,3877,3753,124,3.20000000
CN5401900000000,54,019,"Fayette County, WV",Jun-22,16739,15891,848,5.10000000
CN5402100000000,54,021,"Gilmer County, WV",Jun-22,2318,2179,139,6.00000000
CN5402300000000,54,023,"Grant County, WV",Jun-22,6136,5916,220,3.60000000
CN5402500000000,54,025,"Greenbrier County, WV",Jun-22,16076,15415,661,4.10000000
CN5402700000000,54,027,"Hampshire County, WV",Jun-22,11319,11008,311,2.70000000
CN5402900000000,54,029,"Hancock County, WV",Jun-22,13412,12675,737,5.50000000
CN5403100000000,54,031,"Hardy County, WV",Jun-22,5831,5594,237,4.10000000
CN5403300000000,54,033,"Harrison County, WV",Jun-22,34648,33351,1297,3.70000000
CN5403500000000,54,035,"Jackson County, WV",Jun-22,12480,11921,559,4.50000000
CN5403700000000,54,037,"Jefferson County, WV",Jun-22,31567,30686,881,2.80000000
CN5403900000000,54,039,"Kanawha County, WV",Jun-22,83788,80424,3364,4.00000000
CN5404100000000,54,041,"Lewis County, WV",Jun-22,6273,5940,333,5.30000000
CN5404300000000,54,043,"Lincoln County, WV",Jun-22,7201,6792,409,5.70000000
CN5404500000000,54,045,"Logan County, WV",Jun-22,11403,10807,596,5.20000000
CN5404700000000,54,047,"McDowell County, WV",Jun-22,4416,4087,329,7.50000000
CN5404900000000,54,049,"Marion County, WV",Jun-22,25715,24450,1265,4.90000000
CN5405100000000,54,051,"Marshall County, WV",Jun-22,13730,13049,681,5.00000000
CN5405300000000,54,053,"Mason County, WV",Jun-22,10319,9805,514,5.00000000
CN5405500000000,54,055,"Mercer County, WV",Jun-22,21400,20305,1095,5.10000000
CN5405700000000,54,057,"Mineral County, WV",Jun-22,12351,11849,502,4.10000000
CN5405900000000,54,059,"Mingo County, WV",Jun-22,6187,5754,433,7.00000000
CN5406100000000,54,061,"Monongalia County, WV",Jun-22,57037,54853,2184,3.80000000
CN5406300000000,54,063,"Monroe County, WV",Jun-22,6342,5992,350,5.50000000
CN5406500000000,54,065,"Morgan County, WV",Jun-22,8788,8528,260,3.00000000
CN5406700000000,54,067,"Nicholas County, WV",Jun-22,9423,8962,461,4.90000000
CN5406900000000,54,069,"Ohio County, WV",Jun-22,20984,20093,891,4.20000000
CN5407100000000,54,071,"Pendleton County, WV",Jun-22,3859,3757,102,2.60000000
CN5407300000000,54,073,"Pleasants County, WV",Jun-22,2756,2593,163,5.90000000
CN5407500000000,54,075,"Pocahontas County, WV",Jun-22,4459,4315,144,3.20000000
CN5407700000000,54,077,"Preston County, WV",Jun-22,15903,15235,668,4.20000000
CN5407900000000,54,079,"Putnam County, WV",Jun-22,27440,26411,1029,3.80000000
CN5408100000000,54,081,"Raleigh County, WV",Jun-22,31475,30252,1223,3.90000000
CN5408300000000,54,083,"Randolph County, WV",Jun-22,12081,11519,562,4.70000000
CN5408500000000,54,085,"Ritchie County, WV",Jun-22,4413,4231,182,4.10000000
CN5408700000000,54,087,"Roane County, WV",Jun-22,5141,4795,346,6.70000000
CN5408900000000,54,089,"Summers County, WV",Jun-22,4751,4548,203,4.30000000
CN5409100000000,54,091,"Taylor County, WV",Jun-22,8047,7720,327,4.10000000
CN5409300000000,54,093,"Tucker County, WV",Jun-22,3463,3321,142,4.10000000
CN5409500000000,54,095,"Tyler County, WV",Jun-22,3121,2904,217,7.00000000
CN5409700000000,54,097,"Upshur County, WV",Jun-22,10108,9524,584,5.80000000
CN5409900000000,54,099,"Wayne County, WV",Jun-22,15831,15154,677,4.30000000
CN5410100000000,54,101,"Webster County, WV",Jun-22,3251,3090,161,5.00000000
CN5410300000000,54,103,"Wetzel County, WV",Jun-22,7125,6732,393,5.50000000
CN5410500000000,54,105,"Wirt County, WV",Jun-22,2328,2195,133,5.70000000
CN5410700000000,54,107,"Wood County, WV",Jun-22,37943,36307,1636,4.30000000
CN5410900000000,54,109,"Wyoming County, WV",Jun-22,7606,7198,408,5.40000000
CN5500100000000,55,001,"Adams County, WI",Jun-22,8123,7707,416,5.10000000
CN5500300000000,55,003,"Ashland County, WI",Jun-22,7860,7510,350,4.50000000
CN5500500000000,55,005,"Barron County, WI",Jun-22,24822,24018,804,3.20000000
CN5500700000000,55,007,"Bayfield County, WI",Jun-22,7723,7344,379,4.90000000
CN5500900000000,55,009,"Brown County, WI",Jun-22,143438,138830,4608,3.20000000
CN5501100000000,55,011,"Buffalo County, WI",Jun-22,6365,6124,241,3.80000000
CN5501300000000,55,013,"Burnett County, WI",Jun-22,7644,7322,322,4.20000000
CN5501500000000,55,015,"Calumet County, WI",Jun-22,28256,27445,811,2.90000000
CN5501700000000,55,017,"Chippewa County, WI",Jun-22,33579,32451,1128,3.40000000
CN5501900000000,55,019,"Clark County, WI",Jun-22,18458,17946,512,2.80000000
CN5502100000000,55,021,"Columbia County, WI",Jun-22,32155,31158,997,3.10000000
CN5502300000000,55,023,"Crawford County, WI",Jun-22,7475,7200,275,3.70000000
CN5502500000000,55,025,"Dane County, WI",Jun-22,332936,323812,9124,2.70000000
CN5502700000000,55,027,"Dodge County, WI",Jun-22,49020,47539,1481,3.00000000
CN5502900000000,55,029,"Door County, WI",Jun-22,17109,16600,509,3.00000000
CN5503100000000,55,031,"Douglas County, WI",Jun-22,23609,22602,1007,4.30000000
CN5503300000000,55,033,"Dunn County, WI",Jun-22,23417,22565,852,3.60000000
CN5503500000000,55,035,"Eau Claire County, WI",Jun-22,59732,57857,1875,3.10000000
CN5503700000000,55,037,"Florence County, WI",Jun-22,2260,2181,79,3.50000000
CN5503900000000,55,039,"Fond du Lac County, WI",Jun-22,58400,56597,1803,3.10000000
CN5504100000000,55,041,"Forest County, WI",Jun-22,3923,3715,208,5.30000000
CN5504300000000,55,043,"Grant County, WI",Jun-22,27066,26207,859,3.20000000
CN5504500000000,55,045,"Green County, WI",Jun-22,21118,20530,588,2.80000000
CN5504700000000,55,047,"Green Lake County, WI",Jun-22,9722,9356,366,3.80000000
CN5504900000000,55,049,"Iowa County, WI",Jun-22,13855,13449,406,2.90000000
CN5505100000000,55,051,"Iron County, WI",Jun-22,2540,2409,131,5.20000000
CN5505300000000,55,053,"Jackson County, WI",Jun-22,9646,9263,383,4.00000000
CN5505500000000,55,055,"Jefferson County, WI",Jun-22,46926,45433,1493,3.20000000
CN5505700000000,55,057,"Juneau County, WI",Jun-22,13714,13231,483,3.50000000
CN5505900000000,55,059,"Kenosha County, WI",Jun-22,93929,90319,3610,3.80000000
CN5506100000000,55,061,"Kewaunee County, WI",Jun-22,11076,10761,315,2.80000000
CN5506300000000,55,063,"La Crosse County, WI",Jun-22,66093,64026,2067,3.10000000
CN5506500000000,55,065,"Lafayette County, WI",Jun-22,10573,10302,271,2.60000000
CN5506700000000,55,067,"Langlade County, WI",Jun-22,9594,9206,388,4.00000000
CN5506900000000,55,069,"Lincoln County, WI",Jun-22,15036,14506,530,3.50000000
CN5507100000000,55,071,"Manitowoc County, WI",Jun-22,41416,40092,1324,3.20000000
CN5507300000000,55,073,"Marathon County, WI",Jun-22,75518,73269,2249,3.00000000
CN5507500000000,55,075,"Marinette County, WI",Jun-22,19438,18593,845,4.30000000
CN5507700000000,55,077,"Marquette County, WI",Jun-22,7831,7546,285,3.60000000
CN5507800000000,55,078,"Menominee County, WI",Jun-22,1590,1469,121,7.60000000
CN5507900000000,55,079,"Milwaukee County, WI",Jun-22,469712,447544,22168,4.70000000
CN5508100000000,55,081,"Monroe County, WI",Jun-22,24057,23331,726,3.00000000
CN5508300000000,55,083,"Oconto County, WI",Jun-22,20973,20266,707,3.40000000
CN5508500000000,55,085,"Oneida County, WI",Jun-22,18793,18172,621,3.30000000
CN5508700000000,55,087,"Outagamie County, WI",Jun-22,106431,103171,3260,3.10000000
CN5508900000000,55,089,"Ozaukee County, WI",Jun-22,49807,48300,1507,3.00000000
CN5509100000000,55,091,"Pepin County, WI",Jun-22,4268,4140,128,3.00000000
CN5509300000000,55,093,"Pierce County, WI",Jun-22,25803,24969,834,3.20000000
CN5509500000000,55,095,"Polk County, WI",Jun-22,25222,24383,839,3.30000000
CN5509700000000,55,097,"Portage County, WI",Jun-22,37313,35937,1376,3.70000000
CN5509900000000,55,099,"Price County, WI",Jun-22,6359,6119,240,3.80000000
CN5510100000000,55,101,"Racine County, WI",Jun-22,98909,94703,4206,4.30000000
CN5510300000000,55,103,"Richland County, WI",Jun-22,9146,8852,294,3.20000000
CN5510500000000,55,105,"Rock County, WI",Jun-22,87137,83625,3512,4.00000000
CN5510700000000,55,107,"Rusk County, WI",Jun-22,6423,6162,261,4.10000000
CN5510900000000,55,109,"St. Croix County, WI",Jun-22,52322,50703,1619,3.10000000
CN5511100000000,55,111,"Sauk County, WI",Jun-22,35249,34098,1151,3.30000000
CN5511300000000,55,113,"Sawyer County, WI",Jun-22,8435,8117,318,3.80000000
CN5511500000000,55,115,"Shawano County, WI",Jun-22,21201,20508,693,3.30000000
CN5511700000000,55,117,"Sheboygan County, WI",Jun-22,63520,61621,1899,3.00000000
CN5511900000000,55,119,"Taylor County, WI",Jun-22,11156,10832,324,2.90000000
CN5512100000000,55,121,"Trempealeau County, WI",Jun-22,15469,14969,500,3.20000000
CN5512300000000,55,123,"Vernon County, WI",Jun-22,15929,15471,458,2.90000000
CN5512500000000,55,125,"Vilas County, WI",Jun-22,11224,10796,428,3.80000000
CN5512700000000,55,127,"Walworth County, WI",Jun-22,57600,55641,1959,3.40000000
CN5512900000000,55,129,"Washburn County, WI",Jun-22,8167,7891,276,3.40000000
CN5513100000000,55,131,"Washington County, WI",Jun-22,77812,75523,2289,2.90000000
CN5513300000000,55,133,"Waukesha County, WI",Jun-22,227220,220351,6869,3.00000000
CN5513500000000,55,135,"Waupaca County, WI",Jun-22,26400,25501,899,3.40000000
CN5513700000000,55,137,"Waushara County, WI",Jun-22,11572,11159,413,3.60000000
CN5513900000000,55,139,"Winnebago County, WI",Jun-22,92857,89846,3011,3.20000000
CN5514100000000,55,141,"Wood County, WI",Jun-22,34227,32880,1347,3.90000000
CN5600100000000,56,001,"Albany County, WY",Jun-22,20148,19497,651,3.20000000
CN5600300000000,56,003,"Big Horn County, WY",Jun-22,5480,5284,196,3.60000000
CN5600500000000,56,005,"Campbell County, WY",Jun-22,21627,20852,775,3.60000000
CN5600700000000,56,007,"Carbon County, WY",Jun-22,7717,7478,239,3.10000000
CN5600900000000,56,009,"Converse County, WY",Jun-22,7715,7491,224,2.90000000
CN5601100000000,56,011,"Crook County, WY",Jun-22,4013,3911,102,2.50000000
CN5601300000000,56,013,"Fremont County, WY",Jun-22,18906,18195,711,3.80000000
CN5601500000000,56,015,"Goshen County, WY",Jun-22,6460,6273,187,2.90000000
CN5601700000000,56,017,"Hot Springs County, WY",Jun-22,2266,2204,62,2.70000000
CN5601900000000,56,019,"Johnson County, WY",Jun-22,4567,4437,130,2.80000000
CN5602100000000,56,021,"Laramie County, WY",Jun-22,49319,47746,1573,3.20000000
CN5602300000000,56,023,"Lincoln County, WY",Jun-22,10067,9693,374,3.70000000
CN5602500000000,56,025,"Natrona County, WY",Jun-22,38678,37144,1534,4.00000000
CN5602700000000,56,027,"Niobrara County, WY",Jun-22,1253,1225,28,2.20000000
CN5602900000000,56,029,"Park County, WY",Jun-22,16705,16218,487,2.90000000
CN5603100000000,56,031,"Platte County, WY",Jun-22,4582,4442,140,3.10000000
CN5603300000000,56,033,"Sheridan County, WY",Jun-22,16283,15797,486,3.00000000
CN5603500000000,56,035,"Sublette County, WY",Jun-22,3943,3793,150,3.80000000
CN5603700000000,56,037,"Sweetwater County, WY",Jun-22,18807,18029,778,4.10000000
CN5603900000000,56,039,"Teton County, WY",Jun-22,17405,17026,379,2.20000000
CN5604100000000,56,041,"Uinta County, WY",Jun-22,8644,8312,332,3.80000000
CN5604300000000,56,043,"Washakie County, WY",Jun-22,3942,3800,142,3.60000000
CN5604500000000,56,045,"Weston County, WY",Jun-22,3690,3599,91,2.50000000
CN7200100000000,72,001,"Adjuntas Municipio, PR",Jun-22,4258,3929,329,7.70000000
CN7200300000000,72,003,"Aguada Municipio, PR",Jun-22,12853,11971,882,6.90000000
CN7200500000000,72,005,"Aguadilla Municipio, PR",Jun-22,15662,14383,1279,8.20000000
CN7200700000000,72,007,"Aguas Buenas Municipio, PR",Jun-22,7058,6599,459,6.50000000
CN7200900000000,72,009,"Aibonito Municipio, PR",Jun-22,6778,6297,481,7.10000000
CN7201100000000,72,011,"Anasco Municipio, PR",Jun-22,9654,9078,576,6.00000000
CN7201300000000,72,013,"Arecibo Municipio, PR",Jun-22,25318,23663,1655,6.50000000
CN7201500000000,72,015,"Arroyo Municipio, PR",Jun-22,4995,4605,390,7.80000000
CN7201700000000,72,017,"Barceloneta Municipio, PR",Jun-22,6399,5874,525,8.20000000
CN7201900000000,72,019,"Barranquitas Municipio, PR",Jun-22,7798,7256,542,7.00000000
CN7202100000000,72,021,"Bayamon Municipio, PR",Jun-22,70317,66830,3487,5.00000000
CN7202300000000,72,023,"Cabo Rojo Municipio, PR",Jun-22,15053,14059,994,6.60000000
CN7202500000000,72,025,"Caguas Municipio, PR",Jun-22,51590,49205,2385,4.60000000
CN7202700000000,72,027,"Camuy Municipio, PR",Jun-22,10156,9533,623,6.10000000
CN7202900000000,72,029,"Canovanas Municipio, PR",Jun-22,17659,16815,844,4.80000000
CN7203100000000,72,031,"Carolina Municipio, PR",Jun-22,66442,63283,3159,4.80000000
CN7203300000000,72,033,"Catano Municipio, PR",Jun-22,8426,7978,448,5.30000000
CN7203500000000,72,035,"Cayey Municipio, PR",Jun-22,17482,16672,810,4.60000000
CN7203700000000,72,037,"Ceiba Municipio, PR",Jun-22,3871,3624,247,6.40000000
CN7203900000000,72,039,"Ciales Municipio, PR",Jun-22,3946,3587,359,9.10000000
CN7204100000000,72,041,"Cidra Municipio, PR",Jun-22,16633,15944,689,4.10000000
CN7204300000000,72,043,"Coamo Municipio, PR",Jun-22,10874,10100,774,7.10000000
CN7204500000000,72,045,"Comerio Municipio, PR",Jun-22,5256,4908,348,6.60000000
CN7204700000000,72,047,"Corozal Municipio, PR",Jun-22,9516,8814,702,7.40000000
CN7204900000000,72,049,"Culebra Municipio, PR",Jun-22,1005,978,27,2.70000000
CN7205100000000,72,051,"Dorado Municipio, PR",Jun-22,14606,13998,608,4.20000000
CN7205300000000,72,053,"Fajardo Municipio, PR",Jun-22,11420,10656,764,6.70000000
CN7205400000000,72,054,"Florida Municipio, PR",Jun-22,3515,3247,268,7.60000000
CN7205500000000,72,055,"Guanica Municipio, PR",Jun-22,4077,3676,401,9.80000000
CN7205700000000,72,057,"Guayama Municipio, PR",Jun-22,11749,11005,744,6.30000000
CN7205900000000,72,059,"Guayanilla Municipio, PR",Jun-22,5299,4839,460,8.70000000
CN7206100000000,72,061,"Guaynabo Municipio, PR",Jun-22,41218,40039,1179,2.90000000
CN7206300000000,72,063,"Gurabo Municipio, PR",Jun-22,20321,19547,774,3.80000000
CN7206500000000,72,065,"Hatillo Municipio, PR",Jun-22,14356,13275,1081,7.50000000
CN7206700000000,72,067,"Hormigueros Municipio, PR",Jun-22,5903,5527,376,6.40000000
CN7206900000000,72,069,"Humacao Municipio, PR",Jun-22,18795,17610,1185,6.30000000
CN7207100000000,72,071,"Isabela Municipio, PR",Jun-22,12787,11929,858,6.70000000
CN7207300000000,72,073,"Jayuya Municipio, PR",Jun-22,4484,4129,355,7.90000000
CN7207500000000,72,075,"Juana Diaz Municipio, PR",Jun-22,16681,15651,1030,6.20000000
CN7207700000000,72,077,"Juncos Municipio, PR",Jun-22,13408,12595,813,6.10000000
CN7207900000000,72,079,"Lajas Municipio, PR",Jun-22,5541,5012,529,9.50000000
CN7208100000000,72,081,"Lares Municipio, PR",Jun-22,7151,6395,756,10.60000000
CN7208300000000,72,083,"Las Marias Municipio, PR",Jun-22,2712,2474,238,8.80000000
CN7208500000000,72,085,"Las Piedras Municipio, PR",Jun-22,12425,11664,761,6.10000000
CN7208700000000,72,087,"Loiza Municipio, PR",Jun-22,8972,8449,523,5.80000000
CN7208900000000,72,089,"Luquillo Municipio, PR",Jun-22,6653,6232,421,6.30000000
CN7209100000000,72,091,"Manati Municipio, PR",Jun-22,12124,11404,720,5.90000000
CN7209300000000,72,093,"Maricao Municipio, PR",Jun-22,2052,1833,219,10.70000000
CN7209500000000,72,095,"Maunabo Municipio, PR",Jun-22,3076,2736,340,11.10000000
CN7209700000000,72,097,"Mayaguez Municipio, PR",Jun-22,23417,21810,1607,6.90000000
CN7209900000000,72,099,"Moca Municipio, PR",Jun-22,11294,10403,891,7.90000000
CN7210100000000,72,101,"Morovis Municipio, PR",Jun-22,8704,8084,620,7.10000000
CN7210300000000,72,103,"Naguabo Municipio, PR",Jun-22,8927,8407,520,5.80000000
CN7210500000000,72,105,"Naranjito Municipio, PR",Jun-22,7651,7098,553,7.20000000
CN7210700000000,72,107,"Orocovis Municipio, PR",Jun-22,5172,4795,377,7.30000000
CN7210900000000,72,109,"Patillas Municipio, PR",Jun-22,4460,4058,402,9.00000000
CN7211100000000,72,111,"Penuelas Municipio, PR",Jun-22,6119,5574,545,8.90000000
CN7211300000000,72,113,"Ponce Municipio, PR",Jun-22,48756,45430,3326,6.80000000
CN7211500000000,72,115,"Quebradillas Municipio, PR",Jun-22,6450,5963,487,7.60000000
CN7211700000000,72,117,"Rincon Municipio, PR",Jun-22,4960,4619,341,6.90000000
CN7211900000000,72,119,"Rio Grande Municipio, PR",Jun-22,18404,17358,1046,5.70000000
CN7212100000000,72,121,"Sabana Grande Municipio, PR",Jun-22,6392,5838,554,8.70000000
CN7212300000000,72,123,"Salinas Municipio, PR",Jun-22,7397,6760,637,8.60000000
CN7212500000000,72,125,"San German Municipio, PR",Jun-22,10423,9615,808,7.80000000
CN7212700000000,72,127,"San Juan Municipio, PR",Jun-22,144987,138986,6001,4.10000000
CN7212900000000,72,129,"San Lorenzo Municipio, PR",Jun-22,12503,11731,772,6.20000000
CN7213100000000,72,131,"San Sebastian Municipio, PR",Jun-22,10670,9677,993,9.30000000
CN7213300000000,72,133,"Santa Isabel Municipio, PR",Jun-22,8683,8035,648,7.50000000
CN7213500000000,72,135,"Toa Alta Municipio, PR",Jun-22,30191,28874,1317,4.40000000
CN7213700000000,72,137,"Toa Baja Municipio, PR",Jun-22,31348,29956,1392,4.40000000
CN7213900000000,72,139,"Trujillo Alto Municipio, PR",Jun-22,29424,28365,1059,3.60000000
CN7214100000000,72,141,"Utuado Municipio, PR",Jun-22,7016,6438,578,8.20000000
CN7214300000000,72,143,"Vega Alta Municipio, PR",Jun-22,10650,9898,752,7.10000000
CN7214500000000,72,145,"Vega Baja Municipio, PR",Jun-22,14109,13038,1071,7.60000000
CN7214700000000,72,147,"Vieques Municipio, PR",Jun-22,2722,2523,199,7.30000000
CN7214900000000,72,149,"Villalba Municipio, PR",Jun-22,7629,6987,642,8.40000000
CN7215100000000,72,151,"Yabucoa Municipio, PR",Jun-22,9166,8460,706,7.70000000
CN7215300000000,72,153,"Yauco Municipio, PR",Jun-22,10162,9202,960,9.40000000
CN0100100000000,01,001,"Autauga County, AL",Jul-22,27286,26563,723,2.60000000
CN0100300000000,01,003,"Baldwin County, AL",Jul-22,102906,100103,2803,2.70000000
CN0100500000000,01,005,"Barbour County, AL",Jul-22,8264,7858,406,4.90000000
CN0100700000000,01,007,"Bibb County, AL",Jul-22,8910,8643,267,3.00000000
CN0100900000000,01,009,"Blount County, AL",Jul-22,26388,25722,666,2.50000000
CN0101100000000,01,011,"Bullock County, AL",Jul-22,4517,4355,162,3.60000000
CN0101300000000,01,013,"Butler County, AL",Jul-22,8818,8403,415,4.70000000
CN0101500000000,01,015,"Calhoun County, AL",Jul-22,46929,45204,1725,3.70000000
CN0101700000000,01,017,"Chambers County, AL",Jul-22,16105,15593,512,3.20000000
CN0101900000000,01,019,"Cherokee County, AL",Jul-22,11772,11461,311,2.60000000
CN0102100000000,01,021,"Chilton County, AL",Jul-22,20722,20189,533,2.60000000
CN0102300000000,01,023,"Choctaw County, AL",Jul-22,4371,4170,201,4.60000000
CN0102500000000,01,025,"Clarke County, AL",Jul-22,7785,7309,476,6.10000000
CN0102700000000,01,027,"Clay County, AL",Jul-22,6172,6020,152,2.50000000
CN0102900000000,01,029,"Cleburne County, AL",Jul-22,6334,6167,167,2.60000000
CN0103100000000,01,031,"Coffee County, AL",Jul-22,21776,21147,629,2.90000000
CN0103300000000,01,033,"Colbert County, AL",Jul-22,23937,23048,889,3.70000000
CN0103500000000,01,035,"Conecuh County, AL",Jul-22,4248,4053,195,4.60000000
CN0103700000000,01,037,"Coosa County, AL",Jul-22,4423,4299,124,2.80000000
CN0103900000000,01,039,"Covington County, AL",Jul-22,15440,14950,490,3.20000000
CN0104100000000,01,041,"Crenshaw County, AL",Jul-22,6188,5995,193,3.10000000
CN0104300000000,01,043,"Cullman County, AL",Jul-22,39646,38712,934,2.40000000
CN0104500000000,01,045,"Dale County, AL",Jul-22,21148,20505,643,3.00000000
CN0104700000000,01,047,"Dallas County, AL",Jul-22,14064,13003,1061,7.50000000
CN0104900000000,01,049,"DeKalb County, AL",Jul-22,31672,30809,863,2.70000000
CN0105100000000,01,051,"Elmore County, AL",Jul-22,38915,37896,1019,2.60000000
CN0105300000000,01,053,"Escambia County, AL",Jul-22,14268,13739,529,3.70000000
CN0105500000000,01,055,"Etowah County, AL",Jul-22,40091,38653,1438,3.60000000
CN0105700000000,01,057,"Fayette County, AL",Jul-22,6713,6488,225,3.40000000
CN0105900000000,01,059,"Franklin County, AL",Jul-22,14535,14129,406,2.80000000
CN0106100000000,01,061,"Geneva County, AL",Jul-22,11511,11201,310,2.70000000
CN0106300000000,01,063,"Greene County, AL",Jul-22,2766,2587,179,6.50000000
CN0106500000000,01,065,"Hale County, AL",Jul-22,6118,5793,325,5.30000000
CN0106700000000,01,067,"Henry County, AL",Jul-22,7177,6948,229,3.20000000
CN0106900000000,01,069,"Houston County, AL",Jul-22,48510,47010,1500,3.10000000
CN0107100000000,01,071,"Jackson County, AL",Jul-22,23319,22572,747,3.20000000
CN0107300000000,01,073,"Jefferson County, AL",Jul-22,329581,319378,10203,3.10000000
CN0107500000000,01,075,"Lamar County, AL",Jul-22,5968,5664,304,5.10000000
CN0107700000000,01,077,"Lauderdale County, AL",Jul-22,43106,41719,1387,3.20000000
CN0107900000000,01,079,"Lawrence County, AL",Jul-22,14794,14381,413,2.80000000
CN0108100000000,01,081,"Lee County, AL",Jul-22,79399,77099,2300,2.90000000
CN0108300000000,01,083,"Limestone County, AL",Jul-22,48114,46918,1196,2.50000000
CN0108500000000,01,085,"Lowndes County, AL",Jul-22,3679,3380,299,8.10000000
CN0108700000000,01,087,"Macon County, AL",Jul-22,7960,7523,437,5.50000000
CN0108900000000,01,089,"Madison County, AL",Jul-22,198061,192902,5159,2.60000000
CN0109100000000,01,091,"Marengo County, AL",Jul-22,7596,7293,303,4.00000000
CN0109300000000,01,093,"Marion County, AL",Jul-22,14053,13611,442,3.10000000
CN0109500000000,01,095,"Marshall County, AL",Jul-22,45916,44801,1115,2.40000000
CN0109700000000,01,097,"Mobile County, AL",Jul-22,193168,185276,7892,4.10000000
CN0109900000000,01,099,"Monroe County, AL",Jul-22,7505,7135,370,4.90000000
CN0110100000000,01,101,"Montgomery County, AL",Jul-22,109447,105115,4332,4.00000000
CN0110300000000,01,103,"Morgan County, AL",Jul-22,60840,59280,1560,2.60000000
CN0110500000000,01,105,"Perry County, AL",Jul-22,3164,2903,261,8.20000000
CN0110700000000,01,107,"Pickens County, AL",Jul-22,7770,7445,325,4.20000000
CN0110900000000,01,109,"Pike County, AL",Jul-22,16457,15931,526,3.20000000
CN0111100000000,01,111,"Randolph County, AL",Jul-22,9943,9667,276,2.80000000
CN0111300000000,01,113,"Russell County, AL",Jul-22,24214,23497,717,3.00000000
CN0111500000000,01,115,"St. Clair County, AL",Jul-22,43022,41933,1089,2.50000000
CN0111700000000,01,117,"Shelby County, AL",Jul-22,123446,120848,2598,2.10000000
CN0111900000000,01,119,"Sumter County, AL",Jul-22,4612,4376,236,5.10000000
CN0112100000000,01,121,"Talladega County, AL",Jul-22,36147,34754,1393,3.90000000
CN0112300000000,01,123,"Tallapoosa County, AL",Jul-22,17959,17320,639,3.60000000
CN0112500000000,01,125,"Tuscaloosa County, AL",Jul-22,103492,100093,3399,3.30000000
CN0112700000000,01,127,"Walker County, AL",Jul-22,26128,25291,837,3.20000000
CN0112900000000,01,129,"Washington County, AL",Jul-22,6544,6268,276,4.20000000
CN0113100000000,01,131,"Wilcox County, AL",Jul-22,2665,2365,300,11.30000000
CN0113300000000,01,133,"Winston County, AL",Jul-22,10427,10142,285,2.70000000
CN0201300000000,02,013,"Aleutians East Borough, AK",Jul-22,3979,3930,49,1.20000000
CN0201600000000,02,016,"Aleutians West Census Area, AK",Jul-22,3984,3883,101,2.50000000
CN0202000000000,02,020,"Anchorage Borough/municipality, AK",Jul-22,150013,144614,5399,3.60000000
CN0205000000000,02,050,"Bethel Census Area, AK",Jul-22,7161,6376,785,11.00000000
CN0206000000000,02,060,"Bristol Bay Borough, AK",Jul-22,1256,1242,14,1.10000000
CN0206300000000,02,063,"Chugach Census Area, AK",Jul-22,4284,4166,118,2.80000000
CN0206600000000,02,066,"Copper River Census Area, AK",Jul-22,1728,1603,125,7.20000000
CN0206800000000,02,068,"Denali Borough, AK",Jul-22,1185,1129,56,4.70000000
CN0207000000000,02,070,"Dillingham Census Area, AK",Jul-22,2183,2065,118,5.40000000
CN0209000000000,02,090,"Fairbanks North Star Borough, AK",Jul-22,45879,44232,1647,3.60000000
CN0210000000000,02,100,"Haines Borough, AK",Jul-22,1133,1058,75,6.60000000
CN0210500000000,02,105,"Hoonah-Angoon Census Area, AK",Jul-22,1371,1311,60,4.40000000
CN0211000000000,02,110,"Juneau Borough/city, AK",Jul-22,17453,16979,474,2.70000000
CN0212200000000,02,122,"Kenai Peninsula Borough, AK",Jul-22,29708,28341,1367,4.60000000
CN0213000000000,02,130,"Ketchikan Gateway Borough, AK",Jul-22,7252,6967,285,3.90000000
CN0215000000000,02,150,"Kodiak Island Borough, AK",Jul-22,6847,6623,224,3.30000000
CN0215800000000,02,158,"Kusilvak Census Area, AK",Jul-22,2209,1813,396,17.90000000
CN0216400000000,02,164,"Lake and Peninsula Borough, AK",Jul-22,961,916,45,4.70000000
CN0217000000000,02,170,"Matanuska-Susitna Borough, AK",Jul-22,49519,47058,2461,5.00000000
CN0218000000000,02,180,"Nome Census Area, AK",Jul-22,3945,3576,369,9.40000000
CN0218500000000,02,185,"North Slope Borough, AK",Jul-22,2909,2748,161,5.50000000
CN0218800000000,02,188,"Northwest Arctic Borough, AK",Jul-22,2691,2374,317,11.80000000
CN0219500000000,02,195,"Petersburg Borough, AK",Jul-22,1983,1902,81,4.10000000
CN0219800000000,02,198,"Prince of Wales-Hyder Census Area, AK",Jul-22,2854,2685,169,5.90000000
CN0222000000000,02,220,"Sitka Borough/city, AK",Jul-22,5202,5078,124,2.40000000
CN0223000000000,02,230,"Skagway Municipality, AK",Jul-22,686,647,39,5.70000000
CN0224000000000,02,240,"Southeast Fairbanks Census Area, AK",Jul-22,3326,3164,162,4.90000000
CN0227500000000,02,275,"Wrangell Borough/city, AK",Jul-22,946,898,48,5.10000000
CN0228200000000,02,282,"Yakutat Borough/city, AK",Jul-22,381,368,13,3.40000000
CN0229000000000,02,290,"Yukon-Koyukuk Census Area, AK",Jul-22,2412,2202,210,8.70000000
CN0400100000000,04,001,"Apache County, AZ",Jul-22,17775,16084,1691,9.50000000
CN0400300000000,04,003,"Cochise County, AZ",Jul-22,48536,46431,2105,4.30000000
CN0400500000000,04,005,"Coconino County, AZ",Jul-22,75267,71736,3531,4.70000000
CN0400700000000,04,007,"Gila County, AZ",Jul-22,20024,19175,849,4.20000000
CN0400900000000,04,009,"Graham County, AZ",Jul-22,14894,14344,550,3.70000000
CN0401100000000,04,011,"Greenlee County, AZ",Jul-22,4356,4225,131,3.00000000
CN0401200000000,04,012,"La Paz County, AZ",Jul-22,8138,7712,426,5.20000000
CN0401300000000,04,013,"Maricopa County, AZ",Jul-22,2364775,2287279,77496,3.30000000
CN0401500000000,04,015,"Mohave County, AZ",Jul-22,90879,86749,4130,4.50000000
CN0401700000000,04,017,"Navajo County, AZ",Jul-22,39260,36946,2314,5.90000000
CN0401900000000,04,019,"Pima County, AZ",Jul-22,482906,464268,18638,3.90000000
CN0402100000000,04,021,"Pinal County, AZ",Jul-22,195338,187835,7503,3.80000000
CN0402300000000,04,023,"Santa Cruz County, AZ",Jul-22,18323,16676,1647,9.00000000
CN0402500000000,04,025,"Yavapai County, AZ",Jul-22,107671,104090,3581,3.30000000
CN0402700000000,04,027,"Yuma County, AZ",Jul-22,98060,80288,17772,18.10000000
CN0500100000000,05,001,"Arkansas County, AR",Jul-22,9286,8925,361,3.90000000
CN0500300000000,05,003,"Ashley County, AR",Jul-22,6767,6229,538,8.00000000
CN0500500000000,05,005,"Baxter County, AR",Jul-22,16635,15935,700,4.20000000
CN0500700000000,05,007,"Benton County, AR",Jul-22,150758,146476,4282,2.80000000
CN0500900000000,05,009,"Boone County, AR",Jul-22,15421,14905,516,3.30000000
CN0501100000000,05,011,"Bradley County, AR",Jul-22,4037,3828,209,5.20000000
CN0501300000000,05,013,"Calhoun County, AR",Jul-22,2205,2116,89,4.00000000
CN0501500000000,05,015,"Carroll County, AR",Jul-22,12864,12479,385,3.00000000
CN0501700000000,05,017,"Chicot County, AR",Jul-22,3022,2751,271,9.00000000
CN0501900000000,05,019,"Clark County, AR",Jul-22,8383,7857,526,6.30000000
CN0502100000000,05,021,"Clay County, AR",Jul-22,5507,5254,253,4.60000000
CN0502300000000,05,023,"Cleburne County, AR",Jul-22,9017,8569,448,5.00000000
CN0502500000000,05,025,"Cleveland County, AR",Jul-22,3215,3065,150,4.70000000
CN0502700000000,05,027,"Columbia County, AR",Jul-22,8299,7830,469,5.70000000
CN0502900000000,05,029,"Conway County, AR",Jul-22,8399,8009,390,4.60000000
CN0503100000000,05,031,"Craighead County, AR",Jul-22,57784,55844,1940,3.40000000
CN0503300000000,05,033,"Crawford County, AR",Jul-22,26557,25554,1003,3.80000000
CN0503500000000,05,035,"Crittenden County, AR",Jul-22,21580,20361,1219,5.60000000
CN0503700000000,05,037,"Cross County, AR",Jul-22,6870,6556,314,4.60000000
CN0503900000000,05,039,"Dallas County, AR",Jul-22,2750,2612,138,5.00000000
CN0504100000000,05,041,"Desha County, AR",Jul-22,4883,4508,375,7.70000000
CN0504300000000,05,043,"Drew County, AR",Jul-22,7300,6898,402,5.50000000
CN0504500000000,05,045,"Faulkner County, AR",Jul-22,63385,61141,2244,3.50000000
CN0504700000000,05,047,"Franklin County, AR",Jul-22,7347,7043,304,4.10000000
CN0504900000000,05,049,"Fulton County, AR",Jul-22,5055,4835,220,4.40000000
CN0505100000000,05,051,"Garland County, AR",Jul-22,42212,40131,2081,4.90000000
CN0505300000000,05,053,"Grant County, AR",Jul-22,8513,8192,321,3.80000000
CN0505500000000,05,055,"Greene County, AR",Jul-22,19738,19003,735,3.70000000
CN0505700000000,05,057,"Hempstead County, AR",Jul-22,9067,8692,375,4.10000000
CN0505900000000,05,059,"Hot Spring County, AR",Jul-22,13638,13005,633,4.60000000
CN0506100000000,05,061,"Howard County, AR",Jul-22,5340,5112,228,4.30000000
CN0506300000000,05,063,"Independence County, AR",Jul-22,16022,15300,722,4.50000000
CN0506500000000,05,065,"Izard County, AR",Jul-22,4229,3936,293,6.90000000
CN0506700000000,05,067,"Jackson County, AR",Jul-22,5509,5183,326,5.90000000
CN0506900000000,05,069,"Jefferson County, AR",Jul-22,26770,24849,1921,7.20000000
CN0507100000000,05,071,"Johnson County, AR",Jul-22,9728,9167,561,5.80000000
CN0507300000000,05,073,"Lafayette County, AR",Jul-22,2288,2142,146,6.40000000
CN0507500000000,05,075,"Lawrence County, AR",Jul-22,6458,6148,310,4.80000000
CN0507700000000,05,077,"Lee County, AR",Jul-22,2648,2502,146,5.50000000
CN0507900000000,05,079,"Lincoln County, AR",Jul-22,3862,3662,200,5.20000000
CN0508100000000,05,081,"Little River County, AR",Jul-22,5453,5214,239,4.40000000
CN0508300000000,05,083,"Logan County, AR",Jul-22,8278,7892,386,4.70000000
CN0508500000000,05,085,"Lonoke County, AR",Jul-22,34457,33307,1150,3.30000000
CN0508700000000,05,087,"Madison County, AR",Jul-22,7863,7629,234,3.00000000
CN0508900000000,05,089,"Marion County, AR",Jul-22,6285,6024,261,4.20000000
CN0509100000000,05,091,"Miller County, AR",Jul-22,19743,18820,923,4.70000000
CN0509300000000,05,093,"Mississippi County, AR",Jul-22,16579,15155,1424,8.60000000
CN0509500000000,05,095,"Monroe County, AR",Jul-22,2560,2414,146,5.70000000
CN0509700000000,05,097,"Montgomery County, AR",Jul-22,2965,2800,165,5.60000000
CN0509900000000,05,099,"Nevada County, AR",Jul-22,3330,3161,169,5.10000000
CN0510100000000,05,101,"Newton County, AR",Jul-22,3144,3033,111,3.50000000
CN0510300000000,05,103,"Ouachita County, AR",Jul-22,8856,8403,453,5.10000000
CN0510500000000,05,105,"Perry County, AR",Jul-22,4276,4088,188,4.40000000
CN0510700000000,05,107,"Phillips County, AR",Jul-22,5540,5051,489,8.80000000
CN0510900000000,05,109,"Pike County, AR",Jul-22,4174,3986,188,4.50000000
CN0511100000000,05,111,"Poinsett County, AR",Jul-22,10096,9692,404,4.00000000
CN0511300000000,05,113,"Polk County, AR",Jul-22,7688,7327,361,4.70000000
CN0511500000000,05,115,"Pope County, AR",Jul-22,26982,25584,1398,5.20000000
CN0511700000000,05,117,"Prairie County, AR",Jul-22,3461,3339,122,3.50000000
CN0511900000000,05,119,"Pulaski County, AR",Jul-22,190902,182275,8627,4.50000000
CN0512100000000,05,121,"Randolph County, AR",Jul-22,7264,6952,312,4.30000000
CN0512300000000,05,123,"St. Francis County, AR",Jul-22,7699,7199,500,6.50000000
CN0512500000000,05,125,"Saline County, AR",Jul-22,60129,58156,1973,3.30000000
CN0512700000000,05,127,"Scott County, AR",Jul-22,4107,3963,144,3.50000000
CN0512900000000,05,129,"Searcy County, AR",Jul-22,2808,2659,149,5.30000000
CN0513100000000,05,131,"Sebastian County, AR",Jul-22,55721,53687,2034,3.70000000
CN0513300000000,05,133,"Sevier County, AR",Jul-22,5406,5157,249,4.60000000
CN0513500000000,05,135,"Sharp County, AR",Jul-22,5613,5309,304,5.40000000
CN0513700000000,05,137,"Stone County, AR",Jul-22,4621,4366,255,5.50000000
CN0513900000000,05,139,"Union County, AR",Jul-22,14685,13719,966,6.60000000
CN0514100000000,05,141,"Van Buren County, AR",Jul-22,5860,5551,309,5.30000000
CN0514300000000,05,143,"Washington County, AR",Jul-22,133259,129580,3679,2.80000000
CN0514500000000,05,145,"White County, AR",Jul-22,33378,31927,1451,4.30000000
CN0514700000000,05,147,"Woodruff County, AR",Jul-22,2737,2617,120,4.40000000
CN0514900000000,05,149,"Yell County, AR",Jul-22,7817,7429,388,5.00000000
CN0600100000000,06,001,"Alameda County, CA",Jul-22,828541,804608,23933,2.90000000
CN0600300000000,06,003,"Alpine County, CA",Jul-22,461,438,23,5.00000000
CN0600500000000,06,005,"Amador County, CA",Jul-22,14477,13939,538,3.70000000
CN0600700000000,06,007,"Butte County, CA",Jul-22,90256,86679,3577,4.00000000
CN0600900000000,06,009,"Calaveras County, CA",Jul-22,22060,21405,655,3.00000000
CN0601100000000,06,011,"Colusa County, CA",Jul-22,11312,10412,900,8.00000000
CN0601300000000,06,013,"Contra Costa County, CA",Jul-22,553484,536267,17217,3.10000000
CN0601500000000,06,015,"Del Norte County, CA",Jul-22,9205,8772,433,4.70000000
CN0601700000000,06,017,"El Dorado County, CA",Jul-22,92771,90228,2543,2.70000000
CN0601900000000,06,019,"Fresno County, CA",Jul-22,455091,429306,25785,5.70000000
CN0602100000000,06,021,"Glenn County, CA",Jul-22,12734,12140,594,4.70000000
CN0602300000000,06,023,"Humboldt County, CA",Jul-22,59004,56999,2005,3.40000000
CN0602500000000,06,025,"Imperial County, CA",Jul-22,67779,58022,9757,14.40000000
CN0602700000000,06,027,"Inyo County, CA",Jul-22,8360,8111,249,3.00000000
CN0602900000000,06,029,"Kern County, CA",Jul-22,384251,358864,25387,6.60000000
CN0603100000000,06,031,"Kings County, CA",Jul-22,56161,52697,3464,6.20000000
CN0603300000000,06,033,"Lake County, CA",Jul-22,28693,27470,1223,4.30000000
CN0603500000000,06,035,"Lassen County, CA",Jul-22,8912,8601,311,3.50000000
CN0603700000000,06,037,"Los Angeles County, CA",Jul-22,4957468,4716142,241326,4.90000000
CN0603900000000,06,039,"Madera County, CA",Jul-22,61772,58310,3462,5.60000000
CN0604100000000,06,041,"Marin County, CA",Jul-22,131145,128320,2825,2.20000000
CN0604300000000,06,043,"Mariposa County, CA",Jul-22,7503,7227,276,3.70000000
CN0604500000000,06,045,"Mendocino County, CA",Jul-22,37881,36646,1235,3.30000000
CN0604700000000,06,047,"Merced County, CA",Jul-22,117155,109344,7811,6.70000000
CN0604900000000,06,049,"Modoc County, CA",Jul-22,3269,3144,125,3.80000000
CN0605100000000,06,051,"Mono County, CA",Jul-22,9081,8803,278,3.10000000
CN0605300000000,06,053,"Monterey County, CA",Jul-22,221719,212240,9479,4.30000000
CN0605500000000,06,055,"Napa County, CA",Jul-22,70696,68855,1841,2.60000000
CN0605700000000,06,057,"Nevada County, CA",Jul-22,48498,47166,1332,2.70000000
CN0605900000000,06,059,"Orange County, CA",Jul-22,1593371,1548888,44483,2.80000000
CN0606100000000,06,061,"Placer County, CA",Jul-22,192768,187898,4870,2.50000000
CN0606300000000,06,063,"Plumas County, CA",Jul-22,7946,7576,370,4.70000000
CN0606500000000,06,065,"Riverside County, CA",Jul-22,1159232,1113051,46181,4.00000000
CN0606700000000,06,067,"Sacramento County, CA",Jul-22,725060,699107,25953,3.60000000
CN0606900000000,06,069,"San Benito County, CA",Jul-22,33147,31798,1349,4.10000000
CN0607100000000,06,071,"San Bernardino County, CA",Jul-22,1013590,973684,39906,3.90000000
CN0607300000000,06,073,"San Diego County, CA",Jul-22,1577440,1528312,49128,3.10000000
CN0607500000000,06,075,"San Francisco County/city, CA",Jul-22,577024,564715,12309,2.10000000
CN0607700000000,06,077,"San Joaquin County, CA",Jul-22,335079,318426,16653,5.00000000
CN0607900000000,06,079,"San Luis Obispo County, CA",Jul-22,136959,133476,3483,2.50000000
CN0608100000000,06,081,"San Mateo County, CA",Jul-22,456502,447580,8922,2.00000000
CN0608300000000,06,083,"Santa Barbara County, CA",Jul-22,222525,216344,6181,2.80000000
CN0608500000000,06,085,"Santa Clara County, CA",Jul-22,1053233,1030695,22538,2.10000000
CN0608700000000,06,087,"Santa Cruz County, CA",Jul-22,137628,132584,5044,3.70000000
CN0608900000000,06,089,"Shasta County, CA",Jul-22,72561,69713,2848,3.90000000
CN0609100000000,06,091,"Sierra County, CA",Jul-22,1391,1351,40,2.90000000
CN0609300000000,06,093,"Siskiyou County, CA",Jul-22,16926,16168,758,4.50000000
CN0609500000000,06,095,"Solano County, CA",Jul-22,200835,192958,7877,3.90000000
CN0609700000000,06,097,"Sonoma County, CA",Jul-22,248560,242082,6478,2.60000000
CN0609900000000,06,099,"Stanislaus County, CA",Jul-22,242812,230600,12212,5.00000000
CN0610100000000,06,101,"Sutter County, CA",Jul-22,46355,43808,2547,5.50000000
CN0610300000000,06,103,"Tehama County, CA",Jul-22,25802,24703,1099,4.30000000
CN0610500000000,06,105,"Trinity County, CA",Jul-22,4562,4402,160,3.50000000
CN0610700000000,06,107,"Tulare County, CA",Jul-22,201012,185700,15312,7.60000000
CN0610900000000,06,109,"Tuolumne County, CA",Jul-22,20076,19291,785,3.90000000
CN0611100000000,06,111,"Ventura County, CA",Jul-22,409678,396607,13071,3.20000000
CN0611300000000,06,113,"Yolo County, CA",Jul-22,109619,106069,3550,3.20000000
CN0611500000000,06,115,"Yuba County, CA",Jul-22,30833,29291,1542,5.00000000
CN0800100000000,08,001,"Adams County, CO",Jul-22,284493,273025,11468,4.00000000
CN0800300000000,08,003,"Alamosa County, CO",Jul-22,8883,8525,358,4.00000000
CN0800500000000,08,005,"Arapahoe County, CO",Jul-22,377600,363884,13716,3.60000000
CN0800700000000,08,007,"Archuleta County, CO",Jul-22,7660,7417,243,3.20000000
CN0800900000000,08,009,"Baca County, CO",Jul-22,2286,2248,38,1.70000000
CN0801100000000,08,011,"Bent County, CO",Jul-22,2035,1961,74,3.60000000
CN0801300000000,08,013,"Boulder County, CO",Jul-22,200676,194857,5819,2.90000000
CN0801400000000,08,014,"Broomfield County/city, CO",Jul-22,42587,41379,1208,2.80000000
CN0801500000000,08,015,"Chaffee County, CO",Jul-22,11293,11018,275,2.40000000
CN0801700000000,08,017,"Cheyenne County, CO",Jul-22,1208,1184,24,2.00000000
CN0801900000000,08,019,"Clear Creek County, CO",Jul-22,6199,5989,210,3.40000000
CN0802100000000,08,021,"Conejos County, CO",Jul-22,4343,4196,147,3.40000000
CN0802300000000,08,023,"Costilla County, CO",Jul-22,1987,1904,83,4.20000000
CN0802500000000,08,025,"Crowley County, CO",Jul-22,1488,1424,64,4.30000000
CN0802700000000,08,027,"Custer County, CO",Jul-22,2734,2665,69,2.50000000
CN0802900000000,08,029,"Delta County, CO",Jul-22,14687,14165,522,3.60000000
CN0803100000000,08,031,"Denver County/city, CO",Jul-22,439014,423021,15993,3.60000000
CN0803300000000,08,033,"Dolores County, CO",Jul-22,1243,1210,33,2.70000000
CN0803500000000,08,035,"Douglas County, CO",Jul-22,208517,202620,5897,2.80000000
CN0803700000000,08,037,"Eagle County, CO",Jul-22,39503,38549,954,2.40000000
CN0803900000000,08,039,"Elbert County, CO",Jul-22,16250,15833,417,2.60000000
CN0804100000000,08,041,"El Paso County, CO",Jul-22,359073,345126,13947,3.90000000
CN0804300000000,08,043,"Fremont County, CO",Jul-22,16417,15610,807,4.90000000
CN0804500000000,08,045,"Garfield County, CO",Jul-22,33830,32851,979,2.90000000
CN0804700000000,08,047,"Gilpin County, CO",Jul-22,3958,3830,128,3.20000000
CN0804900000000,08,049,"Grand County, CO",Jul-22,10774,10519,255,2.40000000
CN0805100000000,08,051,"Gunnison County, CO",Jul-22,12489,12197,292,2.30000000
CN0805300000000,08,053,"Hinsdale County, CO",Jul-22,585,574,11,1.90000000
CN0805500000000,08,055,"Huerfano County, CO",Jul-22,2766,2568,198,7.20000000
CN0805700000000,08,057,"Jackson County, CO",Jul-22,1127,1107,20,1.80000000
CN0805900000000,08,059,"Jefferson County, CO",Jul-22,344611,333803,10808,3.10000000
CN0806100000000,08,061,"Kiowa County, CO",Jul-22,1013,995,18,1.80000000
CN0806300000000,08,063,"Kit Carson County, CO",Jul-22,4475,4379,96,2.10000000
CN0806500000000,08,065,"Lake County, CO",Jul-22,5218,5078,140,2.70000000
CN0806700000000,08,067,"La Plata County, CO",Jul-22,33587,32569,1018,3.00000000
CN0806900000000,08,069,"Larimer County, CO",Jul-22,212197,205806,6391,3.00000000
CN0807100000000,08,071,"Las Animas County, CO",Jul-22,6589,6245,344,5.20000000
CN0807300000000,08,073,"Lincoln County, CO",Jul-22,2444,2373,71,2.90000000
CN0807500000000,08,075,"Logan County, CO",Jul-22,10949,10599,350,3.20000000
CN0807700000000,08,077,"Mesa County, CO",Jul-22,77915,74883,3032,3.90000000
CN0807900000000,08,079,"Mineral County, CO",Jul-22,484,471,13,2.70000000
CN0808100000000,08,081,"Moffat County, CO",Jul-22,7247,7024,223,3.10000000
CN0808300000000,08,083,"Montezuma County, CO",Jul-22,14083,13593,490,3.50000000
CN0808500000000,08,085,"Montrose County, CO",Jul-22,23630,22862,768,3.30000000
CN0808700000000,08,087,"Morgan County, CO",Jul-22,16729,16139,590,3.50000000
CN0808900000000,08,089,"Otero County, CO",Jul-22,8562,8163,399,4.70000000
CN0809100000000,08,091,"Ouray County, CO",Jul-22,3198,3122,76,2.40000000
CN0809300000000,08,093,"Park County, CO",Jul-22,11705,11394,311,2.70000000
CN0809500000000,08,095,"Phillips County, CO",Jul-22,2780,2719,61,2.20000000
CN0809700000000,08,097,"Pitkin County, CO",Jul-22,11521,11191,330,2.90000000
CN0809900000000,08,099,"Prowers County, CO",Jul-22,6604,6397,207,3.10000000
CN0810100000000,08,101,"Pueblo County, CO",Jul-22,78537,74106,4431,5.60000000
CN0810300000000,08,103,"Rio Blanco County, CO",Jul-22,2982,2855,127,4.30000000
CN0810500000000,08,105,"Rio Grande County, CO",Jul-22,5975,5689,286,4.80000000
CN0810700000000,08,107,"Routt County, CO",Jul-22,16857,16440,417,2.50000000
CN0810900000000,08,109,"Saguache County, CO",Jul-22,3724,3582,142,3.80000000
CN0811100000000,08,111,"San Juan County, CO",Jul-22,848,833,15,1.80000000
CN0811300000000,08,113,"San Miguel County, CO",Jul-22,6925,6772,153,2.20000000
CN0811500000000,08,115,"Sedgwick County, CO",Jul-22,1287,1256,31,2.40000000
CN0811700000000,08,117,"Summit County, CO",Jul-22,23317,22791,526,2.30000000
CN0811900000000,08,119,"Teller County, CO",Jul-22,13390,12937,453,3.40000000
CN0812100000000,08,121,"Washington County, CO",Jul-22,2949,2878,71,2.40000000
CN0812300000000,08,123,"Weld County, CO",Jul-22,168967,162473,6494,3.80000000
CN0812500000000,08,125,"Yuma County, CO",Jul-22,6314,6185,129,2.00000000
CN0900100000000,09,001,"Fairfield County, CT",Jul-22,489850,468808,21042,4.30000000
CN0900300000000,09,003,"Hartford County, CT",Jul-22,481083,459421,21662,4.50000000
CN0900500000000,09,005,"Litchfield County, CT",Jul-22,105349,101391,3958,3.80000000
CN0900700000000,09,007,"Middlesex County, CT",Jul-22,94039,90681,3358,3.60000000
CN0900900000000,09,009,"New Haven County, CT",Jul-22,471238,449256,21982,4.70000000
CN0901100000000,09,011,"New London County, CT",Jul-22,134533,128330,6203,4.60000000
CN0901300000000,09,013,"Tolland County, CT",Jul-22,86812,83378,3434,4.00000000
CN0901500000000,09,015,"Windham County, CT",Jul-22,64284,61400,2884,4.50000000
CN1000100000000,10,001,"Kent County, DE",Jul-22,81366,76793,4573,5.60000000
CN1000300000000,10,003,"New Castle County, DE",Jul-22,304695,290705,13990,4.60000000
CN1000500000000,10,005,"Sussex County, DE",Jul-22,117445,113013,4432,3.80000000
CN1100100000000,11,001,District of Columbia,Jul-22,398415,379597,18818,4.70000000
CN1200100000000,12,001,"Alachua County, FL",Jul-22,141293,137286,4007,2.80000000
CN1200300000000,12,003,"Baker County, FL",Jul-22,12738,12389,349,2.70000000
CN1200500000000,12,005,"Bay County, FL",Jul-22,90264,87949,2315,2.60000000
CN1200700000000,12,007,"Bradford County, FL",Jul-22,11061,10719,342,3.10000000
CN1200900000000,12,009,"Brevard County, FL",Jul-22,300598,292415,8183,2.70000000
CN1201100000000,12,011,"Broward County, FL",Jul-22,1069932,1039332,30600,2.90000000
CN1201300000000,12,013,"Calhoun County, FL",Jul-22,4901,4750,151,3.10000000
CN1201500000000,12,015,"Charlotte County, FL",Jul-22,76071,73750,2321,3.10000000
CN1201700000000,12,017,"Citrus County, FL",Jul-22,46813,44825,1988,4.20000000
CN1201900000000,12,019,"Clay County, FL",Jul-22,113659,110706,2953,2.60000000
CN1202100000000,12,021,"Collier County, FL",Jul-22,186105,180859,5246,2.80000000
CN1202300000000,12,023,"Columbia County, FL",Jul-22,29149,28221,928,3.20000000
CN1202700000000,12,027,"DeSoto County, FL",Jul-22,14993,14571,422,2.80000000
CN1202900000000,12,029,"Dixie County, FL",Jul-22,5826,5649,177,3.00000000
CN1203100000000,12,031,"Duval County, FL",Jul-22,516954,500968,15986,3.10000000
CN1203300000000,12,033,"Escambia County, FL",Jul-22,152168,147686,4482,2.90000000
CN1203500000000,12,035,"Flagler County, FL",Jul-22,50400,48770,1630,3.20000000
CN1203700000000,12,037,"Franklin County, FL",Jul-22,4906,4786,120,2.40000000
CN1203900000000,12,039,"Gadsden County, FL",Jul-22,20524,19798,726,3.50000000
CN1204100000000,12,041,"Gilchrist County, FL",Jul-22,7347,7128,219,3.00000000
CN1204300000000,12,043,"Glades County, FL",Jul-22,4935,4763,172,3.50000000
CN1204500000000,12,045,"Gulf County, FL",Jul-22,5561,5415,146,2.60000000
CN1204700000000,12,047,"Hamilton County, FL",Jul-22,4091,3924,167,4.10000000
CN1204900000000,12,049,"Hardee County, FL",Jul-22,8578,8214,364,4.20000000
CN1205100000000,12,051,"Hendry County, FL",Jul-22,15548,14635,913,5.90000000
CN1205300000000,12,053,"Hernando County, FL",Jul-22,77018,74324,2694,3.50000000
CN1205500000000,12,055,"Highlands County, FL",Jul-22,34523,32997,1526,4.40000000
CN1205700000000,12,057,"Hillsborough County, FL",Jul-22,803690,781712,21978,2.70000000
CN1205900000000,12,059,"Holmes County, FL",Jul-22,6990,6777,213,3.00000000
CN1206100000000,12,061,"Indian River County, FL",Jul-22,67283,64935,2348,3.50000000
CN1206300000000,12,063,"Jackson County, FL",Jul-22,16855,16330,525,3.10000000
CN1206500000000,12,065,"Jefferson County, FL",Jul-22,5756,5558,198,3.40000000
CN1206700000000,12,067,"Lafayette County, FL",Jul-22,2734,2644,90,3.30000000
CN1206900000000,12,069,"Lake County, FL",Jul-22,168995,163970,5025,3.00000000
CN1207100000000,12,071,"Lee County, FL",Jul-22,369624,359305,10319,2.80000000
CN1207300000000,12,073,"Leon County, FL",Jul-22,157985,153281,4704,3.00000000
CN1207500000000,12,075,"Levy County, FL",Jul-22,16930,16373,557,3.30000000
CN1207700000000,12,077,"Liberty County, FL",Jul-22,2581,2506,75,2.90000000
CN1207900000000,12,079,"Madison County, FL",Jul-22,7953,7706,247,3.10000000
CN1208100000000,12,081,"Manatee County, FL",Jul-22,193557,188354,5203,2.70000000
CN1208300000000,12,083,"Marion County, FL",Jul-22,144905,139861,5044,3.50000000
CN1208500000000,12,085,"Martin County, FL",Jul-22,76382,74368,2014,2.60000000
CN1208600000000,12,086,"Miami-Dade County, FL",Jul-22,1368585,1329633,38952,2.80000000
CN1208700000000,12,087,"Monroe County, FL",Jul-22,50529,49675,854,1.70000000
CN1208900000000,12,089,"Nassau County, FL",Jul-22,45004,43926,1078,2.40000000
CN1209100000000,12,091,"Okaloosa County, FL",Jul-22,104641,102198,2443,2.30000000
CN1209300000000,12,093,"Okeechobee County, FL",Jul-22,17019,16480,539,3.20000000
CN1209500000000,12,095,"Orange County, FL",Jul-22,781462,757982,23480,3.00000000
CN1209700000000,12,097,"Osceola County, FL",Jul-22,195102,187926,7176,3.70000000
CN1209900000000,12,099,"Palm Beach County, FL",Jul-22,766607,744277,22330,2.90000000
CN1210100000000,12,101,"Pasco County, FL",Jul-22,258610,250965,7645,3.00000000
CN1210300000000,12,103,"Pinellas County, FL",Jul-22,510472,497528,12944,2.50000000
CN1210500000000,12,105,"Polk County, FL",Jul-22,338421,326340,12081,3.60000000
CN1210700000000,12,107,"Putnam County, FL",Jul-22,27340,26183,1157,4.20000000
CN1210900000000,12,109,"St. Johns County, FL",Jul-22,149809,146465,3344,2.20000000
CN1211100000000,12,111,"St. Lucie County, FL",Jul-22,155479,150213,5266,3.40000000
CN1211300000000,12,113,"Santa Rosa County, FL",Jul-22,89156,86800,2356,2.60000000
CN1211500000000,12,115,"Sarasota County, FL",Jul-22,203329,198033,5296,2.60000000
CN1211700000000,12,117,"Seminole County, FL",Jul-22,259893,252988,6905,2.70000000
CN1211900000000,12,119,"Sumter County, FL",Jul-22,36101,34698,1403,3.90000000
CN1212100000000,12,121,"Suwannee County, FL",Jul-22,17350,16791,559,3.20000000
CN1212300000000,12,123,"Taylor County, FL",Jul-22,8085,7819,266,3.30000000
CN1212500000000,12,125,"Union County, FL",Jul-22,4619,4487,132,2.90000000
CN1212700000000,12,127,"Volusia County, FL",Jul-22,265704,257592,8112,3.10000000
CN1212900000000,12,129,"Wakulla County, FL",Jul-22,15964,15570,394,2.50000000
CN1213100000000,12,131,"Walton County, FL",Jul-22,35502,34644,858,2.40000000
CN1213300000000,12,133,"Washington County, FL",Jul-22,9735,9428,307,3.20000000
CN1300100000000,13,001,"Appling County, GA",Jul-22,9126,8782,344,3.80000000
CN1300300000000,13,003,"Atkinson County, GA",Jul-22,4593,4467,126,2.70000000
CN1300500000000,13,005,"Bacon County, GA",Jul-22,4722,4587,135,2.90000000
CN1300700000000,13,007,"Baker County, GA",Jul-22,1136,1090,46,4.00000000
CN1300900000000,13,009,"Baldwin County, GA",Jul-22,17386,16727,659,3.80000000
CN1301100000000,13,011,"Banks County, GA",Jul-22,10125,9908,217,2.10000000
CN1301300000000,13,013,"Barrow County, GA",Jul-22,43315,42344,971,2.20000000
CN1301500000000,13,015,"Bartow County, GA",Jul-22,52531,51224,1307,2.50000000
CN1301700000000,13,017,"Ben Hill County, GA",Jul-22,5485,5233,252,4.60000000
CN1301900000000,13,019,"Berrien County, GA",Jul-22,7547,7314,233,3.10000000
CN1302100000000,13,021,"Bibb County, GA",Jul-22,68204,65728,2476,3.60000000
CN1302300000000,13,023,"Bleckley County, GA",Jul-22,4508,4325,183,4.10000000
CN1302500000000,13,025,"Brantley County, GA",Jul-22,7455,7220,235,3.20000000
CN1302700000000,13,027,"Brooks County, GA",Jul-22,6717,6522,195,2.90000000
CN1302900000000,13,029,"Bryan County, GA",Jul-22,20358,19897,461,2.30000000
CN1303100000000,13,031,"Bulloch County, GA",Jul-22,36781,35535,1246,3.40000000
CN1303300000000,13,033,"Burke County, GA",Jul-22,9153,8626,527,5.80000000
CN1303500000000,13,035,"Butts County, GA",Jul-22,11395,11109,286,2.50000000
CN1303700000000,13,037,"Calhoun County, GA",Jul-22,2191,2119,72,3.30000000
CN1303900000000,13,039,"Camden County, GA",Jul-22,21636,21080,556,2.60000000
CN1304300000000,13,043,"Candler County, GA",Jul-22,5997,5871,126,2.10000000
CN1304500000000,13,045,"Carroll County, GA",Jul-22,57642,56023,1619,2.80000000
CN1304700000000,13,047,"Catoosa County, GA",Jul-22,33277,32509,768,2.30000000
CN1304900000000,13,049,"Charlton County, GA",Jul-22,4933,4796,137,2.80000000
CN1305100000000,13,051,"Chatham County, GA",Jul-22,145912,141722,4190,2.90000000
CN1305300000000,13,053,"Chattahoochee County, GA",Jul-22,1927,1847,80,4.20000000
CN1305500000000,13,055,"Chattooga County, GA",Jul-22,9226,8880,346,3.80000000
CN1305700000000,13,057,"Cherokee County, GA",Jul-22,143553,140673,2880,2.00000000
CN1305900000000,13,059,"Clarke County, GA",Jul-22,60606,58870,1736,2.90000000
CN1306100000000,13,061,"Clay County, GA",Jul-22,854,783,71,8.30000000
CN1306300000000,13,063,"Clayton County, GA",Jul-22,142307,135799,6508,4.60000000
CN1306500000000,13,065,"Clinch County, GA",Jul-22,3006,2915,91,3.00000000
CN1306700000000,13,067,"Cobb County, GA",Jul-22,434441,424094,10347,2.40000000
CN1306900000000,13,069,"Coffee County, GA",Jul-22,18198,17493,705,3.90000000
CN1307100000000,13,071,"Colquitt County, GA",Jul-22,22102,21535,567,2.60000000
CN1307300000000,13,073,"Columbia County, GA",Jul-22,76398,74484,1914,2.50000000
CN1307500000000,13,075,"Cook County, GA",Jul-22,8159,7922,237,2.90000000
CN1307700000000,13,077,"Coweta County, GA",Jul-22,78224,76300,1924,2.50000000
CN1307900000000,13,079,"Crawford County, GA",Jul-22,5589,5423,166,3.00000000
CN1308100000000,13,081,"Crisp County, GA",Jul-22,9378,8891,487,5.20000000
CN1308300000000,13,083,"Dade County, GA",Jul-22,8051,7871,180,2.20000000
CN1308500000000,13,085,"Dawson County, GA",Jul-22,13520,13233,287,2.10000000
CN1308700000000,13,087,"Decatur County, GA",Jul-22,11270,10914,356,3.20000000
CN1308900000000,13,089,"DeKalb County, GA",Jul-22,408571,395884,12687,3.10000000
CN1309100000000,13,091,"Dodge County, GA",Jul-22,6984,6744,240,3.40000000
CN1309300000000,13,093,"Dooly County, GA",Jul-22,4656,4461,195,4.20000000
CN1309500000000,13,095,"Dougherty County, GA",Jul-22,36993,35267,1726,4.70000000
CN1309700000000,13,097,"Douglas County, GA",Jul-22,75747,73320,2427,3.20000000
CN1309900000000,13,099,"Early County, GA",Jul-22,4186,4035,151,3.60000000
CN1310100000000,13,101,"Echols County, GA",Jul-22,1873,1832,41,2.20000000
CN1310300000000,13,103,"Effingham County, GA",Jul-22,34008,33240,768,2.30000000
CN1310500000000,13,105,"Elbert County, GA",Jul-22,7741,7392,349,4.50000000
CN1310700000000,13,107,"Emanuel County, GA",Jul-22,8536,8169,367,4.30000000
CN1310900000000,13,109,"Evans County, GA",Jul-22,5158,5026,132,2.60000000
CN1311100000000,13,111,"Fannin County, GA",Jul-22,11994,11734,260,2.20000000
CN1311300000000,13,113,"Fayette County, GA",Jul-22,59895,58499,1396,2.30000000
CN1311500000000,13,115,"Floyd County, GA",Jul-22,43917,42674,1243,2.80000000
CN1311700000000,13,117,"Forsyth County, GA",Jul-22,130964,128328,2636,2.00000000
CN1311900000000,13,119,"Franklin County, GA",Jul-22,10055,9743,312,3.10000000
CN1312100000000,13,121,"Fulton County, GA",Jul-22,580440,562172,18268,3.10000000
CN1312300000000,13,123,"Gilmer County, GA",Jul-22,12320,11996,324,2.60000000
CN1312500000000,13,125,"Glascock County, GA",Jul-22,1258,1226,32,2.50000000
CN1312700000000,13,127,"Glynn County, GA",Jul-22,39657,38648,1009,2.50000000
CN1312900000000,13,129,"Gordon County, GA",Jul-22,29142,28403,739,2.50000000
CN1313100000000,13,131,"Grady County, GA",Jul-22,11013,10713,300,2.70000000
CN1313300000000,13,133,"Greene County, GA",Jul-22,7392,7192,200,2.70000000
CN1313500000000,13,135,"Gwinnett County, GA",Jul-22,504773,492199,12574,2.50000000
CN1313700000000,13,137,"Habersham County, GA",Jul-22,18381,17862,519,2.80000000
CN1313900000000,13,139,"Hall County, GA",Jul-22,105575,103328,2247,2.10000000
CN1314100000000,13,141,"Hancock County, GA",Jul-22,2490,2355,135,5.40000000
CN1314300000000,13,143,"Haralson County, GA",Jul-22,13085,12750,335,2.60000000
CN1314500000000,13,145,"Harris County, GA",Jul-22,17000,16605,395,2.30000000
CN1314700000000,13,147,"Hart County, GA",Jul-22,11704,11351,353,3.00000000
CN1314900000000,13,149,"Heard County, GA",Jul-22,5363,5216,147,2.70000000
CN1315100000000,13,151,"Henry County, GA",Jul-22,121350,117725,3625,3.00000000
CN1315300000000,13,153,"Houston County, GA",Jul-22,71215,69145,2070,2.90000000
CN1315500000000,13,155,"Irwin County, GA",Jul-22,3502,3353,149,4.30000000
CN1315700000000,13,157,"Jackson County, GA",Jul-22,44046,43246,800,1.80000000
CN1315900000000,13,159,"Jasper County, GA",Jul-22,7258,7084,174,2.40000000
CN1316100000000,13,161,"Jeff Davis County, GA",Jul-22,6151,5951,200,3.30000000
CN1316300000000,13,163,"Jefferson County, GA",Jul-22,7046,6760,286,4.10000000
CN1316500000000,13,165,"Jenkins County, GA",Jul-22,3129,2986,143,4.60000000
CN1316700000000,13,167,"Johnson County, GA",Jul-22,4005,3897,108,2.70000000
CN1316900000000,13,169,"Jones County, GA",Jul-22,13833,13489,344,2.50000000
CN1317100000000,13,171,"Lamar County, GA",Jul-22,8458,8192,266,3.10000000
CN1317300000000,13,173,"Lanier County, GA",Jul-22,3769,3655,114,3.00000000
CN1317500000000,13,175,"Laurens County, GA",Jul-22,19176,18445,731,3.80000000
CN1317700000000,13,177,"Lee County, GA",Jul-22,15163,14777,386,2.50000000
CN1317900000000,13,179,"Liberty County, GA",Jul-22,25986,25169,817,3.10000000
CN1318100000000,13,181,"Lincoln County, GA",Jul-22,3544,3424,120,3.40000000
CN1318300000000,13,183,"Long County, GA",Jul-22,8435,8191,244,2.90000000
CN1318500000000,13,185,"Lowndes County, GA",Jul-22,50363,48807,1556,3.10000000
CN1318700000000,13,187,"Lumpkin County, GA",Jul-22,17437,17041,396,2.30000000
CN1318900000000,13,189,"McDuffie County, GA",Jul-22,8530,8106,424,5.00000000
CN1319100000000,13,191,"McIntosh County, GA",Jul-22,6217,6047,170,2.70000000
CN1319300000000,13,193,"Macon County, GA",Jul-22,4522,4328,194,4.30000000
CN1319500000000,13,195,"Madison County, GA",Jul-22,13990,13644,346,2.50000000
CN1319700000000,13,197,"Marion County, GA",Jul-22,3284,3181,103,3.10000000
CN1319900000000,13,199,"Meriwether County, GA",Jul-22,9095,8733,362,4.00000000
CN1320100000000,13,201,"Miller County, GA",Jul-22,2749,2683,66,2.40000000
CN1320500000000,13,205,"Mitchell County, GA",Jul-22,7979,7679,300,3.80000000
CN1320700000000,13,207,"Monroe County, GA",Jul-22,13305,12975,330,2.50000000
CN1320900000000,13,209,"Montgomery County, GA",Jul-22,3731,3579,152,4.10000000
CN1321100000000,13,211,"Morgan County, GA",Jul-22,9790,9547,243,2.50000000
CN1321300000000,13,213,"Murray County, GA",Jul-22,15528,14920,608,3.90000000
CN1321500000000,13,215,"Muscogee County, GA",Jul-22,76513,73423,3090,4.00000000
CN1321700000000,13,217,"Newton County, GA",Jul-22,54823,52892,1931,3.50000000
CN1321900000000,13,219,"Oconee County, GA",Jul-22,20919,20533,386,1.80000000
CN1322100000000,13,221,"Oglethorpe County, GA",Jul-22,7220,7057,163,2.30000000
CN1322300000000,13,223,"Paulding County, GA",Jul-22,91956,89764,2192,2.40000000
CN1322500000000,13,225,"Peach County, GA",Jul-22,11951,11527,424,3.50000000
CN1322700000000,13,227,"Pickens County, GA",Jul-22,15985,15641,344,2.20000000
CN1322900000000,13,229,"Pierce County, GA",Jul-22,8582,8369,213,2.50000000
CN1323100000000,13,231,"Pike County, GA",Jul-22,9265,9045,220,2.40000000
CN1323300000000,13,233,"Polk County, GA",Jul-22,18427,17937,490,2.70000000
CN1323500000000,13,235,"Pulaski County, GA",Jul-22,4039,3915,124,3.10000000
CN1323700000000,13,237,"Putnam County, GA",Jul-22,8806,8526,280,3.20000000
CN1323900000000,13,239,"Quitman County, GA",Jul-22,735,701,34,4.60000000
CN1324100000000,13,241,"Rabun County, GA",Jul-22,7816,7622,194,2.50000000
CN1324300000000,13,243,"Randolph County, GA",Jul-22,2332,2231,101,4.30000000
CN1324500000000,13,245,"Richmond County, GA",Jul-22,83522,79853,3669,4.40000000
CN1324700000000,13,247,"Rockdale County, GA",Jul-22,45631,44060,1571,3.40000000
CN1324900000000,13,249,"Schley County, GA",Jul-22,2092,2014,78,3.70000000
CN1325100000000,13,251,"Screven County, GA",Jul-22,4954,4701,253,5.10000000
CN1325300000000,13,253,"Seminole County, GA",Jul-22,3010,2913,97,3.20000000
CN1325500000000,13,255,"Spalding County, GA",Jul-22,29585,28619,966,3.30000000
CN1325700000000,13,257,"Stephens County, GA",Jul-22,10422,10001,421,4.00000000
CN1325900000000,13,259,"Stewart County, GA",Jul-22,2553,2458,95,3.70000000
CN1326100000000,13,261,"Sumter County, GA",Jul-22,11914,11378,536,4.50000000
CN1326300000000,13,263,"Talbot County, GA",Jul-22,2802,2705,97,3.50000000
CN1326500000000,13,265,"Taliaferro County, GA",Jul-22,546,524,22,4.00000000
CN1326700000000,13,267,"Tattnall County, GA",Jul-22,9713,9455,258,2.70000000
CN1326900000000,13,269,"Taylor County, GA",Jul-22,2862,2741,121,4.20000000
CN1327100000000,13,271,"Telfair County, GA",Jul-22,3568,3358,210,5.90000000
CN1327300000000,13,273,"Terrell County, GA",Jul-22,3535,3365,170,4.80000000
CN1327500000000,13,275,"Thomas County, GA",Jul-22,17366,16804,562,3.20000000
CN1327700000000,13,277,"Tift County, GA",Jul-22,21265,20697,568,2.70000000
CN1327900000000,13,279,"Toombs County, GA",Jul-22,11759,11272,487,4.10000000
CN1328100000000,13,281,"Towns County, GA",Jul-22,4222,4079,143,3.40000000
CN1328300000000,13,283,"Treutlen County, GA",Jul-22,2573,2469,104,4.00000000
CN1328500000000,13,285,"Troup County, GA",Jul-22,37649,36477,1172,3.10000000
CN1328700000000,13,287,"Turner County, GA",Jul-22,3236,3101,135,4.20000000
CN1328900000000,13,289,"Twiggs County, GA",Jul-22,2838,2709,129,4.50000000
CN1329100000000,13,291,"Union County, GA",Jul-22,11217,10980,237,2.10000000
CN1329300000000,13,293,"Upson County, GA",Jul-22,11740,11344,396,3.40000000
CN1329500000000,13,295,"Walker County, GA",Jul-22,31103,30295,808,2.60000000
CN1329700000000,13,297,"Walton County, GA",Jul-22,48301,47074,1227,2.50000000
CN1329900000000,13,299,"Ware County, GA",Jul-22,15316,14848,468,3.10000000
CN1330100000000,13,301,"Warren County, GA",Jul-22,2659,2539,120,4.50000000
CN1330300000000,13,303,"Washington County, GA",Jul-22,6544,6275,269,4.10000000
CN1330500000000,13,305,"Wayne County, GA",Jul-22,11815,11477,338,2.90000000
CN1330700000000,13,307,"Webster County, GA",Jul-22,963,931,32,3.30000000
CN1330900000000,13,309,"Wheeler County, GA",Jul-22,1612,1538,74,4.60000000
CN1331100000000,13,311,"White County, GA",Jul-22,16531,16169,362,2.20000000
CN1331300000000,13,313,"Whitfield County, GA",Jul-22,43441,41950,1491,3.40000000
CN1331500000000,13,315,"Wilcox County, GA",Jul-22,2676,2572,104,3.90000000
CN1331700000000,13,317,"Wilkes County, GA",Jul-22,3757,3599,158,4.20000000
CN1331900000000,13,319,"Wilkinson County, GA",Jul-22,3628,3504,124,3.40000000
CN1332100000000,13,321,"Worth County, GA",Jul-22,8823,8583,240,2.70000000
CN1500100000000,15,001,"Hawaii County, HI",Jul-22,93509,89827,3682,3.90000000
CN1500300000000,15,003,"Honolulu County/city, HI",Jul-22,456808,440599,16209,3.50000000
CN1500700000000,15,007,"Kauai County, HI",Jul-22,36799,35183,1616,4.40000000
CN1500900000000,15,009,"Maui County, HI",Jul-22,87891,84198,3693,4.20000000
CN1600100000000,16,001,"Ada County, ID",Jul-22,279160,272631,6529,2.30000000
CN1600300000000,16,003,"Adams County, ID",Jul-22,1950,1859,91,4.70000000
CN1600500000000,16,005,"Bannock County, ID",Jul-22,44100,42901,1199,2.70000000
CN1600700000000,16,007,"Bear Lake County, ID",Jul-22,3436,3358,78,2.30000000
CN1600900000000,16,009,"Benewah County, ID",Jul-22,4277,4134,143,3.30000000
CN1601100000000,16,011,"Bingham County, ID",Jul-22,25120,24443,677,2.70000000
CN1601300000000,16,013,"Blaine County, ID",Jul-22,14443,14129,314,2.20000000
CN1601500000000,16,015,"Boise County, ID",Jul-22,3881,3735,146,3.80000000
CN1601700000000,16,017,"Bonner County, ID",Jul-22,23423,22726,697,3.00000000
CN1601900000000,16,019,"Bonneville County, ID",Jul-22,63260,61854,1406,2.20000000
CN1602100000000,16,021,"Boundary County, ID",Jul-22,6050,5862,188,3.10000000
CN1602300000000,16,023,"Butte County, ID",Jul-22,1511,1472,39,2.60000000
CN1602500000000,16,025,"Camas County, ID",Jul-22,765,749,16,2.10000000
CN1602700000000,16,027,"Canyon County, ID",Jul-22,116174,112477,3697,3.20000000
CN1602900000000,16,029,"Caribou County, ID",Jul-22,4207,4100,107,2.50000000
CN1603100000000,16,031,"Cassia County, ID",Jul-22,13303,12982,321,2.40000000
CN1603300000000,16,033,"Clark County, ID",Jul-22,408,398,10,2.50000000
CN1603500000000,16,035,"Clearwater County, ID",Jul-22,3181,3047,134,4.20000000
CN1603700000000,16,037,"Custer County, ID",Jul-22,2634,2564,70,2.70000000
CN1603900000000,16,039,"Elmore County, ID",Jul-22,12676,12294,382,3.00000000
CN1604100000000,16,041,"Franklin County, ID",Jul-22,7441,7298,143,1.90000000
CN1604300000000,16,043,"Fremont County, ID",Jul-22,8620,8430,190,2.20000000
CN1604500000000,16,045,"Gem County, ID",Jul-22,9091,8851,240,2.60000000
CN1604700000000,16,047,"Gooding County, ID",Jul-22,8603,8389,214,2.50000000
CN1604900000000,16,049,"Idaho County, ID",Jul-22,7182,6933,249,3.50000000
CN1605100000000,16,051,"Jefferson County, ID",Jul-22,15396,15051,345,2.20000000
CN1605300000000,16,053,"Jerome County, ID",Jul-22,12899,12570,329,2.60000000
CN1605500000000,16,055,"Kootenai County, ID",Jul-22,86977,84524,2453,2.80000000
CN1605700000000,16,057,"Latah County, ID",Jul-22,19705,19195,510,2.60000000
CN1605900000000,16,059,"Lemhi County, ID",Jul-22,4238,4108,130,3.10000000
CN1606100000000,16,061,"Lewis County, ID",Jul-22,1762,1687,75,4.30000000
CN1606300000000,16,063,"Lincoln County, ID",Jul-22,2939,2861,78,2.70000000
CN1606500000000,16,065,"Madison County, ID",Jul-22,24855,24356,499,2.00000000
CN1606700000000,16,067,"Minidoka County, ID",Jul-22,12441,12114,327,2.60000000
CN1606900000000,16,069,"Nez Perce County, ID",Jul-22,21481,20982,499,2.30000000
CN1607100000000,16,071,"Oneida County, ID",Jul-22,2752,2679,73,2.70000000
CN1607300000000,16,073,"Owyhee County, ID",Jul-22,6155,5954,201,3.30000000
CN1607500000000,16,075,"Payette County, ID",Jul-22,12339,11952,387,3.10000000
CN1607700000000,16,077,"Power County, ID",Jul-22,4210,4072,138,3.30000000
CN1607900000000,16,079,"Shoshone County, ID",Jul-22,5649,5401,248,4.40000000
CN1608100000000,16,081,"Teton County, ID",Jul-22,8659,8533,126,1.50000000
CN1608300000000,16,083,"Twin Falls County, ID",Jul-22,44114,42899,1215,2.80000000
CN1608500000000,16,085,"Valley County, ID",Jul-22,6654,6463,191,2.90000000
CN1608700000000,16,087,"Washington County, ID",Jul-22,5035,4857,178,3.50000000
CN1700100000000,17,001,"Adams County, IL",Jul-22,31416,30328,1088,3.50000000
CN1700300000000,17,003,"Alexander County, IL",Jul-22,1829,1675,154,8.40000000
CN1700500000000,17,005,"Bond County, IL",Jul-22,7738,7440,298,3.90000000
CN1700700000000,17,007,"Boone County, IL",Jul-22,26291,24577,1714,6.50000000
CN1700900000000,17,009,"Brown County, IL",Jul-22,3236,3159,77,2.40000000
CN1701100000000,17,011,"Bureau County, IL",Jul-22,16781,16086,695,4.10000000
CN1701300000000,17,013,"Calhoun County, IL",Jul-22,2247,2159,88,3.90000000
CN1701500000000,17,015,"Carroll County, IL",Jul-22,8058,7771,287,3.60000000
CN1701700000000,17,017,"Cass County, IL",Jul-22,5804,5553,251,4.30000000
CN1701900000000,17,019,"Champaign County, IL",Jul-22,108195,103514,4681,4.30000000
CN1702100000000,17,021,"Christian County, IL",Jul-22,13720,13058,662,4.80000000
CN1702300000000,17,023,"Clark County, IL",Jul-22,7450,7135,315,4.20000000
CN1702500000000,17,025,"Clay County, IL",Jul-22,5993,5670,323,5.40000000
CN1702700000000,17,027,"Clinton County, IL",Jul-22,20572,19943,629,3.10000000
CN1702900000000,17,029,"Coles County, IL",Jul-22,21905,20815,1090,5.00000000
CN1703100000000,17,031,"Cook County, IL",Jul-22,2657568,2515296,142272,5.40000000
CN1703300000000,17,033,"Crawford County, IL",Jul-22,8667,8276,391,4.50000000
CN1703500000000,17,035,"Cumberland County, IL",Jul-22,5998,5789,209,3.50000000
CN1703700000000,17,037,"DeKalb County, IL",Jul-22,55773,53270,2503,4.50000000
CN1703900000000,17,039,"De Witt County, IL",Jul-22,7397,7099,298,4.00000000
CN1704100000000,17,041,"Douglas County, IL",Jul-22,10399,10033,366,3.50000000
CN1704300000000,17,043,"DuPage County, IL",Jul-22,515679,497735,17944,3.50000000
CN1704500000000,17,045,"Edgar County, IL",Jul-22,9230,8878,352,3.80000000
CN1704700000000,17,047,"Edwards County, IL",Jul-22,2617,2498,119,4.50000000
CN1704900000000,17,049,"Effingham County, IL",Jul-22,20303,19698,605,3.00000000
CN1705100000000,17,051,"Fayette County, IL",Jul-22,10053,9621,432,4.30000000
CN1705300000000,17,053,"Ford County, IL",Jul-22,6330,6054,276,4.40000000
CN1705500000000,17,055,"Franklin County, IL",Jul-22,16111,15151,960,6.00000000
CN1705700000000,17,057,"Fulton County, IL",Jul-22,14708,13965,743,5.10000000
CN1705900000000,17,059,"Gallatin County, IL",Jul-22,2045,1926,119,5.80000000
CN1706100000000,17,061,"Greene County, IL",Jul-22,6118,5869,249,4.10000000
CN1706300000000,17,063,"Grundy County, IL",Jul-22,25992,24868,1124,4.30000000
CN1706500000000,17,065,"Hamilton County, IL",Jul-22,4274,4124,150,3.50000000
CN1706700000000,17,067,"Hancock County, IL",Jul-22,8415,8093,322,3.80000000
CN1706900000000,17,069,"Hardin County, IL",Jul-22,1343,1250,93,6.90000000
CN1707100000000,17,071,"Henderson County, IL",Jul-22,3760,3619,141,3.80000000
CN1707300000000,17,073,"Henry County, IL",Jul-22,25242,24213,1029,4.10000000
CN1707500000000,17,075,"Iroquois County, IL",Jul-22,13374,12835,539,4.00000000
CN1707700000000,17,077,"Jackson County, IL",Jul-22,28048,26757,1291,4.60000000
CN1707900000000,17,079,"Jasper County, IL",Jul-22,5005,4818,187,3.70000000
CN1708100000000,17,081,"Jefferson County, IL",Jul-22,16741,15838,903,5.40000000
CN1708300000000,17,083,"Jersey County, IL",Jul-22,10928,10513,415,3.80000000
CN1708500000000,17,085,"Jo Daviess County, IL",Jul-22,11175,10814,361,3.20000000
CN1708700000000,17,087,"Johnson County, IL",Jul-22,4156,3925,231,5.60000000
CN1708900000000,17,089,"Kane County, IL",Jul-22,272877,260219,12658,4.60000000
CN1709100000000,17,091,"Kankakee County, IL",Jul-22,54265,51370,2895,5.30000000
CN1709300000000,17,093,"Kendall County, IL",Jul-22,72050,69324,2726,3.80000000
CN1709500000000,17,095,"Knox County, IL",Jul-22,20786,19650,1136,5.50000000
CN1709700000000,17,097,"Lake County, IL",Jul-22,386846,371227,15619,4.00000000
CN1709900000000,17,099,"LaSalle County, IL",Jul-22,53899,51257,2642,4.90000000
CN1710100000000,17,101,"Lawrence County, IL",Jul-22,5670,5363,307,5.40000000
CN1710300000000,17,103,"Lee County, IL",Jul-22,17226,16515,711,4.10000000
CN1710500000000,17,105,"Livingston County, IL",Jul-22,15874,15252,622,3.90000000
CN1710700000000,17,107,"Logan County, IL",Jul-22,11843,11313,530,4.50000000
CN1710900000000,17,109,"McDonough County, IL",Jul-22,11879,11248,631,5.30000000
CN1711100000000,17,111,"McHenry County, IL",Jul-22,168371,162213,6158,3.70000000
CN1711300000000,17,113,"McLean County, IL",Jul-22,89046,85536,3510,3.90000000
CN1711500000000,17,115,"Macon County, IL",Jul-22,48166,45023,3143,6.50000000
CN1711700000000,17,117,"Macoupin County, IL",Jul-22,22820,21946,874,3.80000000
CN1711900000000,17,119,"Madison County, IL",Jul-22,135323,129545,5778,4.30000000
CN1712100000000,17,121,"Marion County, IL",Jul-22,16990,16095,895,5.30000000
CN1712300000000,17,123,"Marshall County, IL",Jul-22,5327,5078,249,4.70000000
CN1712500000000,17,125,"Mason County, IL",Jul-22,6031,5735,296,4.90000000
CN1712700000000,17,127,"Massac County, IL",Jul-22,5486,5178,308,5.60000000
CN1712900000000,17,129,"Menard County, IL",Jul-22,6469,6244,225,3.50000000
CN1713100000000,17,131,"Mercer County, IL",Jul-22,8035,7753,282,3.50000000
CN1713300000000,17,133,"Monroe County, IL",Jul-22,19225,18647,578,3.00000000
CN1713500000000,17,135,"Montgomery County, IL",Jul-22,11585,11048,537,4.60000000
CN1713700000000,17,137,"Morgan County, IL",Jul-22,16095,15427,668,4.20000000
CN1713900000000,17,139,"Moultrie County, IL",Jul-22,7625,7374,251,3.30000000
CN1714100000000,17,141,"Ogle County, IL",Jul-22,24285,23135,1150,4.70000000
CN1714300000000,17,143,"Peoria County, IL",Jul-22,85557,80582,4975,5.80000000
CN1714500000000,17,145,"Perry County, IL",Jul-22,8238,7779,459,5.60000000
CN1714700000000,17,147,"Piatt County, IL",Jul-22,8563,8247,316,3.70000000
CN1714900000000,17,149,"Pike County, IL",Jul-22,7060,6787,273,3.90000000
CN1715100000000,17,151,"Pope County, IL",Jul-22,1743,1644,99,5.70000000
CN1715300000000,17,153,"Pulaski County, IL",Jul-22,1706,1567,139,8.10000000
CN1715500000000,17,155,"Putnam County, IL",Jul-22,3047,2916,131,4.30000000
CN1715700000000,17,157,"Randolph County, IL",Jul-22,14071,13519,552,3.90000000
CN1715900000000,17,159,"Richland County, IL",Jul-22,7381,7081,300,4.10000000
CN1716100000000,17,161,"Rock Island County, IL",Jul-22,71570,68499,3071,4.30000000
CN1716300000000,17,163,"St. Clair County, IL",Jul-22,127295,120932,6363,5.00000000
CN1716500000000,17,165,"Saline County, IL",Jul-22,9272,8709,563,6.10000000
CN1716700000000,17,167,"Sangamon County, IL",Jul-22,102041,97591,4450,4.40000000
CN1716900000000,17,169,"Schuyler County, IL",Jul-22,3386,3256,130,3.80000000
CN1717100000000,17,171,"Scott County, IL",Jul-22,2402,2305,97,4.00000000
CN1717300000000,17,173,"Shelby County, IL",Jul-22,10709,10283,426,4.00000000
CN1717500000000,17,175,"Stark County, IL",Jul-22,2487,2375,112,4.50000000
CN1717700000000,17,177,"Stephenson County, IL",Jul-22,21527,20554,973,4.50000000
CN1717900000000,17,179,"Tazewell County, IL",Jul-22,64063,61313,2750,4.30000000
CN1718100000000,17,181,"Union County, IL",Jul-22,7395,7033,362,4.90000000
CN1718300000000,17,183,"Vermilion County, IL",Jul-22,32471,30633,1838,5.70000000
CN1718500000000,17,185,"Wabash County, IL",Jul-22,5642,5433,209,3.70000000
CN1718700000000,17,187,"Warren County, IL",Jul-22,7756,7429,327,4.20000000
CN1718900000000,17,189,"Washington County, IL",Jul-22,10103,9825,278,2.80000000
CN1719100000000,17,191,"Wayne County, IL",Jul-22,7103,6809,294,4.10000000
CN1719300000000,17,193,"White County, IL",Jul-22,6110,5851,259,4.20000000
CN1719500000000,17,195,"Whiteside County, IL",Jul-22,28244,27032,1212,4.30000000
CN1719700000000,17,197,"Will County, IL",Jul-22,365557,349563,15994,4.40000000
CN1719900000000,17,199,"Williamson County, IL",Jul-22,32013,30562,1451,4.50000000
CN1720100000000,17,201,"Winnebago County, IL",Jul-22,140294,131168,9126,6.50000000
CN1720300000000,17,203,"Woodford County, IL",Jul-22,18851,18207,644,3.40000000
CN1800100000000,18,001,"Adams County, IN",Jul-22,17573,17115,458,2.60000000
CN1800300000000,18,003,"Allen County, IN",Jul-22,191738,185331,6407,3.30000000
CN1800500000000,18,005,"Bartholomew County, IN",Jul-22,44424,43160,1264,2.80000000
CN1800700000000,18,007,"Benton County, IN",Jul-22,4445,4316,129,2.90000000
CN1800900000000,18,009,"Blackford County, IN",Jul-22,4842,4664,178,3.70000000
CN1801100000000,18,011,"Boone County, IN",Jul-22,38861,37928,933,2.40000000
CN1801300000000,18,013,"Brown County, IN",Jul-22,7997,7724,273,3.40000000
CN1801500000000,18,015,"Carroll County, IN",Jul-22,9934,9612,322,3.20000000
CN1801700000000,18,017,"Cass County, IN",Jul-22,17513,16867,646,3.70000000
CN1801900000000,18,019,"Clark County, IN",Jul-22,63955,61950,2005,3.10000000
CN1802100000000,18,021,"Clay County, IN",Jul-22,11909,11437,472,4.00000000
CN1802300000000,18,023,"Clinton County, IN",Jul-22,17315,16831,484,2.80000000
CN1802500000000,18,025,"Crawford County, IN",Jul-22,4887,4712,175,3.60000000
CN1802700000000,18,027,"Daviess County, IN",Jul-22,17051,16610,441,2.60000000
CN1802900000000,18,029,"Dearborn County, IN",Jul-22,26199,25386,813,3.10000000
CN1803100000000,18,031,"Decatur County, IN",Jul-22,15037,14614,423,2.80000000
CN1803300000000,18,033,"DeKalb County, IN",Jul-22,22809,22138,671,2.90000000
CN1803500000000,18,035,"Delaware County, IN",Jul-22,53144,50997,2147,4.00000000
CN1803700000000,18,037,"Dubois County, IN",Jul-22,22630,22070,560,2.50000000
CN1803900000000,18,039,"Elkhart County, IN",Jul-22,122922,119605,3317,2.70000000
CN1804100000000,18,041,"Fayette County, IN",Jul-22,8459,8020,439,5.20000000
CN1804300000000,18,043,"Floyd County, IN",Jul-22,43074,41852,1222,2.80000000
CN1804500000000,18,045,"Fountain County, IN",Jul-22,8177,7923,254,3.10000000
CN1804700000000,18,047,"Franklin County, IN",Jul-22,11622,11272,350,3.00000000
CN1804900000000,18,049,"Fulton County, IN",Jul-22,9994,9675,319,3.20000000
CN1805100000000,18,051,"Gibson County, IN",Jul-22,20068,19525,543,2.70000000
CN1805300000000,18,053,"Grant County, IN",Jul-22,31126,29953,1173,3.80000000
CN1805500000000,18,055,"Greene County, IN",Jul-22,13604,13075,529,3.90000000
CN1805700000000,18,057,"Hamilton County, IN",Jul-22,197902,192826,5076,2.60000000
CN1805900000000,18,059,"Hancock County, IN",Jul-22,43392,42140,1252,2.90000000
CN1806100000000,18,061,"Harrison County, IN",Jul-22,20912,20293,619,3.00000000
CN1806300000000,18,063,"Hendricks County, IN",Jul-22,96321,93640,2681,2.80000000
CN1806500000000,18,065,"Henry County, IN",Jul-22,22365,21613,752,3.40000000
CN1806700000000,18,067,"Howard County, IN",Jul-22,34884,32905,1979,5.70000000
CN1806900000000,18,069,"Huntington County, IN",Jul-22,18509,17954,555,3.00000000
CN1807100000000,18,071,"Jackson County, IN",Jul-22,24162,23429,733,3.00000000
CN1807300000000,18,073,"Jasper County, IN",Jul-22,16251,15689,562,3.50000000
CN1807500000000,18,075,"Jay County, IN",Jul-22,9085,8803,282,3.10000000
CN1807700000000,18,077,"Jefferson County, IN",Jul-22,15145,14631,514,3.40000000
CN1807900000000,18,079,"Jennings County, IN",Jul-22,13751,13287,464,3.40000000
CN1808100000000,18,081,"Johnson County, IN",Jul-22,88093,85696,2397,2.70000000
CN1808300000000,18,083,"Knox County, IN",Jul-22,18643,18033,610,3.30000000
CN1808500000000,18,085,"Kosciusko County, IN",Jul-22,41309,40128,1181,2.90000000
CN1808700000000,18,087,"LaGrange County, IN",Jul-22,21948,21355,593,2.70000000
CN1808900000000,18,089,"Lake County, IN",Jul-22,231469,218763,12706,5.50000000
CN1809100000000,18,091,"LaPorte County, IN",Jul-22,47289,45249,2040,4.30000000
CN1809300000000,18,093,"Lawrence County, IN",Jul-22,20960,20189,771,3.70000000
CN1809500000000,18,095,"Madison County, IN",Jul-22,61149,58894,2255,3.70000000
CN1809700000000,18,097,"Marion County, IN",Jul-22,515164,495600,19564,3.80000000
CN1809900000000,18,099,"Marshall County, IN",Jul-22,23563,22873,690,2.90000000
CN1810100000000,18,101,"Martin County, IN",Jul-22,5701,5547,154,2.70000000
CN1810300000000,18,103,"Miami County, IN",Jul-22,14499,13888,611,4.20000000
CN1810500000000,18,105,"Monroe County, IN",Jul-22,70010,67443,2567,3.70000000
CN1810700000000,18,107,"Montgomery County, IN",Jul-22,19084,18506,578,3.00000000
CN1810900000000,18,109,"Morgan County, IN",Jul-22,37936,36776,1160,3.10000000
CN1811100000000,18,111,"Newton County, IN",Jul-22,6917,6661,256,3.70000000
CN1811300000000,18,113,"Noble County, IN",Jul-22,22103,21361,742,3.40000000
CN1811500000000,18,115,"Ohio County, IN",Jul-22,3225,3144,81,2.50000000
CN1811700000000,18,117,"Orange County, IN",Jul-22,8282,7945,337,4.10000000
CN1811900000000,18,119,"Owen County, IN",Jul-22,9299,8936,363,3.90000000
CN1812100000000,18,121,"Parke County, IN",Jul-22,7509,7266,243,3.20000000
CN1812300000000,18,123,"Perry County, IN",Jul-22,8862,8570,292,3.30000000
CN1812500000000,18,125,"Pike County, IN",Jul-22,5966,5776,190,3.20000000
CN1812700000000,18,127,"Porter County, IN",Jul-22,86796,83623,3173,3.70000000
CN1812900000000,18,129,"Posey County, IN",Jul-22,13461,13081,380,2.80000000
CN1813100000000,18,131,"Pulaski County, IN",Jul-22,6719,6517,202,3.00000000
CN1813300000000,18,133,"Putnam County, IN",Jul-22,17220,16639,581,3.40000000
CN1813500000000,18,135,"Randolph County, IN",Jul-22,12034,11662,372,3.10000000
CN1813700000000,18,137,"Ripley County, IN",Jul-22,13078,12635,443,3.40000000
CN1813900000000,18,139,"Rush County, IN",Jul-22,9173,8919,254,2.80000000
CN1814100000000,18,141,"St. Joseph County, IN",Jul-22,136426,131064,5362,3.90000000
CN1814300000000,18,143,"Scott County, IN",Jul-22,10766,10370,396,3.70000000
CN1814500000000,18,145,"Shelby County, IN",Jul-22,24111,23401,710,2.90000000
CN1814700000000,18,147,"Spencer County, IN",Jul-22,11266,10941,325,2.90000000
CN1814900000000,18,149,"Starke County, IN",Jul-22,9623,9217,406,4.20000000
CN1815100000000,18,151,"Steuben County, IN",Jul-22,21295,20760,535,2.50000000
CN1815300000000,18,153,"Sullivan County, IN",Jul-22,8173,7841,332,4.10000000
CN1815500000000,18,155,"Switzerland County, IN",Jul-22,4749,4589,160,3.40000000
CN1815700000000,18,157,"Tippecanoe County, IN",Jul-22,95618,92159,3459,3.60000000
CN1815900000000,18,159,"Tipton County, IN",Jul-22,9292,9008,284,3.10000000
CN1816100000000,18,161,"Union County, IN",Jul-22,3646,3540,106,2.90000000
CN1816300000000,18,163,"Vanderburgh County, IN",Jul-22,94823,91561,3262,3.40000000
CN1816500000000,18,165,"Vermillion County, IN",Jul-22,6735,6464,271,4.00000000
CN1816700000000,18,167,"Vigo County, IN",Jul-22,46745,44756,1989,4.30000000
CN1816900000000,18,169,"Wabash County, IN",Jul-22,14550,14086,464,3.20000000
CN1817100000000,18,171,"Warren County, IN",Jul-22,4178,4052,126,3.00000000
CN1817300000000,18,173,"Warrick County, IN",Jul-22,33251,32255,996,3.00000000
CN1817500000000,18,175,"Washington County, IN",Jul-22,14246,13805,441,3.10000000
CN1817700000000,18,177,"Wayne County, IN",Jul-22,30169,29097,1072,3.60000000
CN1817900000000,18,179,"Wells County, IN",Jul-22,14607,14239,368,2.50000000
CN1818100000000,18,181,"White County, IN",Jul-22,13752,13374,378,2.70000000
CN1818300000000,18,183,"Whitley County, IN",Jul-22,18117,17626,491,2.70000000
CN1900100000000,19,001,"Adair County, IA",Jul-22,4556,4478,78,1.70000000
CN1900300000000,19,003,"Adams County, IA",Jul-22,2058,2020,38,1.80000000
CN1900500000000,19,005,"Allamakee County, IA",Jul-22,7043,6824,219,3.10000000
CN1900700000000,19,007,"Appanoose County, IA",Jul-22,6033,5865,168,2.80000000
CN1900900000000,19,009,"Audubon County, IA",Jul-22,3100,3035,65,2.10000000
CN1901100000000,19,011,"Benton County, IA",Jul-22,13055,12667,388,3.00000000
CN1901300000000,19,013,"Black Hawk County, IA",Jul-22,68498,66521,1977,2.90000000
CN1901500000000,19,015,"Boone County, IA",Jul-22,14676,14341,335,2.30000000
CN1901700000000,19,017,"Bremer County, IA",Jul-22,14088,13786,302,2.10000000
CN1901900000000,19,019,"Buchanan County, IA",Jul-22,11329,11037,292,2.60000000
CN1902100000000,19,021,"Buena Vista County, IA",Jul-22,12024,11697,327,2.70000000
CN1902300000000,19,023,"Butler County, IA",Jul-22,8041,7845,196,2.40000000
CN1902500000000,19,025,"Calhoun County, IA",Jul-22,4068,3967,101,2.50000000
CN1902700000000,19,027,"Carroll County, IA",Jul-22,11006,10792,214,1.90000000
CN1902900000000,19,029,"Cass County, IA",Jul-22,6755,6597,158,2.30000000
CN1903100000000,19,031,"Cedar County, IA",Jul-22,10469,10213,256,2.40000000
CN1903300000000,19,033,"Cerro Gordo County, IA",Jul-22,22648,21999,649,2.90000000
CN1903500000000,19,035,"Cherokee County, IA",Jul-22,6094,5963,131,2.10000000
CN1903700000000,19,037,"Chickasaw County, IA",Jul-22,6488,6335,153,2.40000000
CN1903900000000,19,039,"Clarke County, IA",Jul-22,4921,4788,133,2.70000000
CN1904100000000,19,041,"Clay County, IA",Jul-22,8582,8378,204,2.40000000
CN1904300000000,19,043,"Clayton County, IA",Jul-22,9701,9396,305,3.10000000
CN1904500000000,19,045,"Clinton County, IA",Jul-22,22204,21379,825,3.70000000
CN1904700000000,19,047,"Crawford County, IA",Jul-22,7802,7540,262,3.40000000
CN1904900000000,19,049,"Dallas County, IA",Jul-22,53912,52808,1104,2.00000000
CN1905100000000,19,051,"Davis County, IA",Jul-22,4277,4172,105,2.50000000
CN1905300000000,19,053,"Decatur County, IA",Jul-22,4053,3945,108,2.70000000
CN1905500000000,19,055,"Delaware County, IA",Jul-22,10647,10425,222,2.10000000
CN1905700000000,19,057,"Des Moines County, IA",Jul-22,18584,17741,843,4.50000000
CN1905900000000,19,059,"Dickinson County, IA",Jul-22,11832,11570,262,2.20000000
CN1906100000000,19,061,"Dubuque County, IA",Jul-22,55778,54239,1539,2.80000000
CN1906300000000,19,063,"Emmet County, IA",Jul-22,5005,4859,146,2.90000000
CN1906500000000,19,065,"Fayette County, IA",Jul-22,9896,9612,284,2.90000000
CN1906700000000,19,067,"Floyd County, IA",Jul-22,8331,8087,244,2.90000000
CN1906900000000,19,069,"Franklin County, IA",Jul-22,5645,5504,141,2.50000000
CN1907100000000,19,071,"Fremont County, IA",Jul-22,3696,3608,88,2.40000000
CN1907300000000,19,073,"Greene County, IA",Jul-22,5331,5218,113,2.10000000
CN1907500000000,19,075,"Grundy County, IA",Jul-22,6408,6265,143,2.20000000
CN1907700000000,19,077,"Guthrie County, IA",Jul-22,5592,5444,148,2.60000000
CN1907900000000,19,079,"Hamilton County, IA",Jul-22,6917,6726,191,2.80000000
CN1908100000000,19,081,"Hancock County, IA",Jul-22,5802,5666,136,2.30000000
CN1908300000000,19,083,"Hardin County, IA",Jul-22,7902,7681,221,2.80000000
CN1908500000000,19,085,"Harrison County, IA",Jul-22,7214,7018,196,2.70000000
CN1908700000000,19,087,"Henry County, IA",Jul-22,9648,9361,287,3.00000000
CN1908900000000,19,089,"Howard County, IA",Jul-22,5213,5082,131,2.50000000
CN1909100000000,19,091,"Humboldt County, IA",Jul-22,4939,4831,108,2.20000000
CN1909300000000,19,093,"Ida County, IA",Jul-22,4030,3947,83,2.10000000
CN1909500000000,19,095,"Iowa County, IA",Jul-22,10128,9889,239,2.40000000
CN1909700000000,19,097,"Jackson County, IA",Jul-22,10826,10517,309,2.90000000
CN1909900000000,19,099,"Jasper County, IA",Jul-22,18750,18229,521,2.80000000
CN1910100000000,19,101,"Jefferson County, IA",Jul-22,10041,9782,259,2.60000000
CN1910300000000,19,103,"Johnson County, IA",Jul-22,87342,85277,2065,2.40000000
CN1910500000000,19,105,"Jones County, IA",Jul-22,10288,10001,287,2.80000000
CN1910700000000,19,107,"Keokuk County, IA",Jul-22,5210,5054,156,3.00000000
CN1910900000000,19,109,"Kossuth County, IA",Jul-22,8084,7898,186,2.30000000
CN1911100000000,19,111,"Lee County, IA",Jul-22,15148,14413,735,4.90000000
CN1911300000000,19,113,"Linn County, IA",Jul-22,120777,116845,3932,3.30000000
CN1911500000000,19,115,"Louisa County, IA",Jul-22,5944,5770,174,2.90000000
CN1911700000000,19,117,"Lucas County, IA",Jul-22,4791,4686,105,2.20000000
CN1911900000000,19,119,"Lyon County, IA",Jul-22,7159,7044,115,1.60000000
CN1912100000000,19,121,"Madison County, IA",Jul-22,8708,8469,239,2.70000000
CN1912300000000,19,123,"Mahaska County, IA",Jul-22,12180,11856,324,2.70000000
CN1912500000000,19,125,"Marion County, IA",Jul-22,19293,18915,378,2.00000000
CN1912700000000,19,127,"Marshall County, IA",Jul-22,17310,16565,745,4.30000000
CN1912900000000,19,129,"Mills County, IA",Jul-22,7194,7038,156,2.20000000
CN1913100000000,19,131,"Mitchell County, IA",Jul-22,5900,5784,116,2.00000000
CN1913300000000,19,133,"Monona County, IA",Jul-22,4424,4306,118,2.70000000
CN1913500000000,19,135,"Monroe County, IA",Jul-22,3980,3860,120,3.00000000
CN1913700000000,19,137,"Montgomery County, IA",Jul-22,4945,4814,131,2.60000000
CN1913900000000,19,139,"Muscatine County, IA",Jul-22,21077,20473,604,2.90000000
CN1914100000000,19,141,"O'Brien County, IA",Jul-22,8246,8070,176,2.10000000
CN1914300000000,19,143,"Osceola County, IA",Jul-22,3645,3580,65,1.80000000
CN1914500000000,19,145,"Page County, IA",Jul-22,6429,6271,158,2.50000000
CN1914700000000,19,147,"Palo Alto County, IA",Jul-22,4559,4439,120,2.60000000
CN1914900000000,19,149,"Plymouth County, IA",Jul-22,14759,14442,317,2.10000000
CN1915100000000,19,151,"Pocahontas County, IA",Jul-22,4468,4377,91,2.00000000
CN1915300000000,19,153,"Polk County, IA",Jul-22,276299,268747,7552,2.70000000
CN1915500000000,19,155,"Pottawattamie County, IA",Jul-22,48418,47122,1296,2.70000000
CN1915700000000,19,157,"Poweshiek County, IA",Jul-22,10185,9908,277,2.70000000
CN1915900000000,19,159,"Ringgold County, IA",Jul-22,2418,2365,53,2.20000000
CN1916100000000,19,161,"Sac County, IA",Jul-22,5332,5209,123,2.30000000
CN1916300000000,19,163,"Scott County, IA",Jul-22,91886,88714,3172,3.50000000
CN1916500000000,19,165,"Shelby County, IA",Jul-22,6383,6245,138,2.20000000
CN1916700000000,19,167,"Sioux County, IA",Jul-22,22108,21728,380,1.70000000
CN1916900000000,19,169,"Story County, IA",Jul-22,56354,55064,1290,2.30000000
CN1917100000000,19,171,"Tama County, IA",Jul-22,9234,8995,239,2.60000000
CN1917300000000,19,173,"Taylor County, IA",Jul-22,3133,3068,65,2.10000000
CN1917500000000,19,175,"Union County, IA",Jul-22,6098,5927,171,2.80000000
CN1917700000000,19,177,"Van Buren County, IA",Jul-22,3741,3638,103,2.80000000
CN1917900000000,19,179,"Wapello County, IA",Jul-22,17145,16539,606,3.50000000
CN1918100000000,19,181,"Warren County, IA",Jul-22,29276,28556,720,2.50000000
CN1918300000000,19,183,"Washington County, IA",Jul-22,11743,11461,282,2.40000000
CN1918500000000,19,185,"Wayne County, IA",Jul-22,2836,2753,83,2.90000000
CN1918700000000,19,187,"Webster County, IA",Jul-22,18550,17939,611,3.30000000
CN1918900000000,19,189,"Winnebago County, IA",Jul-22,4956,4825,131,2.60000000
CN1919100000000,19,191,"Winneshiek County, IA",Jul-22,11304,11004,300,2.70000000
CN1919300000000,19,193,"Woodbury County, IA",Jul-22,56128,54525,1603,2.90000000
CN1919500000000,19,195,"Worth County, IA",Jul-22,4081,3970,111,2.70000000
CN1919700000000,19,197,"Wright County, IA",Jul-22,6749,6588,161,2.40000000
CN2000100000000,20,001,"Allen County, KS",Jul-22,6239,6016,223,3.60000000
CN2000300000000,20,003,"Anderson County, KS",Jul-22,4789,4657,132,2.80000000
CN2000500000000,20,005,"Atchison County, KS",Jul-22,6749,6433,316,4.70000000
CN2000700000000,20,007,"Barber County, KS",Jul-22,2270,2205,65,2.90000000
CN2000900000000,20,009,"Barton County, KS",Jul-22,13033,12610,423,3.20000000
CN2001100000000,20,011,"Bourbon County, KS",Jul-22,6302,6038,264,4.20000000
CN2001300000000,20,013,"Brown County, KS",Jul-22,5056,4905,151,3.00000000
CN2001500000000,20,015,"Butler County, KS",Jul-22,33309,32145,1164,3.50000000
CN2001700000000,20,017,"Chase County, KS",Jul-22,1407,1365,42,3.00000000
CN2001900000000,20,019,"Chautauqua County, KS",Jul-22,1393,1338,55,3.90000000
CN2002100000000,20,021,"Cherokee County, KS",Jul-22,9892,9550,342,3.50000000
CN2002300000000,20,023,"Cheyenne County, KS",Jul-22,1267,1230,37,2.90000000
CN2002500000000,20,025,"Clark County, KS",Jul-22,1092,1064,28,2.60000000
CN2002700000000,20,027,"Clay County, KS",Jul-22,3551,3418,133,3.70000000
CN2002900000000,20,029,"Cloud County, KS",Jul-22,3843,3700,143,3.70000000
CN2003100000000,20,031,"Coffey County, KS",Jul-22,3709,3548,161,4.30000000
CN2003300000000,20,033,"Comanche County, KS",Jul-22,900,877,23,2.60000000
CN2003500000000,20,035,"Cowley County, KS",Jul-22,16380,15747,633,3.90000000
CN2003700000000,20,037,"Crawford County, KS",Jul-22,18680,17946,734,3.90000000
CN2003900000000,20,039,"Decatur County, KS",Jul-22,1212,1163,49,4.00000000
CN2004100000000,20,041,"Dickinson County, KS",Jul-22,8968,8664,304,3.40000000
CN2004300000000,20,043,"Doniphan County, KS",Jul-22,4228,4090,138,3.30000000
CN2004500000000,20,045,"Douglas County, KS",Jul-22,62402,60158,2244,3.60000000
CN2004700000000,20,047,"Edwards County, KS",Jul-22,1429,1385,44,3.10000000
CN2004900000000,20,049,"Elk County, KS",Jul-22,1013,976,37,3.70000000
CN2005100000000,20,051,"Ellis County, KS",Jul-22,16783,16327,456,2.70000000
CN2005300000000,20,053,"Ellsworth County, KS",Jul-22,2664,2586,78,2.90000000
CN2005500000000,20,055,"Finney County, KS",Jul-22,20127,19580,547,2.70000000
CN2005700000000,20,057,"Ford County, KS",Jul-22,17506,17026,480,2.70000000
CN2005900000000,20,059,"Franklin County, KS",Jul-22,14641,14167,474,3.20000000
CN2006100000000,20,061,"Geary County, KS",Jul-22,11138,10593,545,4.90000000
CN2006300000000,20,063,"Gove County, KS",Jul-22,1419,1378,41,2.90000000
CN2006500000000,20,065,"Graham County, KS",Jul-22,1161,1124,37,3.20000000
CN2006700000000,20,067,"Grant County, KS",Jul-22,2775,2655,120,4.30000000
CN2006900000000,20,069,"Gray County, KS",Jul-22,2985,2900,85,2.80000000
CN2007100000000,20,071,"Greeley County, KS",Jul-22,794,776,18,2.30000000
CN2007300000000,20,073,"Greenwood County, KS",Jul-22,2873,2783,90,3.10000000
CN2007500000000,20,075,"Hamilton County, KS",Jul-22,1611,1575,36,2.20000000
CN2007700000000,20,077,"Harper County, KS",Jul-22,2706,2630,76,2.80000000
CN2007900000000,20,079,"Harvey County, KS",Jul-22,17394,16841,553,3.20000000
CN2008100000000,20,081,"Haskell County, KS",Jul-22,2183,2129,54,2.50000000
CN2008300000000,20,083,"Hodgeman County, KS",Jul-22,1030,1002,28,2.70000000
CN2008500000000,20,085,"Jackson County, KS",Jul-22,7426,7218,208,2.80000000
CN2008700000000,20,087,"Jefferson County, KS",Jul-22,10587,10248,339,3.20000000
CN2008900000000,20,089,"Jewell County, KS",Jul-22,1182,1145,37,3.10000000
CN2009100000000,20,091,"Johnson County, KS",Jul-22,355112,344896,10216,2.90000000
CN2009300000000,20,093,"Kearny County, KS",Jul-22,1995,1943,52,2.60000000
CN2009500000000,20,095,"Kingman County, KS",Jul-22,3340,3234,106,3.20000000
CN2009700000000,20,097,"Kiowa County, KS",Jul-22,1129,1095,34,3.00000000
CN2009900000000,20,099,"Labette County, KS",Jul-22,9114,8745,369,4.00000000
CN2010100000000,20,101,"Lane County, KS",Jul-22,726,703,23,3.20000000
CN2010300000000,20,103,"Leavenworth County, KS",Jul-22,38078,36745,1333,3.50000000
CN2010500000000,20,105,"Lincoln County, KS",Jul-22,1648,1601,47,2.90000000
CN2010700000000,20,107,"Linn County, KS",Jul-22,4446,4247,199,4.50000000
CN2010900000000,20,109,"Logan County, KS",Jul-22,1469,1427,42,2.90000000
CN2011100000000,20,111,"Lyon County, KS",Jul-22,16964,16406,558,3.30000000
CN2011300000000,20,113,"McPherson County, KS",Jul-22,17256,16823,433,2.50000000
CN2011500000000,20,115,"Marion County, KS",Jul-22,5777,5580,197,3.40000000
CN2011700000000,20,117,"Marshall County, KS",Jul-22,5499,5364,135,2.50000000
CN2011900000000,20,119,"Meade County, KS",Jul-22,2107,2058,49,2.30000000
CN2012100000000,20,121,"Miami County, KS",Jul-22,18302,17757,545,3.00000000
CN2012300000000,20,123,"Mitchell County, KS",Jul-22,3401,3311,90,2.60000000
CN2012500000000,20,125,"Montgomery County, KS",Jul-22,14400,13806,594,4.10000000
CN2012700000000,20,127,"Morris County, KS",Jul-22,3054,2961,93,3.00000000
CN2012900000000,20,129,"Morton County, KS",Jul-22,1062,1026,36,3.40000000
CN2013100000000,20,131,"Nemaha County, KS",Jul-22,5610,5478,132,2.40000000
CN2013300000000,20,133,"Neosho County, KS",Jul-22,6199,5906,293,4.70000000
CN2013500000000,20,135,"Ness County, KS",Jul-22,1343,1306,37,2.80000000
CN2013700000000,20,137,"Norton County, KS",Jul-22,2628,2568,60,2.30000000
CN2013900000000,20,139,"Osage County, KS",Jul-22,8179,7915,264,3.20000000
CN2014100000000,20,141,"Osborne County, KS",Jul-22,1930,1880,50,2.60000000
CN2014300000000,20,143,"Ottawa County, KS",Jul-22,2922,2821,101,3.50000000
CN2014500000000,20,145,"Pawnee County, KS",Jul-22,2742,2667,75,2.70000000
CN2014700000000,20,147,"Phillips County, KS",Jul-22,2545,2470,75,2.90000000
CN2014900000000,20,149,"Pottawatomie County, KS",Jul-22,11928,11546,382,3.20000000
CN2015100000000,20,151,"Pratt County, KS",Jul-22,4797,4655,142,3.00000000
CN2015300000000,20,153,"Rawlins County, KS",Jul-22,1636,1600,36,2.20000000
CN2015500000000,20,155,"Reno County, KS",Jul-22,29131,28058,1073,3.70000000
CN2015700000000,20,157,"Republic County, KS",Jul-22,2323,2260,63,2.70000000
CN2015900000000,20,159,"Rice County, KS",Jul-22,5362,5193,169,3.20000000
CN2016100000000,20,161,"Riley County, KS",Jul-22,32982,31748,1234,3.70000000
CN2016300000000,20,163,"Rooks County, KS",Jul-22,2397,2322,75,3.10000000
CN2016500000000,20,165,"Rush County, KS",Jul-22,1591,1545,46,2.90000000
CN2016700000000,20,167,"Russell County, KS",Jul-22,3283,3190,93,2.80000000
CN2016900000000,20,169,"Saline County, KS",Jul-22,29379,28476,903,3.10000000
CN2017100000000,20,171,"Scott County, KS",Jul-22,2842,2774,68,2.40000000
CN2017300000000,20,173,"Sedgwick County, KS",Jul-22,260250,249969,10281,4.00000000
CN2017500000000,20,175,"Seward County, KS",Jul-22,9947,9610,337,3.40000000
CN2017700000000,20,177,"Shawnee County, KS",Jul-22,93749,90618,3131,3.30000000
CN2017900000000,20,179,"Sheridan County, KS",Jul-22,1455,1419,36,2.50000000
CN2018100000000,20,181,"Sherman County, KS",Jul-22,2876,2785,91,3.20000000
CN2018300000000,20,183,"Smith County, KS",Jul-22,1910,1858,52,2.70000000
CN2018500000000,20,185,"Stafford County, KS",Jul-22,1912,1852,60,3.10000000
CN2018700000000,20,187,"Stanton County, KS",Jul-22,1092,1066,26,2.40000000
CN2018900000000,20,189,"Stevens County, KS",Jul-22,2852,2777,75,2.60000000
CN2019100000000,20,191,"Sumner County, KS",Jul-22,10980,10563,417,3.80000000
CN2019300000000,20,193,"Thomas County, KS",Jul-22,4277,4165,112,2.60000000
CN2019500000000,20,195,"Trego County, KS",Jul-22,1440,1401,39,2.70000000
CN2019700000000,20,197,"Wabaunsee County, KS",Jul-22,3812,3705,107,2.80000000
CN2019900000000,20,199,"Wallace County, KS",Jul-22,887,866,21,2.40000000
CN2020100000000,20,201,"Washington County, KS",Jul-22,3001,2925,76,2.50000000
CN2020300000000,20,203,"Wichita County, KS",Jul-22,1123,1095,28,2.50000000
CN2020500000000,20,205,"Wilson County, KS",Jul-22,3653,3508,145,4.00000000
CN2020700000000,20,207,"Woodson County, KS",Jul-22,1467,1405,62,4.20000000
CN2020900000000,20,209,"Wyandotte County, KS",Jul-22,79675,76278,3397,4.30000000
CN2100100000000,21,001,"Adair County, KY",Jul-22,7071,6726,345,4.90000000
CN2100300000000,21,003,"Allen County, KY",Jul-22,8869,8491,378,4.30000000
CN2100500000000,21,005,"Anderson County, KY",Jul-22,12044,11636,408,3.40000000
CN2100700000000,21,007,"Ballard County, KY",Jul-22,3464,3278,186,5.40000000
CN2100900000000,21,009,"Barren County, KY",Jul-22,17814,17052,762,4.30000000
CN2101100000000,21,011,"Bath County, KY",Jul-22,4691,4448,243,5.20000000
CN2101300000000,21,013,"Bell County, KY",Jul-22,8140,7692,448,5.50000000
CN2101500000000,21,015,"Boone County, KY",Jul-22,73034,70631,2403,3.30000000
CN2101700000000,21,017,"Bourbon County, KY",Jul-22,9958,9594,364,3.70000000
CN2101900000000,21,019,"Boyd County, KY",Jul-22,17417,16425,992,5.70000000
CN2102100000000,21,021,"Boyle County, KY",Jul-22,12577,12039,538,4.30000000
CN2102300000000,21,023,"Bracken County, KY",Jul-22,3818,3665,153,4.00000000
CN2102500000000,21,025,"Breathitt County, KY",Jul-22,3210,2917,293,9.10000000
CN2102700000000,21,027,"Breckinridge County, KY",Jul-22,8144,7773,371,4.60000000
CN2102900000000,21,029,"Bullitt County, KY",Jul-22,43921,42143,1778,4.00000000
CN2103100000000,21,031,"Butler County, KY",Jul-22,4856,4644,212,4.40000000
CN2103300000000,21,033,"Caldwell County, KY",Jul-22,5999,5768,231,3.90000000
CN2103500000000,21,035,"Calloway County, KY",Jul-22,16776,16011,765,4.60000000
CN2103700000000,21,037,"Campbell County, KY",Jul-22,51246,49459,1787,3.50000000
CN2103900000000,21,039,"Carlisle County, KY",Jul-22,2216,2126,90,4.10000000
CN2104100000000,21,041,"Carroll County, KY",Jul-22,5582,5388,194,3.50000000
CN2104300000000,21,043,"Carter County, KY",Jul-22,9732,8908,824,8.50000000
CN2104500000000,21,045,"Casey County, KY",Jul-22,6798,6536,262,3.90000000
CN2104700000000,21,047,"Christian County, KY",Jul-22,25255,23883,1372,5.40000000
CN2104900000000,21,049,"Clark County, KY",Jul-22,17513,16869,644,3.70000000
CN2105100000000,21,051,"Clay County, KY",Jul-22,5109,4783,326,6.40000000
CN2105300000000,21,053,"Clinton County, KY",Jul-22,4062,3880,182,4.50000000
CN2105500000000,21,055,"Crittenden County, KY",Jul-22,3764,3592,172,4.60000000
CN2105700000000,21,057,"Cumberland County, KY",Jul-22,3446,3344,102,3.00000000
CN2105900000000,21,059,"Daviess County, KY",Jul-22,47319,45433,1886,4.00000000
CN2106100000000,21,061,"Edmonson County, KY",Jul-22,4628,4392,236,5.10000000
CN2106300000000,21,063,"Elliott County, KY",Jul-22,1850,1685,165,8.90000000
CN2106500000000,21,065,"Estill County, KY",Jul-22,5187,4920,267,5.10000000
CN2106700000000,21,067,"Fayette County, KY",Jul-22,178629,172674,5955,3.30000000
CN2106900000000,21,069,"Fleming County, KY",Jul-22,6046,5760,286,4.70000000
CN2107100000000,21,071,"Floyd County, KY",Jul-22,10911,10205,706,6.50000000
CN2107300000000,21,073,"Franklin County, KY",Jul-22,25244,24328,916,3.60000000
CN2107500000000,21,075,"Fulton County, KY",Jul-22,2118,1998,120,5.70000000
CN2107700000000,21,077,"Gallatin County, KY",Jul-22,4069,3922,147,3.60000000
CN2107900000000,21,079,"Garrard County, KY",Jul-22,7718,7402,316,4.10000000
CN2108100000000,21,081,"Grant County, KY",Jul-22,11845,11378,467,3.90000000
CN2108300000000,21,083,"Graves County, KY",Jul-22,15587,14874,713,4.60000000
CN2108500000000,21,085,"Grayson County, KY",Jul-22,10389,9868,521,5.00000000
CN2108700000000,21,087,"Green County, KY",Jul-22,5249,5053,196,3.70000000
CN2108900000000,21,089,"Greenup County, KY",Jul-22,13130,12299,831,6.30000000
CN2109100000000,21,091,"Hancock County, KY",Jul-22,3939,3779,160,4.10000000
CN2109300000000,21,093,"Hardin County, KY",Jul-22,48352,46237,2115,4.40000000
CN2109500000000,21,095,"Harlan County, KY",Jul-22,6572,6077,495,7.50000000
CN2109700000000,21,097,"Harrison County, KY",Jul-22,8963,8651,312,3.50000000
CN2109900000000,21,099,"Hart County, KY",Jul-22,7590,7267,323,4.30000000
CN2110100000000,21,101,"Henderson County, KY",Jul-22,21240,20402,838,3.90000000
CN2110300000000,21,103,"Henry County, KY",Jul-22,8369,8043,326,3.90000000
CN2110500000000,21,105,"Hickman County, KY",Jul-22,1733,1653,80,4.60000000
CN2110700000000,21,107,"Hopkins County, KY",Jul-22,18195,17338,857,4.70000000
CN2110900000000,21,109,"Jackson County, KY",Jul-22,4070,3805,265,6.50000000
CN2111100000000,21,111,"Jefferson County, KY",Jul-22,403338,386957,16381,4.10000000
CN2111300000000,21,113,"Jessamine County, KY",Jul-22,26943,26020,923,3.40000000
CN2111500000000,21,115,"Johnson County, KY",Jul-22,6680,6244,436,6.50000000
CN2111700000000,21,117,"Kenton County, KY",Jul-22,88817,85715,3102,3.50000000
CN2111900000000,21,119,"Knott County, KY",Jul-22,4265,3958,307,7.20000000
CN2112100000000,21,121,"Knox County, KY",Jul-22,10073,9473,600,6.00000000
CN2112300000000,21,123,"Larue County, KY",Jul-22,5891,5615,276,4.70000000
CN2112500000000,21,125,"Laurel County, KY",Jul-22,25361,24225,1136,4.50000000
CN2112700000000,21,127,"Lawrence County, KY",Jul-22,5540,5221,319,5.80000000
CN2112900000000,21,129,"Lee County, KY",Jul-22,2024,1899,125,6.20000000
CN2113100000000,21,131,"Leslie County, KY",Jul-22,2513,2317,196,7.80000000
CN2113300000000,21,133,"Letcher County, KY",Jul-22,6023,5617,406,6.70000000
CN2113500000000,21,135,"Lewis County, KY",Jul-22,4755,4398,357,7.50000000
CN2113700000000,21,137,"Lincoln County, KY",Jul-22,9245,8780,465,5.00000000
CN2113900000000,21,139,"Livingston County, KY",Jul-22,3607,3430,177,4.90000000
CN2114100000000,21,141,"Logan County, KY",Jul-22,12385,11927,458,3.70000000
CN2114300000000,21,143,"Lyon County, KY",Jul-22,3250,3116,134,4.10000000
CN2114500000000,21,145,"McCracken County, KY",Jul-22,29517,28226,1291,4.40000000
CN2114700000000,21,147,"McCreary County, KY",Jul-22,4748,4484,264,5.60000000
CN2114900000000,21,149,"McLean County, KY",Jul-22,4130,3943,187,4.50000000
CN2115100000000,21,151,"Madison County, KY",Jul-22,47506,45622,1884,4.00000000
CN2115300000000,21,153,"Magoffin County, KY",Jul-22,3303,2930,373,11.30000000
CN2115500000000,21,155,"Marion County, KY",Jul-22,9337,9000,337,3.60000000
CN2115700000000,21,157,"Marshall County, KY",Jul-22,14248,13642,606,4.30000000
CN2115900000000,21,159,"Martin County, KY",Jul-22,2244,2048,196,8.70000000
CN2116100000000,21,161,"Mason County, KY",Jul-22,6646,6313,333,5.00000000
CN2116300000000,21,163,"Meade County, KY",Jul-22,11967,11407,560,4.70000000
CN2116500000000,21,165,"Menifee County, KY",Jul-22,2345,2211,134,5.70000000
CN2116700000000,21,167,"Mercer County, KY",Jul-22,9910,9511,399,4.00000000
CN2116900000000,21,169,"Metcalfe County, KY",Jul-22,3932,3741,191,4.90000000
CN2117100000000,21,171,"Monroe County, KY",Jul-22,4565,4409,156,3.40000000
CN2117300000000,21,173,"Montgomery County, KY",Jul-22,11768,11206,562,4.80000000
CN2117500000000,21,175,"Morgan County, KY",Jul-22,4240,4021,219,5.20000000
CN2117700000000,21,177,"Muhlenberg County, KY",Jul-22,9416,8788,628,6.70000000
CN2117900000000,21,179,"Nelson County, KY",Jul-22,23970,22998,972,4.10000000
CN2118100000000,21,181,"Nicholas County, KY",Jul-22,3348,3201,147,4.40000000
CN2118300000000,21,183,"Ohio County, KY",Jul-22,9111,8648,463,5.10000000
CN2118500000000,21,185,"Oldham County, KY",Jul-22,33971,32878,1093,3.20000000
CN2118700000000,21,187,"Owen County, KY",Jul-22,5106,4920,186,3.60000000
CN2118900000000,21,189,"Owsley County, KY",Jul-22,1062,980,82,7.70000000
CN2119100000000,21,191,"Pendleton County, KY",Jul-22,6988,6742,246,3.50000000
CN2119300000000,21,193,"Perry County, KY",Jul-22,7907,7458,449,5.70000000
CN2119500000000,21,195,"Pike County, KY",Jul-22,18981,17907,1074,5.70000000
CN2119700000000,21,197,"Powell County, KY",Jul-22,5278,5056,222,4.20000000
CN2119900000000,21,199,"Pulaski County, KY",Jul-22,26047,24839,1208,4.60000000
CN2120100000000,21,201,"Robertson County, KY",Jul-22,819,779,40,4.90000000
CN2120300000000,21,203,"Rockcastle County, KY",Jul-22,6585,6255,330,5.00000000
CN2120500000000,21,205,"Rowan County, KY",Jul-22,9707,9174,533,5.50000000
CN2120700000000,21,207,"Russell County, KY",Jul-22,6167,5853,314,5.10000000
CN2120900000000,21,209,"Scott County, KY",Jul-22,30875,29879,996,3.20000000
CN2121100000000,21,211,"Shelby County, KY",Jul-22,26598,25595,1003,3.80000000
CN2121300000000,21,213,"Simpson County, KY",Jul-22,8952,8612,340,3.80000000
CN2121500000000,21,215,"Spencer County, KY",Jul-22,10781,10380,401,3.70000000
CN2121700000000,21,217,"Taylor County, KY",Jul-22,12341,11857,484,3.90000000
CN2121900000000,21,219,"Todd County, KY",Jul-22,5526,5332,194,3.50000000
CN2122100000000,21,221,"Trigg County, KY",Jul-22,6181,5893,288,4.70000000
CN2122300000000,21,223,"Trimble County, KY",Jul-22,3907,3756,151,3.90000000
CN2122500000000,21,225,"Union County, KY",Jul-22,6126,5841,285,4.70000000
CN2122700000000,21,227,"Warren County, KY",Jul-22,64118,61545,2573,4.00000000
CN2122900000000,21,229,"Washington County, KY",Jul-22,6265,6045,220,3.50000000
CN2123100000000,21,231,"Wayne County, KY",Jul-22,7175,6819,356,5.00000000
CN2123300000000,21,233,"Webster County, KY",Jul-22,5343,5121,222,4.20000000
CN2123500000000,21,235,"Whitley County, KY",Jul-22,14103,13419,684,4.90000000
CN2123700000000,21,237,"Wolfe County, KY",Jul-22,2235,2094,141,6.30000000
CN2123900000000,21,239,"Woodford County, KY",Jul-22,15465,14991,474,3.10000000
CN2200100000000,22,001,"Acadia Parish, LA",Jul-22,24513,23494,1019,4.20000000
CN2200300000000,22,003,"Allen Parish, LA",Jul-22,7724,7302,422,5.50000000
CN2200500000000,22,005,"Ascension Parish, LA",Jul-22,66008,63765,2243,3.40000000
CN2200700000000,22,007,"Assumption Parish, LA",Jul-22,8807,8266,541,6.10000000
CN2200900000000,22,009,"Avoyelles Parish, LA",Jul-22,14537,13787,750,5.20000000
CN2201100000000,22,011,"Beauregard Parish, LA",Jul-22,14944,14407,537,3.60000000
CN2201300000000,22,013,"Bienville Parish, LA",Jul-22,5447,5187,260,4.80000000
CN2201500000000,22,015,"Bossier Parish, LA",Jul-22,59600,57650,1950,3.30000000
CN2201700000000,22,017,"Caddo Parish, LA",Jul-22,105521,99909,5612,5.30000000
CN2201900000000,22,019,"Calcasieu Parish, LA",Jul-22,100278,96061,4217,4.20000000
CN2202100000000,22,021,"Caldwell Parish, LA",Jul-22,3676,3527,149,4.10000000
CN2202300000000,22,023,"Cameron Parish, LA",Jul-22,3695,3596,99,2.70000000
CN2202500000000,22,025,"Catahoula Parish, LA",Jul-22,3549,3381,168,4.70000000
CN2202700000000,22,027,"Claiborne Parish, LA",Jul-22,5437,5185,252,4.60000000
CN2202900000000,22,029,"Concordia Parish, LA",Jul-22,7116,6697,419,5.90000000
CN2203100000000,22,031,"De Soto Parish, LA",Jul-22,11240,10766,474,4.20000000
CN2203300000000,22,033,"East Baton Rouge Parish, LA",Jul-22,231601,221353,10248,4.40000000
CN2203500000000,22,035,"East Carroll Parish, LA",Jul-22,1695,1515,180,10.60000000
CN2203700000000,22,037,"East Feliciana Parish, LA",Jul-22,7802,7518,284,3.60000000
CN2203900000000,22,039,"Evangeline Parish, LA",Jul-22,11869,11267,602,5.10000000
CN2204100000000,22,041,"Franklin Parish, LA",Jul-22,7474,7059,415,5.60000000
CN2204300000000,22,043,"Grant Parish, LA",Jul-22,8632,8298,334,3.90000000
CN2204500000000,22,045,"Iberia Parish, LA",Jul-22,28549,26965,1584,5.50000000
CN2204700000000,22,047,"Iberville Parish, LA",Jul-22,13966,13097,869,6.20000000
CN2204900000000,22,049,"Jackson Parish, LA",Jul-22,6830,6584,246,3.60000000
CN2205100000000,22,051,"Jefferson Parish, LA",Jul-22,215411,205464,9947,4.60000000
CN2205300000000,22,053,"Jefferson Davis Parish, LA",Jul-22,13080,12582,498,3.80000000
CN2205500000000,22,055,"Lafayette Parish, LA",Jul-22,118747,114530,4217,3.60000000
CN2205700000000,22,057,"Lafourche Parish, LA",Jul-22,41135,39590,1545,3.80000000
CN2205900000000,22,059,"LaSalle Parish, LA",Jul-22,6726,6531,195,2.90000000
CN2206100000000,22,061,"Lincoln Parish, LA",Jul-22,19838,18980,858,4.30000000
CN2206300000000,22,063,"Livingston Parish, LA",Jul-22,70776,68504,2272,3.20000000
CN2206500000000,22,065,"Madison Parish, LA",Jul-22,3469,3226,243,7.00000000
CN2206700000000,22,067,"Morehouse Parish, LA",Jul-22,10059,9358,701,7.00000000
CN2206900000000,22,069,"Natchitoches Parish, LA",Jul-22,16073,15285,788,4.90000000
CN2207100000000,22,071,"Orleans Parish, LA",Jul-22,182799,170740,12059,6.60000000
CN2207300000000,22,073,"Ouachita Parish, LA",Jul-22,70704,67678,3026,4.30000000
CN2207500000000,22,075,"Plaquemines Parish, LA",Jul-22,10002,9659,343,3.40000000
CN2207700000000,22,077,"Pointe Coupee Parish, LA",Jul-22,9827,9328,499,5.10000000
CN2207900000000,22,079,"Rapides Parish, LA",Jul-22,58076,56051,2025,3.50000000
CN2208100000000,22,081,"Red River Parish, LA",Jul-22,3830,3693,137,3.60000000
CN2208300000000,22,083,"Richland Parish, LA",Jul-22,8393,8000,393,4.70000000
CN2208500000000,22,085,"Sabine Parish, LA",Jul-22,9405,9080,325,3.50000000
CN2208700000000,22,087,"St. Bernard Parish, LA",Jul-22,20599,19470,1129,5.50000000
CN2208900000000,22,089,"St. Charles Parish, LA",Jul-22,25267,24278,989,3.90000000
CN2209100000000,22,091,"St. Helena Parish, LA",Jul-22,4324,3987,337,7.80000000
CN2209300000000,22,093,"St. James Parish, LA",Jul-22,9211,8625,586,6.40000000
CN2209500000000,22,095,"St. John the Baptist Parish, LA",Jul-22,19734,18375,1359,6.90000000
CN2209700000000,22,097,"St. Landry Parish, LA",Jul-22,32529,30703,1826,5.60000000
CN2209900000000,22,099,"St. Martin Parish, LA",Jul-22,22633,21648,985,4.40000000
CN2210100000000,22,101,"St. Mary Parish, LA",Jul-22,19651,18520,1131,5.80000000
CN2210300000000,22,103,"St. Tammany Parish, LA",Jul-22,121594,117660,3934,3.20000000
CN2210500000000,22,105,"Tangipahoa Parish, LA",Jul-22,57395,54167,3228,5.60000000
CN2210700000000,22,107,"Tensas Parish, LA",Jul-22,1362,1276,86,6.30000000
CN2210900000000,22,109,"Terrebonne Parish, LA",Jul-22,45503,43396,2107,4.60000000
CN2211100000000,22,111,"Union Parish, LA",Jul-22,9266,8875,391,4.20000000
CN2211300000000,22,113,"Vermilion Parish, LA",Jul-22,24636,23654,982,4.00000000
CN2211500000000,22,115,"Vernon Parish, LA",Jul-22,15970,15274,696,4.40000000
CN2211700000000,22,117,"Washington Parish, LA",Jul-22,16782,15895,887,5.30000000
CN2211900000000,22,119,"Webster Parish, LA",Jul-22,14628,13912,716,4.90000000
CN2212100000000,22,121,"West Baton Rouge Parish, LA",Jul-22,13852,13297,555,4.00000000
CN2212300000000,22,123,"West Carroll Parish, LA",Jul-22,3642,3431,211,5.80000000
CN2212500000000,22,125,"West Feliciana Parish, LA",Jul-22,5383,5226,157,2.90000000
CN2212700000000,22,127,"Winn Parish, LA",Jul-22,4662,4445,217,4.70000000
CN2300100000000,23,001,"Androscoggin County, ME",Jul-22,53453,51874,1579,3.00000000
CN2300300000000,23,003,"Aroostook County, ME",Jul-22,28634,27501,1133,4.00000000
CN2300500000000,23,005,"Cumberland County, ME",Jul-22,165491,161693,3798,2.30000000
CN2300700000000,23,007,"Franklin County, ME",Jul-22,13737,13277,460,3.30000000
CN2300900000000,23,009,"Hancock County, ME",Jul-22,31166,30390,776,2.50000000
CN2301100000000,23,011,"Kennebec County, ME",Jul-22,60890,59201,1689,2.80000000
CN2301300000000,23,013,"Knox County, ME",Jul-22,21146,20624,522,2.50000000
CN2301500000000,23,015,"Lincoln County, ME",Jul-22,17955,17537,418,2.30000000
CN2301700000000,23,017,"Oxford County, ME",Jul-22,26330,25454,876,3.30000000
CN2301900000000,23,019,"Penobscot County, ME",Jul-22,74688,72435,2253,3.00000000
CN2302100000000,23,021,"Piscataquis County, ME",Jul-22,7462,7202,260,3.50000000
CN2302300000000,23,023,"Sagadahoc County, ME",Jul-22,19162,18741,421,2.20000000
CN2302500000000,23,025,"Somerset County, ME",Jul-22,22459,21556,903,4.00000000
CN2302700000000,23,027,"Waldo County, ME",Jul-22,20840,20227,613,2.90000000
CN2302900000000,23,029,"Washington County, ME",Jul-22,13763,13211,552,4.00000000
CN2303100000000,23,031,"York County, ME",Jul-22,113251,110565,2686,2.40000000
CN2400100000000,24,001,"Allegany County, MD",Jul-22,30226,28600,1626,5.40000000
CN2400300000000,24,003,"Anne Arundel County, MD",Jul-22,322217,310644,11573,3.60000000
CN2400500000000,24,005,"Baltimore County, MD",Jul-22,456839,437774,19065,4.20000000
CN2400900000000,24,009,"Calvert County, MD",Jul-22,49708,47748,1960,3.90000000
CN2401100000000,24,011,"Caroline County, MD",Jul-22,16749,16107,642,3.80000000
CN2401300000000,24,013,"Carroll County, MD",Jul-22,97495,94170,3325,3.40000000
CN2401500000000,24,015,"Cecil County, MD",Jul-22,53804,51455,2349,4.40000000
CN2401700000000,24,017,"Charles County, MD",Jul-22,87164,83414,3750,4.30000000
CN2401900000000,24,019,"Dorchester County, MD",Jul-22,15421,14711,710,4.60000000
CN2402100000000,24,021,"Frederick County, MD",Jul-22,139187,134020,5167,3.70000000
CN2402300000000,24,023,"Garrett County, MD",Jul-22,14642,14003,639,4.40000000
CN2402500000000,24,025,"Harford County, MD",Jul-22,144092,138540,5552,3.90000000
CN2402700000000,24,027,"Howard County, MD",Jul-22,192529,186080,6449,3.30000000
CN2402900000000,24,029,"Kent County, MD",Jul-22,9532,9107,425,4.50000000
CN2403100000000,24,031,"Montgomery County, MD",Jul-22,558518,537644,20874,3.70000000
CN2403300000000,24,033,"Prince George's County, MD",Jul-22,501700,477635,24065,4.80000000
CN2403500000000,24,035,"Queen Anne's County, MD",Jul-22,28940,27952,988,3.40000000
CN2403700000000,24,037,"St. Mary's County, MD",Jul-22,58130,55718,2412,4.10000000
CN2403900000000,24,039,"Somerset County, MD",Jul-22,9692,9119,573,5.90000000
CN2404100000000,24,041,"Talbot County, MD",Jul-22,16991,16272,719,4.20000000
CN2404300000000,24,043,"Washington County, MD",Jul-22,73707,70628,3079,4.20000000
CN2404500000000,24,045,"Wicomico County, MD",Jul-22,54086,51631,2455,4.50000000
CN2404700000000,24,047,"Worcester County, MD",Jul-22,26491,25161,1330,5.00000000
CN2451000000000,24,510,"Baltimore city, MD",Jul-22,283251,267318,15933,5.60000000
CN2500100000000,25,001,"Barnstable County, MA",Jul-22,119753,115863,3890,3.20000000
CN2500300000000,25,003,"Berkshire County, MA",Jul-22,61575,59210,2365,3.80000000
CN2500500000000,25,005,"Bristol County, MA",Jul-22,298470,286051,12419,4.20000000
CN2500700000000,25,007,"Dukes County, MA",Jul-22,11878,11561,317,2.70000000
CN2500900000000,25,009,"Essex County, MA",Jul-22,422837,407298,15539,3.70000000
CN2501100000000,25,011,"Franklin County, MA",Jul-22,40329,39128,1201,3.00000000
CN2501300000000,25,013,"Hampden County, MA",Jul-22,224506,213822,10684,4.80000000
CN2501500000000,25,015,"Hampshire County, MA",Jul-22,89585,86795,2790,3.10000000
CN2501700000000,25,017,"Middlesex County, MA",Jul-22,921171,895709,25462,2.80000000
CN2501900000000,25,019,"Nantucket County/town, MA",Jul-22,10155,9911,244,2.40000000
CN2502100000000,25,021,"Norfolk County, MA",Jul-22,396507,384775,11732,3.00000000
CN2502300000000,25,023,"Plymouth County, MA",Jul-22,285679,275578,10101,3.50000000
CN2502500000000,25,025,"Suffolk County, MA",Jul-22,459491,443004,16487,3.60000000
CN2502700000000,25,027,"Worcester County, MA",Jul-22,438741,422705,16036,3.70000000
CN2600100000000,26,001,"Alcona County, MI",Jul-22,4096,3822,274,6.70000000
CN2600300000000,26,003,"Alger County, MI",Jul-22,3542,3305,237,6.70000000
CN2600500000000,26,005,"Allegan County, MI",Jul-22,63264,60932,2332,3.70000000
CN2600700000000,26,007,"Alpena County, MI",Jul-22,13477,12819,658,4.90000000
CN2600900000000,26,009,"Antrim County, MI",Jul-22,11084,10494,590,5.30000000
CN2601100000000,26,011,"Arenac County, MI",Jul-22,6110,5677,433,7.10000000
CN2601300000000,26,013,"Baraga County, MI",Jul-22,3199,2962,237,7.40000000
CN2601500000000,26,015,"Barry County, MI",Jul-22,32151,30907,1244,3.90000000
CN2601700000000,26,017,"Bay County, MI",Jul-22,49543,46826,2717,5.50000000
CN2601900000000,26,019,"Benzie County, MI",Jul-22,9360,8936,424,4.50000000
CN2602100000000,26,021,"Berrien County, MI",Jul-22,72208,68633,3575,5.00000000
CN2602300000000,26,023,"Branch County, MI",Jul-22,19501,18615,886,4.50000000
CN2602500000000,26,025,"Calhoun County, MI",Jul-22,60624,57221,3403,5.60000000
CN2602700000000,26,027,"Cass County, MI",Jul-22,23967,22882,1085,4.50000000
CN2602900000000,26,029,"Charlevoix County, MI",Jul-22,13672,13117,555,4.10000000
CN2603100000000,26,031,"Cheboygan County, MI",Jul-22,11225,10770,455,4.10000000
CN2603300000000,26,033,"Chippewa County, MI",Jul-22,16629,15623,1006,6.00000000
CN2603500000000,26,035,"Clare County, MI",Jul-22,11366,10520,846,7.40000000
CN2603700000000,26,037,"Clinton County, MI",Jul-22,40056,38179,1877,4.70000000
CN2603900000000,26,039,"Crawford County, MI",Jul-22,5624,5252,372,6.60000000
CN2604100000000,26,041,"Delta County, MI",Jul-22,16741,15810,931,5.60000000
CN2604300000000,26,043,"Dickinson County, MI",Jul-22,12377,11863,514,4.20000000
CN2604500000000,26,045,"Eaton County, MI",Jul-22,55752,52393,3359,6.00000000
CN2604700000000,26,047,"Emmet County, MI",Jul-22,18338,17484,854,4.70000000
CN2604900000000,26,049,"Genesee County, MI",Jul-22,179385,167415,11970,6.70000000
CN2605100000000,26,051,"Gladwin County, MI",Jul-22,10028,9392,636,6.30000000
CN2605300000000,26,053,"Gogebic County, MI",Jul-22,5613,5322,291,5.20000000
CN2605500000000,26,055,"Grand Traverse County, MI",Jul-22,53015,51157,1858,3.50000000
CN2605700000000,26,057,"Gratiot County, MI",Jul-22,16948,16045,903,5.30000000
CN2605900000000,26,059,"Hillsdale County, MI",Jul-22,20377,19398,979,4.80000000
CN2606100000000,26,061,"Houghton County, MI",Jul-22,15456,14664,792,5.10000000
CN2606300000000,26,063,"Huron County, MI",Jul-22,15330,14601,729,4.80000000
CN2606500000000,26,065,"Ingham County, MI",Jul-22,144959,136852,8107,5.60000000
CN2606700000000,26,067,"Ionia County, MI",Jul-22,30628,29259,1369,4.50000000
CN2606900000000,26,069,"Iosco County, MI",Jul-22,10670,9990,680,6.40000000
CN2607100000000,26,071,"Iron County, MI",Jul-22,5034,4762,272,5.40000000
CN2607300000000,26,073,"Isabella County, MI",Jul-22,32362,30662,1700,5.30000000
CN2607500000000,26,075,"Jackson County, MI",Jul-22,73207,69545,3662,5.00000000
CN2607700000000,26,077,"Kalamazoo County, MI",Jul-22,131586,125901,5685,4.30000000
CN2607900000000,26,079,"Kalkaska County, MI",Jul-22,8429,7964,465,5.50000000
CN2608100000000,26,081,"Kent County, MI",Jul-22,362401,348628,13773,3.80000000
CN2608300000000,26,083,"Keweenaw County, MI",Jul-22,871,817,54,6.20000000
CN2608500000000,26,085,"Lake County, MI",Jul-22,4196,3903,293,7.00000000
CN2608700000000,26,087,"Lapeer County, MI",Jul-22,40590,39233,1357,3.30000000
CN2608900000000,26,089,"Leelanau County, MI",Jul-22,11120,10704,416,3.70000000
CN2609100000000,26,091,"Lenawee County, MI",Jul-22,44338,41925,2413,5.40000000
CN2609300000000,26,093,"Livingston County, MI",Jul-22,103763,101436,2327,2.20000000
CN2609500000000,26,095,"Luce County, MI",Jul-22,2230,2100,130,5.80000000
CN2609700000000,26,097,"Mackinac County, MI",Jul-22,6292,6110,182,2.90000000
CN2609900000000,26,099,"Macomb County, MI",Jul-22,444083,429699,14384,3.20000000
CN2610100000000,26,101,"Manistee County, MI",Jul-22,10898,10299,599,5.50000000
CN2610300000000,26,103,"Marquette County, MI",Jul-22,30990,29410,1580,5.10000000
CN2610500000000,26,105,"Mason County, MI",Jul-22,13926,13232,694,5.00000000
CN2610700000000,26,107,"Mecosta County, MI",Jul-22,18308,17252,1056,5.80000000
CN2610900000000,26,109,"Menominee County, MI",Jul-22,10752,10297,455,4.20000000
CN2611100000000,26,111,"Midland County, MI",Jul-22,39417,37624,1793,4.50000000
CN2611300000000,26,113,"Missaukee County, MI",Jul-22,7172,6816,356,5.00000000
CN2611500000000,26,115,"Monroe County, MI",Jul-22,74607,70616,3991,5.30000000
CN2611700000000,26,117,"Montcalm County, MI",Jul-22,28226,26849,1377,4.90000000
CN2611900000000,26,119,"Montmorency County, MI",Jul-22,3184,2933,251,7.90000000
CN2612100000000,26,121,"Muskegon County, MI",Jul-22,78477,73618,4859,6.20000000
CN2612300000000,26,123,"Newaygo County, MI",Jul-22,24080,22924,1156,4.80000000
CN2612500000000,26,125,"Oakland County, MI",Jul-22,670434,653631,16803,2.50000000
CN2612700000000,26,127,"Oceana County, MI",Jul-22,12918,12100,818,6.30000000
CN2612900000000,26,129,"Ogemaw County, MI",Jul-22,8537,7950,587,6.90000000
CN2613100000000,26,131,"Ontonagon County, MI",Jul-22,2163,2008,155,7.20000000
CN2613300000000,26,133,"Osceola County, MI",Jul-22,11889,11337,552,4.60000000
CN2613500000000,26,135,"Oscoda County, MI",Jul-22,2817,2562,255,9.10000000
CN2613700000000,26,137,"Otsego County, MI",Jul-22,12030,11337,693,5.80000000
CN2613900000000,26,139,"Ottawa County, MI",Jul-22,163428,157830,5598,3.40000000
CN2614100000000,26,141,"Presque Isle County, MI",Jul-22,5255,4910,345,6.60000000
CN2614300000000,26,143,"Roscommon County, MI",Jul-22,7849,7169,680,8.70000000
CN2614500000000,26,145,"Saginaw County, MI",Jul-22,83024,77600,5424,6.50000000
CN2614700000000,26,147,"St. Clair County, MI",Jul-22,74996,72604,2392,3.20000000
CN2614900000000,26,149,"St. Joseph County, MI",Jul-22,28395,26888,1507,5.30000000
CN2615100000000,26,151,"Sanilac County, MI",Jul-22,19897,18815,1082,5.40000000
CN2615300000000,26,153,"Schoolcraft County, MI",Jul-22,3316,3079,237,7.10000000
CN2615500000000,26,155,"Shiawassee County, MI",Jul-22,32446,30749,1697,5.20000000
CN2615700000000,26,157,"Tuscola County, MI",Jul-22,23305,21951,1354,5.80000000
CN2615900000000,26,159,"Van Buren County, MI",Jul-22,34839,33060,1779,5.10000000
CN2616100000000,26,161,"Washtenaw County, MI",Jul-22,197057,189170,7887,4.00000000
CN2616300000000,26,163,"Wayne County, MI",Jul-22,795253,758274,36979,4.60000000
CN2616500000000,26,165,"Wexford County, MI",Jul-22,15154,14360,794,5.20000000
CN2700100000000,27,001,"Aitkin County, MN",Jul-22,7313,7127,186,2.50000000
CN2700300000000,27,003,"Anoka County, MN",Jul-22,201475,197410,4065,2.00000000
CN2700500000000,27,005,"Becker County, MN",Jul-22,18638,18239,399,2.10000000
CN2700700000000,27,007,"Beltrami County, MN",Jul-22,23750,23169,581,2.40000000
CN2700900000000,27,009,"Benton County, MN",Jul-22,21430,20958,472,2.20000000
CN2701100000000,27,011,"Big Stone County, MN",Jul-22,2439,2389,50,2.10000000
CN2701300000000,27,013,"Blue Earth County, MN",Jul-22,39865,39138,727,1.80000000
CN2701500000000,27,015,"Brown County, MN",Jul-22,13295,13023,272,2.00000000
CN2701700000000,27,017,"Carlton County, MN",Jul-22,17410,16993,417,2.40000000
CN2701900000000,27,019,"Carver County, MN",Jul-22,60323,59314,1009,1.70000000
CN2702100000000,27,021,"Cass County, MN",Jul-22,18059,17659,400,2.20000000
CN2702300000000,27,023,"Chippewa County, MN",Jul-22,6239,6124,115,1.80000000
CN2702500000000,27,025,"Chisago County, MN",Jul-22,30271,29680,591,2.00000000
CN2702700000000,27,027,"Clay County, MN",Jul-22,36328,35678,650,1.80000000
CN2702900000000,27,029,"Clearwater County, MN",Jul-22,4586,4415,171,3.70000000
CN2703100000000,27,031,"Cook County, MN",Jul-22,2998,2939,59,2.00000000
CN2703300000000,27,033,"Cottonwood County, MN",Jul-22,6471,6150,321,5.00000000
CN2703500000000,27,035,"Crow Wing County, MN",Jul-22,32191,31522,669,2.10000000
CN2703700000000,27,037,"Dakota County, MN",Jul-22,245934,241261,4673,1.90000000
CN2703900000000,27,039,"Dodge County, MN",Jul-22,12136,11915,221,1.80000000
CN2704100000000,27,041,"Douglas County, MN",Jul-22,21344,20988,356,1.70000000
CN2704300000000,27,043,"Faribault County, MN",Jul-22,6907,6748,159,2.30000000
CN2704500000000,27,045,"Fillmore County, MN",Jul-22,11691,11486,205,1.80000000
CN2704700000000,27,047,"Freeborn County, MN",Jul-22,14974,14646,328,2.20000000
CN2704900000000,27,049,"Goodhue County, MN",Jul-22,26044,25545,499,1.90000000
CN2705100000000,27,051,"Grant County, MN",Jul-22,3179,3118,61,1.90000000
CN2705300000000,27,053,"Hennepin County, MN",Jul-22,716202,701357,14845,2.10000000
CN2705500000000,27,055,"Houston County, MN",Jul-22,10063,9901,162,1.60000000
CN2705700000000,27,057,"Hubbard County, MN",Jul-22,10647,10375,272,2.60000000
CN2705900000000,27,059,"Isanti County, MN",Jul-22,21887,21454,433,2.00000000
CN2706100000000,27,061,"Itasca County, MN",Jul-22,20746,20121,625,3.00000000
CN2706300000000,27,063,"Jackson County, MN",Jul-22,5372,5231,141,2.60000000
CN2706500000000,27,065,"Kanabec County, MN",Jul-22,8887,8669,218,2.50000000
CN2706700000000,27,067,"Kandiyohi County, MN",Jul-22,22430,21967,463,2.10000000
CN2706900000000,27,069,"Kittson County, MN",Jul-22,2191,2144,47,2.10000000
CN2707100000000,27,071,"Koochiching County, MN",Jul-22,5533,5355,178,3.20000000
CN2707300000000,27,073,"Lac qui Parle County, MN",Jul-22,3184,3119,65,2.00000000
CN2707500000000,27,075,"Lake County, MN",Jul-22,5569,5305,264,4.70000000
CN2707700000000,27,077,"Lake of the Woods County, MN",Jul-22,2374,2308,66,2.80000000
CN2707900000000,27,079,"Le Sueur County, MN",Jul-22,16029,15720,309,1.90000000
CN2708100000000,27,081,"Lincoln County, MN",Jul-22,2932,2880,52,1.80000000
CN2708300000000,27,083,"Lyon County, MN",Jul-22,13506,13233,273,2.00000000
CN2708500000000,27,085,"McLeod County, MN",Jul-22,18633,18255,378,2.00000000
CN2708700000000,27,087,"Mahnomen County, MN",Jul-22,2091,2012,79,3.80000000
CN2708900000000,27,089,"Marshall County, MN",Jul-22,5142,5022,120,2.30000000
CN2709100000000,27,091,"Martin County, MN",Jul-22,9422,9195,227,2.40000000
CN2709300000000,27,093,"Meeker County, MN",Jul-22,12985,12741,244,1.90000000
CN2709500000000,27,095,"Mille Lacs County, MN",Jul-22,12681,12386,295,2.30000000
CN2709700000000,27,097,"Morrison County, MN",Jul-22,17117,16700,417,2.40000000
CN2709900000000,27,099,"Mower County, MN",Jul-22,20009,19604,405,2.00000000
CN2710100000000,27,101,"Murray County, MN",Jul-22,4459,4367,92,2.10000000
CN2710300000000,27,103,"Nicollet County, MN",Jul-22,20493,20171,322,1.60000000
CN2710500000000,27,105,"Nobles County, MN",Jul-22,10975,10749,226,2.10000000
CN2710700000000,27,107,"Norman County, MN",Jul-22,3228,3135,93,2.90000000
CN2710900000000,27,109,"Olmsted County, MN",Jul-22,92790,91209,1581,1.70000000
CN2711100000000,27,111,"Otter Tail County, MN",Jul-22,31465,30862,603,1.90000000
CN2711300000000,27,113,"Pennington County, MN",Jul-22,8428,8248,180,2.10000000
CN2711500000000,27,115,"Pine County, MN",Jul-22,13968,13609,359,2.60000000
CN2711700000000,27,117,"Pipestone County, MN",Jul-22,4472,4401,71,1.60000000
CN2711900000000,27,119,"Polk County, MN",Jul-22,15801,15405,396,2.50000000
CN2712100000000,27,121,"Pope County, MN",Jul-22,6354,6257,97,1.50000000
CN2712300000000,27,123,"Ramsey County, MN",Jul-22,290166,283530,6636,2.30000000
CN2712500000000,27,125,"Red Lake County, MN",Jul-22,2119,2068,51,2.40000000
CN2712700000000,27,127,"Redwood County, MN",Jul-22,7395,7232,163,2.20000000
CN2712900000000,27,129,"Renville County, MN",Jul-22,7933,7701,232,2.90000000
CN2713100000000,27,131,"Rice County, MN",Jul-22,36236,35502,734,2.00000000
CN2713300000000,27,133,"Rock County, MN",Jul-22,5913,5831,82,1.40000000
CN2713500000000,27,135,"Roseau County, MN",Jul-22,7608,7450,158,2.10000000
CN2713700000000,27,137,"St. Louis County, MN",Jul-22,99699,97134,2565,2.60000000
CN2713900000000,27,139,"Scott County, MN",Jul-22,85650,84137,1513,1.80000000
CN2714100000000,27,141,"Sherburne County, MN",Jul-22,53728,52699,1029,1.90000000
CN2714300000000,27,143,"Sibley County, MN",Jul-22,8240,8070,170,2.10000000
CN2714500000000,27,145,"Stearns County, MN",Jul-22,89183,87407,1776,2.00000000
CN2714700000000,27,147,"Steele County, MN",Jul-22,18891,18464,427,2.30000000
CN2714900000000,27,149,"Stevens County, MN",Jul-22,5174,5097,77,1.50000000
CN2715100000000,27,151,"Swift County, MN",Jul-22,4651,4542,109,2.30000000
CN2715300000000,27,153,"Todd County, MN",Jul-22,12985,12704,281,2.20000000
CN2715500000000,27,155,"Traverse County, MN",Jul-22,1619,1596,23,1.40000000
CN2715700000000,27,157,"Wabasha County, MN",Jul-22,12447,12220,227,1.80000000
CN2715900000000,27,159,"Wadena County, MN",Jul-22,5706,5548,158,2.80000000
CN2716100000000,27,161,"Waseca County, MN",Jul-22,8615,8392,223,2.60000000
CN2716300000000,27,163,"Washington County, MN",Jul-22,147129,144437,2692,1.80000000
CN2716500000000,27,165,"Watonwan County, MN",Jul-22,6419,6259,160,2.50000000
CN2716700000000,27,167,"Wilkin County, MN",Jul-22,3283,3216,67,2.00000000
CN2716900000000,27,169,"Winona County, MN",Jul-22,26670,26164,506,1.90000000
CN2717100000000,27,171,"Wright County, MN",Jul-22,77623,76266,1357,1.70000000
CN2717300000000,27,173,"Yellow Medicine County, MN",Jul-22,4854,4747,107,2.20000000
CN2800100000000,28,001,"Adams County, MS",Jul-22,10546,9884,662,6.30000000
CN2800300000000,28,003,"Alcorn County, MS",Jul-22,15067,14480,587,3.90000000
CN2800500000000,28,005,"Amite County, MS",Jul-22,4438,4181,257,5.80000000
CN2800700000000,28,007,"Attala County, MS",Jul-22,7161,6829,332,4.60000000
CN2800900000000,28,009,"Benton County, MS",Jul-22,3193,3012,181,5.70000000
CN2801100000000,28,011,"Bolivar County, MS",Jul-22,11556,10840,716,6.20000000
CN2801300000000,28,013,"Calhoun County, MS",Jul-22,5538,5283,255,4.60000000
CN2801500000000,28,015,"Carroll County, MS",Jul-22,3606,3442,164,4.50000000
CN2801700000000,28,017,"Chickasaw County, MS",Jul-22,6928,6572,356,5.10000000
CN2801900000000,28,019,"Choctaw County, MS",Jul-22,3663,3518,145,4.00000000
CN2802100000000,28,021,"Claiborne County, MS",Jul-22,3007,2679,328,10.90000000
CN2802300000000,28,023,"Clarke County, MS",Jul-22,5661,5375,286,5.10000000
CN2802500000000,28,025,"Clay County, MS",Jul-22,8414,7986,428,5.10000000
CN2802700000000,28,027,"Coahoma County, MS",Jul-22,7931,7403,528,6.70000000
CN2802900000000,28,029,"Copiah County, MS",Jul-22,10980,10423,557,5.10000000
CN2803100000000,28,031,"Covington County, MS",Jul-22,8351,8029,322,3.90000000
CN2803300000000,28,033,"DeSoto County, MS",Jul-22,97089,93735,3354,3.50000000
CN2803500000000,28,035,"Forrest County, MS",Jul-22,33420,31986,1434,4.30000000
CN2803700000000,28,037,"Franklin County, MS",Jul-22,2656,2498,158,5.90000000
CN2803900000000,28,039,"George County, MS",Jul-22,8792,8276,516,5.90000000
CN2804100000000,28,041,"Greene County, MS",Jul-22,4312,4011,301,7.00000000
CN2804300000000,28,043,"Grenada County, MS",Jul-22,9395,9038,357,3.80000000
CN2804500000000,28,045,"Hancock County, MS",Jul-22,19417,18557,860,4.40000000
CN2804700000000,28,047,"Harrison County, MS",Jul-22,89803,86112,3691,4.10000000
CN2804900000000,28,049,"Hinds County, MS",Jul-22,102990,98268,4722,4.60000000
CN2805100000000,28,051,"Holmes County, MS",Jul-22,5134,4692,442,8.60000000
CN2805300000000,28,053,"Humphreys County, MS",Jul-22,2065,1868,197,9.50000000
CN2805500000000,28,055,"Issaquena County, MS",Jul-22,333,312,21,6.30000000
CN2805700000000,28,057,"Itawamba County, MS",Jul-22,10534,10127,407,3.90000000
CN2805900000000,28,059,"Jackson County, MS",Jul-22,60398,57544,2854,4.70000000
CN2806100000000,28,061,"Jasper County, MS",Jul-22,5919,5587,332,5.60000000
CN2806300000000,28,063,"Jefferson County, MS",Jul-22,1952,1654,298,15.30000000
CN2806500000000,28,065,"Jefferson Davis County, MS",Jul-22,3938,3711,227,5.80000000
CN2806700000000,28,067,"Jones County, MS",Jul-22,25048,23893,1155,4.60000000
CN2806900000000,28,069,"Kemper County, MS",Jul-22,3346,3118,228,6.80000000
CN2807100000000,28,071,"Lafayette County, MS",Jul-22,27938,26896,1042,3.70000000
CN2807300000000,28,073,"Lamar County, MS",Jul-22,31663,30607,1056,3.30000000
CN2807500000000,28,075,"Lauderdale County, MS",Jul-22,29075,27782,1293,4.40000000
CN2807700000000,28,077,"Lawrence County, MS",Jul-22,4761,4498,263,5.50000000
CN2807900000000,28,079,"Leake County, MS",Jul-22,8228,7871,357,4.30000000
CN2808100000000,28,081,"Lee County, MS",Jul-22,41623,40083,1540,3.70000000
CN2808300000000,28,083,"Leflore County, MS",Jul-22,10252,9625,627,6.10000000
CN2808500000000,28,085,"Lincoln County, MS",Jul-22,15010,14392,618,4.10000000
CN2808700000000,28,087,"Lowndes County, MS",Jul-22,25279,24108,1171,4.60000000
CN2808900000000,28,089,"Madison County, MS",Jul-22,53790,51906,1884,3.50000000
CN2809100000000,28,091,"Marion County, MS",Jul-22,10568,10145,423,4.00000000
CN2809300000000,28,093,"Marshall County, MS",Jul-22,14786,14114,672,4.50000000
CN2809500000000,28,095,"Monroe County, MS",Jul-22,16340,15609,731,4.50000000
CN2809700000000,28,097,"Montgomery County, MS",Jul-22,3969,3785,184,4.60000000
CN2809900000000,28,099,"Neshoba County, MS",Jul-22,10410,9920,490,4.70000000
CN2810100000000,28,101,"Newton County, MS",Jul-22,8365,7997,368,4.40000000
CN2810300000000,28,103,"Noxubee County, MS",Jul-22,3546,3292,254,7.20000000
CN2810500000000,28,105,"Oktibbeha County, MS",Jul-22,22698,21603,1095,4.80000000
CN2810700000000,28,107,"Panola County, MS",Jul-22,12811,12119,692,5.40000000
CN2810900000000,28,109,"Pearl River County, MS",Jul-22,24091,23074,1017,4.20000000
CN2811100000000,28,111,"Perry County, MS",Jul-22,4295,4053,242,5.60000000
CN2811300000000,28,113,"Pike County, MS",Jul-22,14367,13560,807,5.60000000
CN2811500000000,28,115,"Pontotoc County, MS",Jul-22,15219,14607,612,4.00000000
CN2811700000000,28,117,"Prentiss County, MS",Jul-22,11592,11169,423,3.60000000
CN2811900000000,28,119,"Quitman County, MS",Jul-22,2397,2241,156,6.50000000
CN2812100000000,28,121,"Rankin County, MS",Jul-22,77154,74731,2423,3.10000000
CN2812300000000,28,123,"Scott County, MS",Jul-22,12929,12459,470,3.60000000
CN2812500000000,28,125,"Sharkey County, MS",Jul-22,1455,1362,93,6.40000000
CN2812700000000,28,127,"Simpson County, MS",Jul-22,10741,10298,443,4.10000000
CN2812900000000,28,129,"Smith County, MS",Jul-22,6772,6509,263,3.90000000
CN2813100000000,28,131,"Stone County, MS",Jul-22,7106,6781,325,4.60000000
CN2813300000000,28,133,"Sunflower County, MS",Jul-22,7700,7214,486,6.30000000
CN2813500000000,28,135,"Tallahatchie County, MS",Jul-22,4691,4467,224,4.80000000
CN2813700000000,28,137,"Tate County, MS",Jul-22,12653,12109,544,4.30000000
CN2813900000000,28,139,"Tippah County, MS",Jul-22,10013,9636,377,3.80000000
CN2814100000000,28,141,"Tishomingo County, MS",Jul-22,8388,8051,337,4.00000000
CN2814300000000,28,143,"Tunica County, MS",Jul-22,4428,4176,252,5.70000000
CN2814500000000,28,145,"Union County, MS",Jul-22,14661,14167,494,3.40000000
CN2814700000000,28,147,"Walthall County, MS",Jul-22,4899,4616,283,5.80000000
CN2814900000000,28,149,"Warren County, MS",Jul-22,19472,18506,966,5.00000000
CN2815100000000,28,151,"Washington County, MS",Jul-22,15862,14867,995,6.30000000
CN2815300000000,28,153,"Wayne County, MS",Jul-22,7577,7175,402,5.30000000
CN2815500000000,28,155,"Webster County, MS",Jul-22,3990,3807,183,4.60000000
CN2815700000000,28,157,"Wilkinson County, MS",Jul-22,2584,2392,192,7.40000000
CN2815900000000,28,159,"Winston County, MS",Jul-22,7235,6872,363,5.00000000
CN2816100000000,28,161,"Yalobusha County, MS",Jul-22,4862,4646,216,4.40000000
CN2816300000000,28,163,"Yazoo County, MS",Jul-22,9117,8609,508,5.60000000
CN2900100000000,29,001,"Adair County, MO",Jul-22,9633,9281,352,3.70000000
CN2900300000000,29,003,"Andrew County, MO",Jul-22,9737,9501,236,2.40000000
CN2900500000000,29,005,"Atchison County, MO",Jul-22,2549,2468,81,3.20000000
CN2900700000000,29,007,"Audrain County, MO",Jul-22,10068,9733,335,3.30000000
CN2900900000000,29,009,"Barry County, MO",Jul-22,14286,13870,416,2.90000000
CN2901100000000,29,011,"Barton County, MO",Jul-22,5208,5069,139,2.70000000
CN2901300000000,29,013,"Bates County, MO",Jul-22,7690,7462,228,3.00000000
CN2901500000000,29,015,"Benton County, MO",Jul-22,6929,6649,280,4.00000000
CN2901700000000,29,017,"Bollinger County, MO",Jul-22,5173,5026,147,2.80000000
CN2901900000000,29,019,"Boone County, MO",Jul-22,101015,98730,2285,2.30000000
CN2902100000000,29,021,"Buchanan County, MO",Jul-22,43684,42524,1160,2.70000000
CN2902300000000,29,023,"Butler County, MO",Jul-22,17660,17037,623,3.50000000
CN2902500000000,29,025,"Caldwell County, MO",Jul-22,4295,4151,144,3.40000000
CN2902700000000,29,027,"Callaway County, MO",Jul-22,21585,20979,606,2.80000000
CN2902900000000,29,029,"Camden County, MO",Jul-22,20866,20293,573,2.70000000
CN2903100000000,29,031,"Cape Girardeau County, MO",Jul-22,39445,38371,1074,2.70000000
CN2903300000000,29,033,"Carroll County, MO",Jul-22,4182,4041,141,3.40000000
CN2903500000000,29,035,"Carter County, MO",Jul-22,2536,2433,103,4.10000000
CN2903700000000,29,037,"Cass County, MO",Jul-22,55178,53680,1498,2.70000000
CN2903900000000,29,039,"Cedar County, MO",Jul-22,5568,5371,197,3.50000000
CN2904100000000,29,041,"Chariton County, MO",Jul-22,3567,3486,81,2.30000000
CN2904300000000,29,043,"Christian County, MO",Jul-22,47209,46129,1080,2.30000000
CN2904500000000,29,045,"Clark County, MO",Jul-22,2932,2837,95,3.20000000
CN2904700000000,29,047,"Clay County, MO",Jul-22,139846,135417,4429,3.20000000
CN2904900000000,29,049,"Clinton County, MO",Jul-22,10757,10361,396,3.70000000
CN2905100000000,29,051,"Cole County, MO",Jul-22,39038,38152,886,2.30000000
CN2905300000000,29,053,"Cooper County, MO",Jul-22,7025,6825,200,2.80000000
CN2905500000000,29,055,"Crawford County, MO",Jul-22,10940,10594,346,3.20000000
CN2905700000000,29,057,"Dade County, MO",Jul-22,3330,3256,74,2.20000000
CN2905900000000,29,059,"Dallas County, MO",Jul-22,7211,7008,203,2.80000000
CN2906100000000,29,061,"Daviess County, MO",Jul-22,3914,3803,111,2.80000000
CN2906300000000,29,063,"DeKalb County, MO",Jul-22,4207,4072,135,3.20000000
CN2906500000000,29,065,"Dent County, MO",Jul-22,6068,5863,205,3.40000000
CN2906700000000,29,067,"Douglas County, MO",Jul-22,5045,4898,147,2.90000000
CN2906900000000,29,069,"Dunklin County, MO",Jul-22,10943,10400,543,5.00000000
CN2907100000000,29,071,"Franklin County, MO",Jul-22,53533,52159,1374,2.60000000
CN2907300000000,29,073,"Gasconade County, MO",Jul-22,7492,7300,192,2.60000000
CN2907500000000,29,075,"Gentry County, MO",Jul-22,3259,3170,89,2.70000000
CN2907700000000,29,077,"Greene County, MO",Jul-22,154350,150970,3380,2.20000000
CN2907900000000,29,079,"Grundy County, MO",Jul-22,3929,3818,111,2.80000000
CN2908100000000,29,081,"Harrison County, MO",Jul-22,3690,3612,78,2.10000000
CN2908300000000,29,083,"Henry County, MO",Jul-22,10098,9787,311,3.10000000
CN2908500000000,29,085,"Hickory County, MO",Jul-22,4073,3957,116,2.80000000
CN2908700000000,29,087,"Holt County, MO",Jul-22,2424,2365,59,2.40000000
CN2908900000000,29,089,"Howard County, MO",Jul-22,4606,4475,131,2.80000000
CN2909100000000,29,091,"Howell County, MO",Jul-22,15665,15105,560,3.60000000
CN2909300000000,29,093,"Iron County, MO",Jul-22,3372,3200,172,5.10000000
CN2909500000000,29,095,"Jackson County, MO",Jul-22,362498,349788,12710,3.50000000
CN2909700000000,29,097,"Jasper County, MO",Jul-22,57937,56450,1487,2.60000000
CN2909900000000,29,099,"Jefferson County, MO",Jul-22,119276,116174,3102,2.60000000
CN2910100000000,29,101,"Johnson County, MO",Jul-22,22167,21477,690,3.10000000
CN2910300000000,29,103,"Knox County, MO",Jul-22,1616,1571,45,2.80000000
CN2910500000000,29,105,"Laclede County, MO",Jul-22,16119,15653,466,2.90000000
CN2910700000000,29,107,"Lafayette County, MO",Jul-22,16921,16383,538,3.20000000
CN2910900000000,29,109,"Lawrence County, MO",Jul-22,16629,16150,479,2.90000000
CN2911100000000,29,111,"Lewis County, MO",Jul-22,4665,4554,111,2.40000000
CN2911300000000,29,113,"Lincoln County, MO",Jul-22,29627,28793,834,2.80000000
CN2911500000000,29,115,"Linn County, MO",Jul-22,4887,4721,166,3.40000000
CN2911700000000,29,117,"Livingston County, MO",Jul-22,7221,7080,141,2.00000000
CN2911900000000,29,119,"McDonald County, MO",Jul-22,11042,10701,341,3.10000000
CN2912100000000,29,121,"Macon County, MO",Jul-22,7009,6807,202,2.90000000
CN2912300000000,29,123,"Madison County, MO",Jul-22,5336,5151,185,3.50000000
CN2912500000000,29,125,"Maries County, MO",Jul-22,3731,3625,106,2.80000000
CN2912700000000,29,127,"Marion County, MO",Jul-22,13857,13492,365,2.60000000
CN2912900000000,29,129,"Mercer County, MO",Jul-22,1646,1604,42,2.60000000
CN2913100000000,29,131,"Miller County, MO",Jul-22,12660,12333,327,2.60000000
CN2913300000000,29,133,"Mississippi County, MO",Jul-22,5099,4878,221,4.30000000
CN2913500000000,29,135,"Moniteau County, MO",Jul-22,7098,6918,180,2.50000000
CN2913700000000,29,137,"Monroe County, MO",Jul-22,3620,3517,103,2.80000000
CN2913900000000,29,139,"Montgomery County, MO",Jul-22,5782,5632,150,2.60000000
CN2914100000000,29,141,"Morgan County, MO",Jul-22,8528,8281,247,2.90000000
CN2914300000000,29,143,"New Madrid County, MO",Jul-22,8201,7882,319,3.90000000
CN2914500000000,29,145,"Newton County, MO",Jul-22,27549,26742,807,2.90000000
CN2914700000000,29,147,"Nodaway County, MO",Jul-22,10682,10386,296,2.80000000
CN2914900000000,29,149,"Oregon County, MO",Jul-22,3460,3322,138,4.00000000
CN2915100000000,29,151,"Osage County, MO",Jul-22,7045,6893,152,2.20000000
CN2915300000000,29,153,"Ozark County, MO",Jul-22,3282,3157,125,3.80000000
CN2915500000000,29,155,"Pemiscot County, MO",Jul-22,5716,5387,329,5.80000000
CN2915700000000,29,157,"Perry County, MO",Jul-22,9575,9368,207,2.20000000
CN2915900000000,29,159,"Pettis County, MO",Jul-22,19523,18855,668,3.40000000
CN2916100000000,29,161,"Phelps County, MO",Jul-22,19810,19253,557,2.80000000
CN2916300000000,29,163,"Pike County, MO",Jul-22,7062,6859,203,2.90000000
CN2916500000000,29,165,"Platte County, MO",Jul-22,60255,58734,1521,2.50000000
CN2916700000000,29,167,"Polk County, MO",Jul-22,14700,14287,413,2.80000000
CN2916900000000,29,169,"Pulaski County, MO",Jul-22,13945,13465,480,3.40000000
CN2917100000000,29,171,"Putnam County, MO",Jul-22,2145,2095,50,2.30000000
CN2917300000000,29,173,"Ralls County, MO",Jul-22,5451,5323,128,2.30000000
CN2917500000000,29,175,"Randolph County, MO",Jul-22,10065,9772,293,2.90000000
CN2917700000000,29,177,"Ray County, MO",Jul-22,11142,10552,590,5.30000000
CN2917900000000,29,179,"Reynolds County, MO",Jul-22,2853,2762,91,3.20000000
CN2918100000000,29,181,"Ripley County, MO",Jul-22,4848,4652,196,4.00000000
CN2918300000000,29,183,"St. Charles County, MO",Jul-22,231696,226619,5077,2.20000000
CN2918500000000,29,185,"St. Clair County, MO",Jul-22,3687,3570,117,3.20000000
CN2918600000000,29,186,"Ste. Genevieve County, MO",Jul-22,9285,9039,246,2.60000000
CN2918700000000,29,187,"St. Francois County, MO",Jul-22,25302,24322,980,3.90000000
CN2918900000000,29,189,"St. Louis County, MO",Jul-22,533123,517951,15172,2.80000000
CN2919500000000,29,195,"Saline County, MO",Jul-22,9947,9645,302,3.00000000
CN2919700000000,29,197,"Schuyler County, MO",Jul-22,1769,1719,50,2.80000000
CN2919900000000,29,199,"Scotland County, MO",Jul-22,2280,2231,49,2.10000000
CN2920100000000,29,201,"Scott County, MO",Jul-22,19717,19113,604,3.10000000
CN2920300000000,29,203,"Shannon County, MO",Jul-22,3338,3196,142,4.30000000
CN2920500000000,29,205,"Shelby County, MO",Jul-22,2865,2795,70,2.40000000
CN2920700000000,29,207,"Stoddard County, MO",Jul-22,13188,12720,468,3.50000000
CN2920900000000,29,209,"Stone County, MO",Jul-22,14297,13810,487,3.40000000
CN2921100000000,29,211,"Sullivan County, MO",Jul-22,2457,2391,66,2.70000000
CN2921300000000,29,213,"Taney County, MO",Jul-22,27648,26610,1038,3.80000000
CN2921500000000,29,215,"Texas County, MO",Jul-22,8503,8213,290,3.40000000
CN2921700000000,29,217,"Vernon County, MO",Jul-22,8730,8462,268,3.10000000
CN2921900000000,29,219,"Warren County, MO",Jul-22,18984,18475,509,2.70000000
CN2922100000000,29,221,"Washington County, MO",Jul-22,9823,9469,354,3.60000000
CN2922300000000,29,223,"Wayne County, MO",Jul-22,4561,4375,186,4.10000000
CN2922500000000,29,225,"Webster County, MO",Jul-22,17608,17170,438,2.50000000
CN2922700000000,29,227,"Worth County, MO",Jul-22,1120,1090,30,2.70000000
CN2922900000000,29,229,"Wright County, MO",Jul-22,7244,6997,247,3.40000000
CN2951000000000,29,510,"St. Louis city, MO",Jul-22,151595,145425,6170,4.10000000
CN3000100000000,30,001,"Beaverhead County, MT",Jul-22,5213,5095,118,2.30000000
CN3000300000000,30,003,"Big Horn County, MT",Jul-22,4594,4330,264,5.70000000
CN3000500000000,30,005,"Blaine County, MT",Jul-22,2066,1995,71,3.40000000
CN3000700000000,30,007,"Broadwater County, MT",Jul-22,2796,2702,94,3.40000000
CN3000900000000,30,009,"Carbon County, MT",Jul-22,5826,5675,151,2.60000000
CN3001100000000,30,011,"Carter County, MT",Jul-22,584,572,12,2.10000000
CN3001300000000,30,013,"Cascade County, MT",Jul-22,38387,37331,1056,2.80000000
CN3001500000000,30,015,"Chouteau County, MT",Jul-22,2260,2197,63,2.80000000
CN3001700000000,30,017,"Custer County, MT",Jul-22,6432,6273,159,2.50000000
CN3001900000000,30,019,"Daniels County, MT",Jul-22,869,853,16,1.80000000
CN3002100000000,30,021,"Dawson County, MT",Jul-22,4476,4363,113,2.50000000
CN3002300000000,30,023,"Deer Lodge County, MT",Jul-22,5537,5409,128,2.30000000
CN3002500000000,30,025,"Fallon County, MT",Jul-22,1606,1582,24,1.50000000
CN3002700000000,30,027,"Fergus County, MT",Jul-22,5929,5785,144,2.40000000
CN3002900000000,30,029,"Flathead County, MT",Jul-22,55089,53636,1453,2.60000000
CN3003100000000,30,031,"Gallatin County, MT",Jul-22,80950,79551,1399,1.70000000
CN3003300000000,30,033,"Garfield County, MT",Jul-22,671,652,19,2.80000000
CN3003500000000,30,035,"Glacier County, MT",Jul-22,4897,4530,367,7.50000000
CN3003700000000,30,037,"Golden Valley County, MT",Jul-22,369,358,11,3.00000000
CN3003900000000,30,039,"Granite County, MT",Jul-22,1667,1617,50,3.00000000
CN3004100000000,30,041,"Hill County, MT",Jul-22,7239,7022,217,3.00000000
CN3004300000000,30,043,"Jefferson County, MT",Jul-22,6127,5974,153,2.50000000
CN3004500000000,30,045,"Judith Basin County, MT",Jul-22,845,828,17,2.00000000
CN3004700000000,30,047,"Lake County, MT",Jul-22,14375,13912,463,3.20000000
CN3004900000000,30,049,"Lewis and Clark County, MT",Jul-22,39123,38152,971,2.50000000
CN3005100000000,30,051,"Liberty County, MT",Jul-22,899,877,22,2.40000000
CN3005300000000,30,053,"Lincoln County, MT",Jul-22,8872,8475,397,4.50000000
CN3005500000000,30,055,"McCone County, MT",Jul-22,918,901,17,1.90000000
CN3005700000000,30,057,"Madison County, MT",Jul-22,4830,4728,102,2.10000000
CN3005900000000,30,059,"Meagher County, MT",Jul-22,1005,983,22,2.20000000
CN3006100000000,30,061,"Mineral County, MT",Jul-22,1964,1875,89,4.50000000
CN3006300000000,30,063,"Missoula County, MT",Jul-22,67928,66206,1722,2.50000000
CN3006500000000,30,065,"Musselshell County, MT",Jul-22,2304,2239,65,2.80000000
CN3006700000000,30,067,"Park County, MT",Jul-22,10498,10229,269,2.60000000
CN3006900000000,30,069,"Petroleum County, MT",Jul-22,248,243,5,2.00000000
CN3007100000000,30,071,"Phillips County, MT",Jul-22,1739,1676,63,3.60000000
CN3007300000000,30,073,"Pondera County, MT",Jul-22,2521,2443,78,3.10000000
CN3007500000000,30,075,"Powder River County, MT",Jul-22,930,911,19,2.00000000
CN3007700000000,30,077,"Powell County, MT",Jul-22,3097,3027,70,2.30000000
CN3007900000000,30,079,"Prairie County, MT",Jul-22,488,476,12,2.50000000
CN3008100000000,30,081,"Ravalli County, MT",Jul-22,22023,21445,578,2.60000000
CN3008300000000,30,083,"Richland County, MT",Jul-22,5674,5495,179,3.20000000
CN3008500000000,30,085,"Roosevelt County, MT",Jul-22,4216,4052,164,3.90000000
CN3008700000000,30,087,"Rosebud County, MT",Jul-22,3555,3416,139,3.90000000
CN3008900000000,30,089,"Sanders County, MT",Jul-22,5320,5118,202,3.80000000
CN3009100000000,30,091,"Sheridan County, MT",Jul-22,1712,1682,30,1.80000000
CN3009300000000,30,093,"Silver Bow County, MT",Jul-22,18375,17849,526,2.90000000
CN3009500000000,30,095,"Stillwater County, MT",Jul-22,5461,5343,118,2.20000000
CN3009700000000,30,097,"Sweet Grass County, MT",Jul-22,2010,1972,38,1.90000000
CN3009900000000,30,099,"Teton County, MT",Jul-22,2664,2591,73,2.70000000
CN3010100000000,30,101,"Toole County, MT",Jul-22,2104,2056,48,2.30000000
CN3010300000000,30,103,"Treasure County, MT",Jul-22,324,316,8,2.50000000
CN3010500000000,30,105,"Valley County, MT",Jul-22,4074,3983,91,2.20000000
CN3010700000000,30,107,"Wheatland County, MT",Jul-22,682,659,23,3.40000000
CN3010900000000,30,109,"Wibaux County, MT",Jul-22,414,403,11,2.70000000
CN3011100000000,30,111,"Yellowstone County, MT",Jul-22,88397,86107,2290,2.60000000
CN3100100000000,31,001,"Adams County, NE",Jul-22,17270,16859,411,2.40000000
CN3100300000000,31,003,"Antelope County, NE",Jul-22,3705,3638,67,1.80000000
CN3100500000000,31,005,"Arthur County, NE",Jul-22,234,229,5,2.10000000
CN3100700000000,31,007,"Banner County, NE",Jul-22,383,373,10,2.60000000
CN3100900000000,31,009,"Blaine County, NE",Jul-22,253,243,10,4.00000000
CN3101100000000,31,011,"Boone County, NE",Jul-22,2977,2922,55,1.80000000
CN3101300000000,31,013,"Box Butte County, NE",Jul-22,5434,5286,148,2.70000000
CN3101500000000,31,015,"Boyd County, NE",Jul-22,1019,995,24,2.40000000
CN3101700000000,31,017,"Brown County, NE",Jul-22,1467,1426,41,2.80000000
CN3101900000000,31,019,"Buffalo County, NE",Jul-22,27934,27351,583,2.10000000
CN3102100000000,31,021,"Burt County, NE",Jul-22,3620,3536,84,2.30000000
CN3102300000000,31,023,"Butler County, NE",Jul-22,4624,4536,88,1.90000000
CN3102500000000,31,025,"Cass County, NE",Jul-22,13958,13578,380,2.70000000
CN3102700000000,31,027,"Cedar County, NE",Jul-22,4748,4662,86,1.80000000
CN3102900000000,31,029,"Chase County, NE",Jul-22,2266,2218,48,2.10000000
CN3103100000000,31,031,"Cherry County, NE",Jul-22,3567,3507,60,1.70000000
CN3103300000000,31,033,"Cheyenne County, NE",Jul-22,4226,4111,115,2.70000000
CN3103500000000,31,035,"Clay County, NE",Jul-22,3308,3241,67,2.00000000
CN3103700000000,31,037,"Colfax County, NE",Jul-22,5795,5687,108,1.90000000
CN3103900000000,31,039,"Cuming County, NE",Jul-22,5032,4946,86,1.70000000
CN3104100000000,31,041,"Custer County, NE",Jul-22,6486,6383,103,1.60000000
CN3104300000000,31,043,"Dakota County, NE",Jul-22,11150,10729,421,3.80000000
CN3104500000000,31,045,"Dawes County, NE",Jul-22,5122,5010,112,2.20000000
CN3104700000000,31,047,"Dawson County, NE",Jul-22,13635,13279,356,2.60000000
CN3104900000000,31,049,"Deuel County, NE",Jul-22,1005,974,31,3.10000000
CN3105100000000,31,051,"Dixon County, NE",Jul-22,3046,2981,65,2.10000000
CN3105300000000,31,053,"Dodge County, NE",Jul-22,20780,20326,454,2.20000000
CN3105500000000,31,055,"Douglas County, NE",Jul-22,312152,302889,9263,3.00000000
CN3105700000000,31,057,"Dundy County, NE",Jul-22,1157,1138,19,1.60000000
CN3105900000000,31,059,"Fillmore County, NE",Jul-22,3380,3311,69,2.00000000
CN3106100000000,31,061,"Franklin County, NE",Jul-22,1521,1480,41,2.70000000
CN3106300000000,31,063,"Frontier County, NE",Jul-22,1533,1502,31,2.00000000
CN3106500000000,31,065,"Furnas County, NE",Jul-22,2609,2547,62,2.40000000
CN3106700000000,31,067,"Gage County, NE",Jul-22,11349,10902,447,3.90000000
CN3106900000000,31,069,"Garden County, NE",Jul-22,1169,1145,24,2.10000000
CN3107100000000,31,071,"Garfield County, NE",Jul-22,1180,1154,26,2.20000000
CN3107300000000,31,073,"Gosper County, NE",Jul-22,1241,1217,24,1.90000000
CN3107500000000,31,075,"Grant County, NE",Jul-22,414,407,7,1.70000000
CN3107700000000,31,077,"Greeley County, NE",Jul-22,1248,1219,29,2.30000000
CN3107900000000,31,079,"Hall County, NE",Jul-22,32486,31649,837,2.60000000
CN3108100000000,31,081,"Hamilton County, NE",Jul-22,4865,4772,93,1.90000000
CN3108300000000,31,083,"Harlan County, NE",Jul-22,1854,1821,33,1.80000000
CN3108500000000,31,085,"Hayes County, NE",Jul-22,599,592,7,1.20000000
CN3108700000000,31,087,"Hitchcock County, NE",Jul-22,1332,1306,26,2.00000000
CN3108900000000,31,089,"Holt County, NE",Jul-22,5779,5683,96,1.70000000
CN3109100000000,31,091,"Hooker County, NE",Jul-22,469,455,14,3.00000000
CN3109300000000,31,093,"Howard County, NE",Jul-22,3442,3375,67,1.90000000
CN3109500000000,31,095,"Jefferson County, NE",Jul-22,4224,4133,91,2.20000000
CN3109700000000,31,097,"Johnson County, NE",Jul-22,2052,1985,67,3.30000000
CN3109900000000,31,099,"Kearney County, NE",Jul-22,3807,3742,65,1.70000000
CN3110100000000,31,101,"Keith County, NE",Jul-22,4936,4840,96,1.90000000
CN3110300000000,31,103,"Keya Paha County, NE",Jul-22,587,573,14,2.40000000
CN3110500000000,31,105,"Kimball County, NE",Jul-22,1987,1954,33,1.70000000
CN3110700000000,31,107,"Knox County, NE",Jul-22,4812,4700,112,2.30000000
CN3110900000000,31,109,"Lancaster County, NE",Jul-22,181849,177768,4081,2.20000000
CN3111100000000,31,111,"Lincoln County, NE",Jul-22,18899,18416,483,2.60000000
CN3111300000000,31,113,"Logan County, NE",Jul-22,482,472,10,2.10000000
CN3111500000000,31,115,"Loup County, NE",Jul-22,422,410,12,2.80000000
CN3111700000000,31,117,"McPherson County, NE",Jul-22,427,420,7,1.60000000
CN3111900000000,31,119,"Madison County, NE",Jul-22,20146,19696,450,2.20000000
CN3112100000000,31,121,"Merrick County, NE",Jul-22,4144,4065,79,1.90000000
CN3112300000000,31,123,"Morrill County, NE",Jul-22,2668,2611,57,2.10000000
CN3112500000000,31,125,"Nance County, NE",Jul-22,1978,1937,41,2.10000000
CN3112700000000,31,127,"Nemaha County, NE",Jul-22,3597,3513,84,2.30000000
CN3112900000000,31,129,"Nuckolls County, NE",Jul-22,2519,2469,50,2.00000000
CN3113100000000,31,131,"Otoe County, NE",Jul-22,8757,8537,220,2.50000000
CN3113300000000,31,133,"Pawnee County, NE",Jul-22,1537,1496,41,2.70000000
CN3113500000000,31,135,"Perkins County, NE",Jul-22,1881,1852,29,1.50000000
CN3113700000000,31,137,"Phelps County, NE",Jul-22,5055,4947,108,2.10000000
CN3113900000000,31,139,"Pierce County, NE",Jul-22,4228,4140,88,2.10000000
CN3114100000000,31,141,"Platte County, NE",Jul-22,18630,18231,399,2.10000000
CN3114300000000,31,143,"Polk County, NE",Jul-22,2948,2891,57,1.90000000
CN3114500000000,31,145,"Red Willow County, NE",Jul-22,6018,5879,139,2.30000000
CN3114700000000,31,147,"Richardson County, NE",Jul-22,4306,4206,100,2.30000000
CN3114900000000,31,149,"Rock County, NE",Jul-22,897,883,14,1.60000000
CN3115100000000,31,151,"Saline County, NE",Jul-22,7329,7126,203,2.80000000
CN3115300000000,31,153,"Sarpy County, NE",Jul-22,101328,99021,2307,2.30000000
CN3115500000000,31,155,"Saunders County, NE",Jul-22,11807,11561,246,2.10000000
CN3115700000000,31,157,"Scotts Bluff County, NE",Jul-22,18124,17576,548,3.00000000
CN3115900000000,31,159,"Seward County, NE",Jul-22,9036,8809,227,2.50000000
CN3116100000000,31,161,"Sheridan County, NE",Jul-22,2821,2759,62,2.20000000
CN3116300000000,31,163,"Sherman County, NE",Jul-22,1713,1670,43,2.50000000
CN3116500000000,31,165,"Sioux County, NE",Jul-22,781,767,14,1.80000000
CN3116700000000,31,167,"Stanton County, NE",Jul-22,3670,3591,79,2.20000000
CN3116900000000,31,169,"Thayer County, NE",Jul-22,2746,2691,55,2.00000000
CN3117100000000,31,171,"Thomas County, NE",Jul-22,433,423,10,2.30000000
CN3117300000000,31,173,"Thurston County, NE",Jul-22,3228,3058,170,5.30000000
CN3117500000000,31,175,"Valley County, NE",Jul-22,2188,2135,53,2.40000000
CN3117700000000,31,177,"Washington County, NE",Jul-22,11688,11418,270,2.30000000
CN3117900000000,31,179,"Wayne County, NE",Jul-22,5445,5297,148,2.70000000
CN3118100000000,31,181,"Webster County, NE",Jul-22,1690,1652,38,2.20000000
CN3118300000000,31,183,"Wheeler County, NE",Jul-22,562,555,7,1.20000000
CN3118500000000,31,185,"York County, NE",Jul-22,7586,7407,179,2.40000000
CN3200100000000,32,001,"Churchill County, NV",Jul-22,10873,10504,369,3.40000000
CN3200300000000,32,003,"Clark County, NV",Jul-22,1133617,1070630,62987,5.60000000
CN3200500000000,32,005,"Douglas County, NV",Jul-22,21495,20684,811,3.80000000
CN3200700000000,32,007,"Elko County, NV",Jul-22,25794,24986,808,3.10000000
CN3200900000000,32,009,"Esmeralda County, NV",Jul-22,389,373,16,4.10000000
CN3201100000000,32,011,"Eureka County, NV",Jul-22,883,857,26,2.90000000
CN3201300000000,32,013,"Humboldt County, NV",Jul-22,7676,7433,243,3.20000000
CN3201500000000,32,015,"Lander County, NV",Jul-22,3056,2959,97,3.20000000
CN3201700000000,32,017,"Lincoln County, NV",Jul-22,2045,1962,83,4.10000000
CN3201900000000,32,019,"Lyon County, NV",Jul-22,23453,22407,1046,4.50000000
CN3202100000000,32,021,"Mineral County, NV",Jul-22,2060,1982,78,3.80000000
CN3202300000000,32,023,"Nye County, NV",Jul-22,17074,16133,941,5.50000000
CN3202700000000,32,027,"Pershing County, NV",Jul-22,2340,2259,81,3.50000000
CN3202900000000,32,029,"Storey County, NV",Jul-22,2080,2002,78,3.80000000
CN3203100000000,32,031,"Washoe County, NV",Jul-22,254372,246253,8119,3.20000000
CN3203300000000,32,033,"White Pine County, NV",Jul-22,4563,4433,130,2.80000000
CN3251000000000,32,510,"Carson City, NV",Jul-22,25729,24811,918,3.60000000
CN3300100000000,33,001,"Belknap County, NH",Jul-22,33412,32845,567,1.70000000
CN3300300000000,33,003,"Carroll County, NH",Jul-22,24920,24491,429,1.70000000
CN3300500000000,33,005,"Cheshire County, NH",Jul-22,38804,37966,838,2.20000000
CN3300700000000,33,007,"Coos County, NH",Jul-22,14643,14211,432,3.00000000
CN3300900000000,33,009,"Grafton County, NH",Jul-22,49535,48632,903,1.80000000
CN3301100000000,33,011,"Hillsborough County, NH",Jul-22,245124,240316,4808,2.00000000
CN3301300000000,33,013,"Merrimack County, NH",Jul-22,83284,81830,1454,1.70000000
CN3301500000000,33,015,"Rockingham County, NH",Jul-22,192277,188529,3748,1.90000000
CN3301700000000,33,017,"Strafford County, NH",Jul-22,74194,72779,1415,1.90000000
CN3301900000000,33,019,"Sullivan County, NH",Jul-22,22993,22549,444,1.90000000
CN3400100000000,34,001,"Atlantic County, NJ",Jul-22,130479,124025,6454,4.90000000
CN3400300000000,34,003,"Bergen County, NJ",Jul-22,490815,473497,17318,3.50000000
CN3400500000000,34,005,"Burlington County, NJ",Jul-22,246461,238455,8006,3.20000000
CN3400700000000,34,007,"Camden County, NJ",Jul-22,270054,258822,11232,4.20000000
CN3400900000000,34,009,"Cape May County, NJ",Jul-22,58021,55703,2318,4.00000000
CN3401100000000,34,011,"Cumberland County, NJ",Jul-22,66277,62745,3532,5.30000000
CN3401300000000,34,013,"Essex County, NJ",Jul-22,384653,366166,18487,4.80000000
CN3401500000000,34,015,"Gloucester County, NJ",Jul-22,160716,154785,5931,3.70000000
CN3401700000000,34,017,"Hudson County, NJ",Jul-22,367923,353514,14409,3.90000000
CN3401900000000,34,019,"Hunterdon County, NJ",Jul-22,67001,65150,1851,2.80000000
CN3402100000000,34,021,"Mercer County, NJ",Jul-22,210572,203779,6793,3.20000000
CN3402300000000,34,023,"Middlesex County, NJ",Jul-22,459774,444341,15433,3.40000000
CN3402500000000,34,025,"Monmouth County, NJ",Jul-22,344613,333519,11094,3.20000000
CN3402700000000,34,027,"Morris County, NJ",Jul-22,265134,257361,7773,2.90000000
CN3402900000000,34,029,"Ocean County, NJ",Jul-22,295206,284803,10403,3.50000000
CN3403100000000,34,031,"Passaic County, NJ",Jul-22,246908,234651,12257,5.00000000
CN3403300000000,34,033,"Salem County, NJ",Jul-22,29733,28261,1472,5.00000000
CN3403500000000,34,035,"Somerset County, NJ",Jul-22,176892,171611,5281,3.00000000
CN3403700000000,34,037,"Sussex County, NJ",Jul-22,76483,73719,2764,3.60000000
CN3403900000000,34,039,"Union County, NJ",Jul-22,286372,275029,11343,4.00000000
CN3404100000000,34,041,"Warren County, NJ",Jul-22,58408,56396,2012,3.40000000
CN3500100000000,35,001,"Bernalillo County, NM",Jul-22,333651,319657,13994,4.20000000
CN3500300000000,35,003,"Catron County, NM",Jul-22,1205,1143,62,5.10000000
CN3500500000000,35,005,"Chaves County, NM",Jul-22,27791,26389,1402,5.00000000
CN3500600000000,35,006,"Cibola County, NM",Jul-22,8457,7914,543,6.40000000
CN3500700000000,35,007,"Colfax County, NM",Jul-22,5130,4899,231,4.50000000
CN3500900000000,35,009,"Curry County, NM",Jul-22,22293,21515,778,3.50000000
CN3501100000000,35,011,"De Baca County, NM",Jul-22,687,663,24,3.50000000
CN3501300000000,35,013,"Dona Ana County, NM",Jul-22,97856,92975,4881,5.00000000
CN3501500000000,35,015,"Eddy County, NM",Jul-22,30859,29626,1233,4.00000000
CN3501700000000,35,017,"Grant County, NM",Jul-22,11445,10899,546,4.80000000
CN3501900000000,35,019,"Guadalupe County, NM",Jul-22,1803,1706,97,5.40000000
CN3502100000000,35,021,"Harding County, NM",Jul-22,285,276,9,3.20000000
CN3502300000000,35,023,"Hidalgo County, NM",Jul-22,1969,1901,68,3.50000000
CN3502500000000,35,025,"Lea County, NM",Jul-22,27540,25899,1641,6.00000000
CN3502700000000,35,027,"Lincoln County, NM",Jul-22,8913,8499,414,4.60000000
CN3502800000000,35,028,"Los Alamos County, NM",Jul-22,10304,10059,245,2.40000000
CN3502900000000,35,029,"Luna County, NM",Jul-22,10739,9741,998,9.30000000
CN3503100000000,35,031,"McKinley County, NM",Jul-22,23736,22175,1561,6.60000000
CN3503300000000,35,033,"Mora County, NM",Jul-22,2065,1944,121,5.90000000
CN3503500000000,35,035,"Otero County, NM",Jul-22,25592,24408,1184,4.60000000
CN3503700000000,35,037,"Quay County, NM",Jul-22,2871,2725,146,5.10000000
CN3503900000000,35,039,"Rio Arriba County, NM",Jul-22,16517,15692,825,5.00000000
CN3504100000000,35,041,"Roosevelt County, NM",Jul-22,8283,7943,340,4.10000000
CN3504300000000,35,043,"Sandoval County, NM",Jul-22,67584,64527,3057,4.50000000
CN3504500000000,35,045,"San Juan County, NM",Jul-22,48469,45735,2734,5.60000000
CN3504700000000,35,047,"San Miguel County, NM",Jul-22,10754,10144,610,5.70000000
CN3504900000000,35,049,"Santa Fe County, NM",Jul-22,73081,70103,2978,4.10000000
CN3505100000000,35,051,"Sierra County, NM",Jul-22,4118,3875,243,5.90000000
CN3505300000000,35,053,"Socorro County, NM",Jul-22,6126,5843,283,4.60000000
CN3505500000000,35,055,"Taos County, NM",Jul-22,14838,13985,853,5.70000000
CN3505700000000,35,057,"Torrance County, NM",Jul-22,5376,5034,342,6.40000000
CN3505900000000,35,059,"Union County, NM",Jul-22,1592,1545,47,3.00000000
CN3506100000000,35,061,"Valencia County, NM",Jul-22,30899,29352,1547,5.00000000
CN3600100000000,36,001,"Albany County, NY",Jul-22,160313,154970,5343,3.30000000
CN3600300000000,36,003,"Allegany County, NY",Jul-22,18300,17527,773,4.20000000
CN3600500000000,36,005,"Bronx County, NY",Jul-22,593380,539765,53615,9.00000000
CN3600700000000,36,007,"Broome County, NY",Jul-22,83419,80011,3408,4.10000000
CN3600900000000,36,009,"Cattaraugus County, NY",Jul-22,32555,31178,1377,4.20000000
CN3601100000000,36,011,"Cayuga County, NY",Jul-22,35814,34533,1281,3.60000000
CN3601300000000,36,013,"Chautauqua County, NY",Jul-22,53120,50925,2195,4.10000000
CN3601500000000,36,015,"Chemung County, NY",Jul-22,35085,33701,1384,3.90000000
CN3601700000000,36,017,"Chenango County, NY",Jul-22,21566,20853,713,3.30000000
CN3601900000000,36,019,"Clinton County, NY",Jul-22,34997,33706,1291,3.70000000
CN3602100000000,36,021,"Columbia County, NY",Jul-22,30831,29950,881,2.90000000
CN3602300000000,36,023,"Cortland County, NY",Jul-22,22032,21159,873,4.00000000
CN3602500000000,36,025,"Delaware County, NY",Jul-22,18308,17597,711,3.90000000
CN3602700000000,36,027,"Dutchess County, NY",Jul-22,146904,142050,4854,3.30000000
CN3602900000000,36,029,"Erie County, NY",Jul-22,448303,430538,17765,4.00000000
CN3603100000000,36,031,"Essex County, NY",Jul-22,18144,17584,560,3.10000000
CN3603300000000,36,033,"Franklin County, NY",Jul-22,19331,18637,694,3.60000000
CN3603500000000,36,035,"Fulton County, NY",Jul-22,22386,21469,917,4.10000000
CN3603700000000,36,037,"Genesee County, NY",Jul-22,30439,29528,911,3.00000000
CN3603900000000,36,039,"Greene County, NY",Jul-22,20376,19636,740,3.60000000
CN3604100000000,36,041,"Hamilton County, NY",Jul-22,2690,2619,71,2.60000000
CN3604300000000,36,043,"Herkimer County, NY",Jul-22,27980,26890,1090,3.90000000
CN3604500000000,36,045,"Jefferson County, NY",Jul-22,45856,44102,1754,3.80000000
CN3604700000000,36,047,"Kings County, NY",Jul-22,1182953,1102691,80262,6.80000000
CN3604900000000,36,049,"Lewis County, NY",Jul-22,11781,11356,425,3.60000000
CN3605100000000,36,051,"Livingston County, NY",Jul-22,30467,29445,1022,3.40000000
CN3605300000000,36,053,"Madison County, NY",Jul-22,33125,31989,1136,3.40000000
CN3605500000000,36,055,"Monroe County, NY",Jul-22,366550,352325,14225,3.90000000
CN3605700000000,36,057,"Montgomery County, NY",Jul-22,22020,21071,949,4.30000000
CN3605900000000,36,059,"Nassau County, NY",Jul-22,740630,717116,23514,3.20000000
CN3606100000000,36,061,"New York County, NY",Jul-22,896229,849742,46487,5.20000000
CN3606300000000,36,063,"Niagara County, NY",Jul-22,98929,94896,4033,4.10000000
CN3606500000000,36,065,"Oneida County, NY",Jul-22,102599,98689,3910,3.80000000
CN3606700000000,36,067,"Onondaga County, NY",Jul-22,225495,217408,8087,3.60000000
CN3606900000000,36,069,"Ontario County, NY",Jul-22,55981,54256,1725,3.10000000
CN3607100000000,36,071,"Orange County, NY",Jul-22,192929,186197,6732,3.50000000
CN3607300000000,36,073,"Orleans County, NY",Jul-22,17362,16644,718,4.10000000
CN3607500000000,36,075,"Oswego County, NY",Jul-22,53236,50941,2295,4.30000000
CN3607700000000,36,077,"Otsego County, NY",Jul-22,27625,26662,963,3.50000000
CN3607900000000,36,079,"Putnam County, NY",Jul-22,52093,50431,1662,3.20000000
CN3608100000000,36,081,"Queens County, NY",Jul-22,1115411,1048260,67151,6.00000000
CN3608300000000,36,083,"Rensselaer County, NY",Jul-22,82628,79931,2697,3.30000000
CN3608500000000,36,085,"Richmond County, NY",Jul-22,222266,208137,14129,6.40000000
CN3608700000000,36,087,"Rockland County, NY",Jul-22,161117,155999,5118,3.20000000
CN3608900000000,36,089,"St. Lawrence County, NY",Jul-22,42145,40199,1946,4.60000000
CN3609100000000,36,091,"Saratoga County, NY",Jul-22,122172,118761,3411,2.80000000
CN3609300000000,36,093,"Schenectady County, NY",Jul-22,78381,75542,2839,3.60000000
CN3609500000000,36,095,"Schoharie County, NY",Jul-22,14875,14348,527,3.50000000
CN3609700000000,36,097,"Schuyler County, NY",Jul-22,8348,8080,268,3.20000000
CN3609900000000,36,099,"Seneca County, NY",Jul-22,15654,15188,466,3.00000000
CN3610100000000,36,101,"Steuben County, NY",Jul-22,41089,39596,1493,3.60000000
CN3610300000000,36,103,"Suffolk County, NY",Jul-22,813433,785785,27648,3.40000000
CN3610500000000,36,105,"Sullivan County, NY",Jul-22,39957,38666,1291,3.20000000
CN3610700000000,36,107,"Tioga County, NY",Jul-22,22523,21801,722,3.20000000
CN3610900000000,36,109,"Tompkins County, NY",Jul-22,49341,47775,1566,3.20000000
CN3611100000000,36,111,"Ulster County, NY",Jul-22,88656,85658,2998,3.40000000
CN3611300000000,36,113,"Warren County, NY",Jul-22,32419,31394,1025,3.20000000
CN3611500000000,36,115,"Washington County, NY",Jul-22,28709,27802,907,3.20000000
CN3611700000000,36,117,"Wayne County, NY",Jul-22,43705,42280,1425,3.30000000
CN3611900000000,36,119,"Westchester County, NY",Jul-22,501759,484330,17429,3.50000000
CN3612100000000,36,121,"Wyoming County, NY",Jul-22,18476,17922,554,3.00000000
CN3612300000000,36,123,"Yates County, NY",Jul-22,11783,11451,332,2.80000000
CN3700100000000,37,001,"Alamance County, NC",Jul-22,83697,80500,3197,3.80000000
CN3700300000000,37,003,"Alexander County, NC",Jul-22,17824,17275,549,3.10000000
CN3700500000000,37,005,"Alleghany County, NC",Jul-22,4420,4260,160,3.60000000
CN3700700000000,37,007,"Anson County, NC",Jul-22,10224,9747,477,4.70000000
CN3700900000000,37,009,"Ashe County, NC",Jul-22,13000,12581,419,3.20000000
CN3701100000000,37,011,"Avery County, NC",Jul-22,7929,7690,239,3.00000000
CN3701300000000,37,013,"Beaufort County, NC",Jul-22,19882,19130,752,3.80000000
CN3701500000000,37,015,"Bertie County, NC",Jul-22,7341,6982,359,4.90000000
CN3701700000000,37,017,"Bladen County, NC",Jul-22,14217,13579,638,4.50000000
CN3701900000000,37,019,"Brunswick County, NC",Jul-22,58436,55906,2530,4.30000000
CN3702100000000,37,021,"Buncombe County, NC",Jul-22,141713,137639,4074,2.90000000
CN3702300000000,37,023,"Burke County, NC",Jul-22,40456,39100,1356,3.40000000
CN3702500000000,37,025,"Cabarrus County, NC",Jul-22,116175,112240,3935,3.40000000
CN3702700000000,37,027,"Caldwell County, NC",Jul-22,36056,34777,1279,3.50000000
CN3702900000000,37,029,"Camden County, NC",Jul-22,4554,4400,154,3.40000000
CN3703100000000,37,031,"Carteret County, NC",Jul-22,33138,32111,1027,3.10000000
CN3703300000000,37,033,"Caswell County, NC",Jul-22,9814,9411,403,4.10000000
CN3703500000000,37,035,"Catawba County, NC",Jul-22,78713,76007,2706,3.40000000
CN3703700000000,37,037,"Chatham County, NC",Jul-22,38315,37198,1117,2.90000000
CN3703900000000,37,039,"Cherokee County, NC",Jul-22,10937,10506,431,3.90000000
CN3704100000000,37,041,"Chowan County, NC",Jul-22,5705,5479,226,4.00000000
CN3704300000000,37,043,"Clay County, NC",Jul-22,3994,3834,160,4.00000000
CN3704500000000,37,045,"Cleveland County, NC",Jul-22,48135,46197,1938,4.00000000
CN3704700000000,37,047,"Columbus County, NC",Jul-22,23666,22599,1067,4.50000000
CN3704900000000,37,049,"Craven County, NC",Jul-22,41638,40139,1499,3.60000000
CN3705100000000,37,051,"Cumberland County, NC",Jul-22,127928,120784,7144,5.60000000
CN3705300000000,37,053,"Currituck County, NC",Jul-22,14806,14339,467,3.20000000
CN3705500000000,37,055,"Dare County, NC",Jul-22,23066,22347,719,3.10000000
CN3705700000000,37,057,"Davidson County, NC",Jul-22,81027,78216,2811,3.50000000
CN3705900000000,37,059,"Davie County, NC",Jul-22,20648,19967,681,3.30000000
CN3706100000000,37,061,"Duplin County, NC",Jul-22,24294,23385,909,3.70000000
CN3706300000000,37,063,"Durham County, NC",Jul-22,183457,177871,5586,3.00000000
CN3706500000000,37,065,"Edgecombe County, NC",Jul-22,20202,18702,1500,7.40000000
CN3706700000000,37,067,"Forsyth County, NC",Jul-22,187950,180753,7197,3.80000000
CN3706900000000,37,069,"Franklin County, NC",Jul-22,34020,32805,1215,3.60000000
CN3707100000000,37,071,"Gaston County, NC",Jul-22,114820,110559,4261,3.70000000
CN3707300000000,37,073,"Gates County, NC",Jul-22,5177,5000,177,3.40000000
CN3707500000000,37,075,"Graham County, NC",Jul-22,3096,2939,157,5.10000000
CN3707700000000,37,077,"Granville County, NC",Jul-22,30522,29533,989,3.20000000
CN3707900000000,37,079,"Greene County, NC",Jul-22,9364,9063,301,3.20000000
CN3708100000000,37,081,"Guilford County, NC",Jul-22,260514,249259,11255,4.30000000
CN3708300000000,37,083,"Halifax County, NC",Jul-22,18927,17745,1182,6.20000000
CN3708500000000,37,085,"Harnett County, NC",Jul-22,54763,52481,2282,4.20000000
CN3708700000000,37,087,"Haywood County, NC",Jul-22,30098,29198,900,3.00000000
CN3708900000000,37,089,"Henderson County, NC",Jul-22,55381,53706,1675,3.00000000
CN3709100000000,37,091,"Hertford County, NC",Jul-22,8496,8034,462,5.40000000
CN3709300000000,37,093,"Hoke County, NC",Jul-22,20280,19229,1051,5.20000000
CN3709500000000,37,095,"Hyde County, NC",Jul-22,1942,1857,85,4.40000000
CN3709700000000,37,097,"Iredell County, NC",Jul-22,94690,91495,3195,3.40000000
CN3709900000000,37,099,"Jackson County, NC",Jul-22,19913,19144,769,3.90000000
CN3710100000000,37,101,"Johnston County, NC",Jul-22,108158,104616,3542,3.30000000
CN3710300000000,37,103,"Jones County, NC",Jul-22,4268,4130,138,3.20000000
CN3710500000000,37,105,"Lee County, NC",Jul-22,26154,25060,1094,4.20000000
CN3710700000000,37,107,"Lenoir County, NC",Jul-22,27136,26134,1002,3.70000000
CN3710900000000,37,109,"Lincoln County, NC",Jul-22,46412,44976,1436,3.10000000
CN3711100000000,37,111,"McDowell County, NC",Jul-22,19782,19104,678,3.40000000
CN3711300000000,37,113,"Macon County, NC",Jul-22,15965,15447,518,3.20000000
CN3711500000000,37,115,"Madison County, NC",Jul-22,10058,9724,334,3.30000000
CN3711700000000,37,117,"Martin County, NC",Jul-22,8494,8125,369,4.30000000
CN3711900000000,37,119,"Mecklenburg County, NC",Jul-22,652981,629972,23009,3.50000000
CN3712100000000,37,121,"Mitchell County, NC",Jul-22,5989,5753,236,3.90000000
CN3712300000000,37,123,"Montgomery County, NC",Jul-22,11442,11017,425,3.70000000
CN3712500000000,37,125,"Moore County, NC",Jul-22,40535,39033,1502,3.70000000
CN3712700000000,37,127,"Nash County, NC",Jul-22,41978,39726,2252,5.40000000
CN3712900000000,37,129,"New Hanover County, NC",Jul-22,127785,123673,4112,3.20000000
CN3713100000000,37,131,"Northampton County, NC",Jul-22,7089,6743,346,4.90000000
CN3713300000000,37,133,"Onslow County, NC",Jul-22,66051,63173,2878,4.40000000
CN3713500000000,37,135,"Orange County, NC",Jul-22,83713,81111,2602,3.10000000
CN3713700000000,37,137,"Pamlico County, NC",Jul-22,5434,5250,184,3.40000000
CN3713900000000,37,139,"Pasquotank County, NC",Jul-22,16340,15598,742,4.50000000
CN3714100000000,37,141,"Pender County, NC",Jul-22,30349,29311,1038,3.40000000
CN3714300000000,37,143,"Perquimans County, NC",Jul-22,4856,4646,210,4.30000000
CN3714500000000,37,145,"Person County, NC",Jul-22,19279,18581,698,3.60000000
CN3714700000000,37,147,"Pitt County, NC",Jul-22,87918,84124,3794,4.30000000
CN3714900000000,37,149,"Polk County, NC",Jul-22,9515,9177,338,3.60000000
CN3715100000000,37,151,"Randolph County, NC",Jul-22,65248,62895,2353,3.60000000
CN3715300000000,37,153,"Richmond County, NC",Jul-22,16386,15460,926,5.70000000
CN3715500000000,37,155,"Robeson County, NC",Jul-22,48302,45311,2991,6.20000000
CN3715700000000,37,157,"Rockingham County, NC",Jul-22,39423,37802,1621,4.10000000
CN3715900000000,37,159,"Rowan County, NC",Jul-22,67795,65350,2445,3.60000000
CN3716100000000,37,161,"Rutherford County, NC",Jul-22,23896,22652,1244,5.20000000
CN3716300000000,37,163,"Sampson County, NC",Jul-22,28231,27148,1083,3.80000000
CN3716500000000,37,165,"Scotland County, NC",Jul-22,10793,9974,819,7.60000000
CN3716700000000,37,167,"Stanly County, NC",Jul-22,30577,29572,1005,3.30000000
CN3716900000000,37,169,"Stokes County, NC",Jul-22,21528,20838,690,3.20000000
CN3717100000000,37,171,"Surry County, NC",Jul-22,31959,30846,1113,3.50000000
CN3717300000000,37,173,"Swain County, NC",Jul-22,7448,7233,215,2.90000000
CN3717500000000,37,175,"Transylvania County, NC",Jul-22,15282,14813,469,3.10000000
CN3717700000000,37,177,"Tyrrell County, NC",Jul-22,1498,1429,69,4.60000000
CN3717900000000,37,179,"Union County, NC",Jul-22,130523,126352,4171,3.20000000
CN3718100000000,37,181,"Vance County, NC",Jul-22,16745,15678,1067,6.40000000
CN3718300000000,37,183,"Wake County, NC",Jul-22,631815,612651,19164,3.00000000
CN3718500000000,37,185,"Warren County, NC",Jul-22,6539,6104,435,6.70000000
CN3718700000000,37,187,"Washington County, NC",Jul-22,4387,4154,233,5.30000000
CN3718900000000,37,189,"Watauga County, NC",Jul-22,29546,28542,1004,3.40000000
CN3719100000000,37,191,"Wayne County, NC",Jul-22,51346,49288,2058,4.00000000
CN3719300000000,37,193,"Wilkes County, NC",Jul-22,26730,25706,1024,3.80000000
CN3719500000000,37,195,"Wilson County, NC",Jul-22,32796,30871,1925,5.90000000
CN3719700000000,37,197,"Yadkin County, NC",Jul-22,17516,16963,553,3.20000000
CN3719900000000,37,199,"Yancey County, NC",Jul-22,8287,8011,276,3.30000000
CN3800100000000,38,001,"Adams County, ND",Jul-22,936,916,20,2.10000000
CN3800300000000,38,003,"Barnes County, ND",Jul-22,5100,4973,127,2.50000000
CN3800500000000,38,005,"Benson County, ND",Jul-22,2169,2104,65,3.00000000
CN3800700000000,38,007,"Billings County, ND",Jul-22,574,565,9,1.60000000
CN3800900000000,38,009,"Bottineau County, ND",Jul-22,3052,2960,92,3.00000000
CN3801100000000,38,011,"Bowman County, ND",Jul-22,1562,1537,25,1.60000000
CN3801300000000,38,013,"Burke County, ND",Jul-22,988,967,21,2.10000000
CN3801500000000,38,015,"Burleigh County, ND",Jul-22,53750,52756,994,1.80000000
CN3801700000000,38,017,"Cass County, ND",Jul-22,110696,108842,1854,1.70000000
CN3801900000000,38,019,"Cavalier County, ND",Jul-22,1824,1787,37,2.00000000
CN3802100000000,38,021,"Dickey County, ND",Jul-22,2215,2175,40,1.80000000
CN3802300000000,38,023,"Divide County, ND",Jul-22,1441,1425,16,1.10000000
CN3802500000000,38,025,"Dunn County, ND",Jul-22,3086,3042,44,1.40000000
CN3802700000000,38,027,"Eddy County, ND",Jul-22,1132,1099,33,2.90000000
CN3802900000000,38,029,"Emmons County, ND",Jul-22,1396,1349,47,3.40000000
CN3803100000000,38,031,"Foster County, ND",Jul-22,1492,1466,26,1.70000000
CN3803300000000,38,033,"Golden Valley County, ND",Jul-22,814,801,13,1.60000000
CN3803500000000,38,035,"Grand Forks County, ND",Jul-22,38289,37549,740,1.90000000
CN3803700000000,38,037,"Grant County, ND",Jul-22,1140,1116,24,2.10000000
CN3803900000000,38,039,"Griggs County, ND",Jul-22,969,953,16,1.70000000
CN3804100000000,38,041,"Hettinger County, ND",Jul-22,1351,1322,29,2.10000000
CN3804300000000,38,043,"Kidder County, ND",Jul-22,1281,1236,45,3.50000000
CN3804500000000,38,045,"LaMoure County, ND",Jul-22,1960,1924,36,1.80000000
CN3804700000000,38,047,"Logan County, ND",Jul-22,824,810,14,1.70000000
CN3804900000000,38,049,"McHenry County, ND",Jul-22,3055,2972,83,2.70000000
CN3805100000000,38,051,"McIntosh County, ND",Jul-22,1052,1032,20,1.90000000
CN3805300000000,38,053,"McKenzie County, ND",Jul-22,8897,8689,208,2.30000000
CN3805500000000,38,055,"McLean County, ND",Jul-22,4740,4589,151,3.20000000
CN3805700000000,38,057,"Mercer County, ND",Jul-22,3798,3671,127,3.30000000
CN3805900000000,38,059,"Morton County, ND",Jul-22,17575,17176,399,2.30000000
CN3806100000000,38,061,"Mountrail County, ND",Jul-22,6222,6113,109,1.80000000
CN3806300000000,38,063,"Nelson County, ND",Jul-22,1428,1383,45,3.20000000
CN3806500000000,38,065,"Oliver County, ND",Jul-22,897,869,28,3.10000000
CN3806700000000,38,067,"Pembina County, ND",Jul-22,3185,3071,114,3.60000000
CN3806900000000,38,069,"Pierce County, ND",Jul-22,1667,1626,41,2.50000000
CN3807100000000,38,071,"Ramsey County, ND",Jul-22,5854,5737,117,2.00000000
CN3807300000000,38,073,"Ransom County, ND",Jul-22,2675,2635,40,1.50000000
CN3807500000000,38,075,"Renville County, ND",Jul-22,1148,1124,24,2.10000000
CN3807700000000,38,077,"Richland County, ND",Jul-22,8716,8542,174,2.00000000
CN3807900000000,38,079,"Rolette County, ND",Jul-22,4669,4091,578,12.40000000
CN3808100000000,38,081,"Sargent County, ND",Jul-22,2396,2356,40,1.70000000
CN3808300000000,38,083,"Sheridan County, ND",Jul-22,635,621,14,2.20000000
CN3808500000000,38,085,"Sioux County, ND",Jul-22,1270,1224,46,3.60000000
CN3808700000000,38,087,"Slope County, ND",Jul-22,334,327,7,2.10000000
CN3808900000000,38,089,"Stark County, ND",Jul-22,18073,17706,367,2.00000000
CN3809100000000,38,091,"Steele County, ND",Jul-22,902,882,20,2.20000000
CN3809300000000,38,093,"Stutsman County, ND",Jul-22,10498,10286,212,2.00000000
CN3809500000000,38,095,"Towner County, ND",Jul-22,1087,1064,23,2.10000000
CN3809700000000,38,097,"Traill County, ND",Jul-22,4331,4219,112,2.60000000
CN3809900000000,38,099,"Walsh County, ND",Jul-22,5159,4973,186,3.60000000
CN3810100000000,38,101,"Ward County, ND",Jul-22,32341,31623,718,2.20000000
CN3810300000000,38,103,"Wells County, ND",Jul-22,1891,1842,49,2.60000000
CN3810500000000,38,105,"Williams County, ND",Jul-22,21505,20909,596,2.80000000
CN3900100000000,39,001,"Adams County, OH",Jul-22,11107,10505,602,5.40000000
CN3900300000000,39,003,"Allen County, OH",Jul-22,47604,45553,2051,4.30000000
CN3900500000000,39,005,"Ashland County, OH",Jul-22,27027,26036,991,3.70000000
CN3900700000000,39,007,"Ashtabula County, OH",Jul-22,44043,42100,1943,4.40000000
CN3900900000000,39,009,"Athens County, OH",Jul-22,24251,22849,1402,5.80000000
CN3901100000000,39,011,"Auglaize County, OH",Jul-22,24953,24156,797,3.20000000
CN3901300000000,39,013,"Belmont County, OH",Jul-22,28053,26642,1411,5.00000000
CN3901500000000,39,015,"Brown County, OH",Jul-22,19452,18517,935,4.80000000
CN3901700000000,39,017,"Butler County, OH",Jul-22,197424,189394,8030,4.10000000
CN3901900000000,39,019,"Carroll County, OH",Jul-22,12773,12206,567,4.40000000
CN3902100000000,39,021,"Champaign County, OH",Jul-22,19532,18757,775,4.00000000
CN3902300000000,39,023,"Clark County, OH",Jul-22,63101,60176,2925,4.60000000
CN3902500000000,39,025,"Clermont County, OH",Jul-22,108177,103818,4359,4.00000000
CN3902700000000,39,027,"Clinton County, OH",Jul-22,18018,17197,821,4.60000000
CN3902900000000,39,029,"Columbiana County, OH",Jul-22,46544,44229,2315,5.00000000
CN3903100000000,39,031,"Coshocton County, OH",Jul-22,13848,13113,735,5.30000000
CN3903300000000,39,033,"Crawford County, OH",Jul-22,18133,17106,1027,5.70000000
CN3903500000000,39,035,"Cuyahoga County, OH",Jul-22,618415,584694,33721,5.50000000
CN3903700000000,39,037,"Darke County, OH",Jul-22,26037,25102,935,3.60000000
CN3903900000000,39,039,"Defiance County, OH",Jul-22,17883,17132,751,4.20000000
CN3904100000000,39,041,"Delaware County, OH",Jul-22,117058,113274,3784,3.20000000
CN3904300000000,39,043,"Erie County, OH",Jul-22,39476,37570,1906,4.80000000
CN3904500000000,39,045,"Fairfield County, OH",Jul-22,81442,78303,3139,3.90000000
CN3904700000000,39,047,"Fayette County, OH",Jul-22,13786,13234,552,4.00000000
CN3904900000000,39,049,"Franklin County, OH",Jul-22,719207,692055,27152,3.80000000
CN3905100000000,39,051,"Fulton County, OH",Jul-22,22461,21485,976,4.30000000
CN3905300000000,39,053,"Gallia County, OH",Jul-22,11925,11314,611,5.10000000
CN3905500000000,39,055,"Geauga County, OH",Jul-22,49359,47352,2007,4.10000000
CN3905700000000,39,057,"Greene County, OH",Jul-22,83602,80382,3220,3.90000000
CN3905900000000,39,059,"Guernsey County, OH",Jul-22,18096,17234,862,4.80000000
CN3906100000000,39,061,"Hamilton County, OH",Jul-22,418268,400993,17275,4.10000000
CN3906300000000,39,063,"Hancock County, OH",Jul-22,40984,39597,1387,3.40000000
CN3906500000000,39,065,"Hardin County, OH",Jul-22,12845,12207,638,5.00000000
CN3906700000000,39,067,"Harrison County, OH",Jul-22,6647,6330,317,4.80000000
CN3906900000000,39,069,"Henry County, OH",Jul-22,13159,12592,567,4.30000000
CN3907100000000,39,071,"Highland County, OH",Jul-22,17447,16587,860,4.90000000
CN3907300000000,39,073,"Hocking County, OH",Jul-22,13098,12557,541,4.10000000
CN3907500000000,39,075,"Holmes County, OH",Jul-22,22060,21440,620,2.80000000
CN3907700000000,39,077,"Huron County, OH",Jul-22,28484,26927,1557,5.50000000
CN3907900000000,39,079,"Jackson County, OH",Jul-22,12500,11852,648,5.20000000
CN3908100000000,39,081,"Jefferson County, OH",Jul-22,27402,25754,1648,6.00000000
CN3908300000000,39,083,"Knox County, OH",Jul-22,31191,30031,1160,3.70000000
CN3908500000000,39,085,"Lake County, OH",Jul-22,127918,122246,5672,4.40000000
CN3908700000000,39,087,"Lawrence County, OH",Jul-22,23372,22178,1194,5.10000000
CN3908900000000,39,089,"Licking County, OH",Jul-22,93278,89738,3540,3.80000000
CN3909100000000,39,091,"Logan County, OH",Jul-22,22537,21723,814,3.60000000
CN3909300000000,39,093,"Lorain County, OH",Jul-22,158437,149744,8693,5.50000000
CN3909500000000,39,095,"Lucas County, OH",Jul-22,211095,201253,9842,4.70000000
CN3909700000000,39,097,"Madison County, OH",Jul-22,21206,20489,717,3.40000000
CN3909900000000,39,099,"Mahoning County, OH",Jul-22,99682,94543,5139,5.20000000
CN3910100000000,39,101,"Marion County, OH",Jul-22,28863,27003,1860,6.40000000
CN3910300000000,39,103,"Medina County, OH",Jul-22,100108,95971,4137,4.10000000
CN3910500000000,39,105,"Meigs County, OH",Jul-22,8690,8162,528,6.10000000
CN3910700000000,39,107,"Mercer County, OH",Jul-22,23416,22775,641,2.70000000
CN3910900000000,39,109,"Miami County, OH",Jul-22,54246,52279,1967,3.60000000
CN3911100000000,39,111,"Monroe County, OH",Jul-22,5202,4874,328,6.30000000
CN3911300000000,39,113,"Montgomery County, OH",Jul-22,250697,239352,11345,4.50000000
CN3911500000000,39,115,"Morgan County, OH",Jul-22,6851,6508,343,5.00000000
CN3911700000000,39,117,"Morrow County, OH",Jul-22,17253,16516,737,4.30000000
CN3911900000000,39,119,"Muskingum County, OH",Jul-22,40896,39156,1740,4.30000000
CN3912100000000,39,121,"Noble County, OH",Jul-22,4630,4362,268,5.80000000
CN3912300000000,39,123,"Ottawa County, OH",Jul-22,22274,21314,960,4.30000000
CN3912500000000,39,125,"Paulding County, OH",Jul-22,8795,8472,323,3.70000000
CN3912700000000,39,127,"Perry County, OH",Jul-22,16155,15417,738,4.60000000
CN3912900000000,39,129,"Pickaway County, OH",Jul-22,27107,26072,1035,3.80000000
CN3913100000000,39,131,"Pike County, OH",Jul-22,11260,10669,591,5.20000000
CN3913300000000,39,133,"Portage County, OH",Jul-22,85437,82002,3435,4.00000000
CN3913500000000,39,135,"Preble County, OH",Jul-22,22129,21342,787,3.60000000
CN3913700000000,39,137,"Putnam County, OH",Jul-22,19307,18743,564,2.90000000
CN3913900000000,39,139,"Richland County, OH",Jul-22,52063,49565,2498,4.80000000
CN3914100000000,39,141,"Ross County, OH",Jul-22,35493,34121,1372,3.90000000
CN3914300000000,39,143,"Sandusky County, OH",Jul-22,31181,29707,1474,4.70000000
CN3914500000000,39,145,"Scioto County, OH",Jul-22,29343,27755,1588,5.40000000
CN3914700000000,39,147,"Seneca County, OH",Jul-22,27127,25948,1179,4.30000000
CN3914900000000,39,149,"Shelby County, OH",Jul-22,24304,23424,880,3.60000000
CN3915100000000,39,151,"Stark County, OH",Jul-22,183864,176182,7682,4.20000000
CN3915300000000,39,153,"Summit County, OH",Jul-22,266531,254759,11772,4.40000000
CN3915500000000,39,155,"Trumbull County, OH",Jul-22,84170,79726,4444,5.30000000
CN3915700000000,39,157,"Tuscarawas County, OH",Jul-22,45511,43813,1698,3.70000000
CN3915900000000,39,159,"Union County, OH",Jul-22,30541,29545,996,3.30000000
CN3916100000000,39,161,"Van Wert County, OH",Jul-22,15043,14530,513,3.40000000
CN3916300000000,39,163,"Vinton County, OH",Jul-22,5544,5261,283,5.10000000
CN3916500000000,39,165,"Warren County, OH",Jul-22,122530,118095,4435,3.60000000
CN3916700000000,39,167,"Washington County, OH",Jul-22,27315,26016,1299,4.80000000
CN3916900000000,39,169,"Wayne County, OH",Jul-22,60473,58474,1999,3.30000000
CN3917100000000,39,171,"Williams County, OH",Jul-22,18640,17968,672,3.60000000
CN3917300000000,39,173,"Wood County, OH",Jul-22,71899,69314,2585,3.60000000
CN3917500000000,39,175,"Wyandot County, OH",Jul-22,13288,12861,427,3.20000000
CN4000100000000,40,001,"Adair County, OK",Jul-22,8350,8030,320,3.80000000
CN4000300000000,40,003,"Alfalfa County, OK",Jul-22,2648,2598,50,1.90000000
CN4000500000000,40,005,"Atoka County, OK",Jul-22,4886,4675,211,4.30000000
CN4000700000000,40,007,"Beaver County, OK",Jul-22,2670,2621,49,1.80000000
CN4000900000000,40,009,"Beckham County, OK",Jul-22,9256,8958,298,3.20000000
CN4001100000000,40,011,"Blaine County, OK",Jul-22,4533,4413,120,2.60000000
CN4001300000000,40,013,"Bryan County, OK",Jul-22,23165,22507,658,2.80000000
CN4001500000000,40,015,"Caddo County, OK",Jul-22,11565,11159,406,3.50000000
CN4001700000000,40,017,"Canadian County, OK",Jul-22,80981,78829,2152,2.70000000
CN4001900000000,40,019,"Carter County, OK",Jul-22,21352,20562,790,3.70000000
CN4002100000000,40,021,"Cherokee County, OK",Jul-22,20276,19464,812,4.00000000
CN4002300000000,40,023,"Choctaw County, OK",Jul-22,5981,5671,310,5.20000000
CN4002500000000,40,025,"Cimarron County, OK",Jul-22,1669,1649,20,1.20000000
CN4002700000000,40,027,"Cleveland County, OK",Jul-22,148546,144621,3925,2.60000000
CN4002900000000,40,029,"Coal County, OK",Jul-22,2138,2049,89,4.20000000
CN4003100000000,40,031,"Comanche County, OK",Jul-22,47605,45777,1828,3.80000000
CN4003300000000,40,033,"Cotton County, OK",Jul-22,2750,2670,80,2.90000000
CN4003500000000,40,035,"Craig County, OK",Jul-22,5961,5760,201,3.40000000
CN4003700000000,40,037,"Creek County, OK",Jul-22,32088,30925,1163,3.60000000
CN4003900000000,40,039,"Custer County, OK",Jul-22,14538,14103,435,3.00000000
CN4004100000000,40,041,"Delaware County, OK",Jul-22,19862,19281,581,2.90000000
CN4004300000000,40,043,"Dewey County, OK",Jul-22,2865,2805,60,2.10000000
CN4004500000000,40,045,"Ellis County, OK",Jul-22,2074,2022,52,2.50000000
CN4004700000000,40,047,"Garfield County, OK",Jul-22,27319,26521,798,2.90000000
CN4004900000000,40,049,"Garvin County, OK",Jul-22,12692,12312,380,3.00000000
CN4005100000000,40,051,"Grady County, OK",Jul-22,27698,26908,790,2.90000000
CN4005300000000,40,053,"Grant County, OK",Jul-22,2972,2919,53,1.80000000
CN4005500000000,40,055,"Greer County, OK",Jul-22,1882,1802,80,4.30000000
CN4005700000000,40,057,"Harmon County, OK",Jul-22,1191,1162,29,2.40000000
CN4005900000000,40,059,"Harper County, OK",Jul-22,1862,1825,37,2.00000000
CN4006100000000,40,061,"Haskell County, OK",Jul-22,3889,3697,192,4.90000000
CN4006300000000,40,063,"Hughes County, OK",Jul-22,4960,4739,221,4.50000000
CN4006500000000,40,065,"Jackson County, OK",Jul-22,10432,10141,291,2.80000000
CN4006700000000,40,067,"Jefferson County, OK",Jul-22,2388,2299,89,3.70000000
CN4006900000000,40,069,"Johnston County, OK",Jul-22,3601,3459,142,3.90000000
CN4007100000000,40,071,"Kay County, OK",Jul-22,18599,17903,696,3.70000000
CN4007300000000,40,073,"Kingfisher County, OK",Jul-22,9067,8883,184,2.00000000
CN4007500000000,40,075,"Kiowa County, OK",Jul-22,3729,3606,123,3.30000000
CN4007700000000,40,077,"Latimer County, OK",Jul-22,3070,2848,222,7.20000000
CN4007900000000,40,079,"Le Flore County, OK",Jul-22,19682,18860,822,4.20000000
CN4008100000000,40,081,"Lincoln County, OK",Jul-22,16402,15886,516,3.10000000
CN4008300000000,40,083,"Logan County, OK",Jul-22,23583,22925,658,2.80000000
CN4008500000000,40,085,"Love County, OK",Jul-22,5927,5775,152,2.60000000
CN4008700000000,40,087,"McClain County, OK",Jul-22,21260,20673,587,2.80000000
CN4008900000000,40,089,"McCurtain County, OK",Jul-22,15930,15236,694,4.40000000
CN4009100000000,40,091,"McIntosh County, OK",Jul-22,7251,6826,425,5.90000000
CN4009300000000,40,093,"Major County, OK",Jul-22,3858,3770,88,2.30000000
CN4009500000000,40,095,"Marshall County, OK",Jul-22,7344,7119,225,3.10000000
CN4009700000000,40,097,"Mayes County, OK",Jul-22,19384,18738,646,3.30000000
CN4009900000000,40,099,"Murray County, OK",Jul-22,6160,5955,205,3.30000000
CN4010100000000,40,101,"Muskogee County, OK",Jul-22,28022,26929,1093,3.90000000
CN4010300000000,40,103,"Noble County, OK",Jul-22,5654,5526,128,2.30000000
CN4010500000000,40,105,"Nowata County, OK",Jul-22,4549,4407,142,3.10000000
CN4010700000000,40,107,"Okfuskee County, OK",Jul-22,4356,4172,184,4.20000000
CN4010900000000,40,109,"Oklahoma County, OK",Jul-22,399470,386942,12528,3.10000000
CN4011100000000,40,111,"Okmulgee County, OK",Jul-22,16012,15300,712,4.40000000
CN4011300000000,40,113,"Osage County, OK",Jul-22,21051,20261,790,3.80000000
CN4011500000000,40,115,"Ottawa County, OK",Jul-22,14830,14370,460,3.10000000
CN4011700000000,40,117,"Pawnee County, OK",Jul-22,7576,7288,288,3.80000000
CN4011900000000,40,119,"Payne County, OK",Jul-22,38482,37294,1188,3.10000000
CN4012100000000,40,121,"Pittsburg County, OK",Jul-22,15796,15008,788,5.00000000
CN4012300000000,40,123,"Pontotoc County, OK",Jul-22,18766,18192,574,3.10000000
CN4012500000000,40,125,"Pottawatomie County, OK",Jul-22,32081,30849,1232,3.80000000
CN4012700000000,40,127,"Pushmataha County, OK",Jul-22,4647,4455,192,4.10000000
CN4012900000000,40,129,"Roger Mills County, OK",Jul-22,1754,1705,49,2.80000000
CN4013100000000,40,131,"Rogers County, OK",Jul-22,46378,44978,1400,3.00000000
CN4013300000000,40,133,"Seminole County, OK",Jul-22,8836,8409,427,4.80000000
CN4013500000000,40,135,"Sequoyah County, OK",Jul-22,16871,16253,618,3.70000000
CN4013700000000,40,137,"Stephens County, OK",Jul-22,18343,17709,634,3.50000000
CN4013900000000,40,139,"Texas County, OK",Jul-22,11934,11700,234,2.00000000
CN4014100000000,40,141,"Tillman County, OK",Jul-22,2926,2824,102,3.50000000
CN4014300000000,40,143,"Tulsa County, OK",Jul-22,332340,321824,10516,3.20000000
CN4014500000000,40,145,"Wagoner County, OK",Jul-22,39936,38679,1257,3.10000000
CN4014700000000,40,147,"Washington County, OK",Jul-22,22397,21615,782,3.50000000
CN4014900000000,40,149,"Washita County, OK",Jul-22,4877,4699,178,3.60000000
CN4015100000000,40,151,"Woods County, OK",Jul-22,4756,4660,96,2.00000000
CN4015300000000,40,153,"Woodward County, OK",Jul-22,8617,8342,275,3.20000000
CN4100100000000,41,001,"Baker County, OR",Jul-22,7535,7235,300,4.00000000
CN4100300000000,41,003,"Benton County, OR",Jul-22,47712,46037,1675,3.50000000
CN4100500000000,41,005,"Clackamas County, OR",Jul-22,231789,223689,8100,3.50000000
CN4100700000000,41,007,"Clatsop County, OR",Jul-22,20352,19535,817,4.00000000
CN4100900000000,41,009,"Columbia County, OR",Jul-22,25573,24436,1137,4.40000000
CN4101100000000,41,011,"Coos County, OR",Jul-22,26473,25068,1405,5.30000000
CN4101300000000,41,013,"Crook County, OR",Jul-22,11555,10970,585,5.10000000
CN4101500000000,41,015,"Curry County, OR",Jul-22,9351,8871,480,5.10000000
CN4101700000000,41,017,"Deschutes County, OR",Jul-22,105122,101200,3922,3.70000000
CN4101900000000,41,019,"Douglas County, OR",Jul-22,47901,45513,2388,5.00000000
CN4102100000000,41,021,"Gilliam County, OR",Jul-22,903,870,33,3.70000000
CN4102300000000,41,023,"Grant County, OR",Jul-22,3220,3071,149,4.60000000
CN4102500000000,41,025,"Harney County, OR",Jul-22,3828,3679,149,3.90000000
CN4102700000000,41,027,"Hood River County, OR",Jul-22,16033,15571,462,2.90000000
CN4102900000000,41,029,"Jackson County, OR",Jul-22,107783,102972,4811,4.50000000
CN4103100000000,41,031,"Jefferson County, OR",Jul-22,10689,10157,532,5.00000000
CN4103300000000,41,033,"Josephine County, OR",Jul-22,37302,35314,1988,5.30000000
CN4103500000000,41,035,"Klamath County, OR",Jul-22,30129,28428,1701,5.60000000
CN4103700000000,41,037,"Lake County, OR",Jul-22,3830,3650,180,4.70000000
CN4103900000000,41,039,"Lane County, OR",Jul-22,183620,175537,8083,4.40000000
CN4104100000000,41,041,"Lincoln County, OR",Jul-22,21809,20693,1116,5.10000000
CN4104300000000,41,043,"Linn County, OR",Jul-22,61706,58987,2719,4.40000000
CN4104500000000,41,045,"Malheur County, OR",Jul-22,12691,12160,531,4.20000000
CN4104700000000,41,047,"Marion County, OR",Jul-22,171351,164417,6934,4.00000000
CN4104900000000,41,049,"Morrow County, OR",Jul-22,6145,5909,236,3.80000000
CN4105100000000,41,051,"Multnomah County, OR",Jul-22,478297,460142,18155,3.80000000
CN4105300000000,41,053,"Polk County, OR",Jul-22,42840,41137,1703,4.00000000
CN4105500000000,41,055,"Sherman County, OR",Jul-22,986,958,28,2.80000000
CN4105700000000,41,057,"Tillamook County, OR",Jul-22,12914,12405,509,3.90000000
CN4105900000000,41,059,"Umatilla County, OR",Jul-22,38471,36902,1569,4.10000000
CN4106100000000,41,061,"Union County, OR",Jul-22,12338,11841,497,4.00000000
CN4106300000000,41,063,"Wallowa County, OR",Jul-22,3855,3712,143,3.70000000
CN4106500000000,41,065,"Wasco County, OR",Jul-22,18183,17673,510,2.80000000
CN4106700000000,41,067,"Washington County, OR",Jul-22,341343,330372,10971,3.20000000
CN4106900000000,41,069,"Wheeler County, OR",Jul-22,729,709,20,2.70000000
CN4107100000000,41,071,"Yamhill County, OR",Jul-22,57850,55760,2090,3.60000000
CN4200100000000,42,001,"Adams County, PA",Jul-22,55448,53508,1940,3.50000000
CN4200300000000,42,003,"Allegheny County, PA",Jul-22,639624,611314,28310,4.40000000
CN4200500000000,42,005,"Armstrong County, PA",Jul-22,31629,29907,1722,5.40000000
CN4200700000000,42,007,"Beaver County, PA",Jul-22,83071,78341,4730,5.70000000
CN4200900000000,42,009,"Bedford County, PA",Jul-22,24000,22943,1057,4.40000000
CN4201100000000,42,011,"Berks County, PA",Jul-22,212756,202740,10016,4.70000000
CN4201300000000,42,013,"Blair County, PA",Jul-22,60297,57465,2832,4.70000000
CN4201500000000,42,015,"Bradford County, PA",Jul-22,28180,26965,1215,4.30000000
CN4201700000000,42,017,"Bucks County, PA",Jul-22,350360,336597,13763,3.90000000
CN4201900000000,42,019,"Butler County, PA",Jul-22,99946,95722,4224,4.20000000
CN4202100000000,42,021,"Cambria County, PA",Jul-22,55656,52329,3327,6.00000000
CN4202300000000,42,023,"Cameron County, PA",Jul-22,2008,1891,117,5.80000000
CN4202500000000,42,025,"Carbon County, PA",Jul-22,33027,31280,1747,5.30000000
CN4202700000000,42,027,"Centre County, PA",Jul-22,74644,71746,2898,3.90000000
CN4202900000000,42,029,"Chester County, PA",Jul-22,295948,286056,9892,3.30000000
CN4203100000000,42,031,"Clarion County, PA",Jul-22,16518,15658,860,5.20000000
CN4203300000000,42,033,"Clearfield County, PA",Jul-22,35238,33343,1895,5.40000000
CN4203500000000,42,035,"Clinton County, PA",Jul-22,17047,16156,891,5.20000000
CN4203700000000,42,037,"Columbia County, PA",Jul-22,32957,31382,1575,4.80000000
CN4203900000000,42,039,"Crawford County, PA",Jul-22,37754,35847,1907,5.10000000
CN4204100000000,42,041,"Cumberland County, PA",Jul-22,138953,134050,4903,3.50000000
CN4204300000000,42,043,"Dauphin County, PA",Jul-22,150325,143983,6342,4.20000000
CN4204500000000,42,045,"Delaware County, PA",Jul-22,298917,285405,13512,4.50000000
CN4204700000000,42,047,"Elk County, PA",Jul-22,14995,14178,817,5.40000000
CN4204900000000,42,049,"Erie County, PA",Jul-22,127493,120814,6679,5.20000000
CN4205100000000,42,051,"Fayette County, PA",Jul-22,56027,52365,3662,6.50000000
CN4205300000000,42,053,"Forest County, PA",Jul-22,1746,1622,124,7.10000000
CN4205500000000,42,055,"Franklin County, PA",Jul-22,78520,75505,3015,3.80000000
CN4205700000000,42,057,"Fulton County, PA",Jul-22,7241,6932,309,4.30000000
CN4205900000000,42,059,"Greene County, PA",Jul-22,15444,14519,925,6.00000000
CN4206100000000,42,061,"Huntingdon County, PA",Jul-22,19344,18245,1099,5.70000000
CN4206300000000,42,063,"Indiana County, PA",Jul-22,35863,33729,2134,6.00000000
CN4206500000000,42,065,"Jefferson County, PA",Jul-22,19841,18899,942,4.70000000
CN4206700000000,42,067,"Juniata County, PA",Jul-22,12863,12346,517,4.00000000
CN4206900000000,42,069,"Lackawanna County, PA",Jul-22,105078,99665,5413,5.20000000
CN4207100000000,42,071,"Lancaster County, PA",Jul-22,289924,279047,10877,3.80000000
CN4207300000000,42,073,"Lawrence County, PA",Jul-22,39512,37343,2169,5.50000000
CN4207500000000,42,075,"Lebanon County, PA",Jul-22,74381,71430,2951,4.00000000
CN4207700000000,42,077,"Lehigh County, PA",Jul-22,200235,190917,9318,4.70000000
CN4207900000000,42,079,"Luzerne County, PA",Jul-22,158356,149138,9218,5.80000000
CN4208100000000,42,081,"Lycoming County, PA",Jul-22,54422,51722,2700,5.00000000
CN4208300000000,42,083,"McKean County, PA",Jul-22,16729,15789,940,5.60000000
CN4208500000000,42,085,"Mercer County, PA",Jul-22,48163,45520,2643,5.50000000
CN4208700000000,42,087,"Mifflin County, PA",Jul-22,20933,19913,1020,4.90000000
CN4208900000000,42,089,"Monroe County, PA",Jul-22,83620,78464,5156,6.20000000
CN4209100000000,42,091,"Montgomery County, PA",Jul-22,465966,448994,16972,3.60000000
CN4209300000000,42,093,"Montour County, PA",Jul-22,8962,8624,338,3.80000000
CN4209500000000,42,095,"Northampton County, PA",Jul-22,166608,159279,7329,4.40000000
CN4209700000000,42,097,"Northumberland County, PA",Jul-22,42277,40120,2157,5.10000000
CN4209900000000,42,099,"Perry County, PA",Jul-22,25474,24536,938,3.70000000
CN4210100000000,42,101,"Philadelphia County/city, PA",Jul-22,725809,680533,45276,6.20000000
CN4210300000000,42,103,"Pike County, PA",Jul-22,26146,24624,1522,5.80000000
CN4210500000000,42,105,"Potter County, PA",Jul-22,7253,6862,391,5.40000000
CN4210700000000,42,107,"Schuylkill County, PA",Jul-22,65277,61752,3525,5.40000000
CN4210900000000,42,109,"Snyder County, PA",Jul-22,19565,18711,854,4.40000000
CN4211100000000,42,111,"Somerset County, PA",Jul-22,32430,30650,1780,5.50000000
CN4211300000000,42,113,"Sullivan County, PA",Jul-22,2633,2492,141,5.40000000
CN4211500000000,42,115,"Susquehanna County, PA",Jul-22,20720,19891,829,4.00000000
CN4211700000000,42,117,"Tioga County, PA",Jul-22,18971,17968,1003,5.30000000
CN4211900000000,42,119,"Union County, PA",Jul-22,19548,18756,792,4.10000000
CN4212100000000,42,121,"Venango County, PA",Jul-22,21504,20379,1125,5.20000000
CN4212300000000,42,123,"Warren County, PA",Jul-22,17720,16876,844,4.80000000
CN4212500000000,42,125,"Washington County, PA",Jul-22,106256,101061,5195,4.90000000
CN4212700000000,42,127,"Wayne County, PA",Jul-22,23753,22632,1121,4.70000000
CN4212900000000,42,129,"Westmoreland County, PA",Jul-22,178152,169687,8465,4.80000000
CN4213100000000,42,131,"Wyoming County, PA",Jul-22,13543,12874,669,4.90000000
CN4213300000000,42,133,"York County, PA",Jul-22,240088,230287,9801,4.10000000
CN4400100000000,44,001,"Bristol County, RI",Jul-22,26961,26272,689,2.60000000
CN4400300000000,44,003,"Kent County, RI",Jul-22,95067,92461,2606,2.70000000
CN4400500000000,44,005,"Newport County, RI",Jul-22,45682,44579,1103,2.40000000
CN4400700000000,44,007,"Providence County, RI",Jul-22,339884,328230,11654,3.40000000
CN4400900000000,44,009,"Washington County, RI",Jul-22,71632,69845,1787,2.50000000
CN4500100000000,45,001,"Abbeville County, SC",Jul-22,9119,8750,369,4.00000000
CN4500300000000,45,003,"Aiken County, SC",Jul-22,74310,72141,2169,2.90000000
CN4500500000000,45,005,"Allendale County, SC",Jul-22,2314,2164,150,6.50000000
CN4500700000000,45,007,"Anderson County, SC",Jul-22,91246,88521,2725,3.00000000
CN4500900000000,45,009,"Bamberg County, SC",Jul-22,4372,4093,279,6.40000000
CN4501100000000,45,011,"Barnwell County, SC",Jul-22,7495,7118,377,5.00000000
CN4501300000000,45,013,"Beaufort County, SC",Jul-22,78621,76292,2329,3.00000000
CN4501500000000,45,015,"Berkeley County, SC",Jul-22,111391,108198,3193,2.90000000
CN4501700000000,45,017,"Calhoun County, SC",Jul-22,6354,6130,224,3.50000000
CN4501900000000,45,019,"Charleston County, SC",Jul-22,218765,212916,5849,2.70000000
CN4502100000000,45,021,"Cherokee County, SC",Jul-22,23604,22602,1002,4.20000000
CN4502300000000,45,023,"Chester County, SC",Jul-22,13532,12904,628,4.60000000
CN4502500000000,45,025,"Chesterfield County, SC",Jul-22,21337,20593,744,3.50000000
CN4502700000000,45,027,"Clarendon County, SC",Jul-22,11881,11409,472,4.00000000
CN4502900000000,45,029,"Colleton County, SC",Jul-22,16011,15468,543,3.40000000
CN4503100000000,45,031,"Darlington County, SC",Jul-22,29328,28232,1096,3.70000000
CN4503300000000,45,033,"Dillon County, SC",Jul-22,12411,11795,616,5.00000000
CN4503500000000,45,035,"Dorchester County, SC",Jul-22,80823,78577,2246,2.80000000
CN4503700000000,45,037,"Edgefield County, SC",Jul-22,10425,10114,311,3.00000000
CN4503900000000,45,039,"Fairfield County, SC",Jul-22,9148,8702,446,4.90000000
CN4504100000000,45,041,"Florence County, SC",Jul-22,64887,62727,2160,3.30000000
CN4504300000000,45,043,"Georgetown County, SC",Jul-22,26633,25665,968,3.60000000
CN4504500000000,45,045,"Greenville County, SC",Jul-22,259205,252081,7124,2.70000000
CN4504700000000,45,047,"Greenwood County, SC",Jul-22,28633,27554,1079,3.80000000
CN4504900000000,45,049,"Hampton County, SC",Jul-22,7989,7746,243,3.00000000
CN4505100000000,45,051,"Horry County, SC",Jul-22,155541,150008,5533,3.60000000
CN4505300000000,45,053,"Jasper County, SC",Jul-22,13539,13140,399,2.90000000
CN4505500000000,45,055,"Kershaw County, SC",Jul-22,29065,28121,944,3.20000000
CN4505700000000,45,057,"Lancaster County, SC",Jul-22,43969,42421,1548,3.50000000
CN4505900000000,45,059,"Laurens County, SC",Jul-22,30027,29020,1007,3.40000000
CN4506100000000,45,061,"Lee County, SC",Jul-22,6379,6068,311,4.90000000
CN4506300000000,45,063,"Lexington County, SC",Jul-22,149534,145582,3952,2.60000000
CN4506500000000,45,065,"McCormick County, SC",Jul-22,3282,3157,125,3.80000000
CN4506700000000,45,067,"Marion County, SC",Jul-22,12782,12101,681,5.30000000
CN4506900000000,45,069,"Marlboro County, SC",Jul-22,8287,7689,598,7.20000000
CN4507100000000,45,071,"Newberry County, SC",Jul-22,19087,18566,521,2.70000000
CN4507300000000,45,073,"Oconee County, SC",Jul-22,33440,32395,1045,3.10000000
CN4507500000000,45,075,"Orangeburg County, SC",Jul-22,32335,30448,1887,5.80000000
CN4507700000000,45,077,"Pickens County, SC",Jul-22,57847,56038,1809,3.10000000
CN4507900000000,45,079,"Richland County, SC",Jul-22,195065,188543,6522,3.30000000
CN4508100000000,45,081,"Saluda County, SC",Jul-22,8354,8135,219,2.60000000
CN4508300000000,45,083,"Spartanburg County, SC",Jul-22,156833,151818,5015,3.20000000
CN4508500000000,45,085,"Sumter County, SC",Jul-22,41595,40030,1565,3.80000000
CN4508700000000,45,087,"Union County, SC",Jul-22,11507,10848,659,5.70000000
CN4508900000000,45,089,"Williamsburg County, SC",Jul-22,10870,10311,559,5.10000000
CN4509100000000,45,091,"York County, SC",Jul-22,149420,144806,4614,3.10000000
CN4600300000000,46,003,"Aurora County, SD",Jul-22,1501,1477,24,1.60000000
CN4600500000000,46,005,"Beadle County, SD",Jul-22,9364,9197,167,1.80000000
CN4600700000000,46,007,"Bennett County, SD",Jul-22,1092,1060,32,2.90000000
CN4600900000000,46,009,"Bon Homme County, SD",Jul-22,2922,2872,50,1.70000000
CN4601100000000,46,011,"Brookings County, SD",Jul-22,18674,18283,391,2.10000000
CN4601300000000,46,013,"Brown County, SD",Jul-22,20094,19643,451,2.20000000
CN4601500000000,46,015,"Brule County, SD",Jul-22,2782,2740,42,1.50000000
CN4601700000000,46,017,"Buffalo County, SD",Jul-22,774,712,62,8.00000000
CN4601900000000,46,019,"Butte County, SD",Jul-22,5058,4971,87,1.70000000
CN4602100000000,46,021,"Campbell County, SD",Jul-22,790,770,20,2.50000000
CN4602300000000,46,023,"Charles Mix County, SD",Jul-22,3937,3826,111,2.80000000
CN4602500000000,46,025,"Clark County, SD",Jul-22,2020,1980,40,2.00000000
CN4602700000000,46,027,"Clay County, SD",Jul-22,6942,6791,151,2.20000000
CN4602900000000,46,029,"Codington County, SD",Jul-22,16187,15893,294,1.80000000
CN4603100000000,46,031,"Corson County, SD",Jul-22,1273,1223,50,3.90000000
CN4603300000000,46,033,"Custer County, SD",Jul-22,4339,4228,111,2.60000000
CN4603500000000,46,035,"Davison County, SD",Jul-22,11180,10977,203,1.80000000
CN4603700000000,46,037,"Day County, SD",Jul-22,2775,2705,70,2.50000000
CN4603900000000,46,039,"Deuel County, SD",Jul-22,2470,2414,56,2.30000000
CN4604100000000,46,041,"Dewey County, SD",Jul-22,2398,2058,340,14.20000000
CN4604300000000,46,043,"Douglas County, SD",Jul-22,1558,1528,30,1.90000000
CN4604500000000,46,045,"Edmunds County, SD",Jul-22,2002,1970,32,1.60000000
CN4604700000000,46,047,"Fall River County, SD",Jul-22,3225,3151,74,2.30000000
CN4604900000000,46,049,"Faulk County, SD",Jul-22,1104,1082,22,2.00000000
CN4605100000000,46,051,"Grant County, SD",Jul-22,4431,4348,83,1.90000000
CN4605300000000,46,053,"Gregory County, SD",Jul-22,2164,2132,32,1.50000000
CN4605500000000,46,055,"Haakon County, SD",Jul-22,1084,1068,16,1.50000000
CN4605700000000,46,057,"Hamlin County, SD",Jul-22,3642,3580,62,1.70000000
CN4605900000000,46,059,"Hand County, SD",Jul-22,1801,1769,32,1.80000000
CN4606100000000,46,061,"Hanson County, SD",Jul-22,1795,1761,34,1.90000000
CN4606300000000,46,063,"Harding County, SD",Jul-22,743,729,14,1.90000000
CN4606500000000,46,065,"Hughes County, SD",Jul-22,10074,9925,149,1.50000000
CN4606700000000,46,067,"Hutchinson County, SD",Jul-22,3672,3604,68,1.90000000
CN4606900000000,46,069,"Hyde County, SD",Jul-22,681,663,18,2.60000000
CN4607100000000,46,071,"Jackson County, SD",Jul-22,1323,1295,28,2.10000000
CN4607300000000,46,073,"Jerauld County, SD",Jul-22,1453,1433,20,1.40000000
CN4607500000000,46,075,"Jones County, SD",Jul-22,593,579,14,2.40000000
CN4607700000000,46,077,"Kingsbury County, SD",Jul-22,2956,2904,52,1.80000000
CN4607900000000,46,079,"Lake County, SD",Jul-22,6644,6477,167,2.50000000
CN4608100000000,46,081,"Lawrence County, SD",Jul-22,14463,14205,258,1.80000000
CN4608300000000,46,083,"Lincoln County, SD",Jul-22,38390,37800,590,1.50000000
CN4608500000000,46,085,"Lyman County, SD",Jul-22,1810,1758,52,2.90000000
CN4608700000000,46,087,"McCook County, SD",Jul-22,3186,3138,48,1.50000000
CN4608900000000,46,089,"McPherson County, SD",Jul-22,998,966,32,3.20000000
CN4609100000000,46,091,"Marshall County, SD",Jul-22,2514,2446,68,2.70000000
CN4609300000000,46,093,"Meade County, SD",Jul-22,14899,14603,296,2.00000000
CN4609500000000,46,095,"Mellette County, SD",Jul-22,759,719,40,5.30000000
CN4609700000000,46,097,"Miner County, SD",Jul-22,1230,1208,22,1.80000000
CN4609900000000,46,099,"Minnehaha County, SD",Jul-22,119170,117139,2031,1.70000000
CN4610100000000,46,101,"Moody County, SD",Jul-22,4071,3916,155,3.80000000
CN4610200000000,46,102,"Oglala Lakota County, SD",Jul-22,3991,3633,358,9.00000000
CN4610300000000,46,103,"Pennington County, SD",Jul-22,61366,60184,1182,1.90000000
CN4610500000000,46,105,"Perkins County, SD",Jul-22,1469,1443,26,1.80000000
CN4610700000000,46,107,"Potter County, SD",Jul-22,1097,1071,26,2.40000000
CN4610900000000,46,109,"Roberts County, SD",Jul-22,4652,4495,157,3.40000000
CN4611100000000,46,111,"Sanborn County, SD",Jul-22,1212,1194,18,1.50000000
CN4611500000000,46,115,"Spink County, SD",Jul-22,3095,3029,66,2.10000000
CN4611700000000,46,117,"Stanley County, SD",Jul-22,1967,1931,36,1.80000000
CN4611900000000,46,119,"Sully County, SD",Jul-22,835,821,14,1.70000000
CN4612100000000,46,121,"Todd County, SD",Jul-22,3130,2951,179,5.70000000
CN4612300000000,46,123,"Tripp County, SD",Jul-22,3097,3051,46,1.50000000
CN4612500000000,46,125,"Turner County, SD",Jul-22,4879,4792,87,1.80000000
CN4612700000000,46,127,"Union County, SD",Jul-22,8683,8486,197,2.30000000
CN4612900000000,46,129,"Walworth County, SD",Jul-22,2227,2148,79,3.50000000
CN4613500000000,46,135,"Yankton County, SD",Jul-22,11860,11651,209,1.80000000
CN4613700000000,46,137,"Ziebach County, SD",Jul-22,936,874,62,6.60000000
CN4700100000000,47,001,"Anderson County, TN",Jul-22,35859,34515,1344,3.70000000
CN4700300000000,47,003,"Bedford County, TN",Jul-22,21429,20565,864,4.00000000
CN4700500000000,47,005,"Benton County, TN",Jul-22,6671,6358,313,4.70000000
CN4700700000000,47,007,"Bledsoe County, TN",Jul-22,4280,4017,263,6.10000000
CN4700900000000,47,009,"Blount County, TN",Jul-22,66592,64321,2271,3.40000000
CN4701100000000,47,011,"Bradley County, TN",Jul-22,50846,48779,2067,4.10000000
CN4701300000000,47,013,"Campbell County, TN",Jul-22,15264,14541,723,4.70000000
CN4701500000000,47,015,"Cannon County, TN",Jul-22,6947,6699,248,3.60000000
CN4701700000000,47,017,"Carroll County, TN",Jul-22,11285,10738,547,4.80000000
CN4701900000000,47,019,"Carter County, TN",Jul-22,24329,23332,997,4.10000000
CN4702100000000,47,021,"Cheatham County, TN",Jul-22,22884,22241,643,2.80000000
CN4702300000000,47,023,"Chester County, TN",Jul-22,8640,8349,291,3.40000000
CN4702500000000,47,025,"Claiborne County, TN",Jul-22,12906,12304,602,4.70000000
CN4702700000000,47,027,"Clay County, TN",Jul-22,2723,2573,150,5.50000000
CN4702900000000,47,029,"Cocke County, TN",Jul-22,14842,14026,816,5.50000000
CN4703100000000,47,031,"Coffee County, TN",Jul-22,25071,24098,973,3.90000000
CN4703300000000,47,033,"Crockett County, TN",Jul-22,6961,6714,247,3.50000000
CN4703500000000,47,035,"Cumberland County, TN",Jul-22,22476,21401,1075,4.80000000
CN4703700000000,47,037,"Davidson County, TN",Jul-22,416839,403542,13297,3.20000000
CN4703900000000,47,039,"Decatur County, TN",Jul-22,4258,4028,230,5.40000000
CN4704100000000,47,041,"DeKalb County, TN",Jul-22,7816,7458,358,4.60000000
CN4704300000000,47,043,"Dickson County, TN",Jul-22,28154,27244,910,3.20000000
CN4704500000000,47,045,"Dyer County, TN",Jul-22,15815,15146,669,4.20000000
CN4704700000000,47,047,"Fayette County, TN",Jul-22,19749,19000,749,3.80000000
CN4704900000000,47,049,"Fentress County, TN",Jul-22,7484,7143,341,4.60000000
CN4705100000000,47,051,"Franklin County, TN",Jul-22,19385,18612,773,4.00000000
CN4705300000000,47,053,"Gibson County, TN",Jul-22,21261,20334,927,4.40000000
CN4705500000000,47,055,"Giles County, TN",Jul-22,14620,14036,584,4.00000000
CN4705700000000,47,057,"Grainger County, TN",Jul-22,9944,9508,436,4.40000000
CN4705900000000,47,059,"Greene County, TN",Jul-22,28337,27019,1318,4.70000000
CN4706100000000,47,061,"Grundy County, TN",Jul-22,4959,4679,280,5.60000000
CN4706300000000,47,063,"Hamblen County, TN",Jul-22,28497,27335,1162,4.10000000
CN4706500000000,47,065,"Hamilton County, TN",Jul-22,185216,178124,7092,3.80000000
CN4706700000000,47,067,"Hancock County, TN",Jul-22,2249,2138,111,4.90000000
CN4706900000000,47,069,"Hardeman County, TN",Jul-22,8864,8388,476,5.40000000
CN4707100000000,47,071,"Hardin County, TN",Jul-22,9946,9470,476,4.80000000
CN4707300000000,47,073,"Hawkins County, TN",Jul-22,23369,22320,1049,4.50000000
CN4707500000000,47,075,"Haywood County, TN",Jul-22,7547,7104,443,5.90000000
CN4707700000000,47,077,"Henderson County, TN",Jul-22,11791,11300,491,4.20000000
CN4707900000000,47,079,"Henry County, TN",Jul-22,14349,13745,604,4.20000000
CN4708100000000,47,081,"Hickman County, TN",Jul-22,11889,11520,369,3.10000000
CN4708300000000,47,083,"Houston County, TN",Jul-22,3148,2989,159,5.10000000
CN4708500000000,47,085,"Humphreys County, TN",Jul-22,8545,8215,330,3.90000000
CN4708700000000,47,087,"Jackson County, TN",Jul-22,4725,4514,211,4.50000000
CN4708900000000,47,089,"Jefferson County, TN",Jul-22,25295,24303,992,3.90000000
CN4709100000000,47,091,"Johnson County, TN",Jul-22,7585,7320,265,3.50000000
CN4709300000000,47,093,"Knox County, TN",Jul-22,254892,246618,8274,3.20000000
CN4709500000000,47,095,"Lake County, TN",Jul-22,1606,1517,89,5.50000000
CN4709700000000,47,097,"Lauderdale County, TN",Jul-22,9545,8989,556,5.80000000
CN4709900000000,47,099,"Lawrence County, TN",Jul-22,19199,18421,778,4.10000000
CN4710100000000,47,101,"Lewis County, TN",Jul-22,5733,5492,241,4.20000000
CN4710300000000,47,103,"Lincoln County, TN",Jul-22,16051,15452,599,3.70000000
CN4710500000000,47,105,"Loudon County, TN",Jul-22,24782,23900,882,3.60000000
CN4710700000000,47,107,"McMinn County, TN",Jul-22,21567,20555,1012,4.70000000
CN4710900000000,47,109,"McNairy County, TN",Jul-22,8155,7693,462,5.70000000
CN4711100000000,47,111,"Macon County, TN",Jul-22,11881,11418,463,3.90000000
CN4711300000000,47,113,"Madison County, TN",Jul-22,49831,47768,2063,4.10000000
CN4711500000000,47,115,"Marion County, TN",Jul-22,12472,11899,573,4.60000000
CN4711700000000,47,117,"Marshall County, TN",Jul-22,15464,14869,595,3.80000000
CN4711900000000,47,119,"Maury County, TN",Jul-22,53520,51646,1874,3.50000000
CN4712100000000,47,121,"Meigs County, TN",Jul-22,5147,4850,297,5.80000000
CN4712300000000,47,123,"Monroe County, TN",Jul-22,21093,20248,845,4.00000000
CN4712500000000,47,125,"Montgomery County, TN",Jul-22,88009,84244,3765,4.30000000
CN4712700000000,47,127,"Moore County, TN",Jul-22,3565,3463,102,2.90000000
CN4712900000000,47,129,"Morgan County, TN",Jul-22,7950,7624,326,4.10000000
CN4713100000000,47,131,"Obion County, TN",Jul-22,12227,11599,628,5.10000000
CN4713300000000,47,133,"Overton County, TN",Jul-22,9923,9554,369,3.70000000
CN4713500000000,47,135,"Perry County, TN",Jul-22,2743,2571,172,6.30000000
CN4713700000000,47,137,"Pickett County, TN",Jul-22,2158,2062,96,4.40000000
CN4713900000000,47,139,"Polk County, TN",Jul-22,7138,6843,295,4.10000000
CN4714100000000,47,141,"Putnam County, TN",Jul-22,35000,33669,1331,3.80000000
CN4714300000000,47,143,"Rhea County, TN",Jul-22,13746,13014,732,5.30000000
CN4714500000000,47,145,"Roane County, TN",Jul-22,24145,23140,1005,4.20000000
CN4714700000000,47,147,"Robertson County, TN",Jul-22,39691,38334,1357,3.40000000
CN4714900000000,47,149,"Rutherford County, TN",Jul-22,197053,191031,6022,3.10000000
CN4715100000000,47,151,"Scott County, TN",Jul-22,8113,7642,471,5.80000000
CN4715300000000,47,153,"Sequatchie County, TN",Jul-22,6283,5983,300,4.80000000
CN4715500000000,47,155,"Sevier County, TN",Jul-22,58011,56313,1698,2.90000000
CN4715700000000,47,157,"Shelby County, TN",Jul-22,454271,427170,27101,6.00000000
CN4715900000000,47,159,"Smith County, TN",Jul-22,9868,9542,326,3.30000000
CN4716100000000,47,161,"Stewart County, TN",Jul-22,5350,5115,235,4.40000000
CN4716300000000,47,163,"Sullivan County, TN",Jul-22,69402,66622,2780,4.00000000
CN4716500000000,47,165,"Sumner County, TN",Jul-22,109755,106509,3246,3.00000000
CN4716700000000,47,167,"Tipton County, TN",Jul-22,28355,27187,1168,4.10000000
CN4716900000000,47,169,"Trousdale County, TN",Jul-22,5783,5590,193,3.30000000
CN4717100000000,47,171,"Unicoi County, TN",Jul-22,7153,6795,358,5.00000000
CN4717300000000,47,173,"Union County, TN",Jul-22,8040,7690,350,4.40000000
CN4717500000000,47,175,"Van Buren County, TN",Jul-22,2013,1911,102,5.10000000
CN4717700000000,47,177,"Warren County, TN",Jul-22,16674,15786,888,5.30000000
CN4717900000000,47,179,"Washington County, TN",Jul-22,61738,59504,2234,3.60000000
CN4718100000000,47,181,"Wayne County, TN",Jul-22,6319,5998,321,5.10000000
CN4718300000000,47,183,"Weakley County, TN",Jul-22,14884,14044,840,5.60000000
CN4718500000000,47,185,"White County, TN",Jul-22,11458,10985,473,4.10000000
CN4718700000000,47,187,"Williamson County, TN",Jul-22,139496,135906,3590,2.60000000
CN4718900000000,47,189,"Wilson County, TN",Jul-22,82613,80200,2413,2.90000000
CN4800100000000,48,001,"Anderson County, TX",Jul-22,23516,22649,867,3.70000000
CN4800300000000,48,003,"Andrews County, TX",Jul-22,8698,8364,334,3.80000000
CN4800500000000,48,005,"Angelina County, TX",Jul-22,35680,33857,1823,5.10000000
CN4800700000000,48,007,"Aransas County, TX",Jul-22,9370,8819,551,5.90000000
CN4800900000000,48,009,"Archer County, TX",Jul-22,4060,3919,141,3.50000000
CN4801100000000,48,011,"Armstrong County, TX",Jul-22,941,916,25,2.70000000
CN4801300000000,48,013,"Atascosa County, TX",Jul-22,22421,21390,1031,4.60000000
CN4801500000000,48,015,"Austin County, TX",Jul-22,14253,13645,608,4.30000000
CN4801700000000,48,017,"Bailey County, TX",Jul-22,2518,2400,118,4.70000000
CN4801900000000,48,019,"Bandera County, TX",Jul-22,10537,10141,396,3.80000000
CN4802100000000,48,021,"Bastrop County, TX",Jul-22,47091,45354,1737,3.70000000
CN4802300000000,48,023,"Baylor County, TX",Jul-22,1865,1814,51,2.70000000
CN4802500000000,48,025,"Bee County, TX",Jul-22,8826,8169,657,7.40000000
CN4802700000000,48,027,"Bell County, TX",Jul-22,148468,141286,7182,4.80000000
CN4802900000000,48,029,"Bexar County, TX",Jul-22,964165,925112,39053,4.10000000
CN4803100000000,48,031,"Blanco County, TX",Jul-22,7207,7001,206,2.90000000
CN4803300000000,48,033,"Borden County, TX",Jul-22,733,722,11,1.50000000
CN4803500000000,48,035,"Bosque County, TX",Jul-22,8828,8487,341,3.90000000
CN4803700000000,48,037,"Bowie County, TX",Jul-22,39227,37280,1947,5.00000000
CN4803900000000,48,039,"Brazoria County, TX",Jul-22,185553,175769,9784,5.30000000
CN4804100000000,48,041,"Brazos County, TX",Jul-22,119811,115692,4119,3.40000000
CN4804300000000,48,043,"Brewster County, TX",Jul-22,4165,4024,141,3.40000000
CN4804500000000,48,045,"Briscoe County, TX",Jul-22,603,583,20,3.30000000
CN4804700000000,48,047,"Brooks County, TX",Jul-22,2504,2326,178,7.10000000
CN4804900000000,48,049,"Brown County, TX",Jul-22,15027,14366,661,4.40000000
CN4805100000000,48,051,"Burleson County, TX",Jul-22,8350,8019,331,4.00000000
CN4805300000000,48,053,"Burnet County, TX",Jul-22,25223,24479,744,2.90000000
CN4805500000000,48,055,"Caldwell County, TX",Jul-22,20816,20000,816,3.90000000
CN4805700000000,48,057,"Calhoun County, TX",Jul-22,12211,11685,526,4.30000000
CN4805900000000,48,059,"Callahan County, TX",Jul-22,6194,5962,232,3.70000000
CN4806100000000,48,061,"Cameron County, TX",Jul-22,175888,163908,11980,6.80000000
CN4806300000000,48,063,"Camp County, TX",Jul-22,5246,4999,247,4.70000000
CN4806500000000,48,065,"Carson County, TX",Jul-22,3018,2927,91,3.00000000
CN4806700000000,48,067,"Cass County, TX",Jul-22,12269,11612,657,5.40000000
CN4806900000000,48,069,"Castro County, TX",Jul-22,3490,3387,103,3.00000000
CN4807100000000,48,071,"Chambers County, TX",Jul-22,21221,19854,1367,6.40000000
CN4807300000000,48,073,"Cherokee County, TX",Jul-22,20584,19593,991,4.80000000
CN4807500000000,48,075,"Childress County, TX",Jul-22,3071,2982,89,2.90000000
CN4807700000000,48,077,"Clay County, TX",Jul-22,4939,4743,196,4.00000000
CN4807900000000,48,079,"Cochran County, TX",Jul-22,1141,1081,60,5.30000000
CN4808100000000,48,081,"Coke County, TX",Jul-22,1416,1358,58,4.10000000
CN4808300000000,48,083,"Coleman County, TX",Jul-22,2995,2854,141,4.70000000
CN4808500000000,48,085,"Collin County, TX",Jul-22,628931,608152,20779,3.30000000
CN4808700000000,48,087,"Collingsworth County, TX",Jul-22,1131,1093,38,3.40000000
CN4808900000000,48,089,"Colorado County, TX",Jul-22,10456,10092,364,3.50000000
CN4809100000000,48,091,"Comal County, TX",Jul-22,81162,78136,3026,3.70000000
CN4809300000000,48,093,"Comanche County, TX",Jul-22,6337,6111,226,3.60000000
CN4809500000000,48,095,"Concho County, TX",Jul-22,1487,1444,43,2.90000000
CN4809700000000,48,097,"Cooke County, TX",Jul-22,19705,18990,715,3.60000000
CN4809900000000,48,099,"Coryell County, TX",Jul-22,24526,23357,1169,4.80000000
CN4810100000000,48,101,"Cottle County, TX",Jul-22,667,644,23,3.40000000
CN4810300000000,48,103,"Crane County, TX",Jul-22,1571,1471,100,6.40000000
CN4810500000000,48,105,"Crockett County, TX",Jul-22,1409,1343,66,4.70000000
CN4810700000000,48,107,"Crosby County, TX",Jul-22,2529,2409,120,4.70000000
CN4810900000000,48,109,"Culberson County, TX",Jul-22,1101,1067,34,3.10000000
CN4811100000000,48,111,"Dallam County, TX",Jul-22,3906,3811,95,2.40000000
CN4811300000000,48,113,"Dallas County, TX",Jul-22,1432030,1373995,58035,4.10000000
CN4811500000000,48,115,"Dawson County, TX",Jul-22,4555,4317,238,5.20000000
CN4811700000000,48,117,"Deaf Smith County, TX",Jul-22,9250,8965,285,3.10000000
CN4811900000000,48,119,"Delta County, TX",Jul-22,2456,2353,103,4.20000000
CN4812100000000,48,121,"Denton County, TX",Jul-22,554794,536078,18716,3.40000000
CN4812300000000,48,123,"DeWitt County, TX",Jul-22,9661,9323,338,3.50000000
CN4812500000000,48,125,"Dickens County, TX",Jul-22,790,750,40,5.10000000
CN4812700000000,48,127,"Dimmit County, TX",Jul-22,5661,5382,279,4.90000000
CN4812900000000,48,129,"Donley County, TX",Jul-22,1522,1462,60,3.90000000
CN4813100000000,48,131,"Duval County, TX",Jul-22,5511,5212,299,5.40000000
CN4813300000000,48,133,"Eastland County, TX",Jul-22,6861,6536,325,4.70000000
CN4813500000000,48,135,"Ector County, TX",Jul-22,80900,76779,4121,5.10000000
CN4813700000000,48,137,"Edwards County, TX",Jul-22,1330,1295,35,2.60000000
CN4813900000000,48,139,"Ellis County, TX",Jul-22,104063,100270,3793,3.60000000
CN4814100000000,48,141,"El Paso County, TX",Jul-22,362605,345302,17303,4.80000000
CN4814300000000,48,143,"Erath County, TX",Jul-22,20706,19936,770,3.70000000
CN4814500000000,48,145,"Falls County, TX",Jul-22,6867,6560,307,4.50000000
CN4814700000000,48,147,"Fannin County, TX",Jul-22,17481,16916,565,3.20000000
CN4814900000000,48,149,"Fayette County, TX",Jul-22,11843,11410,433,3.70000000
CN4815100000000,48,151,"Fisher County, TX",Jul-22,1642,1584,58,3.50000000
CN4815300000000,48,153,"Floyd County, TX",Jul-22,2585,2475,110,4.30000000
CN4815500000000,48,155,"Foard County, TX",Jul-22,640,623,17,2.70000000
CN4815700000000,48,157,"Fort Bend County, TX",Jul-22,419684,401331,18353,4.40000000
CN4815900000000,48,159,"Franklin County, TX",Jul-22,5229,5049,180,3.40000000
CN4816100000000,48,161,"Freestone County, TX",Jul-22,6355,5976,379,6.00000000
CN4816300000000,48,163,"Frio County, TX",Jul-22,9567,9202,365,3.80000000
CN4816500000000,48,165,"Gaines County, TX",Jul-22,10005,9697,308,3.10000000
CN4816700000000,48,167,"Galveston County, TX",Jul-22,170067,161421,8646,5.10000000
CN4816900000000,48,169,"Garza County, TX",Jul-22,2046,1932,114,5.60000000
CN4817100000000,48,171,"Gillespie County, TX",Jul-22,15026,14650,376,2.50000000
CN4817300000000,48,173,"Glasscock County, TX",Jul-22,878,855,23,2.60000000
CN4817500000000,48,175,"Goliad County, TX",Jul-22,3148,2988,160,5.10000000
CN4817700000000,48,177,"Gonzales County, TX",Jul-22,9884,9569,315,3.20000000
CN4817900000000,48,179,"Gray County, TX",Jul-22,7748,7357,391,5.00000000
CN4818100000000,48,181,"Grayson County, TX",Jul-22,67327,64841,2486,3.70000000
CN4818300000000,48,183,"Gregg County, TX",Jul-22,56852,54061,2791,4.90000000
CN4818500000000,48,185,"Grimes County, TX",Jul-22,11118,10512,606,5.50000000
CN4818700000000,48,187,"Guadalupe County, TX",Jul-22,84289,81265,3024,3.60000000
CN4818900000000,48,189,"Hale County, TX",Jul-22,12159,11484,675,5.60000000
CN4819100000000,48,191,"Hall County, TX",Jul-22,1127,1081,46,4.10000000
CN4819300000000,48,193,"Hamilton County, TX",Jul-22,3796,3658,138,3.60000000
CN4819500000000,48,195,"Hansford County, TX",Jul-22,2717,2648,69,2.50000000
CN4819700000000,48,197,"Hardeman County, TX",Jul-22,1759,1693,66,3.80000000
CN4819900000000,48,199,"Hardin County, TX",Jul-22,24834,23287,1547,6.20000000
CN4820100000000,48,201,"Harris County, TX",Jul-22,2350107,2236460,113647,4.80000000
CN4820300000000,48,203,"Harrison County, TX",Jul-22,28441,26950,1491,5.20000000
CN4820500000000,48,205,"Hartley County, TX",Jul-22,2843,2794,49,1.70000000
CN4820700000000,48,207,"Haskell County, TX",Jul-22,2854,2776,78,2.70000000
CN4820900000000,48,209,"Hays County, TX",Jul-22,134814,130495,4319,3.20000000
CN4821100000000,48,211,"Hemphill County, TX",Jul-22,1532,1480,52,3.40000000
CN4821300000000,48,213,"Henderson County, TX",Jul-22,39420,37849,1571,4.00000000
CN4821500000000,48,215,"Hidalgo County, TX",Jul-22,370259,340751,29508,8.00000000
CN4821700000000,48,217,"Hill County, TX",Jul-22,17226,16528,698,4.10000000
CN4821900000000,48,219,"Hockley County, TX",Jul-22,11042,10594,448,4.10000000
CN4822100000000,48,221,"Hood County, TX",Jul-22,29883,28715,1168,3.90000000
CN4822300000000,48,223,"Hopkins County, TX",Jul-22,18061,17455,606,3.40000000
CN4822500000000,48,225,"Houston County, TX",Jul-22,10988,10583,405,3.70000000
CN4822700000000,48,227,"Howard County, TX",Jul-22,13379,12616,763,5.70000000
CN4822900000000,48,229,"Hudspeth County, TX",Jul-22,1911,1830,81,4.20000000
CN4823100000000,48,231,"Hunt County, TX",Jul-22,47160,45276,1884,4.00000000
CN4823300000000,48,233,"Hutchinson County, TX",Jul-22,8231,7837,394,4.80000000
CN4823500000000,48,235,"Irion County, TX",Jul-22,791,768,23,2.90000000
CN4823700000000,48,237,"Jack County, TX",Jul-22,3433,3296,137,4.00000000
CN4823900000000,48,239,"Jackson County, TX",Jul-22,7176,6908,268,3.70000000
CN4824100000000,48,241,"Jasper County, TX",Jul-22,12922,11960,962,7.40000000
CN4824300000000,48,243,"Jeff Davis County, TX",Jul-22,1112,1078,34,3.10000000
CN4824500000000,48,245,"Jefferson County, TX",Jul-22,101428,93571,7857,7.70000000
CN4824700000000,48,247,"Jim Hogg County, TX",Jul-22,1829,1715,114,6.20000000
CN4824900000000,48,249,"Jim Wells County, TX",Jul-22,15517,14377,1140,7.30000000
CN4825100000000,48,251,"Johnson County, TX",Jul-22,88714,85339,3375,3.80000000
CN4825300000000,48,253,"Jones County, TX",Jul-22,5831,5535,296,5.10000000
CN4825500000000,48,255,"Karnes County, TX",Jul-22,6934,6684,250,3.60000000
CN4825700000000,48,257,"Kaufman County, TX",Jul-22,75644,72622,3022,4.00000000
CN4825900000000,48,259,"Kendall County, TX",Jul-22,23596,22833,763,3.20000000
CN4826100000000,48,261,"Kenedy County, TX",Jul-22,207,198,9,4.30000000
CN4826300000000,48,263,"Kent County, TX",Jul-22,475,463,12,2.50000000
CN4826500000000,48,265,"Kerr County, TX",Jul-22,22515,21714,801,3.60000000
CN4826700000000,48,267,"Kimble County, TX",Jul-22,2003,1942,61,3.00000000
CN4826900000000,48,269,"King County, TX",Jul-22,649,644,5,0.80000000
CN4827100000000,48,271,"Kinney County, TX",Jul-22,1218,1157,61,5.00000000
CN4827300000000,48,273,"Kleberg County, TX",Jul-22,12900,12168,732,5.70000000
CN4827500000000,48,275,"Knox County, TX",Jul-22,1545,1481,64,4.10000000
CN4827700000000,48,277,"Lamar County, TX",Jul-22,24203,23115,1088,4.50000000
CN4827900000000,48,279,"Lamb County, TX",Jul-22,5435,5206,229,4.20000000
CN4828100000000,48,281,"Lampasas County, TX",Jul-22,9406,9044,362,3.80000000
CN4828300000000,48,283,"La Salle County, TX",Jul-22,3935,3802,133,3.40000000
CN4828500000000,48,285,"Lavaca County, TX",Jul-22,8778,8468,310,3.50000000
CN4828700000000,48,287,"Lee County, TX",Jul-22,9056,8722,334,3.70000000
CN4828900000000,48,289,"Leon County, TX",Jul-22,6262,5906,356,5.70000000
CN4829100000000,48,291,"Liberty County, TX",Jul-22,35801,33259,2542,7.10000000
CN4829300000000,48,293,"Limestone County, TX",Jul-22,8654,8235,419,4.80000000
CN4829500000000,48,295,"Lipscomb County, TX",Jul-22,1488,1447,41,2.80000000
CN4829700000000,48,297,"Live Oak County, TX",Jul-22,4792,4556,236,4.90000000
CN4829900000000,48,299,"Llano County, TX",Jul-22,9327,8962,365,3.90000000
CN4830100000000,48,301,"Loving County, TX",Jul-22,527,522,5,0.90000000
CN4830300000000,48,303,"Lubbock County, TX",Jul-22,163135,156989,6146,3.80000000
CN4830500000000,48,305,"Lynn County, TX",Jul-22,2967,2853,114,3.80000000
CN4830700000000,48,307,"McCulloch County, TX",Jul-22,3143,2999,144,4.60000000
CN4830900000000,48,309,"McLennan County, TX",Jul-22,125809,120927,4882,3.90000000
CN4831100000000,48,311,"McMullen County, TX",Jul-22,779,762,17,2.20000000
CN4831300000000,48,313,"Madison County, TX",Jul-22,4833,4594,239,4.90000000
CN4831500000000,48,315,"Marion County, TX",Jul-22,4276,4027,249,5.80000000
CN4831700000000,48,317,"Martin County, TX",Jul-22,2728,2637,91,3.30000000
CN4831900000000,48,319,"Mason County, TX",Jul-22,1911,1848,63,3.30000000
CN4832100000000,48,321,"Matagorda County, TX",Jul-22,16535,15269,1266,7.70000000
CN4832300000000,48,323,"Maverick County, TX",Jul-22,22938,20813,2125,9.30000000
CN4832500000000,48,325,"Medina County, TX",Jul-22,22523,21609,914,4.10000000
CN4832700000000,48,327,"Menard County, TX",Jul-22,820,789,31,3.80000000
CN4832900000000,48,329,"Midland County, TX",Jul-22,100896,97327,3569,3.50000000
CN4833100000000,48,331,"Milam County, TX",Jul-22,10445,9960,485,4.60000000
CN4833300000000,48,333,"Mills County, TX",Jul-22,1964,1883,81,4.10000000
CN4833500000000,48,335,"Mitchell County, TX",Jul-22,2306,2194,112,4.90000000
CN4833700000000,48,337,"Montague County, TX",Jul-22,9364,9016,348,3.70000000
CN4833900000000,48,339,"Montgomery County, TX",Jul-22,302612,289712,12900,4.30000000
CN4834100000000,48,341,"Moore County, TX",Jul-22,11276,10978,298,2.60000000
CN4834300000000,48,343,"Morris County, TX",Jul-22,4437,4099,338,7.60000000
CN4834500000000,48,345,"Motley County, TX",Jul-22,485,465,20,4.10000000
CN4834700000000,48,347,"Nacogdoches County, TX",Jul-22,28076,26804,1272,4.50000000
CN4834900000000,48,349,"Navarro County, TX",Jul-22,24090,23128,962,4.00000000
CN4835100000000,48,351,"Newton County, TX",Jul-22,4897,4504,393,8.00000000
CN4835300000000,48,353,"Nolan County, TX",Jul-22,7053,6791,262,3.70000000
CN4835500000000,48,355,"Nueces County, TX",Jul-22,164607,155734,8873,5.40000000
CN4835700000000,48,357,"Ochiltree County, TX",Jul-22,4049,3917,132,3.30000000
CN4835900000000,48,359,"Oldham County, TX",Jul-22,943,917,26,2.80000000
CN4836100000000,48,361,"Orange County, TX",Jul-22,34818,32392,2426,7.00000000
CN4836300000000,48,363,"Palo Pinto County, TX",Jul-22,12907,12376,531,4.10000000
CN4836500000000,48,365,"Panola County, TX",Jul-22,9744,9233,511,5.20000000
CN4836700000000,48,367,"Parker County, TX",Jul-22,74298,71812,2486,3.30000000
CN4836900000000,48,369,"Parmer County, TX",Jul-22,5177,5047,130,2.50000000
CN4837100000000,48,371,"Pecos County, TX",Jul-22,5872,5579,293,5.00000000
CN4837300000000,48,373,"Polk County, TX",Jul-22,18524,17327,1197,6.50000000
CN4837500000000,48,375,"Potter County, TX",Jul-22,54084,52251,1833,3.40000000
CN4837700000000,48,377,"Presidio County, TX",Jul-22,3232,2979,253,7.80000000
CN4837900000000,48,379,"Rains County, TX",Jul-22,6591,6365,226,3.40000000
CN4838100000000,48,381,"Randall County, TX",Jul-22,74704,72512,2192,2.90000000
CN4838300000000,48,383,"Reagan County, TX",Jul-22,1604,1530,74,4.60000000
CN4838500000000,48,385,"Real County, TX",Jul-22,1244,1187,57,4.60000000
CN4838700000000,48,387,"Red River County, TX",Jul-22,5426,5141,285,5.30000000
CN4838900000000,48,389,"Reeves County, TX",Jul-22,9420,9078,342,3.60000000
CN4839100000000,48,391,"Refugio County, TX",Jul-22,3069,2903,166,5.40000000
CN4839300000000,48,393,"Roberts County, TX",Jul-22,412,397,15,3.60000000
CN4839500000000,48,395,"Robertson County, TX",Jul-22,7575,7231,344,4.50000000
CN4839700000000,48,397,"Rockwall County, TX",Jul-22,59559,57531,2028,3.40000000
CN4839900000000,48,399,"Runnels County, TX",Jul-22,4716,4561,155,3.30000000
CN4840100000000,48,401,"Rusk County, TX",Jul-22,22439,21397,1042,4.60000000
CN4840300000000,48,403,"Sabine County, TX",Jul-22,4115,3804,311,7.60000000
CN4840500000000,48,405,"San Augustine County, TX",Jul-22,3017,2808,209,6.90000000
CN4840700000000,48,407,"San Jacinto County, TX",Jul-22,12092,11411,681,5.60000000
CN4840900000000,48,409,"San Patricio County, TX",Jul-22,29622,27486,2136,7.20000000
CN4841100000000,48,411,"San Saba County, TX",Jul-22,2151,2064,87,4.00000000
CN4841300000000,48,413,"Schleicher County, TX",Jul-22,1154,1106,48,4.20000000
CN4841500000000,48,415,"Scurry County, TX",Jul-22,5896,5586,310,5.30000000
CN4841700000000,48,417,"Shackelford County, TX",Jul-22,1927,1875,52,2.70000000
CN4841900000000,48,419,"Shelby County, TX",Jul-22,11913,11396,517,4.30000000
CN4842100000000,48,421,"Sherman County, TX",Jul-22,1554,1517,37,2.40000000
CN4842300000000,48,423,"Smith County, TX",Jul-22,110717,106338,4379,4.00000000
CN4842500000000,48,425,"Somervell County, TX",Jul-22,4561,4371,190,4.20000000
CN4842700000000,48,427,"Starr County, TX",Jul-22,24269,20955,3314,13.70000000
CN4842900000000,48,429,"Stephens County, TX",Jul-22,4226,4070,156,3.70000000
CN4843100000000,48,431,"Sterling County, TX",Jul-22,605,588,17,2.80000000
CN4843300000000,48,433,"Stonewall County, TX",Jul-22,627,609,18,2.90000000
CN4843500000000,48,435,"Sutton County, TX",Jul-22,1138,1072,66,5.80000000
CN4843700000000,48,437,"Swisher County, TX",Jul-22,2671,2571,100,3.70000000
CN4843900000000,48,439,"Tarrant County, TX",Jul-22,1134908,1090261,44647,3.90000000
CN4844100000000,48,441,"Taylor County, TX",Jul-22,67511,65144,2367,3.50000000
CN4844300000000,48,443,"Terrell County, TX",Jul-22,452,438,14,3.10000000
CN4844500000000,48,445,"Terry County, TX",Jul-22,4826,4610,216,4.50000000
CN4844700000000,48,447,"Throckmorton County, TX",Jul-22,1502,1479,23,1.50000000
CN4844900000000,48,449,"Titus County, TX",Jul-22,13698,13075,623,4.50000000
CN4845100000000,48,451,"Tom Green County, TX",Jul-22,54009,52041,1968,3.60000000
CN4845300000000,48,453,"Travis County, TX",Jul-22,800273,776242,24031,3.00000000
CN4845500000000,48,455,"Trinity County, TX",Jul-22,5330,5022,308,5.80000000
CN4845700000000,48,457,"Tyler County, TX",Jul-22,7620,7126,494,6.50000000
CN4845900000000,48,459,"Upshur County, TX",Jul-22,17835,16993,842,4.70000000
CN4846100000000,48,461,"Upton County, TX",Jul-22,1772,1706,66,3.70000000
CN4846300000000,48,463,"Uvalde County, TX",Jul-22,11425,10873,552,4.80000000
CN4846500000000,48,465,"Val Verde County, TX",Jul-22,22325,21122,1203,5.40000000
CN4846700000000,48,467,"Van Zandt County, TX",Jul-22,27874,26852,1022,3.70000000
CN4846900000000,48,469,"Victoria County, TX",Jul-22,40326,38405,1921,4.80000000
CN4847100000000,48,471,"Walker County, TX",Jul-22,23230,21969,1261,5.40000000
CN4847300000000,48,473,"Waller County, TX",Jul-22,25663,24440,1223,4.80000000
CN4847500000000,48,475,"Ward County, TX",Jul-22,6320,6039,281,4.40000000
CN4847700000000,48,477,"Washington County, TX",Jul-22,15023,14348,675,4.50000000
CN4847900000000,48,479,"Webb County, TX",Jul-22,117790,112477,5313,4.50000000
CN4848100000000,48,481,"Wharton County, TX",Jul-22,21388,20481,907,4.20000000
CN4848300000000,48,483,"Wheeler County, TX",Jul-22,1982,1895,87,4.40000000
CN4848500000000,48,485,"Wichita County, TX",Jul-22,55574,53251,2323,4.20000000
CN4848700000000,48,487,"Wilbarger County, TX",Jul-22,4775,4517,258,5.40000000
CN4848900000000,48,489,"Willacy County, TX",Jul-22,7305,6559,746,10.20000000
CN4849100000000,48,491,"Williamson County, TX",Jul-22,354066,343199,10867,3.10000000
CN4849300000000,48,493,"Wilson County, TX",Jul-22,25677,24787,890,3.50000000
CN4849500000000,48,495,"Winkler County, TX",Jul-22,3652,3459,193,5.30000000
CN4849700000000,48,497,"Wise County, TX",Jul-22,34267,33000,1267,3.70000000
CN4849900000000,48,499,"Wood County, TX",Jul-22,18020,17165,855,4.70000000
CN4850100000000,48,501,"Yoakum County, TX",Jul-22,3174,3010,164,5.20000000
CN4850300000000,48,503,"Young County, TX",Jul-22,8170,7894,276,3.40000000
CN4850500000000,48,505,"Zapata County, TX",Jul-22,4519,4145,374,8.30000000
CN4850700000000,48,507,"Zavala County, TX",Jul-22,3257,2910,347,10.70000000
CN4900100000000,49,001,"Beaver County, UT",Jul-22,2827,2760,67,2.40000000
CN4900300000000,49,003,"Box Elder County, UT",Jul-22,27775,27277,498,1.80000000
CN4900500000000,49,005,"Cache County, UT",Jul-22,68494,67354,1140,1.70000000
CN4900700000000,49,007,"Carbon County, UT",Jul-22,8438,8175,263,3.10000000
CN4900900000000,49,009,"Daggett County, UT",Jul-22,461,446,15,3.30000000
CN4901100000000,49,011,"Davis County, UT",Jul-22,185315,181921,3394,1.80000000
CN4901300000000,49,013,"Duchesne County, UT",Jul-22,7977,7737,240,3.00000000
CN4901500000000,49,015,"Emery County, UT",Jul-22,4551,4421,130,2.90000000
CN4901700000000,49,017,"Garfield County, UT",Jul-22,3187,3060,127,4.00000000
CN4901900000000,49,019,"Grand County, UT",Jul-22,7375,7212,163,2.20000000
CN4902100000000,49,021,"Iron County, UT",Jul-22,27321,26756,565,2.10000000
CN4902300000000,49,023,"Juab County, UT",Jul-22,6352,6250,102,1.60000000
CN4902500000000,49,025,"Kane County, UT",Jul-22,4471,4391,80,1.80000000
CN4902700000000,49,027,"Millard County, UT",Jul-22,6264,6147,117,1.90000000
CN4902900000000,49,029,"Morgan County, UT",Jul-22,5980,5885,95,1.60000000
CN4903100000000,49,031,"Piute County, UT",Jul-22,497,482,15,3.00000000
CN4903300000000,49,033,"Rich County, UT",Jul-22,1725,1702,23,1.30000000
CN4903500000000,49,035,"Salt Lake County, UT",Jul-22,674173,660131,14042,2.10000000
CN4903700000000,49,037,"San Juan County, UT",Jul-22,5653,5416,237,4.20000000
CN4903900000000,49,039,"Sanpete County, UT",Jul-22,13298,12981,317,2.40000000
CN4904100000000,49,041,"Sevier County, UT",Jul-22,10140,9883,257,2.50000000
CN4904300000000,49,043,"Summit County, UT",Jul-22,25985,25522,463,1.80000000
CN4904500000000,49,045,"Tooele County, UT",Jul-22,37977,37117,860,2.30000000
CN4904700000000,49,047,"Uintah County, UT",Jul-22,13886,13368,518,3.70000000
CN4904900000000,49,049,"Utah County, UT",Jul-22,342133,335846,6287,1.80000000
CN4905100000000,49,051,"Wasatch County, UT",Jul-22,17894,17556,338,1.90000000
CN4905300000000,49,053,"Washington County, UT",Jul-22,84434,82545,1889,2.20000000
CN4905500000000,49,055,"Wayne County, UT",Jul-22,1658,1611,47,2.80000000
CN4905700000000,49,057,"Weber County, UT",Jul-22,135934,133060,2874,2.10000000
CN5000100000000,50,001,"Addison County, VT",Jul-22,21363,20991,372,1.70000000
CN5000300000000,50,003,"Bennington County, VT",Jul-22,17418,16974,444,2.50000000
CN5000500000000,50,005,"Caledonia County, VT",Jul-22,14521,14166,355,2.40000000
CN5000700000000,50,007,"Chittenden County, VT",Jul-22,97831,96171,1660,1.70000000
CN5000900000000,50,009,"Essex County, VT",Jul-22,2652,2558,94,3.50000000
CN5001100000000,50,011,"Franklin County, VT",Jul-22,27961,27352,609,2.20000000
CN5001300000000,50,013,"Grand Isle County, VT",Jul-22,4126,4034,92,2.20000000
CN5001500000000,50,015,"Lamoille County, VT",Jul-22,13962,13644,318,2.30000000
CN5001700000000,50,017,"Orange County, VT",Jul-22,15748,15452,296,1.90000000
CN5001900000000,50,019,"Orleans County, VT",Jul-22,12885,12469,416,3.20000000
CN5002100000000,50,021,"Rutland County, VT",Jul-22,29770,28934,836,2.80000000
CN5002300000000,50,023,"Washington County, VT",Jul-22,33947,33283,664,2.00000000
CN5002500000000,50,025,"Windham County, VT",Jul-22,20695,20208,487,2.40000000
CN5002700000000,50,027,"Windsor County, VT",Jul-22,28410,27878,532,1.90000000
CN5100100000000,51,001,"Accomack County, VA",Jul-22,16597,16107,490,3.00000000
CN5100300000000,51,003,"Albemarle County, VA",Jul-22,56264,54714,1550,2.80000000
CN5100500000000,51,005,"Alleghany County, VA",Jul-22,6921,6703,218,3.10000000
CN5100700000000,51,007,"Amelia County, VA",Jul-22,6187,6000,187,3.00000000
CN5100900000000,51,009,"Amherst County, VA",Jul-22,14682,14245,437,3.00000000
CN5101100000000,51,011,"Appomattox County, VA",Jul-22,7101,6879,222,3.10000000
CN5101300000000,51,013,"Arlington County, VA",Jul-22,154535,151344,3191,2.10000000
CN5101500000000,51,015,"Augusta County, VA",Jul-22,37280,36316,964,2.60000000
CN5101700000000,51,017,"Bath County, VA",Jul-22,2457,2396,61,2.50000000
CN5101900000000,51,019,"Bedford County, VA",Jul-22,37997,36924,1073,2.80000000
CN5102100000000,51,021,"Bland County, VA",Jul-22,2839,2761,78,2.70000000
CN5102300000000,51,023,"Botetourt County, VA",Jul-22,17244,16799,445,2.60000000
CN5102500000000,51,025,"Brunswick County, VA",Jul-22,6107,5821,286,4.70000000
CN5102700000000,51,027,"Buchanan County, VA",Jul-22,6577,6247,330,5.00000000
CN5102900000000,51,029,"Buckingham County, VA",Jul-22,6273,6022,251,4.00000000
CN5103100000000,51,031,"Campbell County, VA",Jul-22,25508,24723,785,3.10000000
CN5103300000000,51,033,"Caroline County, VA",Jul-22,14981,14492,489,3.30000000
CN5103500000000,51,035,"Carroll County, VA",Jul-22,13617,13187,430,3.20000000
CN5103600000000,51,036,"Charles City County, VA",Jul-22,3554,3444,110,3.10000000
CN5103700000000,51,037,"Charlotte County, VA",Jul-22,5857,5696,161,2.70000000
CN5104100000000,51,041,"Chesterfield County, VA",Jul-22,188383,183074,5309,2.80000000
CN5104300000000,51,043,"Clarke County, VA",Jul-22,7644,7452,192,2.50000000
CN5104500000000,51,045,"Craig County, VA",Jul-22,2251,2182,69,3.10000000
CN5104700000000,51,047,"Culpeper County, VA",Jul-22,25201,24515,686,2.70000000
CN5104900000000,51,049,"Cumberland County, VA",Jul-22,4861,4704,157,3.20000000
CN5105100000000,51,051,"Dickenson County, VA",Jul-22,5191,4989,202,3.90000000
CN5105300000000,51,053,"Dinwiddie County, VA",Jul-22,13473,13017,456,3.40000000
CN5105700000000,51,057,"Essex County, VA",Jul-22,5505,5318,187,3.40000000
CN5105900000000,51,059,"Fairfax County, VA",Jul-22,628513,612950,15563,2.50000000
CN5106100000000,51,061,"Fauquier County, VA",Jul-22,37506,36588,918,2.40000000
CN5106300000000,51,063,"Floyd County, VA",Jul-22,8246,8053,193,2.30000000
CN5106500000000,51,065,"Fluvanna County, VA",Jul-22,13721,13355,366,2.70000000
CN5106700000000,51,067,"Franklin County, VA",Jul-22,25859,25111,748,2.90000000
CN5106900000000,51,069,"Frederick County, VA",Jul-22,50200,49018,1182,2.40000000
CN5107100000000,51,071,"Giles County, VA",Jul-22,7786,7550,236,3.00000000
CN5107300000000,51,073,"Gloucester County, VA",Jul-22,19354,18834,520,2.70000000
CN5107500000000,51,075,"Goochland County, VA",Jul-22,11503,11197,306,2.70000000
CN5107700000000,51,077,"Grayson County, VA",Jul-22,8770,8566,204,2.30000000
CN5107900000000,51,079,"Greene County, VA",Jul-22,10275,10034,241,2.30000000
CN5108100000000,51,081,"Greensville County, VA",Jul-22,4691,4540,151,3.20000000
CN5108300000000,51,083,"Halifax County, VA",Jul-22,16000,15387,613,3.80000000
CN5108500000000,51,085,"Hanover County, VA",Jul-22,58554,57113,1441,2.50000000
CN5108700000000,51,087,"Henrico County, VA",Jul-22,180385,175170,5215,2.90000000
CN5108900000000,51,089,"Henry County, VA",Jul-22,25546,24737,809,3.20000000
CN5109100000000,51,091,"Highland County, VA",Jul-22,1360,1333,27,2.00000000
CN5109300000000,51,093,"Isle of Wight County, VA",Jul-22,19541,18993,548,2.80000000
CN5109500000000,51,095,"James City County, VA",Jul-22,36558,35483,1075,2.90000000
CN5109700000000,51,097,"King and Queen County, VA",Jul-22,4100,3996,104,2.50000000
CN5109900000000,51,099,"King George County, VA",Jul-22,14571,14221,350,2.40000000
CN5110100000000,51,101,"King William County, VA",Jul-22,9305,9064,241,2.60000000
CN5110300000000,51,103,"Lancaster County, VA",Jul-22,5880,5710,170,2.90000000
CN5110500000000,51,105,"Lee County, VA",Jul-22,8808,8510,298,3.40000000
CN5110700000000,51,107,"Loudoun County, VA",Jul-22,229289,223824,5465,2.40000000
CN5110900000000,51,109,"Louisa County, VA",Jul-22,21409,20848,561,2.60000000
CN5111100000000,51,111,"Lunenburg County, VA",Jul-22,5436,5258,178,3.30000000
CN5111300000000,51,113,"Madison County, VA",Jul-22,7673,7511,162,2.10000000
CN5111500000000,51,115,"Mathews County, VA",Jul-22,4040,3931,109,2.70000000
CN5111700000000,51,117,"Mecklenburg County, VA",Jul-22,13717,13268,449,3.30000000
CN5111900000000,51,119,"Middlesex County, VA",Jul-22,5646,5498,148,2.60000000
CN5112100000000,51,121,"Montgomery County, VA",Jul-22,49732,48305,1427,2.90000000
CN5112500000000,51,125,"Nelson County, VA",Jul-22,7167,6963,204,2.80000000
CN5112700000000,51,127,"New Kent County, VA",Jul-22,12881,12583,298,2.30000000
CN5113100000000,51,131,"Northampton County, VA",Jul-22,6108,5916,192,3.10000000
CN5113300000000,51,133,"Northumberland County, VA",Jul-22,6010,5822,188,3.10000000
CN5113500000000,51,135,"Nottoway County, VA",Jul-22,7602,7372,230,3.00000000
CN5113700000000,51,137,"Orange County, VA",Jul-22,18053,17541,512,2.80000000
CN5113900000000,51,139,"Page County, VA",Jul-22,13025,12649,376,2.90000000
CN5114100000000,51,141,"Patrick County, VA",Jul-22,7468,7216,252,3.40000000
CN5114300000000,51,143,"Pittsylvania County, VA",Jul-22,31345,30341,1004,3.20000000
CN5114500000000,51,145,"Powhatan County, VA",Jul-22,14250,13889,361,2.50000000
CN5114700000000,51,147,"Prince Edward County, VA",Jul-22,11358,10923,435,3.80000000
CN5114900000000,51,149,"Prince George County, VA",Jul-22,15011,14496,515,3.40000000
CN5115300000000,51,153,"Prince William County, VA",Jul-22,247485,240643,6842,2.80000000
CN5115500000000,51,155,"Pulaski County, VA",Jul-22,15891,15394,497,3.10000000
CN5115700000000,51,157,"Rappahannock County, VA",Jul-22,3667,3573,94,2.60000000
CN5115900000000,51,159,"Richmond County, VA",Jul-22,4238,4136,102,2.40000000
CN5116100000000,51,161,"Roanoke County, VA",Jul-22,48372,47141,1231,2.50000000
CN5116300000000,51,163,"Rockbridge County, VA",Jul-22,11490,11185,305,2.70000000
CN5116500000000,51,165,"Rockingham County, VA",Jul-22,42169,41062,1107,2.60000000
CN5116700000000,51,167,"Russell County, VA",Jul-22,11496,11117,379,3.30000000
CN5116900000000,51,169,"Scott County, VA",Jul-22,9010,8720,290,3.20000000
CN5117100000000,51,171,"Shenandoah County, VA",Jul-22,23582,22988,594,2.50000000
CN5117300000000,51,173,"Smyth County, VA",Jul-22,15649,15234,415,2.70000000
CN5117500000000,51,175,"Southampton County, VA",Jul-22,9477,9225,252,2.70000000
CN5117700000000,51,177,"Spotsylvania County, VA",Jul-22,68518,66491,2027,3.00000000
CN5117900000000,51,179,"Stafford County, VA",Jul-22,74701,72575,2126,2.80000000
CN5118100000000,51,181,"Surry County, VA",Jul-22,3666,3556,110,3.00000000
CN5118300000000,51,183,"Sussex County, VA",Jul-22,3748,3576,172,4.60000000
CN5118500000000,51,185,"Tazewell County, VA",Jul-22,16115,15478,637,4.00000000
CN5118700000000,51,187,"Warren County, VA",Jul-22,20440,19862,578,2.80000000
CN5119100000000,51,191,"Washington County, VA",Jul-22,25786,25011,775,3.00000000
CN5119300000000,51,193,"Westmoreland County, VA",Jul-22,10291,9991,300,2.90000000
CN5119500000000,51,195,"Wise County, VA",Jul-22,14284,13727,557,3.90000000
CN5119700000000,51,197,"Wythe County, VA",Jul-22,15011,14597,414,2.80000000
CN5119900000000,51,199,"York County, VA",Jul-22,32827,31921,906,2.80000000
CN5151000000000,51,510,"Alexandria city, VA",Jul-22,99308,96954,2354,2.40000000
CN5152000000000,51,520,"Bristol city, VA",Jul-22,7334,7082,252,3.40000000
CN5153000000000,51,530,"Buena Vista city, VA",Jul-22,3201,3106,95,3.00000000
CN5154000000000,51,540,"Charlottesville city, VA",Jul-22,24903,24196,707,2.80000000
CN5155000000000,51,550,"Chesapeake city, VA",Jul-22,122828,119152,3676,3.00000000
CN5157000000000,51,570,"Colonial Heights city, VA",Jul-22,8305,8030,275,3.30000000
CN5158000000000,51,580,"Covington city, VA",Jul-22,2413,2318,95,3.90000000
CN5159000000000,51,590,"Danville city, VA",Jul-22,19856,18780,1076,5.40000000
CN5159500000000,51,595,"Emporia city, VA",Jul-22,2624,2489,135,5.10000000
CN5160000000000,51,600,"Fairfax city, VA",Jul-22,12681,12384,297,2.30000000
CN5161000000000,51,610,"Falls Church city, VA",Jul-22,8416,8229,187,2.20000000
CN5162000000000,51,620,"Franklin city, VA",Jul-22,3624,3463,161,4.40000000
CN5163000000000,51,630,"Fredericksburg city, VA",Jul-22,14174,13693,481,3.40000000
CN5164000000000,51,640,"Galax city, VA",Jul-22,3032,2938,94,3.10000000
CN5165000000000,51,650,"Hampton city, VA",Jul-22,63994,61334,2660,4.20000000
CN5166000000000,51,660,"Harrisonburg city, VA",Jul-22,24286,23380,906,3.70000000
CN5167000000000,51,670,"Hopewell city, VA",Jul-22,9467,8977,490,5.20000000
CN5167800000000,51,678,"Lexington city, VA",Jul-22,2275,2174,101,4.40000000
CN5168000000000,51,680,"Lynchburg city, VA",Jul-22,35406,33927,1479,4.20000000
CN5168300000000,51,683,"Manassas city, VA",Jul-22,21415,20846,569,2.70000000
CN5168500000000,51,685,"Manassas Park city, VA",Jul-22,9637,9385,252,2.60000000
CN5169000000000,51,690,"Martinsville city, VA",Jul-22,5946,5661,285,4.80000000
CN5170000000000,51,700,"Newport News city, VA",Jul-22,87850,84366,3484,4.00000000
CN5171000000000,51,710,"Norfolk city, VA",Jul-22,109445,105220,4225,3.90000000
CN5172000000000,51,720,"Norton city, VA",Jul-22,1774,1706,68,3.80000000
CN5173000000000,51,730,"Petersburg city, VA",Jul-22,12448,11590,858,6.90000000
CN5173500000000,51,735,"Poquoson city, VA",Jul-22,6341,6182,159,2.50000000
CN5174000000000,51,740,"Portsmouth city, VA",Jul-22,43920,41944,1976,4.50000000
CN5175000000000,51,750,"Radford city, VA",Jul-22,8614,8287,327,3.80000000
CN5176000000000,51,760,"Richmond city, VA",Jul-22,117762,113372,4390,3.70000000
CN5177000000000,51,770,"Roanoke city, VA",Jul-22,47666,46061,1605,3.40000000
CN5177500000000,51,775,"Salem city, VA",Jul-22,12522,12161,361,2.90000000
CN5179000000000,51,790,"Staunton city, VA",Jul-22,12028,11693,335,2.80000000
CN5180000000000,51,800,"Suffolk city, VA",Jul-22,45252,43822,1430,3.20000000
CN5181000000000,51,810,"Virginia Beach city, VA",Jul-22,229261,222863,6398,2.80000000
CN5182000000000,51,820,"Waynesboro city, VA",Jul-22,10448,10124,324,3.10000000
CN5183000000000,51,830,"Williamsburg city, VA",Jul-22,6742,6453,289,4.30000000
CN5184000000000,51,840,"Winchester city, VA",Jul-22,14793,14391,402,2.70000000
CN5300100000000,53,001,"Adams County, WA",Jul-22,11362,10988,374,3.30000000
CN5300300000000,53,003,"Asotin County, WA",Jul-22,10497,10179,318,3.00000000
CN5300500000000,53,005,"Benton County, WA",Jul-22,108653,104551,4102,3.80000000
CN5300700000000,53,007,"Chelan County, WA",Jul-22,50104,48632,1472,2.90000000
CN5300900000000,53,009,"Clallam County, WA",Jul-22,29474,28103,1371,4.70000000
CN5301100000000,53,011,"Clark County, WA",Jul-22,250968,241454,9514,3.80000000
CN5301300000000,53,013,"Columbia County, WA",Jul-22,1832,1763,69,3.80000000
CN5301500000000,53,015,"Cowlitz County, WA",Jul-22,48891,46670,2221,4.50000000
CN5301700000000,53,017,"Douglas County, WA",Jul-22,24064,23273,791,3.30000000
CN5301900000000,53,019,"Ferry County, WA",Jul-22,2343,2186,157,6.70000000
CN5302100000000,53,021,"Franklin County, WA",Jul-22,46021,43955,2066,4.50000000
CN5302300000000,53,023,"Garfield County, WA",Jul-22,816,777,39,4.80000000
CN5302500000000,53,025,"Grant County, WA",Jul-22,50363,48215,2148,4.30000000
CN5302700000000,53,027,"Grays Harbor County, WA",Jul-22,28122,26549,1573,5.60000000
CN5302900000000,53,029,"Island County, WA",Jul-22,36236,34817,1419,3.90000000
CN5303100000000,53,031,"Jefferson County, WA",Jul-22,12644,12079,565,4.50000000
CN5303300000000,53,033,"King County, WA",Jul-22,1321511,1283854,37657,2.80000000
CN5303500000000,53,035,"Kitsap County, WA",Jul-22,128248,123704,4544,3.50000000
CN5303700000000,53,037,"Kittitas County, WA",Jul-22,20853,19852,1001,4.80000000
CN5303900000000,53,039,"Klickitat County, WA",Jul-22,9874,9430,444,4.50000000
CN5304100000000,53,041,"Lewis County, WA",Jul-22,35165,33531,1634,4.60000000
CN5304300000000,53,043,"Lincoln County, WA",Jul-22,4446,4274,172,3.90000000
CN5304500000000,53,045,"Mason County, WA",Jul-22,25065,23788,1277,5.10000000
CN5304700000000,53,047,"Okanogan County, WA",Jul-22,20200,19333,867,4.30000000
CN5304900000000,53,049,"Pacific County, WA",Jul-22,8310,7825,485,5.80000000
CN5305100000000,53,051,"Pend Oreille County, WA",Jul-22,5109,4844,265,5.20000000
CN5305300000000,53,053,"Pierce County, WA",Jul-22,445639,426962,18677,4.20000000
CN5305500000000,53,055,"San Juan County, WA",Jul-22,7626,7364,262,3.40000000
CN5305700000000,53,057,"Skagit County, WA",Jul-22,62588,59971,2617,4.20000000
CN5305900000000,53,059,"Skamania County, WA",Jul-22,5568,5337,231,4.10000000
CN5306100000000,53,061,"Snohomish County, WA",Jul-22,451024,436309,14715,3.30000000
CN5306300000000,53,063,"Spokane County, WA",Jul-22,262517,252978,9539,3.60000000
CN5306500000000,53,065,"Stevens County, WA",Jul-22,19044,18130,914,4.80000000
CN5306700000000,53,067,"Thurston County, WA",Jul-22,144590,139237,5353,3.70000000
CN5306900000000,53,069,"Wahkiakum County, WA",Jul-22,1338,1264,74,5.50000000
CN5307100000000,53,071,"Walla Walla County, WA",Jul-22,31957,30887,1070,3.30000000
CN5307300000000,53,073,"Whatcom County, WA",Jul-22,115874,111307,4567,3.90000000
CN5307500000000,53,075,"Whitman County, WA",Jul-22,20225,19356,869,4.30000000
CN5307700000000,53,077,"Yakima County, WA",Jul-22,138069,131846,6223,4.50000000
CN5400100000000,54,001,"Barbour County, WV",Jul-22,7228,6861,367,5.10000000
CN5400300000000,54,003,"Berkeley County, WV",Jul-22,62081,60173,1908,3.10000000
CN5400500000000,54,005,"Boone County, WV",Jul-22,7371,6999,372,5.00000000
CN5400700000000,54,007,"Braxton County, WV",Jul-22,5055,4749,306,6.10000000
CN5400900000000,54,009,"Brooke County, WV",Jul-22,10080,9565,515,5.10000000
CN5401100000000,54,011,"Cabell County, WV",Jul-22,41975,40344,1631,3.90000000
CN5401300000000,54,013,"Calhoun County, WV",Jul-22,2608,2423,185,7.10000000
CN5401500000000,54,015,"Clay County, WV",Jul-22,3076,2882,194,6.30000000
CN5401700000000,54,017,"Doddridge County, WV",Jul-22,3862,3741,121,3.10000000
CN5401900000000,54,019,"Fayette County, WV",Jul-22,16663,15851,812,4.90000000
CN5402100000000,54,021,"Gilmer County, WV",Jul-22,2252,2126,126,5.60000000
CN5402300000000,54,023,"Grant County, WV",Jul-22,5946,5720,226,3.80000000
CN5402500000000,54,025,"Greenbrier County, WV",Jul-22,15907,15251,656,4.10000000
CN5402700000000,54,027,"Hampshire County, WV",Jul-22,11275,10943,332,2.90000000
CN5402900000000,54,029,"Hancock County, WV",Jul-22,13342,12601,741,5.60000000
CN5403100000000,54,031,"Hardy County, WV",Jul-22,5686,5445,241,4.20000000
CN5403300000000,54,033,"Harrison County, WV",Jul-22,34258,32978,1280,3.70000000
CN5403500000000,54,035,"Jackson County, WV",Jul-22,12310,11769,541,4.40000000
CN5403700000000,54,037,"Jefferson County, WV",Jul-22,31275,30429,846,2.70000000
CN5403900000000,54,039,"Kanawha County, WV",Jul-22,82886,79641,3245,3.90000000
CN5404100000000,54,041,"Lewis County, WV",Jul-22,6207,5861,346,5.60000000
CN5404300000000,54,043,"Lincoln County, WV",Jul-22,7160,6765,395,5.50000000
CN5404500000000,54,045,"Logan County, WV",Jul-22,11230,10638,592,5.30000000
CN5404700000000,54,047,"McDowell County, WV",Jul-22,4281,3957,324,7.60000000
CN5404900000000,54,049,"Marion County, WV",Jul-22,25442,24234,1208,4.70000000
CN5405100000000,54,051,"Marshall County, WV",Jul-22,13589,12930,659,4.80000000
CN5405300000000,54,053,"Mason County, WV",Jul-22,10048,9560,488,4.90000000
CN5405500000000,54,055,"Mercer County, WV",Jul-22,20791,19732,1059,5.10000000
CN5405700000000,54,057,"Mineral County, WV",Jul-22,12254,11755,499,4.10000000
CN5405900000000,54,059,"Mingo County, WV",Jul-22,6106,5644,462,7.60000000
CN5406100000000,54,061,"Monongalia County, WV",Jul-22,57026,54943,2083,3.70000000
CN5406300000000,54,063,"Monroe County, WV",Jul-22,6227,5887,340,5.50000000
CN5406500000000,54,065,"Morgan County, WV",Jul-22,8725,8471,254,2.90000000
CN5406700000000,54,067,"Nicholas County, WV",Jul-22,9338,8884,454,4.90000000
CN5406900000000,54,069,"Ohio County, WV",Jul-22,20770,19911,859,4.10000000
CN5407100000000,54,071,"Pendleton County, WV",Jul-22,3778,3674,104,2.80000000
CN5407300000000,54,073,"Pleasants County, WV",Jul-22,2721,2574,147,5.40000000
CN5407500000000,54,075,"Pocahontas County, WV",Jul-22,4355,4222,133,3.10000000
CN5407700000000,54,077,"Preston County, WV",Jul-22,15871,15217,654,4.10000000
CN5407900000000,54,079,"Putnam County, WV",Jul-22,27251,26283,968,3.60000000
CN5408100000000,54,081,"Raleigh County, WV",Jul-22,31388,30180,1208,3.80000000
CN5408300000000,54,083,"Randolph County, WV",Jul-22,11932,11384,548,4.60000000
CN5408500000000,54,085,"Ritchie County, WV",Jul-22,4351,4174,177,4.10000000
CN5408700000000,54,087,"Roane County, WV",Jul-22,5034,4714,320,6.40000000
CN5408900000000,54,089,"Summers County, WV",Jul-22,4656,4444,212,4.60000000
CN5409100000000,54,091,"Taylor County, WV",Jul-22,7945,7621,324,4.10000000
CN5409300000000,54,093,"Tucker County, WV",Jul-22,3421,3286,135,3.90000000
CN5409500000000,54,095,"Tyler County, WV",Jul-22,3013,2813,200,6.60000000
CN5409700000000,54,097,"Upshur County, WV",Jul-22,9866,9324,542,5.50000000
CN5409900000000,54,099,"Wayne County, WV",Jul-22,15766,15087,679,4.30000000
CN5410100000000,54,101,"Webster County, WV",Jul-22,3164,3004,160,5.10000000
CN5410300000000,54,103,"Wetzel County, WV",Jul-22,6886,6514,372,5.40000000
CN5410500000000,54,105,"Wirt County, WV",Jul-22,2321,2182,139,6.00000000
CN5410700000000,54,107,"Wood County, WV",Jul-22,37786,36229,1557,4.10000000
CN5410900000000,54,109,"Wyoming County, WV",Jul-22,7525,7132,393,5.20000000
CN5500100000000,55,001,"Adams County, WI",Jul-22,8010,7580,430,5.40000000
CN5500300000000,55,003,"Ashland County, WI",Jul-22,7947,7597,350,4.40000000
CN5500500000000,55,005,"Barron County, WI",Jul-22,24002,23264,738,3.10000000
CN5500700000000,55,007,"Bayfield County, WI",Jul-22,7758,7372,386,5.00000000
CN5500900000000,55,009,"Brown County, WI",Jul-22,143660,139386,4274,3.00000000
CN5501100000000,55,011,"Buffalo County, WI",Jul-22,6133,5891,242,3.90000000
CN5501300000000,55,013,"Burnett County, WI",Jul-22,7504,7190,314,4.20000000
CN5501500000000,55,015,"Calumet County, WI",Jul-22,28007,27269,738,2.60000000
CN5501700000000,55,017,"Chippewa County, WI",Jul-22,33527,32421,1106,3.30000000
CN5501900000000,55,019,"Clark County, WI",Jul-22,17700,17218,482,2.70000000
CN5502100000000,55,021,"Columbia County, WI",Jul-22,32042,31126,916,2.90000000
CN5502300000000,55,023,"Crawford County, WI",Jul-22,7211,6959,252,3.50000000
CN5502500000000,55,025,"Dane County, WI",Jul-22,333221,324956,8265,2.50000000
CN5502700000000,55,027,"Dodge County, WI",Jul-22,48428,47029,1399,2.90000000
CN5502900000000,55,029,"Door County, WI",Jul-22,17222,16748,474,2.80000000
CN5503100000000,55,031,"Douglas County, WI",Jul-22,23470,22496,974,4.10000000
CN5503300000000,55,033,"Dunn County, WI",Jul-22,23348,22598,750,3.20000000
CN5503500000000,55,035,"Eau Claire County, WI",Jul-22,59856,58155,1701,2.80000000
CN5503700000000,55,037,"Florence County, WI",Jul-22,2188,2110,78,3.60000000
CN5503900000000,55,039,"Fond du Lac County, WI",Jul-22,58098,56351,1747,3.00000000
CN5504100000000,55,041,"Forest County, WI",Jul-22,3873,3675,198,5.10000000
CN5504300000000,55,043,"Grant County, WI",Jul-22,26252,25486,766,2.90000000
CN5504500000000,55,045,"Green County, WI",Jul-22,20921,20367,554,2.60000000
CN5504700000000,55,047,"Green Lake County, WI",Jul-22,9503,9187,316,3.30000000
CN5504900000000,55,049,"Iowa County, WI",Jul-22,13622,13252,370,2.70000000
CN5505100000000,55,051,"Iron County, WI",Jul-22,2492,2350,142,5.70000000
CN5505300000000,55,053,"Jackson County, WI",Jul-22,9417,9051,366,3.90000000
CN5505500000000,55,055,"Jefferson County, WI",Jul-22,46785,45428,1357,2.90000000
CN5505700000000,55,057,"Juneau County, WI",Jul-22,13401,12923,478,3.60000000
CN5505900000000,55,059,"Kenosha County, WI",Jul-22,94227,90756,3471,3.70000000
CN5506100000000,55,061,"Kewaunee County, WI",Jul-22,10889,10617,272,2.50000000
CN5506300000000,55,063,"La Crosse County, WI",Jul-22,66004,64157,1847,2.80000000
CN5506500000000,55,065,"Lafayette County, WI",Jul-22,10151,9887,264,2.60000000
CN5506700000000,55,067,"Langlade County, WI",Jul-22,9372,8996,376,4.00000000
CN5506900000000,55,069,"Lincoln County, WI",Jul-22,14759,14229,530,3.60000000
CN5507100000000,55,071,"Manitowoc County, WI",Jul-22,40675,39433,1242,3.10000000
CN5507300000000,55,073,"Marathon County, WI",Jul-22,75009,72896,2113,2.80000000
CN5507500000000,55,075,"Marinette County, WI",Jul-22,19241,18421,820,4.30000000
CN5507700000000,55,077,"Marquette County, WI",Jul-22,7734,7454,280,3.60000000
CN5507800000000,55,078,"Menominee County, WI",Jul-22,1593,1445,148,9.30000000
CN5507900000000,55,079,"Milwaukee County, WI",Jul-22,471197,448847,22350,4.70000000
CN5508100000000,55,081,"Monroe County, WI",Jul-22,23436,22732,704,3.00000000
CN5508300000000,55,083,"Oconto County, WI",Jul-22,20828,20144,684,3.30000000
CN5508500000000,55,085,"Oneida County, WI",Jul-22,18985,18385,600,3.20000000
CN5508700000000,55,087,"Outagamie County, WI",Jul-22,106276,103143,3133,2.90000000
CN5508900000000,55,089,"Ozaukee County, WI",Jul-22,49617,48168,1449,2.90000000
CN5509100000000,55,091,"Pepin County, WI",Jul-22,4112,3990,122,3.00000000
CN5509300000000,55,093,"Pierce County, WI",Jul-22,25656,24866,790,3.10000000
CN5509500000000,55,095,"Polk County, WI",Jul-22,24877,24061,816,3.30000000
CN5509700000000,55,097,"Portage County, WI",Jul-22,37091,35871,1220,3.30000000
CN5509900000000,55,099,"Price County, WI",Jul-22,6272,6056,216,3.40000000
CN5510100000000,55,101,"Racine County, WI",Jul-22,99351,95127,4224,4.30000000
CN5510300000000,55,103,"Richland County, WI",Jul-22,9038,8750,288,3.20000000
CN5510500000000,55,105,"Rock County, WI",Jul-22,87149,83742,3407,3.90000000
CN5510700000000,55,107,"Rusk County, WI",Jul-22,6424,6184,240,3.70000000
CN5510900000000,55,109,"St. Croix County, WI",Jul-22,52177,50662,1515,2.90000000
CN5511100000000,55,111,"Sauk County, WI",Jul-22,35482,34402,1080,3.00000000
CN5511300000000,55,113,"Sawyer County, WI",Jul-22,8466,8128,338,4.00000000
CN5511500000000,55,115,"Shawano County, WI",Jul-22,20776,20112,664,3.20000000
CN5511700000000,55,117,"Sheboygan County, WI",Jul-22,62988,61285,1703,2.70000000
CN5511900000000,55,119,"Taylor County, WI",Jul-22,10726,10422,304,2.80000000
CN5512100000000,55,121,"Trempealeau County, WI",Jul-22,14831,14375,456,3.10000000
CN5512300000000,55,123,"Vernon County, WI",Jul-22,15070,14662,408,2.70000000
CN5512500000000,55,125,"Vilas County, WI",Jul-22,11252,10822,430,3.80000000
CN5512700000000,55,127,"Walworth County, WI",Jul-22,57738,55847,1891,3.30000000
CN5512900000000,55,129,"Washburn County, WI",Jul-22,7974,7684,290,3.60000000
CN5513100000000,55,131,"Washington County, WI",Jul-22,77775,75562,2213,2.80000000
CN5513300000000,55,133,"Waukesha County, WI",Jul-22,227476,220768,6708,2.90000000
CN5513500000000,55,135,"Waupaca County, WI",Jul-22,25974,25130,844,3.20000000
CN5513700000000,55,137,"Waushara County, WI",Jul-22,11123,10733,390,3.50000000
CN5513900000000,55,139,"Winnebago County, WI",Jul-22,93267,90446,2821,3.00000000
CN5514100000000,55,141,"Wood County, WI",Jul-22,34291,32989,1302,3.80000000
CN5600100000000,56,001,"Albany County, WY",Jul-22,19995,19452,543,2.70000000
CN5600300000000,56,003,"Big Horn County, WY",Jul-22,5476,5298,178,3.30000000
CN5600500000000,56,005,"Campbell County, WY",Jul-22,21412,20712,700,3.30000000
CN5600700000000,56,007,"Carbon County, WY",Jul-22,7738,7527,211,2.70000000
CN5600900000000,56,009,"Converse County, WY",Jul-22,7460,7253,207,2.80000000
CN5601100000000,56,011,"Crook County, WY",Jul-22,4154,4064,90,2.20000000
CN5601300000000,56,013,"Fremont County, WY",Jul-22,18479,17814,665,3.60000000
CN5601500000000,56,015,"Goshen County, WY",Jul-22,6564,6406,158,2.40000000
CN5601700000000,56,017,"Hot Springs County, WY",Jul-22,2285,2231,54,2.40000000
CN5601900000000,56,019,"Johnson County, WY",Jul-22,4504,4389,115,2.60000000
CN5602100000000,56,021,"Laramie County, WY",Jul-22,49235,47829,1406,2.90000000
CN5602300000000,56,023,"Lincoln County, WY",Jul-22,9577,9329,248,2.60000000
CN5602500000000,56,025,"Natrona County, WY",Jul-22,38281,36894,1387,3.60000000
CN5602700000000,56,027,"Niobrara County, WY",Jul-22,1290,1262,28,2.20000000
CN5602900000000,56,029,"Park County, WY",Jul-22,16928,16490,438,2.60000000
CN5603100000000,56,031,"Platte County, WY",Jul-22,4514,4376,138,3.10000000
CN5603300000000,56,033,"Sheridan County, WY",Jul-22,16266,15824,442,2.70000000
CN5603500000000,56,035,"Sublette County, WY",Jul-22,4132,4001,131,3.20000000
CN5603700000000,56,037,"Sweetwater County, WY",Jul-22,18104,17410,694,3.80000000
CN5603900000000,56,039,"Teton County, WY",Jul-22,18115,17820,295,1.60000000
CN5604100000000,56,041,"Uinta County, WY",Jul-22,8474,8198,276,3.30000000
CN5604300000000,56,043,"Washakie County, WY",Jul-22,3913,3784,129,3.30000000
CN5604500000000,56,045,"Weston County, WY",Jul-22,3630,3549,81,2.20000000
CN7200100000000,72,001,"Adjuntas Municipio, PR",Jul-22,4165,3846,319,7.70000000
CN7200300000000,72,003,"Aguada Municipio, PR",Jul-22,12666,11803,863,6.80000000
CN7200500000000,72,005,"Aguadilla Municipio, PR",Jul-22,15418,14170,1248,8.10000000
CN7200700000000,72,007,"Aguas Buenas Municipio, PR",Jul-22,6965,6504,461,6.60000000
CN7200900000000,72,009,"Aibonito Municipio, PR",Jul-22,6721,6221,500,7.40000000
CN7201100000000,72,011,"Anasco Municipio, PR",Jul-22,9520,8934,586,6.20000000
CN7201300000000,72,013,"Arecibo Municipio, PR",Jul-22,24919,23313,1606,6.40000000
CN7201500000000,72,015,"Arroyo Municipio, PR",Jul-22,4926,4544,382,7.80000000
CN7201700000000,72,017,"Barceloneta Municipio, PR",Jul-22,6273,5782,491,7.80000000
CN7201900000000,72,019,"Barranquitas Municipio, PR",Jul-22,7710,7158,552,7.20000000
CN7202100000000,72,021,"Bayamon Municipio, PR",Jul-22,68973,65701,3272,4.70000000
CN7202300000000,72,023,"Cabo Rojo Municipio, PR",Jul-22,14825,13860,965,6.50000000
CN7202500000000,72,025,"Caguas Municipio, PR",Jul-22,50787,48400,2387,4.70000000
CN7202700000000,72,027,"Camuy Municipio, PR",Jul-22,10047,9406,641,6.40000000
CN7202900000000,72,029,"Canovanas Municipio, PR",Jul-22,17310,16532,778,4.50000000
CN7203100000000,72,031,"Carolina Municipio, PR",Jul-22,65270,62234,3036,4.70000000
CN7203300000000,72,033,"Catano Municipio, PR",Jul-22,8240,7840,400,4.90000000
CN7203500000000,72,035,"Cayey Municipio, PR",Jul-22,17184,16382,802,4.70000000
CN7203700000000,72,037,"Ceiba Municipio, PR",Jul-22,3800,3561,239,6.30000000
CN7203900000000,72,039,"Ciales Municipio, PR",Jul-22,3894,3527,367,9.40000000
CN7204100000000,72,041,"Cidra Municipio, PR",Jul-22,16390,15681,709,4.30000000
CN7204300000000,72,043,"Coamo Municipio, PR",Jul-22,10695,9918,777,7.30000000
CN7204500000000,72,045,"Comerio Municipio, PR",Jul-22,5196,4823,373,7.20000000
CN7204700000000,72,047,"Corozal Municipio, PR",Jul-22,9394,8671,723,7.70000000
CN7204900000000,72,049,"Culebra Municipio, PR",Jul-22,968,947,21,2.20000000
CN7205100000000,72,051,"Dorado Municipio, PR",Jul-22,14321,13758,563,3.90000000
CN7205300000000,72,053,"Fajardo Municipio, PR",Jul-22,11225,10477,748,6.70000000
CN7205400000000,72,054,"Florida Municipio, PR",Jul-22,3476,3195,281,8.10000000
CN7205500000000,72,055,"Guanica Municipio, PR",Jul-22,4004,3622,382,9.50000000
CN7205700000000,72,057,"Guayama Municipio, PR",Jul-22,11656,10863,793,6.80000000
CN7205900000000,72,059,"Guayanilla Municipio, PR",Jul-22,5176,4741,435,8.40000000
CN7206100000000,72,061,"Guaynabo Municipio, PR",Jul-22,40391,39318,1073,2.70000000
CN7206300000000,72,063,"Gurabo Municipio, PR",Jul-22,20024,19240,784,3.90000000
CN7206500000000,72,065,"Hatillo Municipio, PR",Jul-22,14091,13078,1013,7.20000000
CN7206700000000,72,067,"Hormigueros Municipio, PR",Jul-22,5832,5451,381,6.50000000
CN7206900000000,72,069,"Humacao Municipio, PR",Jul-22,18452,17358,1094,5.90000000
CN7207100000000,72,071,"Isabela Municipio, PR",Jul-22,12586,11742,844,6.70000000
CN7207300000000,72,073,"Jayuya Municipio, PR",Jul-22,4375,4032,343,7.80000000
CN7207500000000,72,075,"Juana Diaz Municipio, PR",Jul-22,16465,15438,1027,6.20000000
CN7207700000000,72,077,"Juncos Municipio, PR",Jul-22,13174,12399,775,5.90000000
CN7207900000000,72,079,"Lajas Municipio, PR",Jul-22,5470,4955,515,9.40000000
CN7208100000000,72,081,"Lares Municipio, PR",Jul-22,7234,6359,875,12.10000000
CN7208300000000,72,083,"Las Marias Municipio, PR",Jul-22,2731,2454,277,10.10000000
CN7208500000000,72,085,"Las Piedras Municipio, PR",Jul-22,12198,11471,727,6.00000000
CN7208700000000,72,087,"Loiza Municipio, PR",Jul-22,8815,8314,501,5.70000000
CN7208900000000,72,089,"Luquillo Municipio, PR",Jul-22,6527,6124,403,6.20000000
CN7209100000000,72,091,"Manati Municipio, PR",Jul-22,11902,11211,691,5.80000000
CN7209300000000,72,093,"Maricao Municipio, PR",Jul-22,1987,1799,188,9.50000000
CN7209500000000,72,095,"Maunabo Municipio, PR",Jul-22,2959,2691,268,9.10000000
CN7209700000000,72,097,"Mayaguez Municipio, PR",Jul-22,23138,21514,1624,7.00000000
CN7209900000000,72,099,"Moca Municipio, PR",Jul-22,11165,10266,899,8.10000000
CN7210100000000,72,101,"Morovis Municipio, PR",Jul-22,8598,7970,628,7.30000000
CN7210300000000,72,103,"Naguabo Municipio, PR",Jul-22,8755,8251,504,5.80000000
CN7210500000000,72,105,"Naranjito Municipio, PR",Jul-22,7551,6990,561,7.40000000
CN7210700000000,72,107,"Orocovis Municipio, PR",Jul-22,5150,4710,440,8.50000000
CN7210900000000,72,109,"Patillas Municipio, PR",Jul-22,4384,4005,379,8.60000000
CN7211100000000,72,111,"Penuelas Municipio, PR",Jul-22,6009,5496,513,8.50000000
CN7211300000000,72,113,"Ponce Municipio, PR",Jul-22,48033,44824,3209,6.70000000
CN7211500000000,72,115,"Quebradillas Municipio, PR",Jul-22,6382,5869,513,8.00000000
CN7211700000000,72,117,"Rincon Municipio, PR",Jul-22,4864,4548,316,6.50000000
CN7211900000000,72,119,"Rio Grande Municipio, PR",Jul-22,18094,17090,1004,5.50000000
CN7212100000000,72,121,"Sabana Grande Municipio, PR",Jul-22,6304,5783,521,8.30000000
CN7212300000000,72,123,"Salinas Municipio, PR",Jul-22,7270,6660,610,8.40000000
CN7212500000000,72,125,"San German Municipio, PR",Jul-22,10218,9467,751,7.30000000
CN7212700000000,72,127,"San Juan Municipio, PR",Jul-22,141972,136425,5547,3.90000000
CN7212900000000,72,129,"San Lorenzo Municipio, PR",Jul-22,12299,11545,754,6.10000000
CN7213100000000,72,131,"San Sebastian Municipio, PR",Jul-22,10560,9554,1006,9.50000000
CN7213300000000,72,133,"Santa Isabel Municipio, PR",Jul-22,8021,7399,622,7.80000000
CN7213500000000,72,135,"Toa Alta Municipio, PR",Jul-22,29616,28406,1210,4.10000000
CN7213700000000,72,137,"Toa Baja Municipio, PR",Jul-22,30756,29472,1284,4.20000000
CN7213900000000,72,139,"Trujillo Alto Municipio, PR",Jul-22,28914,27887,1027,3.60000000
CN7214100000000,72,141,"Utuado Municipio, PR",Jul-22,6924,6352,572,8.30000000
CN7214300000000,72,143,"Vega Alta Municipio, PR",Jul-22,10471,9742,729,7.00000000
CN7214500000000,72,145,"Vega Baja Municipio, PR",Jul-22,13897,12840,1057,7.60000000
CN7214700000000,72,147,"Vieques Municipio, PR",Jul-22,2585,2410,175,6.80000000
CN7214900000000,72,149,"Villalba Municipio, PR",Jul-22,7570,6885,685,9.00000000
CN7215100000000,72,151,"Yabucoa Municipio, PR",Jul-22,9018,8323,695,7.70000000
CN7215300000000,72,153,"Yauco Municipio, PR",Jul-22,9987,9090,897,9.00000000
CN0100100000000,01,001,"Autauga County, AL",Aug-22,27351,26683,668,2.40000000
CN0100300000000,01,003,"Baldwin County, AL",Aug-22,102171,99553,2618,2.60000000
CN0100500000000,01,005,"Barbour County, AL",Aug-22,8273,7892,381,4.60000000
CN0100700000000,01,007,"Bibb County, AL",Aug-22,8888,8635,253,2.80000000
CN0100900000000,01,009,"Blount County, AL",Aug-22,26276,25663,613,2.30000000
CN0101100000000,01,011,"Bullock County, AL",Aug-22,4485,4341,144,3.20000000
CN0101300000000,01,013,"Butler County, AL",Aug-22,8819,8451,368,4.20000000
CN0101500000000,01,015,"Calhoun County, AL",Aug-22,47073,45530,1543,3.30000000
CN0101700000000,01,017,"Chambers County, AL",Aug-22,16211,15747,464,2.90000000
CN0101900000000,01,019,"Cherokee County, AL",Aug-22,11771,11492,279,2.40000000
CN0102100000000,01,021,"Chilton County, AL",Aug-22,20627,20145,482,2.30000000
CN0102300000000,01,023,"Choctaw County, AL",Aug-22,4335,4163,172,4.00000000
CN0102500000000,01,025,"Clarke County, AL",Aug-22,7777,7337,440,5.70000000
CN0102700000000,01,027,"Clay County, AL",Aug-22,6162,6011,151,2.50000000
CN0102900000000,01,029,"Cleburne County, AL",Aug-22,6305,6144,161,2.60000000
CN0103100000000,01,031,"Coffee County, AL",Aug-22,21913,21305,608,2.80000000
CN0103300000000,01,033,"Colbert County, AL",Aug-22,23866,23060,806,3.40000000
CN0103500000000,01,035,"Conecuh County, AL",Aug-22,4223,4048,175,4.10000000
CN0103700000000,01,037,"Coosa County, AL",Aug-22,4441,4327,114,2.60000000
CN0103900000000,01,039,"Covington County, AL",Aug-22,15403,14967,436,2.80000000
CN0104100000000,01,041,"Crenshaw County, AL",Aug-22,6169,5990,179,2.90000000
CN0104300000000,01,043,"Cullman County, AL",Aug-22,39685,38818,867,2.20000000
CN0104500000000,01,045,"Dale County, AL",Aug-22,21151,20555,596,2.80000000
CN0104700000000,01,047,"Dallas County, AL",Aug-22,14080,13097,983,7.00000000
CN0104900000000,01,049,"DeKalb County, AL",Aug-22,31347,30572,775,2.50000000
CN0105100000000,01,051,"Elmore County, AL",Aug-22,39025,38086,939,2.40000000
CN0105300000000,01,053,"Escambia County, AL",Aug-22,14244,13756,488,3.40000000
CN0105500000000,01,055,"Etowah County, AL",Aug-22,39809,38514,1295,3.30000000
CN0105700000000,01,057,"Fayette County, AL",Aug-22,6690,6498,192,2.90000000
CN0105900000000,01,059,"Franklin County, AL",Aug-22,14554,14189,365,2.50000000
CN0106100000000,01,061,"Geneva County, AL",Aug-22,11433,11145,288,2.50000000
CN0106300000000,01,063,"Greene County, AL",Aug-22,2748,2604,144,5.20000000
CN0106500000000,01,065,"Hale County, AL",Aug-22,6081,5780,301,4.90000000
CN0106700000000,01,067,"Henry County, AL",Aug-22,7129,6929,200,2.80000000
CN0106900000000,01,069,"Houston County, AL",Aug-22,48390,47006,1384,2.90000000
CN0107100000000,01,071,"Jackson County, AL",Aug-22,23256,22632,624,2.70000000
CN0107300000000,01,073,"Jefferson County, AL",Aug-22,328802,319365,9437,2.90000000
CN0107500000000,01,075,"Lamar County, AL",Aug-22,5810,5664,146,2.50000000
CN0107700000000,01,077,"Lauderdale County, AL",Aug-22,42980,41719,1261,2.90000000
CN0107900000000,01,079,"Lawrence County, AL",Aug-22,14750,14354,396,2.70000000
CN0108100000000,01,081,"Lee County, AL",Aug-22,79672,77551,2121,2.70000000
CN0108300000000,01,083,"Limestone County, AL",Aug-22,48105,47010,1095,2.30000000
CN0108500000000,01,085,"Lowndes County, AL",Aug-22,3659,3392,267,7.30000000
CN0108700000000,01,087,"Macon County, AL",Aug-22,8008,7612,396,4.90000000
CN0108900000000,01,089,"Madison County, AL",Aug-22,198101,193434,4667,2.40000000
CN0109100000000,01,091,"Marengo County, AL",Aug-22,7587,7299,288,3.80000000
CN0109300000000,01,093,"Marion County, AL",Aug-22,13987,13634,353,2.50000000
CN0109500000000,01,095,"Marshall County, AL",Aug-22,45941,44920,1021,2.20000000
CN0109700000000,01,097,"Mobile County, AL",Aug-22,193825,186571,7254,3.70000000
CN0109900000000,01,099,"Monroe County, AL",Aug-22,7467,7123,344,4.60000000
CN0110100000000,01,101,"Montgomery County, AL",Aug-22,109597,105719,3878,3.50000000
CN0110300000000,01,103,"Morgan County, AL",Aug-22,60663,59259,1404,2.30000000
CN0110500000000,01,105,"Perry County, AL",Aug-22,3153,2928,225,7.10000000
CN0110700000000,01,107,"Pickens County, AL",Aug-22,7736,7455,281,3.60000000
CN0110900000000,01,109,"Pike County, AL",Aug-22,16619,16118,501,3.00000000
CN0111100000000,01,111,"Randolph County, AL",Aug-22,9920,9674,246,2.50000000
CN0111300000000,01,113,"Russell County, AL",Aug-22,24175,23499,676,2.80000000
CN0111500000000,01,115,"St. Clair County, AL",Aug-22,42922,41905,1017,2.40000000
CN0111700000000,01,117,"Shelby County, AL",Aug-22,123222,120826,2396,1.90000000
CN0111900000000,01,119,"Sumter County, AL",Aug-22,4606,4430,176,3.80000000
CN0112100000000,01,121,"Talladega County, AL",Aug-22,36202,34942,1260,3.50000000
CN0112300000000,01,123,"Tallapoosa County, AL",Aug-22,18057,17457,600,3.30000000
CN0112500000000,01,125,"Tuscaloosa County, AL",Aug-22,103573,100588,2985,2.90000000
CN0112700000000,01,127,"Walker County, AL",Aug-22,26044,25258,786,3.00000000
CN0112900000000,01,129,"Washington County, AL",Aug-22,6545,6285,260,4.00000000
CN0113100000000,01,131,"Wilcox County, AL",Aug-22,2594,2336,258,9.90000000
CN0113300000000,01,133,"Winston County, AL",Aug-22,10437,10163,274,2.60000000
CN0201300000000,02,013,"Aleutians East Borough, AK",Aug-22,3409,3367,42,1.20000000
CN0201600000000,02,016,"Aleutians West Census Area, AK",Aug-22,3969,3889,80,2.00000000
CN0202000000000,02,020,"Anchorage Borough/municipality, AK",Aug-22,151281,146843,4438,2.90000000
CN0205000000000,02,050,"Bethel Census Area, AK",Aug-22,6730,6093,637,9.50000000
CN0206000000000,02,060,"Bristol Bay Borough, AK",Aug-22,656,643,13,2.00000000
CN0206300000000,02,063,"Chugach Census Area, AK",Aug-22,4199,4095,104,2.50000000
CN0206600000000,02,066,"Copper River Census Area, AK",Aug-22,1682,1574,108,6.40000000
CN0206800000000,02,068,"Denali Borough, AK",Aug-22,1145,1097,48,4.20000000
CN0207000000000,02,070,"Dillingham Census Area, AK",Aug-22,1892,1798,94,5.00000000
CN0209000000000,02,090,"Fairbanks North Star Borough, AK",Aug-22,45840,44503,1337,2.90000000
CN0210000000000,02,100,"Haines Borough, AK",Aug-22,1111,1050,61,5.50000000
CN0210500000000,02,105,"Hoonah-Angoon Census Area, AK",Aug-22,1391,1341,50,3.60000000
CN0211000000000,02,110,"Juneau Borough/city, AK",Aug-22,17666,17266,400,2.30000000
CN0212200000000,02,122,"Kenai Peninsula Borough, AK",Aug-22,29555,28451,1104,3.70000000
CN0213000000000,02,130,"Ketchikan Gateway Borough, AK",Aug-22,7109,6872,237,3.30000000
CN0215000000000,02,150,"Kodiak Island Borough, AK",Aug-22,6511,6321,190,2.90000000
CN0215800000000,02,158,"Kusilvak Census Area, AK",Aug-22,2262,1935,327,14.50000000
CN0216400000000,02,164,"Lake and Peninsula Borough, AK",Aug-22,853,820,33,3.90000000
CN0217000000000,02,170,"Matanuska-Susitna Borough, AK",Aug-22,49713,47724,1989,4.00000000
CN0218000000000,02,180,"Nome Census Area, AK",Aug-22,3901,3608,293,7.50000000
CN0218500000000,02,185,"North Slope Borough, AK",Aug-22,2878,2739,139,4.80000000
CN0218800000000,02,188,"Northwest Arctic Borough, AK",Aug-22,2954,2699,255,8.60000000
CN0219500000000,02,195,"Petersburg Borough, AK",Aug-22,1895,1826,69,3.60000000
CN0219800000000,02,198,"Prince of Wales-Hyder Census Area, AK",Aug-22,2916,2771,145,5.00000000
CN0222000000000,02,220,"Sitka Borough/city, AK",Aug-22,5342,5243,99,1.90000000
CN0223000000000,02,230,"Skagway Municipality, AK",Aug-22,706,673,33,4.70000000
CN0224000000000,02,240,"Southeast Fairbanks Census Area, AK",Aug-22,3263,3123,140,4.30000000
CN0227500000000,02,275,"Wrangell Borough/city, AK",Aug-22,933,895,38,4.10000000
CN0228200000000,02,282,"Yakutat Borough/city, AK",Aug-22,352,339,13,3.70000000
CN0229000000000,02,290,"Yukon-Koyukuk Census Area, AK",Aug-22,2412,2239,173,7.20000000
CN0400100000000,04,001,"Apache County, AZ",Aug-22,18894,17117,1777,9.40000000
CN0400300000000,04,003,"Cochise County, AZ",Aug-22,49248,47058,2190,4.40000000
CN0400500000000,04,005,"Coconino County, AZ",Aug-22,75836,72082,3754,5.00000000
CN0400700000000,04,007,"Gila County, AZ",Aug-22,20600,19727,873,4.20000000
CN0400900000000,04,009,"Graham County, AZ",Aug-22,15809,15259,550,3.50000000
CN0401100000000,04,011,"Greenlee County, AZ",Aug-22,4452,4318,134,3.00000000
CN0401200000000,04,012,"La Paz County, AZ",Aug-22,8769,8313,456,5.20000000
CN0401300000000,04,013,"Maricopa County, AZ",Aug-22,2374758,2294024,80734,3.40000000
CN0401500000000,04,015,"Mohave County, AZ",Aug-22,90347,85927,4420,4.90000000
CN0401700000000,04,017,"Navajo County, AZ",Aug-22,40458,38071,2387,5.90000000
CN0401900000000,04,019,"Pima County, AZ",Aug-22,487185,467859,19326,4.00000000
CN0402100000000,04,021,"Pinal County, AZ",Aug-22,198004,190136,7868,4.00000000
CN0402300000000,04,023,"Santa Cruz County, AZ",Aug-22,19456,17385,2071,10.60000000
CN0402500000000,04,025,"Yavapai County, AZ",Aug-22,109204,105570,3634,3.30000000
CN0402700000000,04,027,"Yuma County, AZ",Aug-22,106346,84206,22140,20.80000000
CN0500100000000,05,001,"Arkansas County, AR",Aug-22,9247,8949,298,3.20000000
CN0500300000000,05,003,"Ashley County, AR",Aug-22,6789,6341,448,6.60000000
CN0500500000000,05,005,"Baxter County, AR",Aug-22,16571,15968,603,3.60000000
CN0500700000000,05,007,"Benton County, AR",Aug-22,148123,144462,3661,2.50000000
CN0500900000000,05,009,"Boone County, AR",Aug-22,15495,15024,471,3.00000000
CN0501100000000,05,011,"Bradley County, AR",Aug-22,4081,3859,222,5.40000000
CN0501300000000,05,013,"Calhoun County, AR",Aug-22,2191,2118,73,3.30000000
CN0501500000000,05,015,"Carroll County, AR",Aug-22,13091,12740,351,2.70000000
CN0501700000000,05,017,"Chicot County, AR",Aug-22,3018,2790,228,7.60000000
CN0501900000000,05,019,"Clark County, AR",Aug-22,8522,8089,433,5.10000000
CN0502100000000,05,021,"Clay County, AR",Aug-22,5573,5369,204,3.70000000
CN0502300000000,05,023,"Cleburne County, AR",Aug-22,8954,8580,374,4.20000000
CN0502500000000,05,025,"Cleveland County, AR",Aug-22,3156,3039,117,3.70000000
CN0502700000000,05,027,"Columbia County, AR",Aug-22,8607,8201,406,4.70000000
CN0502900000000,05,029,"Conway County, AR",Aug-22,8384,8066,318,3.80000000
CN0503100000000,05,031,"Craighead County, AR",Aug-22,56202,54536,1666,3.00000000
CN0503300000000,05,033,"Crawford County, AR",Aug-22,26205,25361,844,3.20000000
CN0503500000000,05,035,"Crittenden County, AR",Aug-22,21042,20050,992,4.70000000
CN0503700000000,05,037,"Cross County, AR",Aug-22,7092,6815,277,3.90000000
CN0503900000000,05,039,"Dallas County, AR",Aug-22,2736,2617,119,4.30000000
CN0504100000000,05,041,"Desha County, AR",Aug-22,4934,4636,298,6.00000000
CN0504300000000,05,043,"Drew County, AR",Aug-22,7498,7139,359,4.80000000
CN0504500000000,05,045,"Faulkner County, AR",Aug-22,62335,60382,1953,3.10000000
CN0504700000000,05,047,"Franklin County, AR",Aug-22,7453,7192,261,3.50000000
CN0504900000000,05,049,"Fulton County, AR",Aug-22,4993,4825,168,3.40000000
CN0505100000000,05,051,"Garland County, AR",Aug-22,41277,39549,1728,4.20000000
CN0505300000000,05,053,"Grant County, AR",Aug-22,8367,8097,270,3.20000000
CN0505500000000,05,055,"Greene County, AR",Aug-22,19486,18876,610,3.10000000
CN0505700000000,05,057,"Hempstead County, AR",Aug-22,9006,8702,304,3.40000000
CN0505900000000,05,059,"Hot Spring County, AR",Aug-22,13468,12948,520,3.90000000
CN0506100000000,05,061,"Howard County, AR",Aug-22,5313,5126,187,3.50000000
CN0506300000000,05,063,"Independence County, AR",Aug-22,15906,15329,577,3.60000000
CN0506500000000,05,065,"Izard County, AR",Aug-22,4413,4159,254,5.80000000
CN0506700000000,05,067,"Jackson County, AR",Aug-22,5616,5331,285,5.10000000
CN0506900000000,05,069,"Jefferson County, AR",Aug-22,26181,24557,1624,6.20000000
CN0507100000000,05,071,"Johnson County, AR",Aug-22,9655,9205,450,4.70000000
CN0507300000000,05,073,"Lafayette County, AR",Aug-22,2300,2197,103,4.50000000
CN0507500000000,05,075,"Lawrence County, AR",Aug-22,6677,6426,251,3.80000000
CN0507700000000,05,077,"Lee County, AR",Aug-22,2644,2517,127,4.80000000
CN0507900000000,05,079,"Lincoln County, AR",Aug-22,3809,3633,176,4.60000000
CN0508100000000,05,081,"Little River County, AR",Aug-22,5342,5134,208,3.90000000
CN0508300000000,05,083,"Logan County, AR",Aug-22,8367,8044,323,3.90000000
CN0508500000000,05,085,"Lonoke County, AR",Aug-22,33931,32930,1001,3.00000000
CN0508700000000,05,087,"Madison County, AR",Aug-22,7747,7560,187,2.40000000
CN0508900000000,05,089,"Marion County, AR",Aug-22,6251,6022,229,3.70000000
CN0509100000000,05,091,"Miller County, AR",Aug-22,19305,18541,764,4.00000000
CN0509300000000,05,093,"Mississippi County, AR",Aug-22,16372,15274,1098,6.70000000
CN0509500000000,05,095,"Monroe County, AR",Aug-22,2581,2471,110,4.30000000
CN0509700000000,05,097,"Montgomery County, AR",Aug-22,2970,2829,141,4.70000000
CN0509900000000,05,099,"Nevada County, AR",Aug-22,3298,3161,137,4.20000000
CN0510100000000,05,101,"Newton County, AR",Aug-22,3151,3062,89,2.80000000
CN0510300000000,05,103,"Ouachita County, AR",Aug-22,8752,8392,360,4.10000000
CN0510500000000,05,105,"Perry County, AR",Aug-22,4201,4045,156,3.70000000
CN0510700000000,05,107,"Phillips County, AR",Aug-22,5602,5166,436,7.80000000
CN0510900000000,05,109,"Pike County, AR",Aug-22,4205,4061,144,3.40000000
CN0511100000000,05,111,"Poinsett County, AR",Aug-22,9856,9501,355,3.60000000
CN0511300000000,05,113,"Polk County, AR",Aug-22,7869,7578,291,3.70000000
CN0511500000000,05,115,"Pope County, AR",Aug-22,26976,25825,1151,4.30000000
CN0511700000000,05,117,"Prairie County, AR",Aug-22,3549,3446,103,2.90000000
CN0511900000000,05,119,"Pulaski County, AR",Aug-22,187152,179931,7221,3.90000000
CN0512100000000,05,121,"Randolph County, AR",Aug-22,7335,7088,247,3.40000000
CN0512300000000,05,123,"St. Francis County, AR",Aug-22,7741,7312,429,5.50000000
CN0512500000000,05,125,"Saline County, AR",Aug-22,59074,57409,1665,2.80000000
CN0512700000000,05,127,"Scott County, AR",Aug-22,4122,4000,122,3.00000000
CN0512900000000,05,129,"Searcy County, AR",Aug-22,2911,2782,129,4.40000000
CN0513100000000,05,131,"Sebastian County, AR",Aug-22,55006,53247,1759,3.20000000
CN0513300000000,05,133,"Sevier County, AR",Aug-22,5411,5194,217,4.00000000
CN0513500000000,05,135,"Sharp County, AR",Aug-22,5556,5316,240,4.30000000
CN0513700000000,05,137,"Stone County, AR",Aug-22,4703,4513,190,4.00000000
CN0513900000000,05,139,"Union County, AR",Aug-22,14710,13910,800,5.40000000
CN0514100000000,05,141,"Van Buren County, AR",Aug-22,5890,5633,257,4.40000000
CN0514300000000,05,143,"Washington County, AR",Aug-22,131006,127802,3204,2.40000000
CN0514500000000,05,145,"White County, AR",Aug-22,33888,32691,1197,3.50000000
CN0514700000000,05,147,"Woodruff County, AR",Aug-22,2845,2736,109,3.80000000
CN0514900000000,05,149,"Yell County, AR",Aug-22,7830,7514,316,4.00000000
CN0600100000000,06,001,"Alameda County, CA",Aug-22,831329,805176,26153,3.10000000
CN0600300000000,06,003,"Alpine County, CA",Aug-22,463,438,25,5.40000000
CN0600500000000,06,005,"Amador County, CA",Aug-22,14534,13950,584,4.00000000
CN0600700000000,06,007,"Butte County, CA",Aug-22,92118,88289,3829,4.20000000
CN0600900000000,06,009,"Calaveras County, CA",Aug-22,22326,21614,712,3.20000000
CN0601100000000,06,011,"Colusa County, CA",Aug-22,11577,10706,871,7.50000000
CN0601300000000,06,013,"Contra Costa County, CA",Aug-22,555434,536759,18675,3.40000000
CN0601500000000,06,015,"Del Norte County, CA",Aug-22,9579,9126,453,4.70000000
CN0601700000000,06,017,"El Dorado County, CA",Aug-22,92836,90052,2784,3.00000000
CN0601900000000,06,019,"Fresno County, CA",Aug-22,457252,430358,26894,5.90000000
CN0602100000000,06,021,"Glenn County, CA",Aug-22,12756,12119,637,5.00000000
CN0602300000000,06,023,"Humboldt County, CA",Aug-22,59807,57590,2217,3.70000000
CN0602500000000,06,025,"Imperial County, CA",Aug-22,70628,58969,11659,16.50000000
CN0602700000000,06,027,"Inyo County, CA",Aug-22,8380,8117,263,3.10000000
CN0602900000000,06,029,"Kern County, CA",Aug-22,392675,366354,26321,6.70000000
CN0603100000000,06,031,"Kings County, CA",Aug-22,56332,52780,3552,6.30000000
CN0603300000000,06,033,"Lake County, CA",Aug-22,29590,28282,1308,4.40000000
CN0603500000000,06,035,"Lassen County, CA",Aug-22,9133,8793,340,3.70000000
CN0603700000000,06,037,"Los Angeles County, CA",Aug-22,4927912,4697244,230668,4.70000000
CN0603900000000,06,039,"Madera County, CA",Aug-22,63601,60059,3542,5.60000000
CN0604100000000,06,041,"Marin County, CA",Aug-22,131202,128071,3131,2.40000000
CN0604300000000,06,043,"Mariposa County, CA",Aug-22,7546,7248,298,3.90000000
CN0604500000000,06,045,"Mendocino County, CA",Aug-22,38398,37067,1331,3.50000000
CN0604700000000,06,047,"Merced County, CA",Aug-22,117104,109120,7984,6.80000000
CN0604900000000,06,049,"Modoc County, CA",Aug-22,3315,3182,133,4.00000000
CN0605100000000,06,051,"Mono County, CA",Aug-22,8951,8640,311,3.50000000
CN0605300000000,06,053,"Monterey County, CA",Aug-22,221452,211620,9832,4.40000000
CN0605500000000,06,055,"Napa County, CA",Aug-22,70399,68388,2011,2.90000000
CN0605700000000,06,057,"Nevada County, CA",Aug-22,48642,47172,1470,3.00000000
CN0605900000000,06,059,"Orange County, CA",Aug-22,1596293,1547833,48460,3.00000000
CN0606100000000,06,061,"Placer County, CA",Aug-22,192805,187470,5335,2.80000000
CN0606300000000,06,063,"Plumas County, CA",Aug-22,7725,7338,387,5.00000000
CN0606500000000,06,065,"Riverside County, CA",Aug-22,1165166,1114925,50241,4.30000000
CN0606700000000,06,067,"Sacramento County, CA",Aug-22,725469,697330,28139,3.90000000
CN0606900000000,06,069,"San Benito County, CA",Aug-22,33182,31767,1415,4.30000000
CN0607100000000,06,071,"San Bernardino County, CA",Aug-22,1019574,976903,42671,4.20000000
CN0607300000000,06,073,"San Diego County, CA",Aug-22,1585226,1531774,53452,3.40000000
CN0607500000000,06,075,"San Francisco County/city, CA",Aug-22,579398,565810,13588,2.30000000
CN0607700000000,06,077,"San Joaquin County, CA",Aug-22,337981,320326,17655,5.20000000
CN0607900000000,06,079,"San Luis Obispo County, CA",Aug-22,136077,132325,3752,2.80000000
CN0608100000000,06,081,"San Mateo County, CA",Aug-22,458355,448496,9859,2.20000000
CN0608300000000,06,083,"Santa Barbara County, CA",Aug-22,226101,219484,6617,2.90000000
CN0608500000000,06,085,"Santa Clara County, CA",Aug-22,1059257,1034583,24674,2.30000000
CN0608700000000,06,087,"Santa Cruz County, CA",Aug-22,138418,133168,5250,3.80000000
CN0608900000000,06,089,"Shasta County, CA",Aug-22,72750,69680,3070,4.20000000
CN0609100000000,06,091,"Sierra County, CA",Aug-22,1392,1349,43,3.10000000
CN0609300000000,06,093,"Siskiyou County, CA",Aug-22,16518,15719,799,4.80000000
CN0609500000000,06,095,"Solano County, CA",Aug-22,202038,193533,8505,4.20000000
CN0609700000000,06,097,"Sonoma County, CA",Aug-22,251146,244079,7067,2.80000000
CN0609900000000,06,099,"Stanislaus County, CA",Aug-22,243307,230667,12640,5.20000000
CN0610100000000,06,101,"Sutter County, CA",Aug-22,46630,44013,2617,5.60000000
CN0610300000000,06,103,"Tehama County, CA",Aug-22,25960,24787,1173,4.50000000
CN0610500000000,06,105,"Trinity County, CA",Aug-22,4668,4501,167,3.60000000
CN0610700000000,06,107,"Tulare County, CA",Aug-22,206929,190405,16524,8.00000000
CN0610900000000,06,109,"Tuolumne County, CA",Aug-22,20092,19256,836,4.20000000
CN0611100000000,06,111,"Ventura County, CA",Aug-22,411541,397092,14449,3.50000000
CN0611300000000,06,113,"Yolo County, CA",Aug-22,109252,105500,3752,3.40000000
CN0611500000000,06,115,"Yuba County, CA",Aug-22,31101,29455,1646,5.30000000
CN0800100000000,08,001,"Adams County, CO",Aug-22,286357,275367,10990,3.80000000
CN0800300000000,08,003,"Alamosa County, CO",Aug-22,8713,8386,327,3.80000000
CN0800500000000,08,005,"Arapahoe County, CO",Aug-22,380284,366975,13309,3.50000000
CN0800700000000,08,007,"Archuleta County, CO",Aug-22,7499,7276,223,3.00000000
CN0800900000000,08,009,"Baca County, CO",Aug-22,2202,2165,37,1.70000000
CN0801100000000,08,011,"Bent County, CO",Aug-22,2010,1934,76,3.80000000
CN0801300000000,08,013,"Boulder County, CO",Aug-22,203963,198619,5344,2.60000000
CN0801400000000,08,014,"Broomfield County/city, CO",Aug-22,42979,41781,1198,2.80000000
CN0801500000000,08,015,"Chaffee County, CO",Aug-22,11121,10854,267,2.40000000
CN0801700000000,08,017,"Cheyenne County, CO",Aug-22,1154,1131,23,2.00000000
CN0801900000000,08,019,"Clear Creek County, CO",Aug-22,6249,6032,217,3.50000000
CN0802100000000,08,021,"Conejos County, CO",Aug-22,4250,4106,144,3.40000000
CN0802300000000,08,023,"Costilla County, CO",Aug-22,1951,1869,82,4.20000000
CN0802500000000,08,025,"Crowley County, CO",Aug-22,1481,1420,61,4.10000000
CN0802700000000,08,027,"Custer County, CO",Aug-22,2627,2561,66,2.50000000
CN0802900000000,08,029,"Delta County, CO",Aug-22,14477,13968,509,3.50000000
CN0803100000000,08,031,"Denver County/city, CO",Aug-22,442436,426646,15790,3.60000000
CN0803300000000,08,033,"Dolores County, CO",Aug-22,1209,1175,34,2.80000000
CN0803500000000,08,035,"Douglas County, CO",Aug-22,209966,204399,5567,2.70000000
CN0803700000000,08,037,"Eagle County, CO",Aug-22,38952,38048,904,2.30000000
CN0803900000000,08,039,"Elbert County, CO",Aug-22,16276,15863,413,2.50000000
CN0804100000000,08,041,"El Paso County, CO",Aug-22,359532,346366,13166,3.70000000
CN0804300000000,08,043,"Fremont County, CO",Aug-22,16223,15433,790,4.90000000
CN0804500000000,08,045,"Garfield County, CO",Aug-22,33584,32656,928,2.80000000
CN0804700000000,08,047,"Gilpin County, CO",Aug-22,3982,3855,127,3.20000000
CN0804900000000,08,049,"Grand County, CO",Aug-22,10663,10408,255,2.40000000
CN0805100000000,08,051,"Gunnison County, CO",Aug-22,12331,12073,258,2.10000000
CN0805300000000,08,053,"Hinsdale County, CO",Aug-22,603,592,11,1.80000000
CN0805500000000,08,055,"Huerfano County, CO",Aug-22,2698,2511,187,6.90000000
CN0805700000000,08,057,"Jackson County, CO",Aug-22,1081,1062,19,1.80000000
CN0805900000000,08,059,"Jefferson County, CO",Aug-22,346968,336461,10507,3.00000000
CN0806100000000,08,061,"Kiowa County, CO",Aug-22,960,944,16,1.70000000
CN0806300000000,08,063,"Kit Carson County, CO",Aug-22,4332,4252,80,1.80000000
CN0806500000000,08,065,"Lake County, CO",Aug-22,5197,5065,132,2.50000000
CN0806700000000,08,067,"La Plata County, CO",Aug-22,32993,32045,948,2.90000000
CN0806900000000,08,069,"Larimer County, CO",Aug-22,213800,207724,6076,2.80000000
CN0807100000000,08,071,"Las Animas County, CO",Aug-22,6567,6223,344,5.20000000
CN0807300000000,08,073,"Lincoln County, CO",Aug-22,2398,2330,68,2.80000000
CN0807500000000,08,075,"Logan County, CO",Aug-22,10794,10477,317,2.90000000
CN0807700000000,08,077,"Mesa County, CO",Aug-22,78420,75594,2826,3.60000000
CN0807900000000,08,079,"Mineral County, CO",Aug-22,464,450,14,3.00000000
CN0808100000000,08,081,"Moffat County, CO",Aug-22,7117,6916,201,2.80000000
CN0808300000000,08,083,"Montezuma County, CO",Aug-22,13977,13503,474,3.40000000
CN0808500000000,08,085,"Montrose County, CO",Aug-22,23527,22804,723,3.10000000
CN0808700000000,08,087,"Morgan County, CO",Aug-22,16543,15993,550,3.30000000
CN0808900000000,08,089,"Otero County, CO",Aug-22,8457,8086,371,4.40000000
CN0809100000000,08,091,"Ouray County, CO",Aug-22,3195,3116,79,2.50000000
CN0809300000000,08,093,"Park County, CO",Aug-22,11740,11418,322,2.70000000
CN0809500000000,08,095,"Phillips County, CO",Aug-22,2689,2638,51,1.90000000
CN0809700000000,08,097,"Pitkin County, CO",Aug-22,11431,11112,319,2.80000000
CN0809900000000,08,099,"Prowers County, CO",Aug-22,6500,6315,185,2.80000000
CN0810100000000,08,101,"Pueblo County, CO",Aug-22,78751,74502,4249,5.40000000
CN0810300000000,08,103,"Rio Blanco County, CO",Aug-22,2942,2822,120,4.10000000
CN0810500000000,08,105,"Rio Grande County, CO",Aug-22,5819,5545,274,4.70000000
CN0810700000000,08,107,"Routt County, CO",Aug-22,16563,16172,391,2.40000000
CN0810900000000,08,109,"Saguache County, CO",Aug-22,3644,3511,133,3.60000000
CN0811100000000,08,111,"San Juan County, CO",Aug-22,830,817,13,1.60000000
CN0811300000000,08,113,"San Miguel County, CO",Aug-22,6875,6723,152,2.20000000
CN0811500000000,08,115,"Sedgwick County, CO",Aug-22,1256,1229,27,2.10000000
CN0811700000000,08,117,"Summit County, CO",Aug-22,23053,22538,515,2.20000000
CN0811900000000,08,119,"Teller County, CO",Aug-22,13388,12951,437,3.30000000
CN0812100000000,08,121,"Washington County, CO",Aug-22,2879,2813,66,2.30000000
CN0812300000000,08,123,"Weld County, CO",Aug-22,170124,163980,6144,3.60000000
CN0812500000000,08,125,"Yuma County, CO",Aug-22,6099,5980,119,2.00000000
CN0900100000000,09,001,"Fairfield County, CT",Aug-22,483843,463318,20525,4.20000000
CN0900300000000,09,003,"Hartford County, CT",Aug-22,476654,455289,21365,4.50000000
CN0900500000000,09,005,"Litchfield County, CT",Aug-22,104307,100497,3810,3.70000000
CN0900700000000,09,007,"Middlesex County, CT",Aug-22,92990,89719,3271,3.50000000
CN0900900000000,09,009,"New Haven County, CT",Aug-22,465420,444011,21409,4.60000000
CN0901100000000,09,011,"New London County, CT",Aug-22,133499,127551,5948,4.50000000
CN0901300000000,09,013,"Tolland County, CT",Aug-22,85863,82631,3232,3.80000000
CN0901500000000,09,015,"Windham County, CT",Aug-22,63840,60966,2874,4.50000000
CN1000100000000,10,001,"Kent County, DE",Aug-22,81010,76388,4622,5.70000000
CN1000300000000,10,003,"New Castle County, DE",Aug-22,303413,289585,13828,4.60000000
CN1000500000000,10,005,"Sussex County, DE",Aug-22,116603,112098,4505,3.90000000
CN1100100000000,11,001,District of Columbia,Aug-22,391193,373359,17834,4.60000000
CN1200100000000,12,001,"Alachua County, FL",Aug-22,140195,136471,3724,2.70000000
CN1200300000000,12,003,"Baker County, FL",Aug-22,12757,12423,334,2.60000000
CN1200500000000,12,005,"Bay County, FL",Aug-22,90629,88410,2219,2.40000000
CN1200700000000,12,007,"Bradford County, FL",Aug-22,11205,10861,344,3.10000000
CN1200900000000,12,009,"Brevard County, FL",Aug-22,299903,291870,8033,2.70000000
CN1201100000000,12,011,"Broward County, FL",Aug-22,1078878,1048459,30419,2.80000000
CN1201300000000,12,013,"Calhoun County, FL",Aug-22,4951,4804,147,3.00000000
CN1201500000000,12,015,"Charlotte County, FL",Aug-22,76358,73986,2372,3.10000000
CN1201700000000,12,017,"Citrus County, FL",Aug-22,47661,45650,2011,4.20000000
CN1201900000000,12,019,"Clay County, FL",Aug-22,114005,111132,2873,2.50000000
CN1202100000000,12,021,"Collier County, FL",Aug-22,186879,181663,5216,2.80000000
CN1202300000000,12,023,"Columbia County, FL",Aug-22,29675,28769,906,3.10000000
CN1202700000000,12,027,"DeSoto County, FL",Aug-22,15302,14878,424,2.80000000
CN1202900000000,12,029,"Dixie County, FL",Aug-22,5993,5824,169,2.80000000
CN1203100000000,12,031,"Duval County, FL",Aug-22,518397,502616,15781,3.00000000
CN1203300000000,12,033,"Escambia County, FL",Aug-22,152349,147997,4352,2.90000000
CN1203500000000,12,035,"Flagler County, FL",Aug-22,50927,49319,1608,3.20000000
CN1203700000000,12,037,"Franklin County, FL",Aug-22,4874,4757,117,2.40000000
CN1203900000000,12,039,"Gadsden County, FL",Aug-22,20589,19866,723,3.50000000
CN1204100000000,12,041,"Gilchrist County, FL",Aug-22,7292,7080,212,2.90000000
CN1204300000000,12,043,"Glades County, FL",Aug-22,5183,5015,168,3.20000000
CN1204500000000,12,045,"Gulf County, FL",Aug-22,5582,5441,141,2.50000000
CN1204700000000,12,047,"Hamilton County, FL",Aug-22,4211,4048,163,3.90000000
CN1204900000000,12,049,"Hardee County, FL",Aug-22,9000,8653,347,3.90000000
CN1205100000000,12,051,"Hendry County, FL",Aug-22,15996,15102,894,5.60000000
CN1205300000000,12,053,"Hernando County, FL",Aug-22,77056,74374,2682,3.50000000
CN1205500000000,12,055,"Highlands County, FL",Aug-22,34354,32839,1515,4.40000000
CN1205700000000,12,057,"Hillsborough County, FL",Aug-22,805138,783557,21581,2.70000000
CN1205900000000,12,059,"Holmes County, FL",Aug-22,7141,6938,203,2.80000000
CN1206100000000,12,061,"Indian River County, FL",Aug-22,67557,65234,2323,3.40000000
CN1206300000000,12,063,"Jackson County, FL",Aug-22,17131,16624,507,3.00000000
CN1206500000000,12,065,"Jefferson County, FL",Aug-22,5794,5604,190,3.30000000
CN1206700000000,12,067,"Lafayette County, FL",Aug-22,2811,2728,83,3.00000000
CN1206900000000,12,069,"Lake County, FL",Aug-22,170156,165238,4918,2.90000000
CN1207100000000,12,071,"Lee County, FL",Aug-22,371020,360837,10183,2.70000000
CN1207300000000,12,073,"Leon County, FL",Aug-22,158888,154429,4459,2.80000000
CN1207500000000,12,075,"Levy County, FL",Aug-22,17218,16671,547,3.20000000
CN1207700000000,12,077,"Liberty County, FL",Aug-22,2596,2518,78,3.00000000
CN1207900000000,12,079,"Madison County, FL",Aug-22,8088,7842,246,3.00000000
CN1208100000000,12,081,"Manatee County, FL",Aug-22,192276,187121,5155,2.70000000
CN1208300000000,12,083,"Marion County, FL",Aug-22,144968,139967,5001,3.40000000
CN1208500000000,12,085,"Martin County, FL",Aug-22,76580,74581,1999,2.60000000
CN1208600000000,12,086,"Miami-Dade County, FL",Aug-22,1380890,1340712,40178,2.90000000
CN1208700000000,12,087,"Monroe County, FL",Aug-22,50991,50135,856,1.70000000
CN1208900000000,12,089,"Nassau County, FL",Aug-22,45114,44048,1066,2.40000000
CN1209100000000,12,091,"Okaloosa County, FL",Aug-22,104164,101840,2324,2.20000000
CN1209300000000,12,093,"Okeechobee County, FL",Aug-22,17631,17102,529,3.00000000
CN1209500000000,12,095,"Orange County, FL",Aug-22,787618,764734,22884,2.90000000
CN1209700000000,12,097,"Osceola County, FL",Aug-22,196647,189589,7058,3.60000000
CN1209900000000,12,099,"Palm Beach County, FL",Aug-22,768051,745985,22066,2.90000000
CN1210100000000,12,101,"Pasco County, FL",Aug-22,258821,251282,7539,2.90000000
CN1210300000000,12,103,"Pinellas County, FL",Aug-22,511130,498196,12934,2.50000000
CN1210500000000,12,105,"Polk County, FL",Aug-22,339572,327591,11981,3.50000000
CN1210700000000,12,107,"Putnam County, FL",Aug-22,27805,26685,1120,4.00000000
CN1210900000000,12,109,"St. Johns County, FL",Aug-22,150057,146848,3209,2.10000000
CN1211100000000,12,111,"St. Lucie County, FL",Aug-22,156096,150819,5277,3.40000000
CN1211300000000,12,113,"Santa Rosa County, FL",Aug-22,89174,87019,2155,2.40000000
CN1211500000000,12,115,"Sarasota County, FL",Aug-22,201690,196452,5238,2.60000000
CN1211700000000,12,117,"Seminole County, FL",Aug-22,261879,255104,6775,2.60000000
CN1211900000000,12,119,"Sumter County, FL",Aug-22,36372,34915,1457,4.00000000
CN1212100000000,12,121,"Suwannee County, FL",Aug-22,17619,17080,539,3.10000000
CN1212300000000,12,123,"Taylor County, FL",Aug-22,7999,7747,252,3.20000000
CN1212500000000,12,125,"Union County, FL",Aug-22,4691,4564,127,2.70000000
CN1212700000000,12,127,"Volusia County, FL",Aug-22,268526,260491,8035,3.00000000
CN1212900000000,12,129,"Wakulla County, FL",Aug-22,16043,15674,369,2.30000000
CN1213100000000,12,131,"Walton County, FL",Aug-22,35320,34476,844,2.40000000
CN1213300000000,12,133,"Washington County, FL",Aug-22,9920,9629,291,2.90000000
CN1300100000000,13,001,"Appling County, GA",Aug-22,8971,8628,343,3.80000000
CN1300300000000,13,003,"Atkinson County, GA",Aug-22,4499,4379,120,2.70000000
CN1300500000000,13,005,"Bacon County, GA",Aug-22,4660,4515,145,3.10000000
CN1300700000000,13,007,"Baker County, GA",Aug-22,1099,1051,48,4.40000000
CN1300900000000,13,009,"Baldwin County, GA",Aug-22,17668,16937,731,4.10000000
CN1301100000000,13,011,"Banks County, GA",Aug-22,10043,9802,241,2.40000000
CN1301300000000,13,013,"Barrow County, GA",Aug-22,43121,42028,1093,2.50000000
CN1301500000000,13,015,"Bartow County, GA",Aug-22,52306,50824,1482,2.80000000
CN1301700000000,13,017,"Ben Hill County, GA",Aug-22,5459,5213,246,4.50000000
CN1301900000000,13,019,"Berrien County, GA",Aug-22,7491,7245,246,3.30000000
CN1302100000000,13,021,"Bibb County, GA",Aug-22,67734,65187,2547,3.80000000
CN1302300000000,13,023,"Bleckley County, GA",Aug-22,4540,4330,210,4.60000000
CN1302500000000,13,025,"Brantley County, GA",Aug-22,7450,7188,262,3.50000000
CN1302700000000,13,027,"Brooks County, GA",Aug-22,6667,6457,210,3.10000000
CN1302900000000,13,029,"Bryan County, GA",Aug-22,20273,19755,518,2.60000000
CN1303100000000,13,031,"Bulloch County, GA",Aug-22,37277,35932,1345,3.60000000
CN1303300000000,13,033,"Burke County, GA",Aug-22,8981,8508,473,5.30000000
CN1303500000000,13,035,"Butts County, GA",Aug-22,11336,11017,319,2.80000000
CN1303700000000,13,037,"Calhoun County, GA",Aug-22,2140,2060,80,3.70000000
CN1303900000000,13,039,"Camden County, GA",Aug-22,21844,21191,653,3.00000000
CN1304300000000,13,043,"Candler County, GA",Aug-22,5996,5847,149,2.50000000
CN1304500000000,13,045,"Carroll County, GA",Aug-22,57437,55657,1780,3.10000000
CN1304700000000,13,047,"Catoosa County, GA",Aug-22,33287,32418,869,2.60000000
CN1304900000000,13,049,"Charlton County, GA",Aug-22,4940,4782,158,3.20000000
CN1305100000000,13,051,"Chatham County, GA",Aug-22,145166,140691,4475,3.10000000
CN1305300000000,13,053,"Chattahoochee County, GA",Aug-22,1906,1815,91,4.80000000
CN1305500000000,13,055,"Chattooga County, GA",Aug-22,9187,8806,381,4.10000000
CN1305700000000,13,057,"Cherokee County, GA",Aug-22,143295,139900,3395,2.40000000
CN1305900000000,13,059,"Clarke County, GA",Aug-22,60676,58712,1964,3.20000000
CN1306100000000,13,061,"Clay County, GA",Aug-22,833,764,69,8.30000000
CN1306300000000,13,063,"Clayton County, GA",Aug-22,141007,134778,6229,4.40000000
CN1306500000000,13,065,"Clinch County, GA",Aug-22,2943,2860,83,2.80000000
CN1306700000000,13,067,"Cobb County, GA",Aug-22,432986,421630,11356,2.60000000
CN1306900000000,13,069,"Coffee County, GA",Aug-22,17984,17348,636,3.50000000
CN1307100000000,13,071,"Colquitt County, GA",Aug-22,21566,20922,644,3.00000000
CN1307300000000,13,073,"Columbia County, GA",Aug-22,76171,74012,2159,2.80000000
CN1307500000000,13,075,"Cook County, GA",Aug-22,8158,7902,256,3.10000000
CN1307700000000,13,077,"Coweta County, GA",Aug-22,77866,75756,2110,2.70000000
CN1307900000000,13,079,"Crawford County, GA",Aug-22,5532,5357,175,3.20000000
CN1308100000000,13,081,"Crisp County, GA",Aug-22,9254,8759,495,5.30000000
CN1308300000000,13,083,"Dade County, GA",Aug-22,8099,7896,203,2.50000000
CN1308500000000,13,085,"Dawson County, GA",Aug-22,13493,13168,325,2.40000000
CN1308700000000,13,087,"Decatur County, GA",Aug-22,11086,10692,394,3.60000000
CN1308900000000,13,089,"DeKalb County, GA",Aug-22,406414,393416,12998,3.20000000
CN1309100000000,13,091,"Dodge County, GA",Aug-22,6996,6743,253,3.60000000
CN1309300000000,13,093,"Dooly County, GA",Aug-22,4613,4385,228,4.90000000
CN1309500000000,13,095,"Dougherty County, GA",Aug-22,36830,34982,1848,5.00000000
CN1309700000000,13,097,"Douglas County, GA",Aug-22,75376,72873,2503,3.30000000
CN1309900000000,13,099,"Early County, GA",Aug-22,4154,3989,165,4.00000000
CN1310100000000,13,101,"Echols County, GA",Aug-22,1833,1788,45,2.50000000
CN1310300000000,13,103,"Effingham County, GA",Aug-22,33803,32955,848,2.50000000
CN1310500000000,13,105,"Elbert County, GA",Aug-22,7618,7325,293,3.80000000
CN1310700000000,13,107,"Emanuel County, GA",Aug-22,8518,8145,373,4.40000000
CN1310900000000,13,109,"Evans County, GA",Aug-22,5166,5008,158,3.10000000
CN1311100000000,13,111,"Fannin County, GA",Aug-22,12004,11675,329,2.70000000
CN1311300000000,13,113,"Fayette County, GA",Aug-22,59643,58095,1548,2.60000000
CN1311500000000,13,115,"Floyd County, GA",Aug-22,43637,42292,1345,3.10000000
CN1311700000000,13,117,"Forsyth County, GA",Aug-22,130572,127486,3086,2.40000000
CN1311900000000,13,119,"Franklin County, GA",Aug-22,10043,9728,315,3.10000000
CN1312100000000,13,121,"Fulton County, GA",Aug-22,577568,558533,19035,3.30000000
CN1312300000000,13,123,"Gilmer County, GA",Aug-22,12368,11994,374,3.00000000
CN1312500000000,13,125,"Glascock County, GA",Aug-22,1252,1212,40,3.20000000
CN1312700000000,13,127,"Glynn County, GA",Aug-22,39656,38493,1163,2.90000000
CN1312900000000,13,129,"Gordon County, GA",Aug-22,29038,28258,780,2.70000000
CN1313100000000,13,131,"Grady County, GA",Aug-22,10942,10610,332,3.00000000
CN1313300000000,13,133,"Greene County, GA",Aug-22,7250,7018,232,3.20000000
CN1313500000000,13,135,"Gwinnett County, GA",Aug-22,503224,489536,13688,2.70000000
CN1313700000000,13,137,"Habersham County, GA",Aug-22,18337,17761,576,3.10000000
CN1313900000000,13,139,"Hall County, GA",Aug-22,105770,103129,2641,2.50000000
CN1314100000000,13,141,"Hancock County, GA",Aug-22,2477,2344,133,5.40000000
CN1314300000000,13,143,"Haralson County, GA",Aug-22,13068,12685,383,2.90000000
CN1314500000000,13,145,"Harris County, GA",Aug-22,16887,16408,479,2.80000000
CN1314700000000,13,147,"Hart County, GA",Aug-22,11644,11276,368,3.20000000
CN1314900000000,13,149,"Heard County, GA",Aug-22,5334,5175,159,3.00000000
CN1315100000000,13,151,"Henry County, GA",Aug-22,120597,116754,3843,3.20000000
CN1315300000000,13,153,"Houston County, GA",Aug-22,70909,68678,2231,3.10000000
CN1315500000000,13,155,"Irwin County, GA",Aug-22,3443,3302,141,4.10000000
CN1315700000000,13,157,"Jackson County, GA",Aug-22,44039,43102,937,2.10000000
CN1315900000000,13,159,"Jasper County, GA",Aug-22,7214,7027,187,2.60000000
CN1316100000000,13,161,"Jeff Davis County, GA",Aug-22,6114,5889,225,3.70000000
CN1316300000000,13,163,"Jefferson County, GA",Aug-22,6963,6690,273,3.90000000
CN1316500000000,13,165,"Jenkins County, GA",Aug-22,3132,2991,141,4.50000000
CN1316700000000,13,167,"Johnson County, GA",Aug-22,3983,3868,115,2.90000000
CN1316900000000,13,169,"Jones County, GA",Aug-22,13751,13359,392,2.90000000
CN1317100000000,13,171,"Lamar County, GA",Aug-22,8429,8156,273,3.20000000
CN1317300000000,13,173,"Lanier County, GA",Aug-22,3795,3663,132,3.50000000
CN1317500000000,13,175,"Laurens County, GA",Aug-22,19122,18385,737,3.90000000
CN1317700000000,13,177,"Lee County, GA",Aug-22,15074,14656,418,2.80000000
CN1317900000000,13,179,"Liberty County, GA",Aug-22,26018,25149,869,3.30000000
CN1318100000000,13,181,"Lincoln County, GA",Aug-22,3501,3374,127,3.60000000
CN1318300000000,13,183,"Long County, GA",Aug-22,8412,8150,262,3.10000000
CN1318500000000,13,185,"Lowndes County, GA",Aug-22,50581,48927,1654,3.30000000
CN1318700000000,13,187,"Lumpkin County, GA",Aug-22,17687,17226,461,2.60000000
CN1318900000000,13,189,"McDuffie County, GA",Aug-22,8413,8037,376,4.50000000
CN1319100000000,13,191,"McIntosh County, GA",Aug-22,6175,5978,197,3.20000000
CN1319300000000,13,193,"Macon County, GA",Aug-22,4475,4270,205,4.60000000
CN1319500000000,13,195,"Madison County, GA",Aug-22,14005,13628,377,2.70000000
CN1319700000000,13,197,"Marion County, GA",Aug-22,3266,3146,120,3.70000000
CN1319900000000,13,199,"Meriwether County, GA",Aug-22,9064,8669,395,4.40000000
CN1320100000000,13,201,"Miller County, GA",Aug-22,2666,2593,73,2.70000000
CN1320500000000,13,205,"Mitchell County, GA",Aug-22,7965,7528,437,5.50000000
CN1320700000000,13,207,"Monroe County, GA",Aug-22,13245,12867,378,2.90000000
CN1320900000000,13,209,"Montgomery County, GA",Aug-22,3691,3541,150,4.10000000
CN1321100000000,13,211,"Morgan County, GA",Aug-22,9727,9471,256,2.60000000
CN1321300000000,13,213,"Murray County, GA",Aug-22,15258,14711,547,3.60000000
CN1321500000000,13,215,"Muscogee County, GA",Aug-22,76029,72655,3374,4.40000000
CN1321700000000,13,217,"Newton County, GA",Aug-22,54383,52498,1885,3.50000000
CN1321900000000,13,219,"Oconee County, GA",Aug-22,20981,20509,472,2.20000000
CN1322100000000,13,221,"Oglethorpe County, GA",Aug-22,7192,7003,189,2.60000000
CN1322300000000,13,223,"Paulding County, GA",Aug-22,91509,89088,2421,2.60000000
CN1322500000000,13,225,"Peach County, GA",Aug-22,11866,11418,448,3.80000000
CN1322700000000,13,227,"Pickens County, GA",Aug-22,15955,15538,417,2.60000000
CN1322900000000,13,229,"Pierce County, GA",Aug-22,8532,8282,250,2.90000000
CN1323100000000,13,231,"Pike County, GA",Aug-22,9229,8987,242,2.60000000
CN1323300000000,13,233,"Polk County, GA",Aug-22,18436,17851,585,3.20000000
CN1323500000000,13,235,"Pulaski County, GA",Aug-22,4001,3875,126,3.10000000
CN1323700000000,13,237,"Putnam County, GA",Aug-22,8724,8421,303,3.50000000
CN1323900000000,13,239,"Quitman County, GA",Aug-22,740,700,40,5.40000000
CN1324100000000,13,241,"Rabun County, GA",Aug-22,7743,7519,224,2.90000000
CN1324300000000,13,243,"Randolph County, GA",Aug-22,2317,2206,111,4.80000000
CN1324500000000,13,245,"Richmond County, GA",Aug-22,82851,79201,3650,4.40000000
CN1324700000000,13,247,"Rockdale County, GA",Aug-22,45360,43782,1578,3.50000000
CN1324900000000,13,249,"Schley County, GA",Aug-22,2096,2017,79,3.80000000
CN1325100000000,13,251,"Screven County, GA",Aug-22,4939,4706,233,4.70000000
CN1325300000000,13,253,"Seminole County, GA",Aug-22,2953,2845,108,3.70000000
CN1325500000000,13,255,"Spalding County, GA",Aug-22,29416,28415,1001,3.40000000
CN1325700000000,13,257,"Stephens County, GA",Aug-22,10336,9977,359,3.50000000
CN1325900000000,13,259,"Stewart County, GA",Aug-22,2534,2426,108,4.30000000
CN1326100000000,13,261,"Sumter County, GA",Aug-22,11884,11361,523,4.40000000
CN1326300000000,13,263,"Talbot County, GA",Aug-22,2829,2683,146,5.20000000
CN1326500000000,13,265,"Taliaferro County, GA",Aug-22,533,511,22,4.10000000
CN1326700000000,13,267,"Tattnall County, GA",Aug-22,9633,9344,289,3.00000000
CN1326900000000,13,269,"Taylor County, GA",Aug-22,2872,2728,144,5.00000000
CN1327100000000,13,271,"Telfair County, GA",Aug-22,3564,3337,227,6.40000000
CN1327300000000,13,273,"Terrell County, GA",Aug-22,3500,3332,168,4.80000000
CN1327500000000,13,275,"Thomas County, GA",Aug-22,17362,16752,610,3.50000000
CN1327700000000,13,277,"Tift County, GA",Aug-22,21185,20589,596,2.80000000
CN1327900000000,13,279,"Toombs County, GA",Aug-22,11658,11177,481,4.10000000
CN1328100000000,13,281,"Towns County, GA",Aug-22,4273,4103,170,4.00000000
CN1328300000000,13,283,"Treutlen County, GA",Aug-22,2543,2432,111,4.40000000
CN1328500000000,13,285,"Troup County, GA",Aug-22,37419,36287,1132,3.00000000
CN1328700000000,13,287,"Turner County, GA",Aug-22,3200,3042,158,4.90000000
CN1328900000000,13,289,"Twiggs County, GA",Aug-22,2797,2673,124,4.40000000
CN1329100000000,13,291,"Union County, GA",Aug-22,11137,10843,294,2.60000000
CN1329300000000,13,293,"Upson County, GA",Aug-22,11729,11307,422,3.60000000
CN1329500000000,13,295,"Walker County, GA",Aug-22,31080,30173,907,2.90000000
CN1329700000000,13,297,"Walton County, GA",Aug-22,48066,46725,1341,2.80000000
CN1329900000000,13,299,"Ware County, GA",Aug-22,15179,14688,491,3.20000000
CN1330100000000,13,301,"Warren County, GA",Aug-22,2626,2518,108,4.10000000
CN1330300000000,13,303,"Washington County, GA",Aug-22,6529,6241,288,4.40000000
CN1330500000000,13,305,"Wayne County, GA",Aug-22,11754,11376,378,3.20000000
CN1330700000000,13,307,"Webster County, GA",Aug-22,955,915,40,4.20000000
CN1330900000000,13,309,"Wheeler County, GA",Aug-22,1602,1513,89,5.60000000
CN1331100000000,13,311,"White County, GA",Aug-22,16687,16274,413,2.50000000
CN1331300000000,13,313,"Whitfield County, GA",Aug-22,42946,41420,1526,3.60000000
CN1331500000000,13,315,"Wilcox County, GA",Aug-22,2647,2539,108,4.10000000
CN1331700000000,13,317,"Wilkes County, GA",Aug-22,3652,3494,158,4.30000000
CN1331900000000,13,319,"Wilkinson County, GA",Aug-22,3642,3512,130,3.60000000
CN1332100000000,13,321,"Worth County, GA",Aug-22,8746,8469,277,3.20000000
CN1500100000000,15,001,"Hawaii County, HI",Aug-22,94458,91023,3435,3.60000000
CN1500300000000,15,003,"Honolulu County/city, HI",Aug-22,459482,443656,15826,3.40000000
CN1500700000000,15,007,"Kauai County, HI",Aug-22,37007,35454,1553,4.20000000
CN1500900000000,15,009,"Maui County, HI",Aug-22,89131,85687,3444,3.90000000
CN1600100000000,16,001,"Ada County, ID",Aug-22,281402,274386,7016,2.50000000
CN1600300000000,16,003,"Adams County, ID",Aug-22,1961,1870,91,4.60000000
CN1600500000000,16,005,"Bannock County, ID",Aug-22,44479,43170,1309,2.90000000
CN1600700000000,16,007,"Bear Lake County, ID",Aug-22,3509,3427,82,2.30000000
CN1600900000000,16,009,"Benewah County, ID",Aug-22,4321,4169,152,3.50000000
CN1601100000000,16,011,"Bingham County, ID",Aug-22,25700,24900,800,3.10000000
CN1601300000000,16,013,"Blaine County, ID",Aug-22,14294,13945,349,2.40000000
CN1601500000000,16,015,"Boise County, ID",Aug-22,3909,3755,154,3.90000000
CN1601700000000,16,017,"Bonner County, ID",Aug-22,23500,22755,745,3.20000000
CN1601900000000,16,019,"Bonneville County, ID",Aug-22,63453,61965,1488,2.30000000
CN1602100000000,16,021,"Boundary County, ID",Aug-22,6092,5902,190,3.10000000
CN1602300000000,16,023,"Butte County, ID",Aug-22,1529,1487,42,2.70000000
CN1602500000000,16,025,"Camas County, ID",Aug-22,767,750,17,2.20000000
CN1602700000000,16,027,"Canyon County, ID",Aug-22,116780,113147,3633,3.10000000
CN1602900000000,16,029,"Caribou County, ID",Aug-22,4293,4191,102,2.40000000
CN1603100000000,16,031,"Cassia County, ID",Aug-22,13482,13157,325,2.40000000
CN1603300000000,16,033,"Clark County, ID",Aug-22,413,402,11,2.70000000
CN1603500000000,16,035,"Clearwater County, ID",Aug-22,3224,3078,146,4.50000000
CN1603700000000,16,037,"Custer County, ID",Aug-22,2674,2603,71,2.70000000
CN1603900000000,16,039,"Elmore County, ID",Aug-22,12880,12486,394,3.10000000
CN1604100000000,16,041,"Franklin County, ID",Aug-22,7575,7410,165,2.20000000
CN1604300000000,16,043,"Fremont County, ID",Aug-22,8101,7914,187,2.30000000
CN1604500000000,16,045,"Gem County, ID",Aug-22,9163,8912,251,2.70000000
CN1604700000000,16,047,"Gooding County, ID",Aug-22,8728,8505,223,2.60000000
CN1604900000000,16,049,"Idaho County, ID",Aug-22,7290,7026,264,3.60000000
CN1605100000000,16,051,"Jefferson County, ID",Aug-22,15457,15122,335,2.20000000
CN1605300000000,16,053,"Jerome County, ID",Aug-22,13063,12727,336,2.60000000
CN1605500000000,16,055,"Kootenai County, ID",Aug-22,87233,84629,2604,3.00000000
CN1605700000000,16,057,"Latah County, ID",Aug-22,20766,20265,501,2.40000000
CN1605900000000,16,059,"Lemhi County, ID",Aug-22,4286,4149,137,3.20000000
CN1606100000000,16,061,"Lewis County, ID",Aug-22,1784,1713,71,4.00000000
CN1606300000000,16,063,"Lincoln County, ID",Aug-22,2943,2857,86,2.90000000
CN1606500000000,16,065,"Madison County, ID",Aug-22,22998,22567,431,1.90000000
CN1606700000000,16,067,"Minidoka County, ID",Aug-22,12617,12298,319,2.50000000
CN1606900000000,16,069,"Nez Perce County, ID",Aug-22,21583,21017,566,2.60000000
CN1607100000000,16,071,"Oneida County, ID",Aug-22,2812,2743,69,2.50000000
CN1607300000000,16,073,"Owyhee County, ID",Aug-22,6133,5941,192,3.10000000
CN1607500000000,16,075,"Payette County, ID",Aug-22,12536,12135,401,3.20000000
CN1607700000000,16,077,"Power County, ID",Aug-22,4337,4207,130,3.00000000
CN1607900000000,16,079,"Shoshone County, ID",Aug-22,5675,5424,251,4.40000000
CN1608100000000,16,081,"Teton County, ID",Aug-22,8673,8535,138,1.60000000
CN1608300000000,16,083,"Twin Falls County, ID",Aug-22,44675,43434,1241,2.80000000
CN1608500000000,16,085,"Valley County, ID",Aug-22,6613,6412,201,3.00000000
CN1608700000000,16,087,"Washington County, ID",Aug-22,5107,4926,181,3.50000000
CN1700100000000,17,001,"Adams County, IL",Aug-22,30725,29670,1055,3.40000000
CN1700300000000,17,003,"Alexander County, IL",Aug-22,1828,1683,145,7.90000000
CN1700500000000,17,005,"Bond County, IL",Aug-22,7572,7275,297,3.90000000
CN1700700000000,17,007,"Boone County, IL",Aug-22,25867,24139,1728,6.70000000
CN1700900000000,17,009,"Brown County, IL",Aug-22,3197,3127,70,2.20000000
CN1701100000000,17,011,"Bureau County, IL",Aug-22,16438,15738,700,4.30000000
CN1701300000000,17,013,"Calhoun County, IL",Aug-22,2196,2113,83,3.80000000
CN1701500000000,17,015,"Carroll County, IL",Aug-22,7840,7554,286,3.60000000
CN1701700000000,17,017,"Cass County, IL",Aug-22,5668,5424,244,4.30000000
CN1701900000000,17,019,"Champaign County, IL",Aug-22,105353,100727,4626,4.40000000
CN1702100000000,17,021,"Christian County, IL",Aug-22,13552,12887,665,4.90000000
CN1702300000000,17,023,"Clark County, IL",Aug-22,7318,6978,340,4.60000000
CN1702500000000,17,025,"Clay County, IL",Aug-22,5859,5575,284,4.80000000
CN1702700000000,17,027,"Clinton County, IL",Aug-22,20132,19549,583,2.90000000
CN1702900000000,17,029,"Coles County, IL",Aug-22,22050,20983,1067,4.80000000
CN1703100000000,17,031,"Cook County, IL",Aug-22,2663735,2517535,146200,5.50000000
CN1703300000000,17,033,"Crawford County, IL",Aug-22,8556,8190,366,4.30000000
CN1703500000000,17,035,"Cumberland County, IL",Aug-22,5982,5767,215,3.60000000
CN1703700000000,17,037,"DeKalb County, IL",Aug-22,54900,52364,2536,4.60000000
CN1703900000000,17,039,"De Witt County, IL",Aug-22,7345,7052,293,4.00000000
CN1704100000000,17,041,"Douglas County, IL",Aug-22,10135,9778,357,3.50000000
CN1704300000000,17,043,"DuPage County, IL",Aug-22,516156,498146,18010,3.50000000
CN1704500000000,17,045,"Edgar County, IL",Aug-22,8999,8672,327,3.60000000
CN1704700000000,17,047,"Edwards County, IL",Aug-22,2515,2403,112,4.50000000
CN1704900000000,17,049,"Effingham County, IL",Aug-22,19895,19308,587,3.00000000
CN1705100000000,17,051,"Fayette County, IL",Aug-22,9882,9470,412,4.20000000
CN1705300000000,17,053,"Ford County, IL",Aug-22,6109,5840,269,4.40000000
CN1705500000000,17,055,"Franklin County, IL",Aug-22,15816,14881,935,5.90000000
CN1705700000000,17,057,"Fulton County, IL",Aug-22,14576,13854,722,5.00000000
CN1705900000000,17,059,"Gallatin County, IL",Aug-22,2006,1886,120,6.00000000
CN1706100000000,17,061,"Greene County, IL",Aug-22,5996,5760,236,3.90000000
CN1706300000000,17,063,"Grundy County, IL",Aug-22,25967,24859,1108,4.30000000
CN1706500000000,17,065,"Hamilton County, IL",Aug-22,4189,4035,154,3.70000000
CN1706700000000,17,067,"Hancock County, IL",Aug-22,8268,7922,346,4.20000000
CN1706900000000,17,069,"Hardin County, IL",Aug-22,1348,1261,87,6.50000000
CN1707100000000,17,071,"Henderson County, IL",Aug-22,3655,3517,138,3.80000000
CN1707300000000,17,073,"Henry County, IL",Aug-22,24750,23762,988,4.00000000
CN1707500000000,17,075,"Iroquois County, IL",Aug-22,12982,12429,553,4.30000000
CN1707700000000,17,077,"Jackson County, IL",Aug-22,27436,26175,1261,4.60000000
CN1707900000000,17,079,"Jasper County, IL",Aug-22,4942,4763,179,3.60000000
CN1708100000000,17,081,"Jefferson County, IL",Aug-22,16408,15521,887,5.40000000
CN1708300000000,17,083,"Jersey County, IL",Aug-22,10717,10326,391,3.60000000
CN1708500000000,17,085,"Jo Daviess County, IL",Aug-22,10873,10524,349,3.20000000
CN1708700000000,17,087,"Johnson County, IL",Aug-22,4117,3877,240,5.80000000
CN1708900000000,17,089,"Kane County, IL",Aug-22,268566,256067,12499,4.70000000
CN1709100000000,17,091,"Kankakee County, IL",Aug-22,53474,50345,3129,5.90000000
CN1709300000000,17,093,"Kendall County, IL",Aug-22,72069,69324,2745,3.80000000
CN1709500000000,17,095,"Knox County, IL",Aug-22,20617,19480,1137,5.50000000
CN1709700000000,17,097,"Lake County, IL",Aug-22,380072,364444,15628,4.10000000
CN1709900000000,17,099,"LaSalle County, IL",Aug-22,53128,50463,2665,5.00000000
CN1710100000000,17,101,"Lawrence County, IL",Aug-22,5570,5266,304,5.50000000
CN1710300000000,17,103,"Lee County, IL",Aug-22,16897,16203,694,4.10000000
CN1710500000000,17,105,"Livingston County, IL",Aug-22,15689,15070,619,3.90000000
CN1710700000000,17,107,"Logan County, IL",Aug-22,11832,11307,525,4.40000000
CN1710900000000,17,109,"McDonough County, IL",Aug-22,12235,11626,609,5.00000000
CN1711100000000,17,111,"McHenry County, IL",Aug-22,168373,162248,6125,3.60000000
CN1711300000000,17,113,"McLean County, IL",Aug-22,88842,85391,3451,3.90000000
CN1711500000000,17,115,"Macon County, IL",Aug-22,47586,44487,3099,6.50000000
CN1711700000000,17,117,"Macoupin County, IL",Aug-22,22357,21517,840,3.80000000
CN1711900000000,17,119,"Madison County, IL",Aug-22,132985,127412,5573,4.20000000
CN1712100000000,17,121,"Marion County, IL",Aug-22,16679,15828,851,5.10000000
CN1712300000000,17,123,"Marshall County, IL",Aug-22,5244,4995,249,4.70000000
CN1712500000000,17,125,"Mason County, IL",Aug-22,5956,5663,293,4.90000000
CN1712700000000,17,127,"Massac County, IL",Aug-22,5426,5135,291,5.40000000
CN1712900000000,17,129,"Menard County, IL",Aug-22,6454,6231,223,3.50000000
CN1713100000000,17,131,"Mercer County, IL",Aug-22,7858,7591,267,3.40000000
CN1713300000000,17,133,"Monroe County, IL",Aug-22,18882,18325,557,2.90000000
CN1713500000000,17,135,"Montgomery County, IL",Aug-22,11442,10909,533,4.70000000
CN1713700000000,17,137,"Morgan County, IL",Aug-22,15980,15316,664,4.20000000
CN1713900000000,17,139,"Moultrie County, IL",Aug-22,7565,7324,241,3.20000000
CN1714100000000,17,141,"Ogle County, IL",Aug-22,23958,22803,1155,4.80000000
CN1714300000000,17,143,"Peoria County, IL",Aug-22,84692,79746,4946,5.80000000
CN1714500000000,17,145,"Perry County, IL",Aug-22,8052,7643,409,5.10000000
CN1714700000000,17,147,"Piatt County, IL",Aug-22,8287,7990,297,3.60000000
CN1714900000000,17,149,"Pike County, IL",Aug-22,6907,6632,275,4.00000000
CN1715100000000,17,151,"Pope County, IL",Aug-22,1712,1617,95,5.50000000
CN1715300000000,17,153,"Pulaski County, IL",Aug-22,1710,1567,143,8.40000000
CN1715500000000,17,155,"Putnam County, IL",Aug-22,2992,2850,142,4.70000000
CN1715700000000,17,157,"Randolph County, IL",Aug-22,14086,13583,503,3.60000000
CN1715900000000,17,159,"Richland County, IL",Aug-22,7236,6940,296,4.10000000
CN1716100000000,17,161,"Rock Island County, IL",Aug-22,70568,67482,3086,4.40000000
CN1716300000000,17,163,"St. Clair County, IL",Aug-22,125388,118981,6407,5.10000000
CN1716500000000,17,165,"Saline County, IL",Aug-22,9219,8670,549,6.00000000
CN1716700000000,17,167,"Sangamon County, IL",Aug-22,102154,97699,4455,4.40000000
CN1716900000000,17,169,"Schuyler County, IL",Aug-22,3290,3174,116,3.50000000
CN1717100000000,17,171,"Scott County, IL",Aug-22,2364,2274,90,3.80000000
CN1717300000000,17,173,"Shelby County, IL",Aug-22,10527,10124,403,3.80000000
CN1717500000000,17,175,"Stark County, IL",Aug-22,2434,2327,107,4.40000000
CN1717700000000,17,177,"Stephenson County, IL",Aug-22,21182,20221,961,4.50000000
CN1717900000000,17,179,"Tazewell County, IL",Aug-22,63241,60598,2643,4.20000000
CN1718100000000,17,181,"Union County, IL",Aug-22,7281,6924,357,4.90000000
CN1718300000000,17,183,"Vermilion County, IL",Aug-22,31894,30075,1819,5.70000000
CN1718500000000,17,185,"Wabash County, IL",Aug-22,5564,5359,205,3.70000000
CN1718700000000,17,187,"Warren County, IL",Aug-22,7529,7224,305,4.10000000
CN1718900000000,17,189,"Washington County, IL",Aug-22,9855,9616,239,2.40000000
CN1719100000000,17,191,"Wayne County, IL",Aug-22,6926,6642,284,4.10000000
CN1719300000000,17,193,"White County, IL",Aug-22,6022,5755,267,4.40000000
CN1719500000000,17,195,"Whiteside County, IL",Aug-22,28033,26852,1181,4.20000000
CN1719700000000,17,197,"Will County, IL",Aug-22,366112,349678,16434,4.50000000
CN1719900000000,17,199,"Williamson County, IL",Aug-22,31335,29918,1417,4.50000000
CN1720100000000,17,201,"Winnebago County, IL",Aug-22,138353,129002,9351,6.80000000
CN1720300000000,17,203,"Woodford County, IL",Aug-22,18603,17972,631,3.40000000
CN1800100000000,18,001,"Adams County, IN",Aug-22,17198,16839,359,2.10000000
CN1800300000000,18,003,"Allen County, IN",Aug-22,189597,184169,5428,2.90000000
CN1800500000000,18,005,"Bartholomew County, IN",Aug-22,44041,42969,1072,2.40000000
CN1800700000000,18,007,"Benton County, IN",Aug-22,4204,4097,107,2.50000000
CN1800900000000,18,009,"Blackford County, IN",Aug-22,4789,4637,152,3.20000000
CN1801100000000,18,011,"Boone County, IN",Aug-22,38503,37720,783,2.00000000
CN1801300000000,18,013,"Brown County, IN",Aug-22,7969,7738,231,2.90000000
CN1801500000000,18,015,"Carroll County, IN",Aug-22,9603,9331,272,2.80000000
CN1801700000000,18,017,"Cass County, IN",Aug-22,17235,16636,599,3.50000000
CN1801900000000,18,019,"Clark County, IN",Aug-22,64227,62537,1690,2.60000000
CN1802100000000,18,021,"Clay County, IN",Aug-22,11667,11250,417,3.60000000
CN1802300000000,18,023,"Clinton County, IN",Aug-22,16989,16586,403,2.40000000
CN1802500000000,18,025,"Crawford County, IN",Aug-22,4924,4772,152,3.10000000
CN1802700000000,18,027,"Daviess County, IN",Aug-22,16581,16222,359,2.20000000
CN1802900000000,18,029,"Dearborn County, IN",Aug-22,25654,24983,671,2.60000000
CN1803100000000,18,031,"Decatur County, IN",Aug-22,14654,14298,356,2.40000000
CN1803300000000,18,033,"DeKalb County, IN",Aug-22,22391,21822,569,2.50000000
CN1803500000000,18,035,"Delaware County, IN",Aug-22,52980,51169,1811,3.40000000
CN1803700000000,18,037,"Dubois County, IN",Aug-22,21884,21415,469,2.10000000
CN1803900000000,18,039,"Elkhart County, IN",Aug-22,120840,117761,3079,2.50000000
CN1804100000000,18,041,"Fayette County, IN",Aug-22,8489,8118,371,4.40000000
CN1804300000000,18,043,"Floyd County, IN",Aug-22,43224,42194,1030,2.40000000
CN1804500000000,18,045,"Fountain County, IN",Aug-22,7946,7743,203,2.60000000
CN1804700000000,18,047,"Franklin County, IN",Aug-22,11431,11152,279,2.40000000
CN1804900000000,18,049,"Fulton County, IN",Aug-22,9643,9370,273,2.80000000
CN1805100000000,18,051,"Gibson County, IN",Aug-22,19775,19318,457,2.30000000
CN1805300000000,18,053,"Grant County, IN",Aug-22,30952,29926,1026,3.30000000
CN1805500000000,18,055,"Greene County, IN",Aug-22,13685,13209,476,3.50000000
CN1805700000000,18,057,"Hamilton County, IN",Aug-22,196733,192557,4176,2.10000000
CN1805900000000,18,059,"Hancock County, IN",Aug-22,43006,41957,1049,2.40000000
CN1806100000000,18,061,"Harrison County, IN",Aug-22,20959,20441,518,2.50000000
CN1806300000000,18,063,"Hendricks County, IN",Aug-22,95722,93494,2228,2.30000000
CN1806500000000,18,065,"Henry County, IN",Aug-22,22337,21659,678,3.00000000
CN1806700000000,18,067,"Howard County, IN",Aug-22,34918,32487,2431,7.00000000
CN1806900000000,18,069,"Huntington County, IN",Aug-22,18380,17897,483,2.60000000
CN1807100000000,18,071,"Jackson County, IN",Aug-22,23696,23086,610,2.60000000
CN1807300000000,18,073,"Jasper County, IN",Aug-22,15743,15247,496,3.20000000
CN1807500000000,18,075,"Jay County, IN",Aug-22,8799,8571,228,2.60000000
CN1807700000000,18,077,"Jefferson County, IN",Aug-22,14946,14513,433,2.90000000
CN1807900000000,18,079,"Jennings County, IN",Aug-22,13535,13139,396,2.90000000
CN1808100000000,18,081,"Johnson County, IN",Aug-22,87381,85382,1999,2.30000000
CN1808300000000,18,083,"Knox County, IN",Aug-22,18036,17540,496,2.80000000
CN1808500000000,18,085,"Kosciusko County, IN",Aug-22,40598,39577,1021,2.50000000
CN1808700000000,18,087,"LaGrange County, IN",Aug-22,21411,20903,508,2.40000000
CN1808900000000,18,089,"Lake County, IN",Aug-22,229324,217257,12067,5.30000000
CN1809100000000,18,091,"LaPorte County, IN",Aug-22,46323,44550,1773,3.80000000
CN1809300000000,18,093,"Lawrence County, IN",Aug-22,21102,20447,655,3.10000000
CN1809500000000,18,095,"Madison County, IN",Aug-22,60571,58609,1962,3.20000000
CN1809700000000,18,097,"Marion County, IN",Aug-22,513063,495804,17259,3.40000000
CN1809900000000,18,099,"Marshall County, IN",Aug-22,22919,22336,583,2.50000000
CN1810100000000,18,101,"Martin County, IN",Aug-22,5492,5359,133,2.40000000
CN1810300000000,18,103,"Miami County, IN",Aug-22,14350,13702,648,4.50000000
CN1810500000000,18,105,"Monroe County, IN",Aug-22,71438,69462,1976,2.80000000
CN1810700000000,18,107,"Montgomery County, IN",Aug-22,18695,18229,466,2.50000000
CN1810900000000,18,109,"Morgan County, IN",Aug-22,37657,36678,979,2.60000000
CN1811100000000,18,111,"Newton County, IN",Aug-22,6713,6473,240,3.60000000
CN1811300000000,18,113,"Noble County, IN",Aug-22,21546,20900,646,3.00000000
CN1811500000000,18,115,"Ohio County, IN",Aug-22,3173,3108,65,2.00000000
CN1811700000000,18,117,"Orange County, IN",Aug-22,8170,7888,282,3.50000000
CN1811900000000,18,119,"Owen County, IN",Aug-22,9410,9112,298,3.20000000
CN1812100000000,18,121,"Parke County, IN",Aug-22,7274,7067,207,2.80000000
CN1812300000000,18,123,"Perry County, IN",Aug-22,8750,8500,250,2.90000000
CN1812500000000,18,125,"Pike County, IN",Aug-22,5836,5654,182,3.10000000
CN1812700000000,18,127,"Porter County, IN",Aug-22,85898,83017,2881,3.40000000
CN1812900000000,18,129,"Posey County, IN",Aug-22,13148,12829,319,2.40000000
CN1813100000000,18,131,"Pulaski County, IN",Aug-22,6460,6288,172,2.70000000
CN1813300000000,18,133,"Putnam County, IN",Aug-22,16989,16500,489,2.90000000
CN1813500000000,18,135,"Randolph County, IN",Aug-22,11793,11467,326,2.80000000
CN1813700000000,18,137,"Ripley County, IN",Aug-22,12892,12538,354,2.70000000
CN1813900000000,18,139,"Rush County, IN",Aug-22,8873,8658,215,2.40000000
CN1814100000000,18,141,"St. Joseph County, IN",Aug-22,134895,130187,4708,3.50000000
CN1814300000000,18,143,"Scott County, IN",Aug-22,10805,10444,361,3.30000000
CN1814500000000,18,145,"Shelby County, IN",Aug-22,23872,23268,604,2.50000000
CN1814700000000,18,147,"Spencer County, IN",Aug-22,10764,10492,272,2.50000000
CN1814900000000,18,149,"Starke County, IN",Aug-22,9463,9118,345,3.60000000
CN1815100000000,18,151,"Steuben County, IN",Aug-22,20845,20402,443,2.10000000
CN1815300000000,18,153,"Sullivan County, IN",Aug-22,7900,7621,279,3.50000000
CN1815500000000,18,155,"Switzerland County, IN",Aug-22,4652,4514,138,3.00000000
CN1815700000000,18,157,"Tippecanoe County, IN",Aug-22,94666,91911,2755,2.90000000
CN1815900000000,18,159,"Tipton County, IN",Aug-22,9075,8791,284,3.10000000
CN1816100000000,18,161,"Union County, IN",Aug-22,3518,3439,79,2.20000000
CN1816300000000,18,163,"Vanderburgh County, IN",Aug-22,93663,90829,2834,3.00000000
CN1816500000000,18,165,"Vermillion County, IN",Aug-22,6568,6311,257,3.90000000
CN1816700000000,18,167,"Vigo County, IN",Aug-22,46073,44356,1717,3.70000000
CN1816900000000,18,169,"Wabash County, IN",Aug-22,14136,13738,398,2.80000000
CN1817100000000,18,171,"Warren County, IN",Aug-22,4041,3943,98,2.40000000
CN1817300000000,18,173,"Warrick County, IN",Aug-22,32853,32031,822,2.50000000
CN1817500000000,18,175,"Washington County, IN",Aug-22,14003,13632,371,2.60000000
CN1817700000000,18,177,"Wayne County, IN",Aug-22,30046,29144,902,3.00000000
CN1817900000000,18,179,"Wells County, IN",Aug-22,14249,13941,308,2.20000000
CN1818100000000,18,181,"White County, IN",Aug-22,13281,12966,315,2.40000000
CN1818300000000,18,183,"Whitley County, IN",Aug-22,17782,17386,396,2.20000000
CN1900100000000,19,001,"Adair County, IA",Aug-22,4433,4354,79,1.80000000
CN1900300000000,19,003,"Adams County, IA",Aug-22,1990,1943,47,2.40000000
CN1900500000000,19,005,"Allamakee County, IA",Aug-22,6812,6619,193,2.80000000
CN1900700000000,19,007,"Appanoose County, IA",Aug-22,5911,5738,173,2.90000000
CN1900900000000,19,009,"Audubon County, IA",Aug-22,2986,2917,69,2.30000000
CN1901100000000,19,011,"Benton County, IA",Aug-22,12892,12497,395,3.10000000
CN1901300000000,19,013,"Black Hawk County, IA",Aug-22,68481,66407,2074,3.00000000
CN1901500000000,19,015,"Boone County, IA",Aug-22,14575,14228,347,2.40000000
CN1901700000000,19,017,"Bremer County, IA",Aug-22,13972,13654,318,2.30000000
CN1901900000000,19,019,"Buchanan County, IA",Aug-22,11134,10844,290,2.60000000
CN1902100000000,19,021,"Buena Vista County, IA",Aug-22,11811,11504,307,2.60000000
CN1902300000000,19,023,"Butler County, IA",Aug-22,7895,7683,212,2.70000000
CN1902500000000,19,025,"Calhoun County, IA",Aug-22,3968,3866,102,2.60000000
CN1902700000000,19,027,"Carroll County, IA",Aug-22,10727,10494,233,2.20000000
CN1902900000000,19,029,"Cass County, IA",Aug-22,6640,6473,167,2.50000000
CN1903100000000,19,031,"Cedar County, IA",Aug-22,10378,10107,271,2.60000000
CN1903300000000,19,033,"Cerro Gordo County, IA",Aug-22,22414,21751,663,3.00000000
CN1903500000000,19,035,"Cherokee County, IA",Aug-22,5937,5797,140,2.40000000
CN1903700000000,19,037,"Chickasaw County, IA",Aug-22,6296,6148,148,2.40000000
CN1903900000000,19,039,"Clarke County, IA",Aug-22,4852,4716,136,2.80000000
CN1904100000000,19,041,"Clay County, IA",Aug-22,8428,8200,228,2.70000000
CN1904300000000,19,043,"Clayton County, IA",Aug-22,9513,9235,278,2.90000000
CN1904500000000,19,045,"Clinton County, IA",Aug-22,21946,21095,851,3.90000000
CN1904700000000,19,047,"Crawford County, IA",Aug-22,7638,7369,269,3.50000000
CN1904900000000,19,049,"Dallas County, IA",Aug-22,53669,52514,1155,2.20000000
CN1905100000000,19,051,"Davis County, IA",Aug-22,4194,4087,107,2.60000000
CN1905300000000,19,053,"Decatur County, IA",Aug-22,3998,3891,107,2.70000000
CN1905500000000,19,055,"Delaware County, IA",Aug-22,10397,10171,226,2.20000000
CN1905700000000,19,057,"Des Moines County, IA",Aug-22,18301,17436,865,4.70000000
CN1905900000000,19,059,"Dickinson County, IA",Aug-22,11483,11226,257,2.20000000
CN1906100000000,19,061,"Dubuque County, IA",Aug-22,55126,53586,1540,2.80000000
CN1906300000000,19,063,"Emmet County, IA",Aug-22,4863,4727,136,2.80000000
CN1906500000000,19,065,"Fayette County, IA",Aug-22,9766,9486,280,2.90000000
CN1906700000000,19,067,"Floyd County, IA",Aug-22,8143,7886,257,3.20000000
CN1906900000000,19,069,"Franklin County, IA",Aug-22,5448,5317,131,2.40000000
CN1907100000000,19,071,"Fremont County, IA",Aug-22,3619,3521,98,2.70000000
CN1907300000000,19,073,"Greene County, IA",Aug-22,5177,5061,116,2.20000000
CN1907500000000,19,075,"Grundy County, IA",Aug-22,6290,6140,150,2.40000000
CN1907700000000,19,077,"Guthrie County, IA",Aug-22,5480,5325,155,2.80000000
CN1907900000000,19,079,"Hamilton County, IA",Aug-22,6810,6613,197,2.90000000
CN1908100000000,19,081,"Hancock County, IA",Aug-22,5634,5499,135,2.40000000
CN1908300000000,19,083,"Hardin County, IA",Aug-22,7702,7483,219,2.80000000
CN1908500000000,19,085,"Harrison County, IA",Aug-22,7095,6888,207,2.90000000
CN1908700000000,19,087,"Henry County, IA",Aug-22,9526,9246,280,2.90000000
CN1908900000000,19,089,"Howard County, IA",Aug-22,5071,4938,133,2.60000000
CN1909100000000,19,091,"Humboldt County, IA",Aug-22,4836,4719,117,2.40000000
CN1909300000000,19,093,"Ida County, IA",Aug-22,3900,3815,85,2.20000000
CN1909500000000,19,095,"Iowa County, IA",Aug-22,9985,9762,223,2.20000000
CN1909700000000,19,097,"Jackson County, IA",Aug-22,10628,10303,325,3.10000000
CN1909900000000,19,099,"Jasper County, IA",Aug-22,18522,17980,542,2.90000000
CN1910100000000,19,101,"Jefferson County, IA",Aug-22,9874,9615,259,2.60000000
CN1910300000000,19,103,"Johnson County, IA",Aug-22,87904,85689,2215,2.50000000
CN1910500000000,19,105,"Jones County, IA",Aug-22,10120,9826,294,2.90000000
CN1910700000000,19,107,"Keokuk County, IA",Aug-22,5075,4925,150,3.00000000
CN1910900000000,19,109,"Kossuth County, IA",Aug-22,7793,7600,193,2.50000000
CN1911100000000,19,111,"Lee County, IA",Aug-22,15221,14397,824,5.40000000
CN1911300000000,19,113,"Linn County, IA",Aug-22,120504,116374,4130,3.40000000
CN1911500000000,19,115,"Louisa County, IA",Aug-22,5818,5635,183,3.10000000
CN1911700000000,19,117,"Lucas County, IA",Aug-22,4709,4597,112,2.40000000
CN1911900000000,19,119,"Lyon County, IA",Aug-22,6954,6826,128,1.80000000
CN1912100000000,19,121,"Madison County, IA",Aug-22,8642,8383,259,3.00000000
CN1912300000000,19,123,"Mahaska County, IA",Aug-22,12065,11749,316,2.60000000
CN1912500000000,19,125,"Marion County, IA",Aug-22,19068,18667,401,2.10000000
CN1912700000000,19,127,"Marshall County, IA",Aug-22,16984,16252,732,4.30000000
CN1912900000000,19,129,"Mills County, IA",Aug-22,7104,6937,167,2.40000000
CN1913100000000,19,131,"Mitchell County, IA",Aug-22,5756,5637,119,2.10000000
CN1913300000000,19,133,"Monona County, IA",Aug-22,4311,4190,121,2.80000000
CN1913500000000,19,135,"Monroe County, IA",Aug-22,3897,3778,119,3.10000000
CN1913700000000,19,137,"Montgomery County, IA",Aug-22,4839,4711,128,2.60000000
CN1913900000000,19,139,"Muscatine County, IA",Aug-22,20833,20185,648,3.10000000
CN1914100000000,19,141,"O'Brien County, IA",Aug-22,8022,7844,178,2.20000000
CN1914300000000,19,143,"Osceola County, IA",Aug-22,3526,3453,73,2.10000000
CN1914500000000,19,145,"Page County, IA",Aug-22,6278,6105,173,2.80000000
CN1914700000000,19,147,"Palo Alto County, IA",Aug-22,4445,4329,116,2.60000000
CN1914900000000,19,149,"Plymouth County, IA",Aug-22,14446,14108,338,2.30000000
CN1915100000000,19,151,"Pocahontas County, IA",Aug-22,4427,4332,95,2.10000000
CN1915300000000,19,153,"Polk County, IA",Aug-22,275764,267915,7849,2.80000000
CN1915500000000,19,155,"Pottawattamie County, IA",Aug-22,48210,46761,1449,3.00000000
CN1915700000000,19,157,"Poweshiek County, IA",Aug-22,10088,9813,275,2.70000000
CN1915900000000,19,159,"Ringgold County, IA",Aug-22,2354,2297,57,2.40000000
CN1916100000000,19,161,"Sac County, IA",Aug-22,5182,5054,128,2.50000000
CN1916300000000,19,163,"Scott County, IA",Aug-22,91485,88382,3103,3.40000000
CN1916500000000,19,165,"Shelby County, IA",Aug-22,6258,6111,147,2.30000000
CN1916700000000,19,167,"Sioux County, IA",Aug-22,21471,21088,383,1.80000000
CN1916900000000,19,169,"Story County, IA",Aug-22,57625,56225,1400,2.40000000
CN1917100000000,19,171,"Tama County, IA",Aug-22,9015,8770,245,2.70000000
CN1917300000000,19,173,"Taylor County, IA",Aug-22,3058,2987,71,2.30000000
CN1917500000000,19,175,"Union County, IA",Aug-22,5977,5794,183,3.10000000
CN1917700000000,19,177,"Van Buren County, IA",Aug-22,3657,3550,107,2.90000000
CN1917900000000,19,179,"Wapello County, IA",Aug-22,16896,16312,584,3.50000000
CN1918100000000,19,181,"Warren County, IA",Aug-22,29181,28447,734,2.50000000
CN1918300000000,19,183,"Washington County, IA",Aug-22,11666,11376,290,2.50000000
CN1918500000000,19,185,"Wayne County, IA",Aug-22,2738,2660,78,2.80000000
CN1918700000000,19,187,"Webster County, IA",Aug-22,18379,17726,653,3.60000000
CN1918900000000,19,189,"Winnebago County, IA",Aug-22,4864,4722,142,2.90000000
CN1919100000000,19,191,"Winneshiek County, IA",Aug-22,10961,10662,299,2.70000000
CN1919300000000,19,193,"Woodbury County, IA",Aug-22,55481,53844,1637,3.00000000
CN1919500000000,19,195,"Worth County, IA",Aug-22,3974,3874,100,2.50000000
CN1919700000000,19,197,"Wright County, IA",Aug-22,6667,6493,174,2.60000000
CN2000100000000,20,001,"Allen County, KS",Aug-22,6068,5866,202,3.30000000
CN2000300000000,20,003,"Anderson County, KS",Aug-22,4494,4395,99,2.20000000
CN2000500000000,20,005,"Atchison County, KS",Aug-22,6434,6181,253,3.90000000
CN2000700000000,20,007,"Barber County, KS",Aug-22,2201,2148,53,2.40000000
CN2000900000000,20,009,"Barton County, KS",Aug-22,12818,12455,363,2.80000000
CN2001100000000,20,011,"Bourbon County, KS",Aug-22,6239,6014,225,3.60000000
CN2001300000000,20,013,"Brown County, KS",Aug-22,4975,4839,136,2.70000000
CN2001500000000,20,015,"Butler County, KS",Aug-22,32603,31580,1023,3.10000000
CN2001700000000,20,017,"Chase County, KS",Aug-22,1357,1323,34,2.50000000
CN2001900000000,20,019,"Chautauqua County, KS",Aug-22,1390,1344,46,3.30000000
CN2002100000000,20,021,"Cherokee County, KS",Aug-22,9656,9352,304,3.10000000
CN2002300000000,20,023,"Cheyenne County, KS",Aug-22,1269,1233,36,2.80000000
CN2002500000000,20,025,"Clark County, KS",Aug-22,1098,1070,28,2.60000000
CN2002700000000,20,027,"Clay County, KS",Aug-22,3654,3541,113,3.10000000
CN2002900000000,20,029,"Cloud County, KS",Aug-22,3688,3568,120,3.30000000
CN2003100000000,20,031,"Coffey County, KS",Aug-22,3872,3721,151,3.90000000
CN2003300000000,20,033,"Comanche County, KS",Aug-22,862,841,21,2.40000000
CN2003500000000,20,035,"Cowley County, KS",Aug-22,16222,15670,552,3.40000000
CN2003700000000,20,037,"Crawford County, KS",Aug-22,18174,17550,624,3.40000000
CN2003900000000,20,039,"Decatur County, KS",Aug-22,1209,1165,44,3.60000000
CN2004100000000,20,041,"Dickinson County, KS",Aug-22,8772,8516,256,2.90000000
CN2004300000000,20,043,"Doniphan County, KS",Aug-22,4102,3984,118,2.90000000
CN2004500000000,20,045,"Douglas County, KS",Aug-22,63401,61475,1926,3.00000000
CN2004700000000,20,047,"Edwards County, KS",Aug-22,1410,1372,38,2.70000000
CN2004900000000,20,049,"Elk County, KS",Aug-22,1056,1023,33,3.10000000
CN2005100000000,20,051,"Ellis County, KS",Aug-22,16392,15998,394,2.40000000
CN2005300000000,20,053,"Ellsworth County, KS",Aug-22,2680,2609,71,2.60000000
CN2005500000000,20,055,"Finney County, KS",Aug-22,19700,19221,479,2.40000000
CN2005700000000,20,057,"Ford County, KS",Aug-22,17681,17261,420,2.40000000
CN2005900000000,20,059,"Franklin County, KS",Aug-22,13910,13516,394,2.80000000
CN2006100000000,20,061,"Geary County, KS",Aug-22,10915,10434,481,4.40000000
CN2006300000000,20,063,"Gove County, KS",Aug-22,1401,1368,33,2.40000000
CN2006500000000,20,065,"Graham County, KS",Aug-22,1075,1044,31,2.90000000
CN2006700000000,20,067,"Grant County, KS",Aug-22,2846,2752,94,3.30000000
CN2006900000000,20,069,"Gray County, KS",Aug-22,3010,2938,72,2.40000000
CN2007100000000,20,071,"Greeley County, KS",Aug-22,795,782,13,1.60000000
CN2007300000000,20,073,"Greenwood County, KS",Aug-22,2841,2759,82,2.90000000
CN2007500000000,20,075,"Hamilton County, KS",Aug-22,1579,1548,31,2.00000000
CN2007700000000,20,077,"Harper County, KS",Aug-22,2647,2576,71,2.70000000
CN2007900000000,20,079,"Harvey County, KS",Aug-22,17036,16547,489,2.90000000
CN2008100000000,20,081,"Haskell County, KS",Aug-22,2133,2085,48,2.30000000
CN2008300000000,20,083,"Hodgeman County, KS",Aug-22,1020,995,25,2.50000000
CN2008500000000,20,085,"Jackson County, KS",Aug-22,7260,7083,177,2.40000000
CN2008700000000,20,087,"Jefferson County, KS",Aug-22,10350,10059,291,2.80000000
CN2008900000000,20,089,"Jewell County, KS",Aug-22,1201,1167,34,2.80000000
CN2009100000000,20,091,"Johnson County, KS",Aug-22,345682,336615,9067,2.60000000
CN2009300000000,20,093,"Kearny County, KS",Aug-22,1942,1898,44,2.30000000
CN2009500000000,20,095,"Kingman County, KS",Aug-22,3277,3180,97,3.00000000
CN2009700000000,20,097,"Kiowa County, KS",Aug-22,1141,1111,30,2.60000000
CN2009900000000,20,099,"Labette County, KS",Aug-22,8985,8663,322,3.60000000
CN2010100000000,20,101,"Lane County, KS",Aug-22,706,685,21,3.00000000
CN2010300000000,20,103,"Leavenworth County, KS",Aug-22,37040,35851,1189,3.20000000
CN2010500000000,20,105,"Lincoln County, KS",Aug-22,1633,1590,43,2.60000000
CN2010700000000,20,107,"Linn County, KS",Aug-22,4328,4151,177,4.10000000
CN2010900000000,20,109,"Logan County, KS",Aug-22,1458,1424,34,2.30000000
CN2011100000000,20,111,"Lyon County, KS",Aug-22,16132,15667,465,2.90000000
CN2011300000000,20,113,"McPherson County, KS",Aug-22,16852,16468,384,2.30000000
CN2011500000000,20,115,"Marion County, KS",Aug-22,5783,5622,161,2.80000000
CN2011700000000,20,117,"Marshall County, KS",Aug-22,5392,5272,120,2.20000000
CN2011900000000,20,119,"Meade County, KS",Aug-22,2107,2061,46,2.20000000
CN2012100000000,20,121,"Miami County, KS",Aug-22,17804,17328,476,2.70000000
CN2012300000000,20,123,"Mitchell County, KS",Aug-22,3320,3246,74,2.20000000
CN2012500000000,20,125,"Montgomery County, KS",Aug-22,14084,13583,501,3.60000000
CN2012700000000,20,127,"Morris County, KS",Aug-22,2987,2905,82,2.70000000
CN2012900000000,20,129,"Morton County, KS",Aug-22,1074,1041,33,3.10000000
CN2013100000000,20,131,"Nemaha County, KS",Aug-22,5414,5299,115,2.10000000
CN2013300000000,20,133,"Neosho County, KS",Aug-22,5905,5659,246,4.20000000
CN2013500000000,20,135,"Ness County, KS",Aug-22,1245,1212,33,2.70000000
CN2013700000000,20,137,"Norton County, KS",Aug-22,2578,2524,54,2.10000000
CN2013900000000,20,139,"Osage County, KS",Aug-22,8016,7776,240,3.00000000
CN2014100000000,20,141,"Osborne County, KS",Aug-22,1908,1865,43,2.30000000
CN2014300000000,20,143,"Ottawa County, KS",Aug-22,2840,2760,80,2.80000000
CN2014500000000,20,145,"Pawnee County, KS",Aug-22,2754,2682,72,2.60000000
CN2014700000000,20,147,"Phillips County, KS",Aug-22,2448,2386,62,2.50000000
CN2014900000000,20,149,"Pottawatomie County, KS",Aug-22,12102,11770,332,2.70000000
CN2015100000000,20,151,"Pratt County, KS",Aug-22,4686,4558,128,2.70000000
CN2015300000000,20,153,"Rawlins County, KS",Aug-22,1601,1570,31,1.90000000
CN2015500000000,20,155,"Reno County, KS",Aug-22,28222,27317,905,3.20000000
CN2015700000000,20,157,"Republic County, KS",Aug-22,2242,2189,53,2.40000000
CN2015900000000,20,159,"Rice County, KS",Aug-22,4947,4811,136,2.70000000
CN2016100000000,20,161,"Riley County, KS",Aug-22,33451,32397,1054,3.20000000
CN2016300000000,20,163,"Rooks County, KS",Aug-22,2358,2289,69,2.90000000
CN2016500000000,20,165,"Rush County, KS",Aug-22,1514,1473,41,2.70000000
CN2016700000000,20,167,"Russell County, KS",Aug-22,3177,3095,82,2.60000000
CN2016900000000,20,169,"Saline County, KS",Aug-22,28848,28037,811,2.80000000
CN2017100000000,20,171,"Scott County, KS",Aug-22,2787,2725,62,2.20000000
CN2017300000000,20,173,"Sedgwick County, KS",Aug-22,254682,245564,9118,3.60000000
CN2017500000000,20,175,"Seward County, KS",Aug-22,9901,9633,268,2.70000000
CN2017700000000,20,177,"Shawnee County, KS",Aug-22,91661,88909,2752,3.00000000
CN2017900000000,20,179,"Sheridan County, KS",Aug-22,1417,1387,30,2.10000000
CN2018100000000,20,181,"Sherman County, KS",Aug-22,2781,2707,74,2.70000000
CN2018300000000,20,183,"Smith County, KS",Aug-22,1885,1836,49,2.60000000
CN2018500000000,20,185,"Stafford County, KS",Aug-22,1874,1820,54,2.90000000
CN2018700000000,20,187,"Stanton County, KS",Aug-22,1035,1012,23,2.20000000
CN2018900000000,20,189,"Stevens County, KS",Aug-22,2696,2637,59,2.20000000
CN2019100000000,20,191,"Sumner County, KS",Aug-22,10746,10375,371,3.50000000
CN2019300000000,20,193,"Thomas County, KS",Aug-22,4140,4046,94,2.30000000
CN2019500000000,20,195,"Trego County, KS",Aug-22,1349,1313,36,2.70000000
CN2019700000000,20,197,"Wabaunsee County, KS",Aug-22,3732,3635,97,2.60000000
CN2019900000000,20,199,"Wallace County, KS",Aug-22,851,831,20,2.40000000
CN2020100000000,20,201,"Washington County, KS",Aug-22,3014,2952,62,2.10000000
CN2020300000000,20,203,"Wichita County, KS",Aug-22,1113,1087,26,2.30000000
CN2020500000000,20,205,"Wilson County, KS",Aug-22,3674,3548,126,3.40000000
CN2020700000000,20,207,"Woodson County, KS",Aug-22,1431,1378,53,3.70000000
CN2020900000000,20,209,"Wyandotte County, KS",Aug-22,77416,74408,3008,3.90000000
CN2100100000000,21,001,"Adair County, KY",Aug-22,7111,6809,302,4.20000000
CN2100300000000,21,003,"Allen County, KY",Aug-22,8932,8586,346,3.90000000
CN2100500000000,21,005,"Anderson County, KY",Aug-22,11928,11551,377,3.20000000
CN2100700000000,21,007,"Ballard County, KY",Aug-22,3444,3272,172,5.00000000
CN2100900000000,21,009,"Barren County, KY",Aug-22,17613,16903,710,4.00000000
CN2101100000000,21,011,"Bath County, KY",Aug-22,4671,4452,219,4.70000000
CN2101300000000,21,013,"Bell County, KY",Aug-22,8037,7627,410,5.10000000
CN2101500000000,21,015,"Boone County, KY",Aug-22,72176,69995,2181,3.00000000
CN2101700000000,21,017,"Bourbon County, KY",Aug-22,9891,9560,331,3.30000000
CN2101900000000,21,019,"Boyd County, KY",Aug-22,17179,16256,923,5.40000000
CN2102100000000,21,021,"Boyle County, KY",Aug-22,12536,12045,491,3.90000000
CN2102300000000,21,023,"Bracken County, KY",Aug-22,3773,3628,145,3.80000000
CN2102500000000,21,025,"Breathitt County, KY",Aug-22,3185,2920,265,8.30000000
CN2102700000000,21,027,"Breckinridge County, KY",Aug-22,8059,7715,344,4.30000000
CN2102900000000,21,029,"Bullitt County, KY",Aug-22,44086,42687,1399,3.20000000
CN2103100000000,21,031,"Butler County, KY",Aug-22,4900,4695,205,4.20000000
CN2103300000000,21,033,"Caldwell County, KY",Aug-22,5968,5771,197,3.30000000
CN2103500000000,21,035,"Calloway County, KY",Aug-22,16712,16064,648,3.90000000
CN2103700000000,21,037,"Campbell County, KY",Aug-22,50652,49002,1650,3.30000000
CN2103900000000,21,039,"Carlisle County, KY",Aug-22,2217,2140,77,3.50000000
CN2104100000000,21,041,"Carroll County, KY",Aug-22,5532,5350,182,3.30000000
CN2104300000000,21,043,"Carter County, KY",Aug-22,9673,8932,741,7.70000000
CN2104500000000,21,045,"Casey County, KY",Aug-22,6752,6516,236,3.50000000
CN2104700000000,21,047,"Christian County, KY",Aug-22,25020,23774,1246,5.00000000
CN2104900000000,21,049,"Clark County, KY",Aug-22,17453,16851,602,3.40000000
CN2105100000000,21,051,"Clay County, KY",Aug-22,5204,4902,302,5.80000000
CN2105300000000,21,053,"Clinton County, KY",Aug-22,3979,3816,163,4.10000000
CN2105500000000,21,055,"Crittenden County, KY",Aug-22,3797,3634,163,4.30000000
CN2105700000000,21,057,"Cumberland County, KY",Aug-22,3412,3321,91,2.70000000
CN2105900000000,21,059,"Daviess County, KY",Aug-22,46994,45200,1794,3.80000000
CN2106100000000,21,061,"Edmonson County, KY",Aug-22,4687,4457,230,4.90000000
CN2106300000000,21,063,"Elliott County, KY",Aug-22,1835,1686,149,8.10000000
CN2106500000000,21,065,"Estill County, KY",Aug-22,5157,4911,246,4.80000000
CN2106700000000,21,067,"Fayette County, KY",Aug-22,177941,172587,5354,3.00000000
CN2106900000000,21,069,"Fleming County, KY",Aug-22,5972,5728,244,4.10000000
CN2107100000000,21,071,"Floyd County, KY",Aug-22,10776,10097,679,6.30000000
CN2107300000000,21,073,"Franklin County, KY",Aug-22,24948,24147,801,3.20000000
CN2107500000000,21,075,"Fulton County, KY",Aug-22,2095,1994,101,4.80000000
CN2107700000000,21,077,"Gallatin County, KY",Aug-22,4017,3883,134,3.30000000
CN2107900000000,21,079,"Garrard County, KY",Aug-22,7656,7375,281,3.70000000
CN2108100000000,21,081,"Grant County, KY",Aug-22,11679,11269,410,3.50000000
CN2108300000000,21,083,"Graves County, KY",Aug-22,15564,14920,644,4.10000000
CN2108500000000,21,085,"Grayson County, KY",Aug-22,10712,10236,476,4.40000000
CN2108700000000,21,087,"Green County, KY",Aug-22,5306,5118,188,3.50000000
CN2108900000000,21,089,"Greenup County, KY",Aug-22,12929,12174,755,5.80000000
CN2109100000000,21,091,"Hancock County, KY",Aug-22,3913,3760,153,3.90000000
CN2109300000000,21,093,"Hardin County, KY",Aug-22,47904,46021,1883,3.90000000
CN2109500000000,21,095,"Harlan County, KY",Aug-22,6511,6066,445,6.80000000
CN2109700000000,21,097,"Harrison County, KY",Aug-22,8917,8646,271,3.00000000
CN2109900000000,21,099,"Hart County, KY",Aug-22,7499,7203,296,3.90000000
CN2110100000000,21,101,"Henderson County, KY",Aug-22,21103,20308,795,3.80000000
CN2110300000000,21,103,"Henry County, KY",Aug-22,8373,8123,250,3.00000000
CN2110500000000,21,105,"Hickman County, KY",Aug-22,1706,1634,72,4.20000000
CN2110700000000,21,107,"Hopkins County, KY",Aug-22,17900,17128,772,4.30000000
CN2110900000000,21,109,"Jackson County, KY",Aug-22,4176,3932,244,5.80000000
CN2111100000000,21,111,"Jefferson County, KY",Aug-22,405574,391834,13740,3.40000000
CN2111300000000,21,113,"Jessamine County, KY",Aug-22,26843,25992,851,3.20000000
CN2111500000000,21,115,"Johnson County, KY",Aug-22,6575,6176,399,6.10000000
CN2111700000000,21,117,"Kenton County, KY",Aug-22,87847,84943,2904,3.30000000
CN2111900000000,21,119,"Knott County, KY",Aug-22,4294,4006,288,6.70000000
CN2112100000000,21,121,"Knox County, KY",Aug-22,10217,9654,563,5.50000000
CN2112300000000,21,123,"Larue County, KY",Aug-22,5828,5576,252,4.30000000
CN2112500000000,21,125,"Laurel County, KY",Aug-22,25784,24691,1093,4.20000000
CN2112700000000,21,127,"Lawrence County, KY",Aug-22,5568,5282,286,5.10000000
CN2112900000000,21,129,"Lee County, KY",Aug-22,1999,1893,106,5.30000000
CN2113100000000,21,131,"Leslie County, KY",Aug-22,2532,2344,188,7.40000000
CN2113300000000,21,133,"Letcher County, KY",Aug-22,6119,5715,404,6.60000000
CN2113500000000,21,135,"Lewis County, KY",Aug-22,4708,4367,341,7.20000000
CN2113700000000,21,137,"Lincoln County, KY",Aug-22,9237,8784,453,4.90000000
CN2113900000000,21,139,"Livingston County, KY",Aug-22,3600,3430,170,4.70000000
CN2114100000000,21,141,"Logan County, KY",Aug-22,12508,12084,424,3.40000000
CN2114300000000,21,143,"Lyon County, KY",Aug-22,3177,3045,132,4.20000000
CN2114500000000,21,145,"McCracken County, KY",Aug-22,29398,28206,1192,4.10000000
CN2114700000000,21,147,"McCreary County, KY",Aug-22,4733,4495,238,5.00000000
CN2114900000000,21,149,"McLean County, KY",Aug-22,4095,3919,176,4.30000000
CN2115100000000,21,151,"Madison County, KY",Aug-22,47270,45621,1649,3.50000000
CN2115300000000,21,153,"Magoffin County, KY",Aug-22,3361,2968,393,11.70000000
CN2115500000000,21,155,"Marion County, KY",Aug-22,9323,9027,296,3.20000000
CN2115700000000,21,157,"Marshall County, KY",Aug-22,14414,13834,580,4.00000000
CN2115900000000,21,159,"Martin County, KY",Aug-22,2227,2039,188,8.40000000
CN2116100000000,21,161,"Mason County, KY",Aug-22,6587,6266,321,4.90000000
CN2116300000000,21,163,"Meade County, KY",Aug-22,11848,11353,495,4.20000000
CN2116500000000,21,165,"Menifee County, KY",Aug-22,2337,2221,116,5.00000000
CN2116700000000,21,167,"Mercer County, KY",Aug-22,9904,9546,358,3.60000000
CN2116900000000,21,169,"Metcalfe County, KY",Aug-22,3879,3703,176,4.50000000
CN2117100000000,21,171,"Monroe County, KY",Aug-22,4506,4361,145,3.20000000
CN2117300000000,21,173,"Montgomery County, KY",Aug-22,11768,11249,519,4.40000000
CN2117500000000,21,175,"Morgan County, KY",Aug-22,4334,4139,195,4.50000000
CN2117700000000,21,177,"Muhlenberg County, KY",Aug-22,9497,8909,588,6.20000000
CN2117900000000,21,179,"Nelson County, KY",Aug-22,23994,23220,774,3.20000000
CN2118100000000,21,181,"Nicholas County, KY",Aug-22,3325,3186,139,4.20000000
CN2118300000000,21,183,"Ohio County, KY",Aug-22,9161,8702,459,5.00000000
CN2118500000000,21,185,"Oldham County, KY",Aug-22,34188,33271,917,2.70000000
CN2118700000000,21,187,"Owen County, KY",Aug-22,5062,4899,163,3.20000000
CN2118900000000,21,189,"Owsley County, KY",Aug-22,1053,976,77,7.30000000
CN2119100000000,21,191,"Pendleton County, KY",Aug-22,6894,6673,221,3.20000000
CN2119300000000,21,193,"Perry County, KY",Aug-22,7986,7551,435,5.40000000
CN2119500000000,21,195,"Pike County, KY",Aug-22,18730,17734,996,5.30000000
CN2119700000000,21,197,"Powell County, KY",Aug-22,5249,5042,207,3.90000000
CN2119900000000,21,199,"Pulaski County, KY",Aug-22,26061,24910,1151,4.40000000
CN2120100000000,21,201,"Robertson County, KY",Aug-22,824,783,41,5.00000000
CN2120300000000,21,203,"Rockcastle County, KY",Aug-22,6560,6254,306,4.70000000
CN2120500000000,21,205,"Rowan County, KY",Aug-22,9640,9195,445,4.60000000
CN2120700000000,21,207,"Russell County, KY",Aug-22,6148,5850,298,4.80000000
CN2120900000000,21,209,"Scott County, KY",Aug-22,30753,29865,888,2.90000000
CN2121100000000,21,211,"Shelby County, KY",Aug-22,26642,25876,766,2.90000000
CN2121300000000,21,213,"Simpson County, KY",Aug-22,8887,8581,306,3.40000000
CN2121500000000,21,215,"Spencer County, KY",Aug-22,10831,10502,329,3.00000000
CN2121700000000,21,217,"Taylor County, KY",Aug-22,12410,11973,437,3.50000000
CN2121900000000,21,219,"Todd County, KY",Aug-22,5578,5398,180,3.20000000
CN2122100000000,21,221,"Trigg County, KY",Aug-22,6128,5865,263,4.30000000
CN2122300000000,21,223,"Trimble County, KY",Aug-22,3926,3796,130,3.30000000
CN2122500000000,21,225,"Union County, KY",Aug-22,6088,5844,244,4.00000000
CN2122700000000,21,227,"Warren County, KY",Aug-22,64767,62521,2246,3.50000000
CN2122900000000,21,229,"Washington County, KY",Aug-22,6227,6030,197,3.20000000
CN2123100000000,21,231,"Wayne County, KY",Aug-22,7132,6793,339,4.80000000
CN2123300000000,21,233,"Webster County, KY",Aug-22,5356,5151,205,3.80000000
CN2123500000000,21,235,"Whitley County, KY",Aug-22,14318,13695,623,4.40000000
CN2123700000000,21,237,"Wolfe County, KY",Aug-22,2221,2103,118,5.30000000
CN2123900000000,21,239,"Woodford County, KY",Aug-22,15377,14938,439,2.90000000
CN2200100000000,22,001,"Acadia Parish, LA",Aug-22,23995,23177,818,3.40000000
CN2200300000000,22,003,"Allen Parish, LA",Aug-22,7626,7297,329,4.30000000
CN2200500000000,22,005,"Ascension Parish, LA",Aug-22,65614,63777,1837,2.80000000
CN2200700000000,22,007,"Assumption Parish, LA",Aug-22,8584,8129,455,5.30000000
CN2200900000000,22,009,"Avoyelles Parish, LA",Aug-22,14149,13541,608,4.30000000
CN2201100000000,22,011,"Beauregard Parish, LA",Aug-22,14711,14277,434,3.00000000
CN2201300000000,22,013,"Bienville Parish, LA",Aug-22,5277,5065,212,4.00000000
CN2201500000000,22,015,"Bossier Parish, LA",Aug-22,58227,56627,1600,2.70000000
CN2201700000000,22,017,"Caddo Parish, LA",Aug-22,102727,98198,4529,4.40000000
CN2201900000000,22,019,"Calcasieu Parish, LA",Aug-22,98111,94690,3421,3.50000000
CN2202100000000,22,021,"Caldwell Parish, LA",Aug-22,3623,3496,127,3.50000000
CN2202300000000,22,023,"Cameron Parish, LA",Aug-22,3619,3537,82,2.30000000
CN2202500000000,22,025,"Catahoula Parish, LA",Aug-22,3435,3305,130,3.80000000
CN2202700000000,22,027,"Claiborne Parish, LA",Aug-22,5326,5116,210,3.90000000
CN2202900000000,22,029,"Concordia Parish, LA",Aug-22,6959,6630,329,4.70000000
CN2203100000000,22,031,"De Soto Parish, LA",Aug-22,10949,10550,399,3.60000000
CN2203300000000,22,033,"East Baton Rouge Parish, LA",Aug-22,229928,221448,8480,3.70000000
CN2203500000000,22,035,"East Carroll Parish, LA",Aug-22,1636,1485,151,9.20000000
CN2203700000000,22,037,"East Feliciana Parish, LA",Aug-22,7730,7495,235,3.00000000
CN2203900000000,22,039,"Evangeline Parish, LA",Aug-22,11584,11099,485,4.20000000
CN2204100000000,22,041,"Franklin Parish, LA",Aug-22,7254,6917,337,4.60000000
CN2204300000000,22,043,"Grant Parish, LA",Aug-22,8382,8117,265,3.20000000
CN2204500000000,22,045,"Iberia Parish, LA",Aug-22,27919,26634,1285,4.60000000
CN2204700000000,22,047,"Iberville Parish, LA",Aug-22,13756,13041,715,5.20000000
CN2204900000000,22,049,"Jackson Parish, LA",Aug-22,6642,6432,210,3.20000000
CN2205100000000,22,051,"Jefferson Parish, LA",Aug-22,211727,203620,8107,3.80000000
CN2205300000000,22,053,"Jefferson Davis Parish, LA",Aug-22,12768,12367,401,3.10000000
CN2205500000000,22,055,"Lafayette Parish, LA",Aug-22,117405,113928,3477,3.00000000
CN2205700000000,22,057,"Lafourche Parish, LA",Aug-22,40457,39224,1233,3.00000000
CN2205900000000,22,059,"LaSalle Parish, LA",Aug-22,6644,6488,156,2.30000000
CN2206100000000,22,061,"Lincoln Parish, LA",Aug-22,19667,18943,724,3.70000000
CN2206300000000,22,063,"Livingston Parish, LA",Aug-22,70257,68393,1864,2.70000000
CN2206500000000,22,065,"Madison Parish, LA",Aug-22,3336,3145,191,5.70000000
CN2206700000000,22,067,"Morehouse Parish, LA",Aug-22,9798,9220,578,5.90000000
CN2206900000000,22,069,"Natchitoches Parish, LA",Aug-22,15811,15164,647,4.10000000
CN2207100000000,22,071,"Orleans Parish, LA",Aug-22,178914,169155,9759,5.50000000
CN2207300000000,22,073,"Ouachita Parish, LA",Aug-22,69139,66632,2507,3.60000000
CN2207500000000,22,075,"Plaquemines Parish, LA",Aug-22,9755,9472,283,2.90000000
CN2207700000000,22,077,"Pointe Coupee Parish, LA",Aug-22,9632,9221,411,4.30000000
CN2207900000000,22,079,"Rapides Parish, LA",Aug-22,56606,54929,1677,3.00000000
CN2208100000000,22,081,"Red River Parish, LA",Aug-22,3740,3625,115,3.10000000
CN2208300000000,22,083,"Richland Parish, LA",Aug-22,8190,7860,330,4.00000000
CN2208500000000,22,085,"Sabine Parish, LA",Aug-22,9056,8796,260,2.90000000
CN2208700000000,22,087,"St. Bernard Parish, LA",Aug-22,20137,19218,919,4.60000000
CN2208900000000,22,089,"St. Charles Parish, LA",Aug-22,24857,24058,799,3.20000000
CN2209100000000,22,091,"St. Helena Parish, LA",Aug-22,4240,3970,270,6.40000000
CN2209300000000,22,093,"St. James Parish, LA",Aug-22,8998,8532,466,5.20000000
CN2209500000000,22,095,"St. John the Baptist Parish, LA",Aug-22,19328,18229,1099,5.70000000
CN2209700000000,22,097,"St. Landry Parish, LA",Aug-22,31746,30237,1509,4.80000000
CN2209900000000,22,099,"St. Martin Parish, LA",Aug-22,22301,21481,820,3.70000000
CN2210100000000,22,101,"St. Mary Parish, LA",Aug-22,19250,18318,932,4.80000000
CN2210300000000,22,103,"St. Tammany Parish, LA",Aug-22,119651,116483,3168,2.60000000
CN2210500000000,22,105,"Tangipahoa Parish, LA",Aug-22,56588,53954,2634,4.70000000
CN2210700000000,22,107,"Tensas Parish, LA",Aug-22,1283,1222,61,4.80000000
CN2210900000000,22,109,"Terrebonne Parish, LA",Aug-22,44638,42916,1722,3.90000000
CN2211100000000,22,111,"Union Parish, LA",Aug-22,8966,8646,320,3.60000000
CN2211300000000,22,113,"Vermilion Parish, LA",Aug-22,24174,23386,788,3.30000000
CN2211500000000,22,115,"Vernon Parish, LA",Aug-22,15574,15037,537,3.40000000
CN2211700000000,22,117,"Washington Parish, LA",Aug-22,16507,15792,715,4.30000000
CN2211900000000,22,119,"Webster Parish, LA",Aug-22,14266,13661,605,4.20000000
CN2212100000000,22,121,"West Baton Rouge Parish, LA",Aug-22,13772,13313,459,3.30000000
CN2212300000000,22,123,"West Carroll Parish, LA",Aug-22,3516,3341,175,5.00000000
CN2212500000000,22,125,"West Feliciana Parish, LA",Aug-22,5327,5196,131,2.50000000
CN2212700000000,22,127,"Winn Parish, LA",Aug-22,4493,4322,171,3.80000000
CN2300100000000,23,001,"Androscoggin County, ME",Aug-22,53275,51603,1672,3.10000000
CN2300300000000,23,003,"Aroostook County, ME",Aug-22,27940,26866,1074,3.80000000
CN2300500000000,23,005,"Cumberland County, ME",Aug-22,165444,161318,4126,2.50000000
CN2300700000000,23,007,"Franklin County, ME",Aug-22,13357,12876,481,3.60000000
CN2300900000000,23,009,"Hancock County, ME",Aug-22,30502,29695,807,2.60000000
CN2301100000000,23,011,"Kennebec County, ME",Aug-22,60553,58779,1774,2.90000000
CN2301300000000,23,013,"Knox County, ME",Aug-22,20107,19562,545,2.70000000
CN2301500000000,23,015,"Lincoln County, ME",Aug-22,17176,16719,457,2.70000000
CN2301700000000,23,017,"Oxford County, ME",Aug-22,26118,25199,919,3.50000000
CN2301900000000,23,019,"Penobscot County, ME",Aug-22,73853,71484,2369,3.20000000
CN2302100000000,23,021,"Piscataquis County, ME",Aug-22,7252,6975,277,3.80000000
CN2302300000000,23,023,"Sagadahoc County, ME",Aug-22,18836,18368,468,2.50000000
CN2302500000000,23,025,"Somerset County, ME",Aug-22,21949,21043,906,4.10000000
CN2302700000000,23,027,"Waldo County, ME",Aug-22,20417,19785,632,3.10000000
CN2302900000000,23,029,"Washington County, ME",Aug-22,13387,12827,560,4.20000000
CN2303100000000,23,031,"York County, ME",Aug-22,112956,110127,2829,2.50000000
CN2400100000000,24,001,"Allegany County, MD",Aug-22,30070,28357,1713,5.70000000
CN2400300000000,24,003,"Anne Arundel County, MD",Aug-22,322884,310753,12131,3.80000000
CN2400500000000,24,005,"Baltimore County, MD",Aug-22,457850,437990,19860,4.30000000
CN2400900000000,24,009,"Calvert County, MD",Aug-22,49407,47341,2066,4.20000000
CN2401100000000,24,011,"Caroline County, MD",Aug-22,16575,15898,677,4.10000000
CN2401300000000,24,013,"Carroll County, MD",Aug-22,97474,93976,3498,3.60000000
CN2401500000000,24,015,"Cecil County, MD",Aug-22,53462,51039,2423,4.50000000
CN2401700000000,24,017,"Charles County, MD",Aug-22,86668,82703,3965,4.60000000
CN2401900000000,24,019,"Dorchester County, MD",Aug-22,15322,14566,756,4.90000000
CN2402100000000,24,021,"Frederick County, MD",Aug-22,138089,132662,5427,3.90000000
CN2402300000000,24,023,"Garrett County, MD",Aug-22,14496,13854,642,4.40000000
CN2402500000000,24,025,"Harford County, MD",Aug-22,144331,138534,5797,4.00000000
CN2402700000000,24,027,"Howard County, MD",Aug-22,192895,186189,6706,3.50000000
CN2402900000000,24,029,"Kent County, MD",Aug-22,9313,8872,441,4.70000000
CN2403100000000,24,031,"Montgomery County, MD",Aug-22,554861,533187,21674,3.90000000
CN2403300000000,24,033,"Prince George's County, MD",Aug-22,498379,473563,24816,5.00000000
CN2403500000000,24,035,"Queen Anne's County, MD",Aug-22,28824,27796,1028,3.60000000
CN2403700000000,24,037,"St. Mary's County, MD",Aug-22,57971,55400,2571,4.40000000
CN2403900000000,24,039,"Somerset County, MD",Aug-22,9508,8900,608,6.40000000
CN2404100000000,24,041,"Talbot County, MD",Aug-22,16883,16140,743,4.40000000
CN2404300000000,24,043,"Washington County, MD",Aug-22,73417,70195,3222,4.40000000
CN2404500000000,24,045,"Wicomico County, MD",Aug-22,53449,50856,2593,4.90000000
CN2404700000000,24,047,"Worcester County, MD",Aug-22,26091,24754,1337,5.10000000
CN2451000000000,24,510,"Baltimore city, MD",Aug-22,284411,267529,16882,5.90000000
CN2500100000000,25,001,"Barnstable County, MA",Aug-22,119431,115524,3907,3.30000000
CN2500300000000,25,003,"Berkshire County, MA",Aug-22,61118,58706,2412,3.90000000
CN2500500000000,25,005,"Bristol County, MA",Aug-22,298609,285776,12833,4.30000000
CN2500700000000,25,007,"Dukes County, MA",Aug-22,11582,11262,320,2.80000000
CN2500900000000,25,009,"Essex County, MA",Aug-22,423143,407291,15852,3.70000000
CN2501100000000,25,011,"Franklin County, MA",Aug-22,39966,38762,1204,3.00000000
CN2501300000000,25,013,"Hampden County, MA",Aug-22,223598,212606,10992,4.90000000
CN2501500000000,25,015,"Hampshire County, MA",Aug-22,89172,86291,2881,3.20000000
CN2501700000000,25,017,"Middlesex County, MA",Aug-22,919781,893750,26031,2.80000000
CN2501900000000,25,019,"Nantucket County/town, MA",Aug-22,10055,9814,241,2.40000000
CN2502100000000,25,021,"Norfolk County, MA",Aug-22,396241,384003,12238,3.10000000
CN2502300000000,25,023,"Plymouth County, MA",Aug-22,285647,275307,10340,3.60000000
CN2502500000000,25,025,"Suffolk County, MA",Aug-22,458156,442020,16136,3.50000000
CN2502700000000,25,027,"Worcester County, MA",Aug-22,438165,421675,16490,3.80000000
CN2600100000000,26,001,"Alcona County, MI",Aug-22,4095,3837,258,6.30000000
CN2600300000000,26,003,"Alger County, MI",Aug-22,3557,3338,219,6.20000000
CN2600500000000,26,005,"Allegan County, MI",Aug-22,63315,61173,2142,3.40000000
CN2600700000000,26,007,"Alpena County, MI",Aug-22,13493,12863,630,4.70000000
CN2600900000000,26,009,"Antrim County, MI",Aug-22,10890,10334,556,5.10000000
CN2601100000000,26,011,"Arenac County, MI",Aug-22,6092,5688,404,6.60000000
CN2601300000000,26,013,"Baraga County, MI",Aug-22,3180,2960,220,6.90000000
CN2601500000000,26,015,"Barry County, MI",Aug-22,32140,30971,1169,3.60000000
CN2601700000000,26,017,"Bay County, MI",Aug-22,49183,46728,2455,5.00000000
CN2601900000000,26,019,"Benzie County, MI",Aug-22,9251,8849,402,4.30000000
CN2602100000000,26,021,"Berrien County, MI",Aug-22,72109,68855,3254,4.50000000
CN2602300000000,26,023,"Branch County, MI",Aug-22,19606,18812,794,4.00000000
CN2602500000000,26,025,"Calhoun County, MI",Aug-22,60539,57421,3118,5.20000000
CN2602700000000,26,027,"Cass County, MI",Aug-22,24089,23040,1049,4.40000000
CN2602900000000,26,029,"Charlevoix County, MI",Aug-22,13387,12860,527,3.90000000
CN2603100000000,26,031,"Cheboygan County, MI",Aug-22,11098,10655,443,4.00000000
CN2603300000000,26,033,"Chippewa County, MI",Aug-22,16630,15708,922,5.50000000
CN2603500000000,26,035,"Clare County, MI",Aug-22,11468,10695,773,6.70000000
CN2603700000000,26,037,"Clinton County, MI",Aug-22,40088,38523,1565,3.90000000
CN2603900000000,26,039,"Crawford County, MI",Aug-22,5625,5274,351,6.20000000
CN2604100000000,26,041,"Delta County, MI",Aug-22,16761,15921,840,5.00000000
CN2604300000000,26,043,"Dickinson County, MI",Aug-22,12354,11865,489,4.00000000
CN2604500000000,26,045,"Eaton County, MI",Aug-22,55303,52807,2496,4.50000000
CN2604700000000,26,047,"Emmet County, MI",Aug-22,18009,17233,776,4.30000000
CN2604900000000,26,049,"Genesee County, MI",Aug-22,178558,167754,10804,6.10000000
CN2605100000000,26,051,"Gladwin County, MI",Aug-22,10119,9534,585,5.80000000
CN2605300000000,26,053,"Gogebic County, MI",Aug-22,5651,5375,276,4.90000000
CN2605500000000,26,055,"Grand Traverse County, MI",Aug-22,52343,50614,1729,3.30000000
CN2605700000000,26,057,"Gratiot County, MI",Aug-22,17248,16425,823,4.80000000
CN2605900000000,26,059,"Hillsdale County, MI",Aug-22,20427,19577,850,4.20000000
CN2606100000000,26,061,"Houghton County, MI",Aug-22,15566,14868,698,4.50000000
CN2606300000000,26,063,"Huron County, MI",Aug-22,15366,14696,670,4.40000000
CN2606500000000,26,065,"Ingham County, MI",Aug-22,144672,137902,6770,4.70000000
CN2606700000000,26,067,"Ionia County, MI",Aug-22,30514,29363,1151,3.80000000
CN2606900000000,26,069,"Iosco County, MI",Aug-22,10698,10072,626,5.90000000
CN2607100000000,26,071,"Iron County, MI",Aug-22,5034,4787,247,4.90000000
CN2607300000000,26,073,"Isabella County, MI",Aug-22,32795,31321,1474,4.50000000
CN2607500000000,26,075,"Jackson County, MI",Aug-22,73103,69842,3261,4.50000000
CN2607700000000,26,077,"Kalamazoo County, MI",Aug-22,131410,126163,5247,4.00000000
CN2607900000000,26,079,"Kalkaska County, MI",Aug-22,8310,7874,436,5.20000000
CN2608100000000,26,081,"Kent County, MI",Aug-22,361337,348764,12573,3.50000000
CN2608300000000,26,083,"Keweenaw County, MI",Aug-22,876,830,46,5.30000000
CN2608500000000,26,085,"Lake County, MI",Aug-22,4305,4029,276,6.40000000
CN2608700000000,26,087,"Lapeer County, MI",Aug-22,40753,39366,1387,3.40000000
CN2608900000000,26,089,"Leelanau County, MI",Aug-22,11013,10623,390,3.50000000
CN2609100000000,26,091,"Lenawee County, MI",Aug-22,44917,42969,1948,4.30000000
CN2609300000000,26,093,"Livingston County, MI",Aug-22,104203,101745,2458,2.40000000
CN2609500000000,26,095,"Luce County, MI",Aug-22,2211,2088,123,5.60000000
CN2609700000000,26,097,"Mackinac County, MI",Aug-22,6262,6084,178,2.80000000
CN2609900000000,26,099,"Macomb County, MI",Aug-22,445385,430553,14832,3.30000000
CN2610100000000,26,101,"Manistee County, MI",Aug-22,10745,10188,557,5.20000000
CN2610300000000,26,103,"Marquette County, MI",Aug-22,31130,29700,1430,4.60000000
CN2610500000000,26,105,"Mason County, MI",Aug-22,13902,13267,635,4.60000000
CN2610700000000,26,107,"Mecosta County, MI",Aug-22,18349,17388,961,5.20000000
CN2610900000000,26,109,"Menominee County, MI",Aug-22,10703,10276,427,4.00000000
CN2611100000000,26,111,"Midland County, MI",Aug-22,39220,37574,1646,4.20000000
CN2611300000000,26,113,"Missaukee County, MI",Aug-22,7169,6850,319,4.40000000
CN2611500000000,26,115,"Monroe County, MI",Aug-22,73792,70408,3384,4.60000000
CN2611700000000,26,117,"Montcalm County, MI",Aug-22,28232,26984,1248,4.40000000
CN2611900000000,26,119,"Montmorency County, MI",Aug-22,3176,2933,243,7.70000000
CN2612100000000,26,121,"Muskegon County, MI",Aug-22,77935,73493,4442,5.70000000
CN2612300000000,26,123,"Newaygo County, MI",Aug-22,24093,23024,1069,4.40000000
CN2612500000000,26,125,"Oakland County, MI",Aug-22,673124,655346,17778,2.60000000
CN2612700000000,26,127,"Oceana County, MI",Aug-22,12851,12128,723,5.60000000
CN2612900000000,26,129,"Ogemaw County, MI",Aug-22,8497,7941,556,6.50000000
CN2613100000000,26,131,"Ontonagon County, MI",Aug-22,2162,2010,152,7.00000000
CN2613300000000,26,133,"Osceola County, MI",Aug-22,11927,11435,492,4.10000000
CN2613500000000,26,135,"Oscoda County, MI",Aug-22,2807,2578,229,8.20000000
CN2613700000000,26,137,"Otsego County, MI",Aug-22,11956,11343,613,5.10000000
CN2613900000000,26,139,"Ottawa County, MI",Aug-22,163078,157977,5101,3.10000000
CN2614100000000,26,141,"Presque Isle County, MI",Aug-22,5230,4908,322,6.20000000
CN2614300000000,26,143,"Roscommon County, MI",Aug-22,7892,7260,632,8.00000000
CN2614500000000,26,145,"Saginaw County, MI",Aug-22,82455,77613,4842,5.90000000
CN2614700000000,26,147,"St. Clair County, MI",Aug-22,75326,72825,2501,3.30000000
CN2614900000000,26,149,"St. Joseph County, MI",Aug-22,28892,27667,1225,4.20000000
CN2615100000000,26,151,"Sanilac County, MI",Aug-22,19885,18904,981,4.90000000
CN2615300000000,26,153,"Schoolcraft County, MI",Aug-22,3303,3086,217,6.60000000
CN2615500000000,26,155,"Shiawassee County, MI",Aug-22,32362,30889,1473,4.60000000
CN2615700000000,26,157,"Tuscola County, MI",Aug-22,23309,22087,1222,5.20000000
CN2615900000000,26,159,"Van Buren County, MI",Aug-22,34723,33074,1649,4.70000000
CN2616100000000,26,161,"Washtenaw County, MI",Aug-22,196337,189496,6841,3.50000000
CN2616300000000,26,163,"Wayne County, MI",Aug-22,795348,758969,36379,4.60000000
CN2616500000000,26,165,"Wexford County, MI",Aug-22,15074,14370,704,4.70000000
CN2700100000000,27,001,"Aitkin County, MN",Aug-22,7312,7112,200,2.70000000
CN2700300000000,27,003,"Anoka County, MN",Aug-22,200555,196241,4314,2.20000000
CN2700500000000,27,005,"Becker County, MN",Aug-22,18567,18181,386,2.10000000
CN2700700000000,27,007,"Beltrami County, MN",Aug-22,23826,23224,602,2.50000000
CN2700900000000,27,009,"Benton County, MN",Aug-22,21323,20818,505,2.40000000
CN2701100000000,27,011,"Big Stone County, MN",Aug-22,2360,2308,52,2.20000000
CN2701300000000,27,013,"Blue Earth County, MN",Aug-22,39687,38958,729,1.80000000
CN2701500000000,27,015,"Brown County, MN",Aug-22,13202,12935,267,2.00000000
CN2701700000000,27,017,"Carlton County, MN",Aug-22,17332,16917,415,2.40000000
CN2701900000000,27,019,"Carver County, MN",Aug-22,59933,58886,1047,1.70000000
CN2702100000000,27,021,"Cass County, MN",Aug-22,17760,17344,416,2.30000000
CN2702300000000,27,023,"Chippewa County, MN",Aug-22,6198,6078,120,1.90000000
CN2702500000000,27,025,"Chisago County, MN",Aug-22,30137,29498,639,2.10000000
CN2702700000000,27,027,"Clay County, MN",Aug-22,36361,35718,643,1.80000000
CN2702900000000,27,029,"Clearwater County, MN",Aug-22,4498,4326,172,3.80000000
CN2703100000000,27,031,"Cook County, MN",Aug-22,3024,2962,62,2.10000000
CN2703300000000,27,033,"Cottonwood County, MN",Aug-22,6403,6250,153,2.40000000
CN2703500000000,27,035,"Crow Wing County, MN",Aug-22,32219,31538,681,2.10000000
CN2703700000000,27,037,"Dakota County, MN",Aug-22,244705,239826,4879,2.00000000
CN2703900000000,27,039,"Dodge County, MN",Aug-22,12000,11775,225,1.90000000
CN2704100000000,27,041,"Douglas County, MN",Aug-22,21278,20916,362,1.70000000
CN2704300000000,27,043,"Faribault County, MN",Aug-22,6851,6695,156,2.30000000
CN2704500000000,27,045,"Fillmore County, MN",Aug-22,11507,11289,218,1.90000000
CN2704700000000,27,047,"Freeborn County, MN",Aug-22,14639,14296,343,2.30000000
CN2704900000000,27,049,"Goodhue County, MN",Aug-22,26028,25484,544,2.10000000
CN2705100000000,27,051,"Grant County, MN",Aug-22,3123,3066,57,1.80000000
CN2705300000000,27,053,"Hennepin County, MN",Aug-22,713496,697899,15597,2.20000000
CN2705500000000,27,055,"Houston County, MN",Aug-22,9993,9834,159,1.60000000
CN2705700000000,27,057,"Hubbard County, MN",Aug-22,10486,10210,276,2.60000000
CN2705900000000,27,059,"Isanti County, MN",Aug-22,21776,21308,468,2.10000000
CN2706100000000,27,061,"Itasca County, MN",Aug-22,20836,20161,675,3.20000000
CN2706300000000,27,063,"Jackson County, MN",Aug-22,5268,5173,95,1.80000000
CN2706500000000,27,065,"Kanabec County, MN",Aug-22,8937,8705,232,2.60000000
CN2706700000000,27,067,"Kandiyohi County, MN",Aug-22,22164,21692,472,2.10000000
CN2706900000000,27,069,"Kittson County, MN",Aug-22,2157,2111,46,2.10000000
CN2707100000000,27,071,"Koochiching County, MN",Aug-22,5521,5341,180,3.30000000
CN2707300000000,27,073,"Lac qui Parle County, MN",Aug-22,3102,3039,63,2.00000000
CN2707500000000,27,075,"Lake County, MN",Aug-22,5614,5325,289,5.10000000
CN2707700000000,27,077,"Lake of the Woods County, MN",Aug-22,2355,2275,80,3.40000000
CN2707900000000,27,079,"Le Sueur County, MN",Aug-22,15895,15566,329,2.10000000
CN2708100000000,27,081,"Lincoln County, MN",Aug-22,2847,2793,54,1.90000000
CN2708300000000,27,083,"Lyon County, MN",Aug-22,13370,13096,274,2.00000000
CN2708500000000,27,085,"McLeod County, MN",Aug-22,18576,18174,402,2.20000000
CN2708700000000,27,087,"Mahnomen County, MN",Aug-22,2077,1995,82,3.90000000
CN2708900000000,27,089,"Marshall County, MN",Aug-22,5002,4892,110,2.20000000
CN2709100000000,27,091,"Martin County, MN",Aug-22,9319,9113,206,2.20000000
CN2709300000000,27,093,"Meeker County, MN",Aug-22,12907,12658,249,1.90000000
CN2709500000000,27,095,"Mille Lacs County, MN",Aug-22,12625,12293,332,2.60000000
CN2709700000000,27,097,"Morrison County, MN",Aug-22,16954,16520,434,2.60000000
CN2709900000000,27,099,"Mower County, MN",Aug-22,19929,19505,424,2.10000000
CN2710100000000,27,101,"Murray County, MN",Aug-22,4355,4282,73,1.70000000
CN2710300000000,27,103,"Nicollet County, MN",Aug-22,20391,20065,326,1.60000000
CN2710500000000,27,105,"Nobles County, MN",Aug-22,10773,10578,195,1.80000000
CN2710700000000,27,107,"Norman County, MN",Aug-22,3125,3044,81,2.60000000
CN2710900000000,27,109,"Olmsted County, MN",Aug-22,92383,90747,1636,1.80000000
CN2711100000000,27,111,"Otter Tail County, MN",Aug-22,30995,30399,596,1.90000000
CN2711300000000,27,113,"Pennington County, MN",Aug-22,8393,8211,182,2.20000000
CN2711500000000,27,115,"Pine County, MN",Aug-22,13885,13514,371,2.70000000
CN2711700000000,27,117,"Pipestone County, MN",Aug-22,4376,4301,75,1.70000000
CN2711900000000,27,119,"Polk County, MN",Aug-22,15531,15151,380,2.40000000
CN2712100000000,27,121,"Pope County, MN",Aug-22,6259,6166,93,1.50000000
CN2712300000000,27,123,"Ramsey County, MN",Aug-22,288881,282006,6875,2.40000000
CN2712500000000,27,125,"Red Lake County, MN",Aug-22,2116,2055,61,2.90000000
CN2712700000000,27,127,"Redwood County, MN",Aug-22,7204,7048,156,2.20000000
CN2712900000000,27,129,"Renville County, MN",Aug-22,7906,7675,231,2.90000000
CN2713100000000,27,131,"Rice County, MN",Aug-22,36141,35400,741,2.10000000
CN2713300000000,27,133,"Rock County, MN",Aug-22,5833,5748,85,1.50000000
CN2713500000000,27,135,"Roseau County, MN",Aug-22,7556,7397,159,2.10000000
CN2713700000000,27,137,"St. Louis County, MN",Aug-22,99403,96737,2666,2.70000000
CN2713900000000,27,139,"Scott County, MN",Aug-22,85202,83638,1564,1.80000000
CN2714100000000,27,141,"Sherburne County, MN",Aug-22,53442,52343,1099,2.10000000
CN2714300000000,27,143,"Sibley County, MN",Aug-22,8059,7894,165,2.00000000
CN2714500000000,27,145,"Stearns County, MN",Aug-22,88482,86683,1799,2.00000000
CN2714700000000,27,147,"Steele County, MN",Aug-22,18996,18531,465,2.40000000
CN2714900000000,27,149,"Stevens County, MN",Aug-22,5091,5010,81,1.60000000
CN2715100000000,27,151,"Swift County, MN",Aug-22,4579,4471,108,2.40000000
CN2715300000000,27,153,"Todd County, MN",Aug-22,12830,12567,263,2.00000000
CN2715500000000,27,155,"Traverse County, MN",Aug-22,1572,1548,24,1.50000000
CN2715700000000,27,157,"Wabasha County, MN",Aug-22,12271,12037,234,1.90000000
CN2715900000000,27,159,"Wadena County, MN",Aug-22,5742,5578,164,2.90000000
CN2716100000000,27,161,"Waseca County, MN",Aug-22,8589,8364,225,2.60000000
CN2716300000000,27,163,"Washington County, MN",Aug-22,146289,143506,2783,1.90000000
CN2716500000000,27,165,"Watonwan County, MN",Aug-22,6221,6092,129,2.10000000
CN2716700000000,27,167,"Wilkin County, MN",Aug-22,3224,3157,67,2.10000000
CN2716900000000,27,169,"Winona County, MN",Aug-22,26725,26192,533,2.00000000
CN2717100000000,27,171,"Wright County, MN",Aug-22,77190,75765,1425,1.80000000
CN2717300000000,27,173,"Yellow Medicine County, MN",Aug-22,4738,4629,109,2.30000000
CN2800100000000,28,001,"Adams County, MS",Aug-22,10469,9913,556,5.30000000
CN2800300000000,28,003,"Alcorn County, MS",Aug-22,15006,14501,505,3.40000000
CN2800500000000,28,005,"Amite County, MS",Aug-22,4319,4095,224,5.20000000
CN2800700000000,28,007,"Attala County, MS",Aug-22,7042,6769,273,3.90000000
CN2800900000000,28,009,"Benton County, MS",Aug-22,3134,2993,141,4.50000000
CN2801100000000,28,011,"Bolivar County, MS",Aug-22,10923,10395,528,4.80000000
CN2801300000000,28,013,"Calhoun County, MS",Aug-22,5367,5154,213,4.00000000
CN2801500000000,28,015,"Carroll County, MS",Aug-22,3488,3348,140,4.00000000
CN2801700000000,28,017,"Chickasaw County, MS",Aug-22,6821,6506,315,4.60000000
CN2801900000000,28,019,"Choctaw County, MS",Aug-22,3606,3495,111,3.10000000
CN2802100000000,28,021,"Claiborne County, MS",Aug-22,2900,2637,263,9.10000000
CN2802300000000,28,023,"Clarke County, MS",Aug-22,5504,5257,247,4.50000000
CN2802500000000,28,025,"Clay County, MS",Aug-22,8162,7787,375,4.60000000
CN2802700000000,28,027,"Coahoma County, MS",Aug-22,7593,7152,441,5.80000000
CN2802900000000,28,029,"Copiah County, MS",Aug-22,10605,10148,457,4.30000000
CN2803100000000,28,031,"Covington County, MS",Aug-22,8204,7933,271,3.30000000
CN2803300000000,28,033,"DeSoto County, MS",Aug-22,96164,93348,2816,2.90000000
CN2803500000000,28,035,"Forrest County, MS",Aug-22,33207,32025,1182,3.60000000
CN2803700000000,28,037,"Franklin County, MS",Aug-22,2552,2427,125,4.90000000
CN2803900000000,28,039,"George County, MS",Aug-22,8497,8052,445,5.20000000
CN2804100000000,28,041,"Greene County, MS",Aug-22,4157,3898,259,6.20000000
CN2804300000000,28,043,"Grenada County, MS",Aug-22,9257,8948,309,3.30000000
CN2804500000000,28,045,"Hancock County, MS",Aug-22,19108,18381,727,3.80000000
CN2804700000000,28,047,"Harrison County, MS",Aug-22,88658,85550,3108,3.50000000
CN2804900000000,28,049,"Hinds County, MS",Aug-22,100791,96844,3947,3.90000000
CN2805100000000,28,051,"Holmes County, MS",Aug-22,4870,4528,342,7.00000000
CN2805300000000,28,053,"Humphreys County, MS",Aug-22,1890,1726,164,8.70000000
CN2805500000000,28,055,"Issaquena County, MS",Aug-22,303,283,20,6.60000000
CN2805700000000,28,057,"Itawamba County, MS",Aug-22,10371,10056,315,3.00000000
CN2805900000000,28,059,"Jackson County, MS",Aug-22,59677,57238,2439,4.10000000
CN2806100000000,28,061,"Jasper County, MS",Aug-22,5712,5431,281,4.90000000
CN2806300000000,28,063,"Jefferson County, MS",Aug-22,1877,1606,271,14.40000000
CN2806500000000,28,065,"Jefferson Davis County, MS",Aug-22,3809,3622,187,4.90000000
CN2806700000000,28,067,"Jones County, MS",Aug-22,24378,23408,970,4.00000000
CN2806900000000,28,069,"Kemper County, MS",Aug-22,3177,2999,178,5.60000000
CN2807100000000,28,071,"Lafayette County, MS",Aug-22,28924,28092,832,2.90000000
CN2807300000000,28,073,"Lamar County, MS",Aug-22,31599,30725,874,2.80000000
CN2807500000000,28,075,"Lauderdale County, MS",Aug-22,28560,27485,1075,3.80000000
CN2807700000000,28,077,"Lawrence County, MS",Aug-22,4588,4368,220,4.80000000
CN2807900000000,28,079,"Leake County, MS",Aug-22,7843,7540,303,3.90000000
CN2808100000000,28,081,"Lee County, MS",Aug-22,41480,40178,1302,3.10000000
CN2808300000000,28,083,"Leflore County, MS",Aug-22,9956,9436,520,5.20000000
CN2808500000000,28,085,"Lincoln County, MS",Aug-22,14597,14077,520,3.60000000
CN2808700000000,28,087,"Lowndes County, MS",Aug-22,25144,24151,993,3.90000000
CN2808900000000,28,089,"Madison County, MS",Aug-22,52659,51115,1544,2.90000000
CN2809100000000,28,091,"Marion County, MS",Aug-22,10350,10000,350,3.40000000
CN2809300000000,28,093,"Marshall County, MS",Aug-22,14531,13998,533,3.70000000
CN2809500000000,28,095,"Monroe County, MS",Aug-22,16251,15644,607,3.70000000
CN2809700000000,28,097,"Montgomery County, MS",Aug-22,3876,3712,164,4.20000000
CN2809900000000,28,099,"Neshoba County, MS",Aug-22,9867,9469,398,4.00000000
CN2810100000000,28,101,"Newton County, MS",Aug-22,8145,7842,303,3.70000000
CN2810300000000,28,103,"Noxubee County, MS",Aug-22,3400,3190,210,6.20000000
CN2810500000000,28,105,"Oktibbeha County, MS",Aug-22,22628,21768,860,3.80000000
CN2810700000000,28,107,"Panola County, MS",Aug-22,12576,12013,563,4.50000000
CN2810900000000,28,109,"Pearl River County, MS",Aug-22,23632,22786,846,3.60000000
CN2811100000000,28,111,"Perry County, MS",Aug-22,4220,4026,194,4.60000000
CN2811300000000,28,113,"Pike County, MS",Aug-22,14222,13535,687,4.80000000
CN2811500000000,28,115,"Pontotoc County, MS",Aug-22,15046,14549,497,3.30000000
CN2811700000000,28,117,"Prentiss County, MS",Aug-22,11434,11080,354,3.10000000
CN2811900000000,28,119,"Quitman County, MS",Aug-22,2248,2119,129,5.70000000
CN2812100000000,28,121,"Rankin County, MS",Aug-22,75676,73631,2045,2.70000000
CN2812300000000,28,123,"Scott County, MS",Aug-22,12281,11904,377,3.10000000
CN2812500000000,28,125,"Sharkey County, MS",Aug-22,1317,1237,80,6.10000000
CN2812700000000,28,127,"Simpson County, MS",Aug-22,10414,10043,371,3.60000000
CN2812900000000,28,129,"Smith County, MS",Aug-22,6476,6255,221,3.40000000
CN2813100000000,28,131,"Stone County, MS",Aug-22,6982,6719,263,3.80000000
CN2813300000000,28,133,"Sunflower County, MS",Aug-22,7263,6826,437,6.00000000
CN2813500000000,28,135,"Tallahatchie County, MS",Aug-22,4524,4342,182,4.00000000
CN2813700000000,28,137,"Tate County, MS",Aug-22,12364,11924,440,3.60000000
CN2813900000000,28,139,"Tippah County, MS",Aug-22,9849,9542,307,3.10000000
CN2814100000000,28,141,"Tishomingo County, MS",Aug-22,8238,7957,281,3.40000000
CN2814300000000,28,143,"Tunica County, MS",Aug-22,4267,4065,202,4.70000000
CN2814500000000,28,145,"Union County, MS",Aug-22,14499,14105,394,2.70000000
CN2814700000000,28,147,"Walthall County, MS",Aug-22,4886,4658,228,4.70000000
CN2814900000000,28,149,"Warren County, MS",Aug-22,19145,18358,787,4.10000000
CN2815100000000,28,151,"Washington County, MS",Aug-22,15237,14397,840,5.50000000
CN2815300000000,28,153,"Wayne County, MS",Aug-22,7245,6910,335,4.60000000
CN2815500000000,28,155,"Webster County, MS",Aug-22,3898,3755,143,3.70000000
CN2815700000000,28,157,"Wilkinson County, MS",Aug-22,2594,2420,174,6.70000000
CN2815900000000,28,159,"Winston County, MS",Aug-22,6996,6688,308,4.40000000
CN2816100000000,28,161,"Yalobusha County, MS",Aug-22,4931,4745,186,3.80000000
CN2816300000000,28,163,"Yazoo County, MS",Aug-22,8681,8270,411,4.70000000
CN2900100000000,29,001,"Adair County, MO",Aug-22,9512,9160,352,3.70000000
CN2900300000000,29,003,"Andrew County, MO",Aug-22,9629,9376,253,2.60000000
CN2900500000000,29,005,"Atchison County, MO",Aug-22,2408,2338,70,2.90000000
CN2900700000000,29,007,"Audrain County, MO",Aug-22,9780,9457,323,3.30000000
CN2900900000000,29,009,"Barry County, MO",Aug-22,13832,13385,447,3.20000000
CN2901100000000,29,011,"Barton County, MO",Aug-22,5071,4936,135,2.70000000
CN2901300000000,29,013,"Bates County, MO",Aug-22,7564,7331,233,3.10000000
CN2901500000000,29,015,"Benton County, MO",Aug-22,6938,6640,298,4.30000000
CN2901700000000,29,017,"Bollinger County, MO",Aug-22,5193,5028,165,3.20000000
CN2901900000000,29,019,"Boone County, MO",Aug-22,100350,97949,2401,2.40000000
CN2902100000000,29,021,"Buchanan County, MO",Aug-22,43319,42110,1209,2.80000000
CN2902300000000,29,023,"Butler County, MO",Aug-22,17746,17115,631,3.60000000
CN2902500000000,29,025,"Caldwell County, MO",Aug-22,4206,4068,138,3.30000000
CN2902700000000,29,027,"Callaway County, MO",Aug-22,21366,20739,627,2.90000000
CN2902900000000,29,029,"Camden County, MO",Aug-22,20435,19802,633,3.10000000
CN2903100000000,29,031,"Cape Girardeau County, MO",Aug-22,39918,38841,1077,2.70000000
CN2903300000000,29,033,"Carroll County, MO",Aug-22,4086,3968,118,2.90000000
CN2903500000000,29,035,"Carter County, MO",Aug-22,2590,2494,96,3.70000000
CN2903700000000,29,037,"Cass County, MO",Aug-22,54997,53423,1574,2.90000000
CN2903900000000,29,039,"Cedar County, MO",Aug-22,5449,5262,187,3.40000000
CN2904100000000,29,041,"Chariton County, MO",Aug-22,3454,3375,79,2.30000000
CN2904300000000,29,043,"Christian County, MO",Aug-22,46839,45662,1177,2.50000000
CN2904500000000,29,045,"Clark County, MO",Aug-22,3016,2896,120,4.00000000
CN2904700000000,29,047,"Clay County, MO",Aug-22,138928,134965,3963,2.90000000
CN2904900000000,29,049,"Clinton County, MO",Aug-22,10586,10239,347,3.30000000
CN2905100000000,29,051,"Cole County, MO",Aug-22,38830,37852,978,2.50000000
CN2905300000000,29,053,"Cooper County, MO",Aug-22,6926,6723,203,2.90000000
CN2905500000000,29,055,"Crawford County, MO",Aug-22,10856,10503,353,3.30000000
CN2905700000000,29,057,"Dade County, MO",Aug-22,3230,3146,84,2.60000000
CN2905900000000,29,059,"Dallas County, MO",Aug-22,7063,6849,214,3.00000000
CN2906100000000,29,061,"Daviess County, MO",Aug-22,3768,3654,114,3.00000000
CN2906300000000,29,063,"DeKalb County, MO",Aug-22,4100,3971,129,3.10000000
CN2906500000000,29,065,"Dent County, MO",Aug-22,6034,5811,223,3.70000000
CN2906700000000,29,067,"Douglas County, MO",Aug-22,4975,4815,160,3.20000000
CN2906900000000,29,069,"Dunklin County, MO",Aug-22,10769,10218,551,5.10000000
CN2907100000000,29,071,"Franklin County, MO",Aug-22,53081,51654,1427,2.70000000
CN2907300000000,29,073,"Gasconade County, MO",Aug-22,7519,7310,209,2.80000000
CN2907500000000,29,075,"Gentry County, MO",Aug-22,3133,3051,82,2.60000000
CN2907700000000,29,077,"Greene County, MO",Aug-22,152992,149223,3769,2.50000000
CN2907900000000,29,079,"Grundy County, MO",Aug-22,3783,3665,118,3.10000000
CN2908100000000,29,081,"Harrison County, MO",Aug-22,3501,3405,96,2.70000000
CN2908300000000,29,083,"Henry County, MO",Aug-22,9964,9638,326,3.30000000
CN2908500000000,29,085,"Hickory County, MO",Aug-22,3945,3825,120,3.00000000
CN2908700000000,29,087,"Holt County, MO",Aug-22,2353,2305,48,2.00000000
CN2908900000000,29,089,"Howard County, MO",Aug-22,4577,4438,139,3.00000000
CN2909100000000,29,091,"Howell County, MO",Aug-22,15797,15236,561,3.60000000
CN2909300000000,29,093,"Iron County, MO",Aug-22,3389,3226,163,4.80000000
CN2909500000000,29,095,"Jackson County, MO",Aug-22,361822,349134,12688,3.50000000
CN2909700000000,29,097,"Jasper County, MO",Aug-22,57826,56263,1563,2.70000000
CN2909900000000,29,099,"Jefferson County, MO",Aug-22,118787,115436,3351,2.80000000
CN2910100000000,29,101,"Johnson County, MO",Aug-22,22223,21502,721,3.20000000
CN2910300000000,29,103,"Knox County, MO",Aug-22,1567,1522,45,2.90000000
CN2910500000000,29,105,"Laclede County, MO",Aug-22,15888,15418,470,3.00000000
CN2910700000000,29,107,"Lafayette County, MO",Aug-22,16673,16157,516,3.10000000
CN2910900000000,29,109,"Lawrence County, MO",Aug-22,16359,15847,512,3.10000000
CN2911100000000,29,111,"Lewis County, MO",Aug-22,4555,4426,129,2.80000000
CN2911300000000,29,113,"Lincoln County, MO",Aug-22,29332,28454,878,3.00000000
CN2911500000000,29,115,"Linn County, MO",Aug-22,4837,4660,177,3.70000000
CN2911700000000,29,117,"Livingston County, MO",Aug-22,6994,6835,159,2.30000000
CN2911900000000,29,119,"McDonald County, MO",Aug-22,10909,10595,314,2.90000000
CN2912100000000,29,121,"Macon County, MO",Aug-22,6837,6622,215,3.10000000
CN2912300000000,29,123,"Madison County, MO",Aug-22,5326,5142,184,3.50000000
CN2912500000000,29,125,"Maries County, MO",Aug-22,3724,3606,118,3.20000000
CN2912700000000,29,127,"Marion County, MO",Aug-22,13564,13180,384,2.80000000
CN2912900000000,29,129,"Mercer County, MO",Aug-22,1517,1474,43,2.80000000
CN2913100000000,29,131,"Miller County, MO",Aug-22,12539,12193,346,2.80000000
CN2913300000000,29,133,"Mississippi County, MO",Aug-22,5027,4824,203,4.00000000
CN2913500000000,29,135,"Moniteau County, MO",Aug-22,6924,6738,186,2.70000000
CN2913700000000,29,137,"Monroe County, MO",Aug-22,3571,3460,111,3.10000000
CN2913900000000,29,139,"Montgomery County, MO",Aug-22,5783,5630,153,2.60000000
CN2914100000000,29,141,"Morgan County, MO",Aug-22,8507,8238,269,3.20000000
CN2914300000000,29,143,"New Madrid County, MO",Aug-22,8004,7685,319,4.00000000
CN2914500000000,29,145,"Newton County, MO",Aug-22,27324,26534,790,2.90000000
CN2914700000000,29,147,"Nodaway County, MO",Aug-22,10616,10317,299,2.80000000
CN2914900000000,29,149,"Oregon County, MO",Aug-22,3631,3498,133,3.70000000
CN2915100000000,29,151,"Osage County, MO",Aug-22,6924,6762,162,2.30000000
CN2915300000000,29,153,"Ozark County, MO",Aug-22,3215,3077,138,4.30000000
CN2915500000000,29,155,"Pemiscot County, MO",Aug-22,5763,5467,296,5.10000000
CN2915700000000,29,157,"Perry County, MO",Aug-22,9555,9332,223,2.30000000
CN2915900000000,29,159,"Pettis County, MO",Aug-22,19811,19123,688,3.50000000
CN2916100000000,29,161,"Phelps County, MO",Aug-22,20226,19646,580,2.90000000
CN2916300000000,29,163,"Pike County, MO",Aug-22,7021,6804,217,3.10000000
CN2916500000000,29,165,"Platte County, MO",Aug-22,60029,58502,1527,2.50000000
CN2916700000000,29,167,"Polk County, MO",Aug-22,14506,14057,449,3.10000000
CN2916900000000,29,169,"Pulaski County, MO",Aug-22,14404,13883,521,3.60000000
CN2917100000000,29,171,"Putnam County, MO",Aug-22,2070,2013,57,2.80000000
CN2917300000000,29,173,"Ralls County, MO",Aug-22,5314,5173,141,2.70000000
CN2917500000000,29,175,"Randolph County, MO",Aug-22,9953,9651,302,3.00000000
CN2917700000000,29,177,"Ray County, MO",Aug-22,10867,10481,386,3.60000000
CN2917900000000,29,179,"Reynolds County, MO",Aug-22,2752,2658,94,3.40000000
CN2918100000000,29,181,"Ripley County, MO",Aug-22,4864,4650,214,4.40000000
CN2918300000000,29,183,"St. Charles County, MO",Aug-22,229931,224485,5446,2.40000000
CN2918500000000,29,185,"St. Clair County, MO",Aug-22,3590,3472,118,3.30000000
CN2918600000000,29,186,"Ste. Genevieve County, MO",Aug-22,9212,8962,250,2.70000000
CN2918700000000,29,187,"St. Francois County, MO",Aug-22,25599,24600,999,3.90000000
CN2918900000000,29,189,"St. Louis County, MO",Aug-22,529963,514135,15828,3.00000000
CN2919500000000,29,195,"Saline County, MO",Aug-22,9796,9473,323,3.30000000
CN2919700000000,29,197,"Schuyler County, MO",Aug-22,1714,1657,57,3.30000000
CN2919900000000,29,199,"Scotland County, MO",Aug-22,2227,2175,52,2.30000000
CN2920100000000,29,201,"Scott County, MO",Aug-22,19625,19054,571,2.90000000
CN2920300000000,29,203,"Shannon County, MO",Aug-22,3234,3101,133,4.10000000
CN2920500000000,29,205,"Shelby County, MO",Aug-22,2769,2697,72,2.60000000
CN2920700000000,29,207,"Stoddard County, MO",Aug-22,13045,12586,459,3.50000000
CN2920900000000,29,209,"Stone County, MO",Aug-22,14005,13487,518,3.70000000
CN2921100000000,29,211,"Sullivan County, MO",Aug-22,2328,2255,73,3.10000000
CN2921300000000,29,213,"Taney County, MO",Aug-22,26985,25945,1040,3.90000000
CN2921500000000,29,215,"Texas County, MO",Aug-22,8514,8218,296,3.50000000
CN2921700000000,29,217,"Vernon County, MO",Aug-22,8579,8304,275,3.20000000
CN2921900000000,29,219,"Warren County, MO",Aug-22,18812,18270,542,2.90000000
CN2922100000000,29,221,"Washington County, MO",Aug-22,9922,9576,346,3.50000000
CN2922300000000,29,223,"Wayne County, MO",Aug-22,4747,4544,203,4.30000000
CN2922500000000,29,225,"Webster County, MO",Aug-22,17324,16844,480,2.80000000
CN2922700000000,29,227,"Worth County, MO",Aug-22,1075,1051,24,2.20000000
CN2922900000000,29,229,"Wright County, MO",Aug-22,7182,6944,238,3.30000000
CN2951000000000,29,510,"St. Louis city, MO",Aug-22,150562,144320,6242,4.10000000
CN3000100000000,30,001,"Beaverhead County, MT",Aug-22,5214,5097,117,2.20000000
CN3000300000000,30,003,"Big Horn County, MT",Aug-22,4653,4390,263,5.70000000
CN3000500000000,30,005,"Blaine County, MT",Aug-22,2139,2067,72,3.40000000
CN3000700000000,30,007,"Broadwater County, MT",Aug-22,2832,2739,93,3.30000000
CN3000900000000,30,009,"Carbon County, MT",Aug-22,5892,5737,155,2.60000000
CN3001100000000,30,011,"Carter County, MT",Aug-22,627,612,15,2.40000000
CN3001300000000,30,013,"Cascade County, MT",Aug-22,38803,37759,1044,2.70000000
CN3001500000000,30,015,"Chouteau County, MT",Aug-22,2326,2266,60,2.60000000
CN3001700000000,30,017,"Custer County, MT",Aug-22,6388,6227,161,2.50000000
CN3001900000000,30,019,"Daniels County, MT",Aug-22,868,851,17,2.00000000
CN3002100000000,30,021,"Dawson County, MT",Aug-22,4534,4420,114,2.50000000
CN3002300000000,30,023,"Deer Lodge County, MT",Aug-22,5508,5377,131,2.40000000
CN3002500000000,30,025,"Fallon County, MT",Aug-22,1679,1655,24,1.40000000
CN3002700000000,30,027,"Fergus County, MT",Aug-22,5937,5796,141,2.40000000
CN3002900000000,30,029,"Flathead County, MT",Aug-22,54655,53151,1504,2.80000000
CN3003100000000,30,031,"Gallatin County, MT",Aug-22,80170,78770,1400,1.70000000
CN3003300000000,30,033,"Garfield County, MT",Aug-22,673,656,17,2.50000000
CN3003500000000,30,035,"Glacier County, MT",Aug-22,5026,4658,368,7.30000000
CN3003700000000,30,037,"Golden Valley County, MT",Aug-22,373,362,11,2.90000000
CN3003900000000,30,039,"Granite County, MT",Aug-22,1674,1626,48,2.90000000
CN3004100000000,30,041,"Hill County, MT",Aug-22,7280,7056,224,3.10000000
CN3004300000000,30,043,"Jefferson County, MT",Aug-22,6118,5960,158,2.60000000
CN3004500000000,30,045,"Judith Basin County, MT",Aug-22,855,832,23,2.70000000
CN3004700000000,30,047,"Lake County, MT",Aug-22,14371,13887,484,3.40000000
CN3004900000000,30,049,"Lewis and Clark County, MT",Aug-22,39038,38057,981,2.50000000
CN3005100000000,30,051,"Liberty County, MT",Aug-22,899,872,27,3.00000000
CN3005300000000,30,053,"Lincoln County, MT",Aug-22,9011,8616,395,4.40000000
CN3005500000000,30,055,"McCone County, MT",Aug-22,909,891,18,2.00000000
CN3005700000000,30,057,"Madison County, MT",Aug-22,4787,4677,110,2.30000000
CN3005900000000,30,059,"Meagher County, MT",Aug-22,963,942,21,2.20000000
CN3006100000000,30,061,"Mineral County, MT",Aug-22,1963,1874,89,4.50000000
CN3006300000000,30,063,"Missoula County, MT",Aug-22,68339,66649,1690,2.50000000
CN3006500000000,30,065,"Musselshell County, MT",Aug-22,2296,2228,68,3.00000000
CN3006700000000,30,067,"Park County, MT",Aug-22,10539,10257,282,2.70000000
CN3006900000000,30,069,"Petroleum County, MT",Aug-22,250,242,8,3.20000000
CN3007100000000,30,071,"Phillips County, MT",Aug-22,1776,1711,65,3.70000000
CN3007300000000,30,073,"Pondera County, MT",Aug-22,2548,2480,68,2.70000000
CN3007500000000,30,075,"Powder River County, MT",Aug-22,942,924,18,1.90000000
CN3007700000000,30,077,"Powell County, MT",Aug-22,3088,3017,71,2.30000000
CN3007900000000,30,079,"Prairie County, MT",Aug-22,492,478,14,2.80000000
CN3008100000000,30,081,"Ravalli County, MT",Aug-22,22038,21456,582,2.60000000
CN3008300000000,30,083,"Richland County, MT",Aug-22,5773,5591,182,3.20000000
CN3008500000000,30,085,"Roosevelt County, MT",Aug-22,4239,4077,162,3.80000000
CN3008700000000,30,087,"Rosebud County, MT",Aug-22,3587,3438,149,4.20000000
CN3008900000000,30,089,"Sanders County, MT",Aug-22,5405,5189,216,4.00000000
CN3009100000000,30,091,"Sheridan County, MT",Aug-22,1742,1712,30,1.70000000
CN3009300000000,30,093,"Silver Bow County, MT",Aug-22,18288,17755,533,2.90000000
CN3009500000000,30,095,"Stillwater County, MT",Aug-22,5517,5392,125,2.30000000
CN3009700000000,30,097,"Sweet Grass County, MT",Aug-22,1998,1963,35,1.80000000
CN3009900000000,30,099,"Teton County, MT",Aug-22,2714,2643,71,2.60000000
CN3010100000000,30,101,"Toole County, MT",Aug-22,2090,2051,39,1.90000000
CN3010300000000,30,103,"Treasure County, MT",Aug-22,331,323,8,2.40000000
CN3010500000000,30,105,"Valley County, MT",Aug-22,4055,3960,95,2.30000000
CN3010700000000,30,107,"Wheatland County, MT",Aug-22,699,676,23,3.30000000
CN3010900000000,30,109,"Wibaux County, MT",Aug-22,410,399,11,2.70000000
CN3011100000000,30,111,"Yellowstone County, MT",Aug-22,89406,87160,2246,2.50000000
CN3100100000000,31,001,"Adams County, NE",Aug-22,17031,16678,353,2.10000000
CN3100300000000,31,003,"Antelope County, NE",Aug-22,3615,3549,66,1.80000000
CN3100500000000,31,005,"Arthur County, NE",Aug-22,224,219,5,2.20000000
CN3100700000000,31,007,"Banner County, NE",Aug-22,374,364,10,2.70000000
CN3100900000000,31,009,"Blaine County, NE",Aug-22,242,235,7,2.90000000
CN3101100000000,31,011,"Boone County, NE",Aug-22,2910,2859,51,1.80000000
CN3101300000000,31,013,"Box Butte County, NE",Aug-22,5335,5218,117,2.20000000
CN3101500000000,31,015,"Boyd County, NE",Aug-22,993,972,21,2.10000000
CN3101700000000,31,017,"Brown County, NE",Aug-22,1432,1399,33,2.30000000
CN3101900000000,31,019,"Buffalo County, NE",Aug-22,27826,27291,535,1.90000000
CN3102100000000,31,021,"Burt County, NE",Aug-22,3569,3490,79,2.20000000
CN3102300000000,31,023,"Butler County, NE",Aug-22,4580,4493,87,1.90000000
CN3102500000000,31,025,"Cass County, NE",Aug-22,13858,13538,320,2.30000000
CN3102700000000,31,027,"Cedar County, NE",Aug-22,4648,4573,75,1.60000000
CN3102900000000,31,029,"Chase County, NE",Aug-22,2213,2171,42,1.90000000
CN3103100000000,31,031,"Cherry County, NE",Aug-22,3482,3426,56,1.60000000
CN3103300000000,31,033,"Cheyenne County, NE",Aug-22,4184,4084,100,2.40000000
CN3103500000000,31,035,"Clay County, NE",Aug-22,3246,3181,65,2.00000000
CN3103700000000,31,037,"Colfax County, NE",Aug-22,5778,5670,108,1.90000000
CN3103900000000,31,039,"Cuming County, NE",Aug-22,4980,4889,91,1.80000000
CN3104100000000,31,041,"Custer County, NE",Aug-22,6393,6295,98,1.50000000
CN3104300000000,31,043,"Dakota County, NE",Aug-22,10927,10661,266,2.40000000
CN3104500000000,31,045,"Dawes County, NE",Aug-22,5019,4907,112,2.20000000
CN3104700000000,31,047,"Dawson County, NE",Aug-22,13490,13182,308,2.30000000
CN3104900000000,31,049,"Deuel County, NE",Aug-22,984,960,24,2.40000000
CN3105100000000,31,051,"Dixon County, NE",Aug-22,2995,2936,59,2.00000000
CN3105300000000,31,053,"Dodge County, NE",Aug-22,20688,20256,432,2.10000000
CN3105500000000,31,055,"Douglas County, NE",Aug-22,310716,302657,8059,2.60000000
CN3105700000000,31,057,"Dundy County, NE",Aug-22,1124,1107,17,1.50000000
CN3105900000000,31,059,"Fillmore County, NE",Aug-22,3310,3251,59,1.80000000
CN3106100000000,31,061,"Franklin County, NE",Aug-22,1485,1450,35,2.40000000
CN3106300000000,31,063,"Frontier County, NE",Aug-22,1510,1477,33,2.20000000
CN3106500000000,31,065,"Furnas County, NE",Aug-22,2544,2495,49,1.90000000
CN3106700000000,31,067,"Gage County, NE",Aug-22,11099,10851,248,2.20000000
CN3106900000000,31,069,"Garden County, NE",Aug-22,1150,1124,26,2.30000000
CN3107100000000,31,071,"Garfield County, NE",Aug-22,1160,1137,23,2.00000000
CN3107300000000,31,073,"Gosper County, NE",Aug-22,1231,1207,24,1.90000000
CN3107500000000,31,075,"Grant County, NE",Aug-22,402,397,5,1.20000000
CN3107700000000,31,077,"Greeley County, NE",Aug-22,1201,1177,24,2.00000000
CN3107900000000,31,079,"Hall County, NE",Aug-22,32155,31422,733,2.30000000
CN3108100000000,31,081,"Hamilton County, NE",Aug-22,4801,4710,91,1.90000000
CN3108300000000,31,083,"Harlan County, NE",Aug-22,1811,1780,31,1.70000000
CN3108500000000,31,085,"Hayes County, NE",Aug-22,591,581,10,1.70000000
CN3108700000000,31,087,"Hitchcock County, NE",Aug-22,1318,1290,28,2.10000000
CN3108900000000,31,089,"Holt County, NE",Aug-22,5662,5569,93,1.60000000
CN3109100000000,31,091,"Hooker County, NE",Aug-22,466,454,12,2.60000000
CN3109300000000,31,093,"Howard County, NE",Aug-22,3391,3330,61,1.80000000
CN3109500000000,31,095,"Jefferson County, NE",Aug-22,4155,4082,73,1.80000000
CN3109700000000,31,097,"Johnson County, NE",Aug-22,2018,1966,52,2.60000000
CN3109900000000,31,099,"Kearney County, NE",Aug-22,3771,3706,65,1.70000000
CN3110100000000,31,101,"Keith County, NE",Aug-22,4818,4734,84,1.70000000
CN3110300000000,31,103,"Keya Paha County, NE",Aug-22,570,558,12,2.10000000
CN3110500000000,31,105,"Kimball County, NE",Aug-22,1966,1933,33,1.70000000
CN3110700000000,31,107,"Knox County, NE",Aug-22,4672,4578,94,2.00000000
CN3110900000000,31,109,"Lancaster County, NE",Aug-22,182057,178231,3826,2.10000000
CN3111100000000,31,111,"Lincoln County, NE",Aug-22,18779,18396,383,2.00000000
CN3111300000000,31,113,"Logan County, NE",Aug-22,472,462,10,2.10000000
CN3111500000000,31,115,"Loup County, NE",Aug-22,402,390,12,3.00000000
CN3111700000000,31,117,"McPherson County, NE",Aug-22,419,412,7,1.70000000
CN3111900000000,31,119,"Madison County, NE",Aug-22,20022,19625,397,2.00000000
CN3112100000000,31,121,"Merrick County, NE",Aug-22,4085,4010,75,1.80000000
CN3112300000000,31,123,"Morrill County, NE",Aug-22,2628,2570,58,2.20000000
CN3112500000000,31,125,"Nance County, NE",Aug-22,1941,1908,33,1.70000000
CN3112700000000,31,127,"Nemaha County, NE",Aug-22,3583,3501,82,2.30000000
CN3112900000000,31,129,"Nuckolls County, NE",Aug-22,2486,2441,45,1.80000000
CN3113100000000,31,131,"Otoe County, NE",Aug-22,8632,8448,184,2.10000000
CN3113300000000,31,133,"Pawnee County, NE",Aug-22,1510,1480,30,2.00000000
CN3113500000000,31,135,"Perkins County, NE",Aug-22,1838,1807,31,1.70000000
CN3113700000000,31,137,"Phelps County, NE",Aug-22,4975,4874,101,2.00000000
CN3113900000000,31,139,"Pierce County, NE",Aug-22,4170,4097,73,1.80000000
CN3114100000000,31,141,"Platte County, NE",Aug-22,18626,18257,369,2.00000000
CN3114300000000,31,143,"Polk County, NE",Aug-22,2907,2856,51,1.80000000
CN3114500000000,31,145,"Red Willow County, NE",Aug-22,5966,5842,124,2.10000000
CN3114700000000,31,147,"Richardson County, NE",Aug-22,4253,4169,84,2.00000000
CN3114900000000,31,149,"Rock County, NE",Aug-22,869,857,12,1.40000000
CN3115100000000,31,151,"Saline County, NE",Aug-22,7231,7063,168,2.30000000
CN3115300000000,31,153,"Sarpy County, NE",Aug-22,101124,98951,2173,2.10000000
CN3115500000000,31,155,"Saunders County, NE",Aug-22,11742,11508,234,2.00000000
CN3115700000000,31,157,"Scotts Bluff County, NE",Aug-22,17964,17509,455,2.50000000
CN3115900000000,31,159,"Seward County, NE",Aug-22,8961,8776,185,2.10000000
CN3116100000000,31,161,"Sheridan County, NE",Aug-22,2778,2717,61,2.20000000
CN3116300000000,31,163,"Sherman County, NE",Aug-22,1681,1644,37,2.20000000
CN3116500000000,31,165,"Sioux County, NE",Aug-22,755,741,14,1.90000000
CN3116700000000,31,167,"Stanton County, NE",Aug-22,3635,3569,66,1.80000000
CN3116900000000,31,169,"Thayer County, NE",Aug-22,2694,2647,47,1.70000000
CN3117100000000,31,171,"Thomas County, NE",Aug-22,425,413,12,2.80000000
CN3117300000000,31,173,"Thurston County, NE",Aug-22,3166,3051,115,3.60000000
CN3117500000000,31,175,"Valley County, NE",Aug-22,2135,2097,38,1.80000000
CN3117700000000,31,177,"Washington County, NE",Aug-22,11622,11377,245,2.10000000
CN3117900000000,31,179,"Wayne County, NE",Aug-22,5446,5318,128,2.40000000
CN3118100000000,31,181,"Webster County, NE",Aug-22,1665,1623,42,2.50000000
CN3118300000000,31,183,"Wheeler County, NE",Aug-22,542,533,9,1.70000000
CN3118500000000,31,185,"York County, NE",Aug-22,7450,7287,163,2.20000000
CN3200100000000,32,001,"Churchill County, NV",Aug-22,10980,10565,415,3.80000000
CN3200300000000,32,003,"Clark County, NV",Aug-22,1155735,1089349,66386,5.70000000
CN3200500000000,32,005,"Douglas County, NV",Aug-22,21786,20896,890,4.10000000
CN3200700000000,32,007,"Elko County, NV",Aug-22,26318,25432,886,3.40000000
CN3200900000000,32,009,"Esmeralda County, NV",Aug-22,403,385,18,4.50000000
CN3201100000000,32,011,"Eureka County, NV",Aug-22,877,844,33,3.80000000
CN3201300000000,32,013,"Humboldt County, NV",Aug-22,7717,7445,272,3.50000000
CN3201500000000,32,015,"Lander County, NV",Aug-22,3080,2983,97,3.10000000
CN3201700000000,32,017,"Lincoln County, NV",Aug-22,2059,1977,82,4.00000000
CN3201900000000,32,019,"Lyon County, NV",Aug-22,23885,22707,1178,4.90000000
CN3202100000000,32,021,"Mineral County, NV",Aug-22,2099,2010,89,4.20000000
CN3202300000000,32,023,"Nye County, NV",Aug-22,17425,16393,1032,5.90000000
CN3202700000000,32,027,"Pershing County, NV",Aug-22,2362,2270,92,3.90000000
CN3202900000000,32,029,"Storey County, NV",Aug-22,2126,2037,89,4.20000000
CN3203100000000,32,031,"Washoe County, NV",Aug-22,259694,250732,8962,3.50000000
CN3203300000000,32,033,"White Pine County, NV",Aug-22,4616,4474,142,3.10000000
CN3251000000000,32,510,"Carson City, NV",Aug-22,26135,25147,988,3.80000000
CN3300100000000,33,001,"Belknap County, NH",Aug-22,33568,32856,712,2.10000000
CN3300300000000,33,003,"Carroll County, NH",Aug-22,25049,24498,551,2.20000000
CN3300500000000,33,005,"Cheshire County, NH",Aug-22,39244,38287,957,2.40000000
CN3300700000000,33,007,"Coos County, NH",Aug-22,14772,14260,512,3.50000000
CN3300900000000,33,009,"Grafton County, NH",Aug-22,49765,48752,1013,2.00000000
CN3301100000000,33,011,"Hillsborough County, NH",Aug-22,246305,240584,5721,2.30000000
CN3301300000000,33,013,"Merrimack County, NH",Aug-22,83612,81899,1713,2.00000000
CN3301500000000,33,015,"Rockingham County, NH",Aug-22,193586,189009,4577,2.40000000
CN3301700000000,33,017,"Strafford County, NH",Aug-22,73935,72382,1553,2.10000000
CN3301900000000,33,019,"Sullivan County, NH",Aug-22,23214,22685,529,2.30000000
CN3400100000000,34,001,"Atlantic County, NJ",Aug-22,130863,124386,6477,4.90000000
CN3400300000000,34,003,"Bergen County, NJ",Aug-22,492182,474946,17236,3.50000000
CN3400500000000,34,005,"Burlington County, NJ",Aug-22,249298,241157,8141,3.30000000
CN3400700000000,34,007,"Camden County, NJ",Aug-22,272304,260989,11315,4.20000000
CN3400900000000,34,009,"Cape May County, NJ",Aug-22,58024,55764,2260,3.90000000
CN3401100000000,34,011,"Cumberland County, NJ",Aug-22,68544,64906,3638,5.30000000
CN3401300000000,34,013,"Essex County, NJ",Aug-22,386838,368260,18578,4.80000000
CN3401500000000,34,015,"Gloucester County, NJ",Aug-22,162178,156226,5952,3.70000000
CN3401700000000,34,017,"Hudson County, NJ",Aug-22,368504,354076,14428,3.90000000
CN3401900000000,34,019,"Hunterdon County, NJ",Aug-22,67956,66160,1796,2.60000000
CN3402100000000,34,021,"Mercer County, NJ",Aug-22,212118,205444,6674,3.10000000
CN3402300000000,34,023,"Middlesex County, NJ",Aug-22,460766,445427,15339,3.30000000
CN3402500000000,34,025,"Monmouth County, NJ",Aug-22,346658,335681,10977,3.20000000
CN3402700000000,34,027,"Morris County, NJ",Aug-22,266603,259070,7533,2.80000000
CN3402900000000,34,029,"Ocean County, NJ",Aug-22,296621,286354,10267,3.50000000
CN3403100000000,34,031,"Passaic County, NJ",Aug-22,247599,235236,12363,5.00000000
CN3403300000000,34,033,"Salem County, NJ",Aug-22,30434,28957,1477,4.90000000
CN3403500000000,34,035,"Somerset County, NJ",Aug-22,177915,172736,5179,2.90000000
CN3403700000000,34,037,"Sussex County, NJ",Aug-22,77319,74605,2714,3.50000000
CN3403900000000,34,039,"Union County, NJ",Aug-22,287632,276360,11272,3.90000000
CN3404100000000,34,041,"Warren County, NJ",Aug-22,59358,57372,1986,3.30000000
CN3500100000000,35,001,"Bernalillo County, NM",Aug-22,333391,320031,13360,4.00000000
CN3500300000000,35,003,"Catron County, NM",Aug-22,1181,1119,62,5.20000000
CN3500500000000,35,005,"Chaves County, NM",Aug-22,27663,26340,1323,4.80000000
CN3500600000000,35,006,"Cibola County, NM",Aug-22,8403,7884,519,6.20000000
CN3500700000000,35,007,"Colfax County, NM",Aug-22,4862,4640,222,4.60000000
CN3500900000000,35,009,"Curry County, NM",Aug-22,22307,21585,722,3.20000000
CN3501100000000,35,011,"De Baca County, NM",Aug-22,689,669,20,2.90000000
CN3501300000000,35,013,"Dona Ana County, NM",Aug-22,98251,93734,4517,4.60000000
CN3501500000000,35,015,"Eddy County, NM",Aug-22,31059,29889,1170,3.80000000
CN3501700000000,35,017,"Grant County, NM",Aug-22,11483,10958,525,4.60000000
CN3501900000000,35,019,"Guadalupe County, NM",Aug-22,1829,1737,92,5.00000000
CN3502100000000,35,021,"Harding County, NM",Aug-22,283,274,9,3.20000000
CN3502300000000,35,023,"Hidalgo County, NM",Aug-22,1949,1884,65,3.30000000
CN3502500000000,35,025,"Lea County, NM",Aug-22,27549,26002,1547,5.60000000
CN3502700000000,35,027,"Lincoln County, NM",Aug-22,8778,8388,390,4.40000000
CN3502800000000,35,028,"Los Alamos County, NM",Aug-22,10327,10103,224,2.20000000
CN3502900000000,35,029,"Luna County, NM",Aug-22,10410,9477,933,9.00000000
CN3503100000000,35,031,"McKinley County, NM",Aug-22,24002,22523,1479,6.20000000
CN3503300000000,35,033,"Mora County, NM",Aug-22,2069,1955,114,5.50000000
CN3503500000000,35,035,"Otero County, NM",Aug-22,25686,24551,1135,4.40000000
CN3503700000000,35,037,"Quay County, NM",Aug-22,2844,2709,135,4.70000000
CN3503900000000,35,039,"Rio Arriba County, NM",Aug-22,16445,15661,784,4.80000000
CN3504100000000,35,041,"Roosevelt County, NM",Aug-22,8408,8094,314,3.70000000
CN3504300000000,35,043,"Sandoval County, NM",Aug-22,67498,64602,2896,4.30000000
CN3504500000000,35,045,"San Juan County, NM",Aug-22,48894,46312,2582,5.30000000
CN3504700000000,35,047,"San Miguel County, NM",Aug-22,10938,10345,593,5.40000000
CN3504900000000,35,049,"Santa Fe County, NM",Aug-22,72518,69721,2797,3.90000000
CN3505100000000,35,051,"Sierra County, NM",Aug-22,4046,3807,239,5.90000000
CN3505300000000,35,053,"Socorro County, NM",Aug-22,6086,5820,266,4.40000000
CN3505500000000,35,055,"Taos County, NM",Aug-22,14689,13875,814,5.50000000
CN3505700000000,35,057,"Torrance County, NM",Aug-22,5365,5044,321,6.00000000
CN3505900000000,35,059,"Union County, NM",Aug-22,1610,1565,45,2.80000000
CN3506100000000,35,061,"Valencia County, NM",Aug-22,30767,29305,1462,4.80000000
CN3600100000000,36,001,"Albany County, NY",Aug-22,160029,154657,5372,3.40000000
CN3600300000000,36,003,"Allegany County, NY",Aug-22,18300,17542,758,4.10000000
CN3600500000000,36,005,"Bronx County, NY",Aug-22,596356,539960,56396,9.50000000
CN3600700000000,36,007,"Broome County, NY",Aug-22,83102,79699,3403,4.10000000
CN3600900000000,36,009,"Cattaraugus County, NY",Aug-22,32364,30950,1414,4.40000000
CN3601100000000,36,011,"Cayuga County, NY",Aug-22,35422,34109,1313,3.70000000
CN3601300000000,36,013,"Chautauqua County, NY",Aug-22,52701,50473,2228,4.20000000
CN3601500000000,36,015,"Chemung County, NY",Aug-22,34821,33399,1422,4.10000000
CN3601700000000,36,017,"Chenango County, NY",Aug-22,21406,20706,700,3.30000000
CN3601900000000,36,019,"Clinton County, NY",Aug-22,34387,33073,1314,3.80000000
CN3602100000000,36,021,"Columbia County, NY",Aug-22,30510,29604,906,3.00000000
CN3602300000000,36,023,"Cortland County, NY",Aug-22,21881,21024,857,3.90000000
CN3602500000000,36,025,"Delaware County, NY",Aug-22,18327,17646,681,3.70000000
CN3602700000000,36,027,"Dutchess County, NY",Aug-22,145983,141152,4831,3.30000000
CN3602900000000,36,029,"Erie County, NY",Aug-22,450533,432248,18285,4.10000000
CN3603100000000,36,031,"Essex County, NY",Aug-22,17506,16945,561,3.20000000
CN3603300000000,36,033,"Franklin County, NY",Aug-22,18741,18047,694,3.70000000
CN3603500000000,36,035,"Fulton County, NY",Aug-22,22462,21526,936,4.20000000
CN3603700000000,36,037,"Genesee County, NY",Aug-22,30187,29273,914,3.00000000
CN3603900000000,36,039,"Greene County, NY",Aug-22,20419,19646,773,3.80000000
CN3604100000000,36,041,"Hamilton County, NY",Aug-22,2532,2462,70,2.80000000
CN3604300000000,36,043,"Herkimer County, NY",Aug-22,27770,26657,1113,4.00000000
CN3604500000000,36,045,"Jefferson County, NY",Aug-22,45701,43895,1806,4.00000000
CN3604700000000,36,047,"Kings County, NY",Aug-22,1186653,1102775,83878,7.10000000
CN3604900000000,36,049,"Lewis County, NY",Aug-22,11596,11171,425,3.70000000
CN3605100000000,36,051,"Livingston County, NY",Aug-22,30241,29253,988,3.30000000
CN3605300000000,36,053,"Madison County, NY",Aug-22,32900,31816,1084,3.30000000
CN3605500000000,36,055,"Monroe County, NY",Aug-22,366914,352375,14539,4.00000000
CN3605700000000,36,057,"Montgomery County, NY",Aug-22,22001,20988,1013,4.60000000
CN3605900000000,36,059,"Nassau County, NY",Aug-22,735315,711338,23977,3.30000000
CN3606100000000,36,061,"New York County, NY",Aug-22,898186,849715,48471,5.40000000
CN3606300000000,36,063,"Niagara County, NY",Aug-22,99359,95160,4199,4.20000000
CN3606500000000,36,065,"Oneida County, NY",Aug-22,102004,98078,3926,3.80000000
CN3606700000000,36,067,"Onondaga County, NY",Aug-22,225594,217383,8211,3.60000000
CN3606900000000,36,069,"Ontario County, NY",Aug-22,55798,54075,1723,3.10000000
CN3607100000000,36,071,"Orange County, NY",Aug-22,191637,184841,6796,3.50000000
CN3607300000000,36,073,"Orleans County, NY",Aug-22,17232,16505,727,4.20000000
CN3607500000000,36,075,"Oswego County, NY",Aug-22,53146,50853,2293,4.30000000
CN3607700000000,36,077,"Otsego County, NY",Aug-22,27356,26418,938,3.40000000
CN3607900000000,36,079,"Putnam County, NY",Aug-22,51839,50169,1670,3.20000000
CN3608100000000,36,081,"Queens County, NY",Aug-22,1117861,1048416,69445,6.20000000
CN3608300000000,36,083,"Rensselaer County, NY",Aug-22,82409,79706,2703,3.30000000
CN3608500000000,36,085,"Richmond County, NY",Aug-22,223144,208426,14718,6.60000000
CN3608700000000,36,087,"Rockland County, NY",Aug-22,160079,154918,5161,3.20000000
CN3608900000000,36,089,"St. Lawrence County, NY",Aug-22,40970,39052,1918,4.70000000
CN3609100000000,36,091,"Saratoga County, NY",Aug-22,121743,118334,3409,2.80000000
CN3609300000000,36,093,"Schenectady County, NY",Aug-22,78277,75372,2905,3.70000000
CN3609500000000,36,095,"Schoharie County, NY",Aug-22,14754,14213,541,3.70000000
CN3609700000000,36,097,"Schuyler County, NY",Aug-22,8237,7969,268,3.30000000
CN3609900000000,36,099,"Seneca County, NY",Aug-22,15536,15055,481,3.10000000
CN3610100000000,36,101,"Steuben County, NY",Aug-22,40502,39024,1478,3.60000000
CN3610300000000,36,103,"Suffolk County, NY",Aug-22,807729,779383,28346,3.50000000
CN3610500000000,36,105,"Sullivan County, NY",Aug-22,39874,38552,1322,3.30000000
CN3610700000000,36,107,"Tioga County, NY",Aug-22,22415,21697,718,3.20000000
CN3610900000000,36,109,"Tompkins County, NY",Aug-22,49121,47642,1479,3.00000000
CN3611100000000,36,111,"Ulster County, NY",Aug-22,88353,85293,3060,3.50000000
CN3611300000000,36,113,"Warren County, NY",Aug-22,32194,31168,1026,3.20000000
CN3611500000000,36,115,"Washington County, NY",Aug-22,28347,27441,906,3.20000000
CN3611700000000,36,117,"Wayne County, NY",Aug-22,43491,42041,1450,3.30000000
CN3611900000000,36,119,"Westchester County, NY",Aug-22,498538,480754,17784,3.60000000
CN3612100000000,36,121,"Wyoming County, NY",Aug-22,18247,17696,551,3.00000000
CN3612300000000,36,123,"Yates County, NY",Aug-22,11574,11247,327,2.80000000
CN3700100000000,37,001,"Alamance County, NC",Aug-22,82967,79661,3306,4.00000000
CN3700300000000,37,003,"Alexander County, NC",Aug-22,17694,17107,587,3.30000000
CN3700500000000,37,005,"Alleghany County, NC",Aug-22,4408,4245,163,3.70000000
CN3700700000000,37,007,"Anson County, NC",Aug-22,10119,9624,495,4.90000000
CN3700900000000,37,009,"Ashe County, NC",Aug-22,13256,12806,450,3.40000000
CN3701100000000,37,011,"Avery County, NC",Aug-22,7817,7570,247,3.20000000
CN3701300000000,37,013,"Beaufort County, NC",Aug-22,19745,18941,804,4.10000000
CN3701500000000,37,015,"Bertie County, NC",Aug-22,7308,6913,395,5.40000000
CN3701700000000,37,017,"Bladen County, NC",Aug-22,14097,13432,665,4.70000000
CN3701900000000,37,019,"Brunswick County, NC",Aug-22,57311,54563,2748,4.80000000
CN3702100000000,37,021,"Buncombe County, NC",Aug-22,139985,135694,4291,3.10000000
CN3702300000000,37,023,"Burke County, NC",Aug-22,40164,38723,1441,3.60000000
CN3702500000000,37,025,"Cabarrus County, NC",Aug-22,114992,110902,4090,3.60000000
CN3702700000000,37,027,"Caldwell County, NC",Aug-22,35782,34441,1341,3.70000000
CN3702900000000,37,029,"Camden County, NC",Aug-22,4566,4398,168,3.70000000
CN3703100000000,37,031,"Carteret County, NC",Aug-22,32438,31346,1092,3.40000000
CN3703300000000,37,033,"Caswell County, NC",Aug-22,9700,9284,416,4.30000000
CN3703500000000,37,035,"Catawba County, NC",Aug-22,78134,75286,2848,3.60000000
CN3703700000000,37,037,"Chatham County, NC",Aug-22,37832,36650,1182,3.10000000
CN3703900000000,37,039,"Cherokee County, NC",Aug-22,10805,10349,456,4.20000000
CN3704100000000,37,041,"Chowan County, NC",Aug-22,5614,5373,241,4.30000000
CN3704300000000,37,043,"Clay County, NC",Aug-22,3972,3799,173,4.40000000
CN3704500000000,37,045,"Cleveland County, NC",Aug-22,47779,45712,2067,4.30000000
CN3704700000000,37,047,"Columbus County, NC",Aug-22,23240,22147,1093,4.70000000
CN3704900000000,37,049,"Craven County, NC",Aug-22,41222,39639,1583,3.80000000
CN3705100000000,37,051,"Cumberland County, NC",Aug-22,127472,120040,7432,5.80000000
CN3705300000000,37,053,"Currituck County, NC",Aug-22,14607,14119,488,3.30000000
CN3705500000000,37,055,"Dare County, NC",Aug-22,22491,21736,755,3.40000000
CN3705700000000,37,057,"Davidson County, NC",Aug-22,80197,77250,2947,3.70000000
CN3705900000000,37,059,"Davie County, NC",Aug-22,20446,19720,726,3.60000000
CN3706100000000,37,061,"Duplin County, NC",Aug-22,24228,23296,932,3.80000000
CN3706300000000,37,063,"Durham County, NC",Aug-22,181143,175296,5847,3.20000000
CN3706500000000,37,065,"Edgecombe County, NC",Aug-22,20072,18477,1595,7.90000000
CN3706700000000,37,067,"Forsyth County, NC",Aug-22,186015,178536,7479,4.00000000
CN3706900000000,37,069,"Franklin County, NC",Aug-22,33675,32392,1283,3.80000000
CN3707100000000,37,071,"Gaston County, NC",Aug-22,113764,109243,4521,4.00000000
CN3707300000000,37,073,"Gates County, NC",Aug-22,5113,4922,191,3.70000000
CN3707500000000,37,075,"Graham County, NC",Aug-22,3050,2890,160,5.20000000
CN3707700000000,37,077,"Granville County, NC",Aug-22,30237,29207,1030,3.40000000
CN3707900000000,37,079,"Greene County, NC",Aug-22,9367,9050,317,3.40000000
CN3708100000000,37,081,"Guilford County, NC",Aug-22,260551,248823,11728,4.50000000
CN3708300000000,37,083,"Halifax County, NC",Aug-22,18946,17691,1255,6.60000000
CN3708500000000,37,085,"Harnett County, NC",Aug-22,54249,51839,2410,4.40000000
CN3708700000000,37,087,"Haywood County, NC",Aug-22,29751,28787,964,3.20000000
CN3708900000000,37,089,"Henderson County, NC",Aug-22,54727,52946,1781,3.30000000
CN3709100000000,37,091,"Hertford County, NC",Aug-22,8415,7952,463,5.50000000
CN3709300000000,37,093,"Hoke County, NC",Aug-22,20213,19105,1108,5.50000000
CN3709500000000,37,095,"Hyde County, NC",Aug-22,1893,1807,86,4.50000000
CN3709700000000,37,097,"Iredell County, NC",Aug-22,93742,90399,3343,3.60000000
CN3709900000000,37,099,"Jackson County, NC",Aug-22,19630,18855,775,3.90000000
CN3710100000000,37,101,"Johnston County, NC",Aug-22,107006,103291,3715,3.50000000
CN3710300000000,37,103,"Jones County, NC",Aug-22,4216,4077,139,3.30000000
CN3710500000000,37,105,"Lee County, NC",Aug-22,26023,24839,1184,4.50000000
CN3710700000000,37,107,"Lenoir County, NC",Aug-22,27123,26077,1046,3.90000000
CN3710900000000,37,109,"Lincoln County, NC",Aug-22,45959,44432,1527,3.30000000
CN3711100000000,37,111,"McDowell County, NC",Aug-22,19498,18770,728,3.70000000
CN3711300000000,37,113,"Macon County, NC",Aug-22,15674,15113,561,3.60000000
CN3711500000000,37,115,"Madison County, NC",Aug-22,9935,9587,348,3.50000000
CN3711700000000,37,117,"Martin County, NC",Aug-22,8497,8104,393,4.60000000
CN3711900000000,37,119,"Mecklenburg County, NC",Aug-22,646893,622452,24441,3.80000000
CN3712100000000,37,121,"Mitchell County, NC",Aug-22,5918,5667,251,4.20000000
CN3712300000000,37,123,"Montgomery County, NC",Aug-22,11446,11006,440,3.80000000
CN3712500000000,37,125,"Moore County, NC",Aug-22,40583,39006,1577,3.90000000
CN3712700000000,37,127,"Nash County, NC",Aug-22,41633,39246,2387,5.70000000
CN3712900000000,37,129,"New Hanover County, NC",Aug-22,127083,122726,4357,3.40000000
CN3713100000000,37,131,"Northampton County, NC",Aug-22,7076,6719,357,5.00000000
CN3713300000000,37,133,"Onslow County, NC",Aug-22,67287,64228,3059,4.50000000
CN3713500000000,37,135,"Orange County, NC",Aug-22,82541,79929,2612,3.20000000
CN3713700000000,37,137,"Pamlico County, NC",Aug-22,5383,5184,199,3.70000000
CN3713900000000,37,139,"Pasquotank County, NC",Aug-22,16386,15600,786,4.80000000
CN3714100000000,37,141,"Pender County, NC",Aug-22,30170,29080,1090,3.60000000
CN3714300000000,37,143,"Perquimans County, NC",Aug-22,4861,4638,223,4.60000000
CN3714500000000,37,145,"Person County, NC",Aug-22,19045,18309,736,3.90000000
CN3714700000000,37,147,"Pitt County, NC",Aug-22,87554,83632,3922,4.50000000
CN3714900000000,37,149,"Polk County, NC",Aug-22,9392,9038,354,3.80000000
CN3715100000000,37,151,"Randolph County, NC",Aug-22,65305,62769,2536,3.90000000
CN3715300000000,37,153,"Richmond County, NC",Aug-22,16230,15263,967,6.00000000
CN3715500000000,37,155,"Robeson County, NC",Aug-22,47563,44472,3091,6.50000000
CN3715700000000,37,157,"Rockingham County, NC",Aug-22,39469,37724,1745,4.40000000
CN3715900000000,37,159,"Rowan County, NC",Aug-22,67115,64563,2552,3.80000000
CN3716100000000,37,161,"Rutherford County, NC",Aug-22,23932,22648,1284,5.40000000
CN3716300000000,37,163,"Sampson County, NC",Aug-22,28009,26885,1124,4.00000000
CN3716500000000,37,165,"Scotland County, NC",Aug-22,11031,10185,846,7.70000000
CN3716700000000,37,167,"Stanly County, NC",Aug-22,30234,29179,1055,3.50000000
CN3716900000000,37,169,"Stokes County, NC",Aug-22,21314,20578,736,3.50000000
CN3717100000000,37,171,"Surry County, NC",Aug-22,31560,30397,1163,3.70000000
CN3717300000000,37,173,"Swain County, NC",Aug-22,7387,7157,230,3.10000000
CN3717500000000,37,175,"Transylvania County, NC",Aug-22,15010,14497,513,3.40000000
CN3717700000000,37,177,"Tyrrell County, NC",Aug-22,1465,1391,74,5.10000000
CN3717900000000,37,179,"Union County, NC",Aug-22,129112,124827,4285,3.30000000
CN3718100000000,37,181,"Vance County, NC",Aug-22,16685,15538,1147,6.90000000
CN3718300000000,37,183,"Wake County, NC",Aug-22,625100,604958,20142,3.20000000
CN3718500000000,37,185,"Warren County, NC",Aug-22,6508,6057,451,6.90000000
CN3718700000000,37,187,"Washington County, NC",Aug-22,4368,4124,244,5.60000000
CN3718900000000,37,189,"Watauga County, NC",Aug-22,29235,28242,993,3.40000000
CN3719100000000,37,191,"Wayne County, NC",Aug-22,51157,49020,2137,4.20000000
CN3719300000000,37,193,"Wilkes County, NC",Aug-22,26658,25602,1056,4.00000000
CN3719500000000,37,195,"Wilson County, NC",Aug-22,32519,30489,2030,6.20000000
CN3719700000000,37,197,"Yadkin County, NC",Aug-22,17345,16753,592,3.40000000
CN3719900000000,37,199,"Yancey County, NC",Aug-22,8356,8058,298,3.60000000
CN3800100000000,38,001,"Adams County, ND",Aug-22,957,933,24,2.50000000
CN3800300000000,38,003,"Barnes County, ND",Aug-22,5133,5029,104,2.00000000
CN3800500000000,38,005,"Benson County, ND",Aug-22,2335,2265,70,3.00000000
CN3800700000000,38,007,"Billings County, ND",Aug-22,584,572,12,2.10000000
CN3800900000000,38,009,"Bottineau County, ND",Aug-22,3067,2973,94,3.10000000
CN3801100000000,38,011,"Bowman County, ND",Aug-22,1581,1557,24,1.50000000
CN3801300000000,38,013,"Burke County, ND",Aug-22,998,977,21,2.10000000
CN3801500000000,38,015,"Burleigh County, ND",Aug-22,52832,51818,1014,1.90000000
CN3801700000000,38,017,"Cass County, ND",Aug-22,110202,108318,1884,1.70000000
CN3801900000000,38,019,"Cavalier County, ND",Aug-22,1889,1852,37,2.00000000
CN3802100000000,38,021,"Dickey County, ND",Aug-22,2254,2216,38,1.70000000
CN3802300000000,38,023,"Divide County, ND",Aug-22,1474,1456,18,1.20000000
CN3802500000000,38,025,"Dunn County, ND",Aug-22,3180,3138,42,1.30000000
CN3802700000000,38,027,"Eddy County, ND",Aug-22,1145,1112,33,2.90000000
CN3802900000000,38,029,"Emmons County, ND",Aug-22,1444,1392,52,3.60000000
CN3803100000000,38,031,"Foster County, ND",Aug-22,1503,1477,26,1.70000000
CN3803300000000,38,033,"Golden Valley County, ND",Aug-22,835,823,12,1.40000000
CN3803500000000,38,035,"Grand Forks County, ND",Aug-22,37722,36998,724,1.90000000
CN3803700000000,38,037,"Grant County, ND",Aug-22,1196,1171,25,2.10000000
CN3803900000000,38,039,"Griggs County, ND",Aug-22,999,981,18,1.80000000
CN3804100000000,38,041,"Hettinger County, ND",Aug-22,1409,1387,22,1.60000000
CN3804300000000,38,043,"Kidder County, ND",Aug-22,1350,1297,53,3.90000000
CN3804500000000,38,045,"LaMoure County, ND",Aug-22,2068,2030,38,1.80000000
CN3804700000000,38,047,"Logan County, ND",Aug-22,870,854,16,1.80000000
CN3804900000000,38,049,"McHenry County, ND",Aug-22,3108,3026,82,2.60000000
CN3805100000000,38,051,"McIntosh County, ND",Aug-22,1075,1054,21,2.00000000
CN3805300000000,38,053,"McKenzie County, ND",Aug-22,9053,8842,211,2.30000000
CN3805500000000,38,055,"McLean County, ND",Aug-22,4788,4647,141,2.90000000
CN3805700000000,38,057,"Mercer County, ND",Aug-22,3776,3639,137,3.60000000
CN3805900000000,38,059,"Morton County, ND",Aug-22,17390,16961,429,2.50000000
CN3806100000000,38,061,"Mountrail County, ND",Aug-22,6327,6225,102,1.60000000
CN3806300000000,38,063,"Nelson County, ND",Aug-22,1478,1432,46,3.10000000
CN3806500000000,38,065,"Oliver County, ND",Aug-22,905,876,29,3.20000000
CN3806700000000,38,067,"Pembina County, ND",Aug-22,3323,3209,114,3.40000000
CN3806900000000,38,069,"Pierce County, ND",Aug-22,1685,1643,42,2.50000000
CN3807100000000,38,071,"Ramsey County, ND",Aug-22,5820,5692,128,2.20000000
CN3807300000000,38,073,"Ransom County, ND",Aug-22,2701,2655,46,1.70000000
CN3807500000000,38,075,"Renville County, ND",Aug-22,1202,1177,25,2.10000000
CN3807700000000,38,077,"Richland County, ND",Aug-22,8764,8591,173,2.00000000
CN3807900000000,38,079,"Rolette County, ND",Aug-22,4834,4252,582,12.00000000
CN3808100000000,38,081,"Sargent County, ND",Aug-22,2424,2383,41,1.70000000
CN3808300000000,38,083,"Sheridan County, ND",Aug-22,677,665,12,1.80000000
CN3808500000000,38,085,"Sioux County, ND",Aug-22,1273,1221,52,4.10000000
CN3808700000000,38,087,"Slope County, ND",Aug-22,355,347,8,2.30000000
CN3808900000000,38,089,"Stark County, ND",Aug-22,17949,17567,382,2.10000000
CN3809100000000,38,091,"Steele County, ND",Aug-22,926,906,20,2.20000000
CN3809300000000,38,093,"Stutsman County, ND",Aug-22,10466,10256,210,2.00000000
CN3809500000000,38,095,"Towner County, ND",Aug-22,1142,1116,26,2.30000000
CN3809700000000,38,097,"Traill County, ND",Aug-22,4374,4279,95,2.20000000
CN3809900000000,38,099,"Walsh County, ND",Aug-22,5248,5056,192,3.70000000
CN3810100000000,38,101,"Ward County, ND",Aug-22,31993,31273,720,2.30000000
CN3810300000000,38,103,"Wells County, ND",Aug-22,1926,1876,50,2.60000000
CN3810500000000,38,105,"Williams County, ND",Aug-22,21547,20939,608,2.80000000
CN3900100000000,39,001,"Adams County, OH",Aug-22,11053,10454,599,5.40000000
CN3900300000000,39,003,"Allen County, OH",Aug-22,47107,45007,2100,4.50000000
CN3900500000000,39,005,"Ashland County, OH",Aug-22,26768,25777,991,3.70000000
CN3900700000000,39,007,"Ashtabula County, OH",Aug-22,43605,41625,1980,4.50000000
CN3900900000000,39,009,"Athens County, OH",Aug-22,24723,23401,1322,5.30000000
CN3901100000000,39,011,"Auglaize County, OH",Aug-22,24710,23899,811,3.30000000
CN3901300000000,39,013,"Belmont County, OH",Aug-22,27708,26245,1463,5.30000000
CN3901500000000,39,015,"Brown County, OH",Aug-22,19277,18344,933,4.80000000
CN3901700000000,39,017,"Butler County, OH",Aug-22,195750,187923,7827,4.00000000
CN3901900000000,39,019,"Carroll County, OH",Aug-22,12618,12038,580,4.60000000
CN3902100000000,39,021,"Champaign County, OH",Aug-22,19346,18583,763,3.90000000
CN3902300000000,39,023,"Clark County, OH",Aug-22,62397,59645,2752,4.40000000
CN3902500000000,39,025,"Clermont County, OH",Aug-22,107245,102983,4262,4.00000000
CN3902700000000,39,027,"Clinton County, OH",Aug-22,17845,17019,826,4.60000000
CN3902900000000,39,029,"Columbiana County, OH",Aug-22,46144,43821,2323,5.00000000
CN3903100000000,39,031,"Coshocton County, OH",Aug-22,13742,13010,732,5.30000000
CN3903300000000,39,033,"Crawford County, OH",Aug-22,18048,17049,999,5.50000000
CN3903500000000,39,035,"Cuyahoga County, OH",Aug-22,617809,587092,30717,5.00000000
CN3903700000000,39,037,"Darke County, OH",Aug-22,25770,24814,956,3.70000000
CN3903900000000,39,039,"Defiance County, OH",Aug-22,17749,17009,740,4.20000000
CN3904100000000,39,041,"Delaware County, OH",Aug-22,115864,112045,3819,3.30000000
CN3904300000000,39,043,"Erie County, OH",Aug-22,38820,37071,1749,4.50000000
CN3904500000000,39,045,"Fairfield County, OH",Aug-22,80481,77425,3056,3.80000000
CN3904700000000,39,047,"Fayette County, OH",Aug-22,13664,13122,542,4.00000000
CN3904900000000,39,049,"Franklin County, OH",Aug-22,712364,684801,27563,3.90000000
CN3905100000000,39,051,"Fulton County, OH",Aug-22,22064,21209,855,3.90000000
CN3905300000000,39,053,"Gallia County, OH",Aug-22,11852,11247,605,5.10000000
CN3905500000000,39,055,"Geauga County, OH",Aug-22,49285,47475,1810,3.70000000
CN3905700000000,39,057,"Greene County, OH",Aug-22,82983,79739,3244,3.90000000
CN3905900000000,39,059,"Guernsey County, OH",Aug-22,18025,17145,880,4.90000000
CN3906100000000,39,061,"Hamilton County, OH",Aug-22,415312,397886,17426,4.20000000
CN3906300000000,39,063,"Hancock County, OH",Aug-22,40661,39231,1430,3.50000000
CN3906500000000,39,065,"Hardin County, OH",Aug-22,12923,12304,619,4.80000000
CN3906700000000,39,067,"Harrison County, OH",Aug-22,6596,6263,333,5.00000000
CN3906900000000,39,069,"Henry County, OH",Aug-22,13071,12514,557,4.30000000
CN3907100000000,39,071,"Highland County, OH",Aug-22,17325,16465,860,5.00000000
CN3907300000000,39,073,"Hocking County, OH",Aug-22,12942,12420,522,4.00000000
CN3907500000000,39,075,"Holmes County, OH",Aug-22,21796,21177,619,2.80000000
CN3907700000000,39,077,"Huron County, OH",Aug-22,28338,27078,1260,4.40000000
CN3907900000000,39,079,"Jackson County, OH",Aug-22,12396,11736,660,5.30000000
CN3908100000000,39,081,"Jefferson County, OH",Aug-22,27183,25495,1688,6.20000000
CN3908300000000,39,083,"Knox County, OH",Aug-22,30941,29779,1162,3.80000000
CN3908500000000,39,085,"Lake County, OH",Aug-22,127840,122717,5123,4.00000000
CN3908700000000,39,087,"Lawrence County, OH",Aug-22,23209,21987,1222,5.30000000
CN3908900000000,39,089,"Licking County, OH",Aug-22,92231,88719,3512,3.80000000
CN3909100000000,39,091,"Logan County, OH",Aug-22,22252,21424,828,3.70000000
CN3909300000000,39,093,"Lorain County, OH",Aug-22,157715,150296,7419,4.70000000
CN3909500000000,39,095,"Lucas County, OH",Aug-22,209385,199101,10284,4.90000000
CN3909700000000,39,097,"Madison County, OH",Aug-22,20941,20228,713,3.40000000
CN3909900000000,39,099,"Mahoning County, OH",Aug-22,98400,93174,5226,5.30000000
CN3910100000000,39,101,"Marion County, OH",Aug-22,29028,27161,1867,6.40000000
CN3910300000000,39,103,"Medina County, OH",Aug-22,100101,96308,3793,3.80000000
CN3910500000000,39,105,"Meigs County, OH",Aug-22,8735,8213,522,6.00000000
CN3910700000000,39,107,"Mercer County, OH",Aug-22,23114,22464,650,2.80000000
CN3910900000000,39,109,"Miami County, OH",Aug-22,53900,51865,2035,3.80000000
CN3911100000000,39,111,"Monroe County, OH",Aug-22,5112,4778,334,6.50000000
CN3911300000000,39,113,"Montgomery County, OH",Aug-22,248835,237578,11257,4.50000000
CN3911500000000,39,115,"Morgan County, OH",Aug-22,6805,6464,341,5.00000000
CN3911700000000,39,117,"Morrow County, OH",Aug-22,17060,16323,737,4.30000000
CN3911900000000,39,119,"Muskingum County, OH",Aug-22,40658,38915,1743,4.30000000
CN3912100000000,39,121,"Noble County, OH",Aug-22,4605,4339,266,5.80000000
CN3912300000000,39,123,"Ottawa County, OH",Aug-22,21907,20901,1006,4.60000000
CN3912500000000,39,125,"Paulding County, OH",Aug-22,8702,8388,314,3.60000000
CN3912700000000,39,127,"Perry County, OH",Aug-22,15939,15241,698,4.40000000
CN3912900000000,39,129,"Pickaway County, OH",Aug-22,26804,25765,1039,3.90000000
CN3913100000000,39,131,"Pike County, OH",Aug-22,11167,10565,602,5.40000000
CN3913300000000,39,133,"Portage County, OH",Aug-22,84629,81202,3427,4.00000000
CN3913500000000,39,135,"Preble County, OH",Aug-22,21944,21176,768,3.50000000
CN3913700000000,39,137,"Putnam County, OH",Aug-22,19134,18577,557,2.90000000
CN3913900000000,39,139,"Richland County, OH",Aug-22,51473,49060,2413,4.70000000
CN3914100000000,39,141,"Ross County, OH",Aug-22,35170,33757,1413,4.00000000
CN3914300000000,39,143,"Sandusky County, OH",Aug-22,30816,29456,1360,4.40000000
CN3914500000000,39,145,"Scioto County, OH",Aug-22,29239,27609,1630,5.60000000
CN3914700000000,39,147,"Seneca County, OH",Aug-22,26943,25849,1094,4.10000000
CN3914900000000,39,149,"Shelby County, OH",Aug-22,24038,23158,880,3.70000000
CN3915100000000,39,151,"Stark County, OH",Aug-22,181853,173996,7857,4.30000000
CN3915300000000,39,153,"Summit County, OH",Aug-22,264327,252351,11976,4.50000000
CN3915500000000,39,155,"Trumbull County, OH",Aug-22,83053,78572,4481,5.40000000
CN3915700000000,39,157,"Tuscarawas County, OH",Aug-22,45183,43464,1719,3.80000000
CN3915900000000,39,159,"Union County, OH",Aug-22,30189,29171,1018,3.40000000
CN3916100000000,39,161,"Van Wert County, OH",Aug-22,14865,14355,510,3.40000000
CN3916300000000,39,163,"Vinton County, OH",Aug-22,5509,5236,273,5.00000000
CN3916500000000,39,165,"Warren County, OH",Aug-22,121626,117156,4470,3.70000000
CN3916700000000,39,167,"Washington County, OH",Aug-22,27179,25870,1309,4.80000000
CN3916900000000,39,169,"Wayne County, OH",Aug-22,59996,57982,2014,3.40000000
CN3917100000000,39,171,"Williams County, OH",Aug-22,18579,17939,640,3.40000000
CN3917300000000,39,173,"Wood County, OH",Aug-22,71225,68550,2675,3.80000000
CN3917500000000,39,175,"Wyandot County, OH",Aug-22,13204,12785,419,3.20000000
CN4000100000000,40,001,"Adair County, OK",Aug-22,8510,8212,298,3.50000000
CN4000300000000,40,003,"Alfalfa County, OK",Aug-22,2538,2482,56,2.20000000
CN4000500000000,40,005,"Atoka County, OK",Aug-22,4992,4772,220,4.40000000
CN4000700000000,40,007,"Beaver County, OK",Aug-22,2631,2579,52,2.00000000
CN4000900000000,40,009,"Beckham County, OK",Aug-22,9320,9014,306,3.30000000
CN4001100000000,40,011,"Blaine County, OK",Aug-22,4470,4355,115,2.60000000
CN4001300000000,40,013,"Bryan County, OK",Aug-22,23199,22529,670,2.90000000
CN4001500000000,40,015,"Caddo County, OK",Aug-22,11860,11457,403,3.40000000
CN4001700000000,40,017,"Canadian County, OK",Aug-22,80284,78034,2250,2.80000000
CN4001900000000,40,019,"Carter County, OK",Aug-22,21231,20401,830,3.90000000
CN4002100000000,40,021,"Cherokee County, OK",Aug-22,20059,19256,803,4.00000000
CN4002300000000,40,023,"Choctaw County, OK",Aug-22,5915,5611,304,5.10000000
CN4002500000000,40,025,"Cimarron County, OK",Aug-22,1603,1581,22,1.40000000
CN4002700000000,40,027,"Cleveland County, OK",Aug-22,147940,143699,4241,2.90000000
CN4002900000000,40,029,"Coal County, OK",Aug-22,2258,2176,82,3.60000000
CN4003100000000,40,031,"Comanche County, OK",Aug-22,47682,45766,1916,4.00000000
CN4003300000000,40,033,"Cotton County, OK",Aug-22,2684,2595,89,3.30000000
CN4003500000000,40,035,"Craig County, OK",Aug-22,5851,5644,207,3.50000000
CN4003700000000,40,037,"Creek County, OK",Aug-22,31990,30766,1224,3.80000000
CN4003900000000,40,039,"Custer County, OK",Aug-22,14476,14038,438,3.00000000
CN4004100000000,40,041,"Delaware County, OK",Aug-22,19377,18752,625,3.20000000
CN4004300000000,40,043,"Dewey County, OK",Aug-22,2990,2924,66,2.20000000
CN4004500000000,40,045,"Ellis County, OK",Aug-22,2057,2005,52,2.50000000
CN4004700000000,40,047,"Garfield County, OK",Aug-22,26941,26114,827,3.10000000
CN4004900000000,40,049,"Garvin County, OK",Aug-22,12786,12389,397,3.10000000
CN4005100000000,40,051,"Grady County, OK",Aug-22,27286,26429,857,3.10000000
CN4005300000000,40,053,"Grant County, OK",Aug-22,2861,2801,60,2.10000000
CN4005500000000,40,055,"Greer County, OK",Aug-22,1844,1770,74,4.00000000
CN4005700000000,40,057,"Harmon County, OK",Aug-22,1161,1130,31,2.70000000
CN4005900000000,40,059,"Harper County, OK",Aug-22,1801,1766,35,1.90000000
CN4006100000000,40,061,"Haskell County, OK",Aug-22,4012,3811,201,5.00000000
CN4006300000000,40,063,"Hughes County, OK",Aug-22,4956,4725,231,4.70000000
CN4006500000000,40,065,"Jackson County, OK",Aug-22,10705,10390,315,2.90000000
CN4006700000000,40,067,"Jefferson County, OK",Aug-22,2419,2337,82,3.40000000
CN4006900000000,40,069,"Johnston County, OK",Aug-22,3669,3525,144,3.90000000
CN4007100000000,40,071,"Kay County, OK",Aug-22,18507,17763,744,4.00000000
CN4007300000000,40,073,"Kingfisher County, OK",Aug-22,8913,8722,191,2.10000000
CN4007500000000,40,075,"Kiowa County, OK",Aug-22,3682,3552,130,3.50000000
CN4007700000000,40,077,"Latimer County, OK",Aug-22,3054,2841,213,7.00000000
CN4007900000000,40,079,"Le Flore County, OK",Aug-22,19456,18660,796,4.10000000
CN4008100000000,40,081,"Lincoln County, OK",Aug-22,16144,15590,554,3.40000000
CN4008300000000,40,083,"Logan County, OK",Aug-22,23283,22599,684,2.90000000
CN4008500000000,40,085,"Love County, OK",Aug-22,5874,5728,146,2.50000000
CN4008700000000,40,087,"McClain County, OK",Aug-22,20848,20230,618,3.00000000
CN4008900000000,40,089,"McCurtain County, OK",Aug-22,15993,15277,716,4.50000000
CN4009100000000,40,091,"McIntosh County, OK",Aug-22,7217,6807,410,5.70000000
CN4009300000000,40,093,"Major County, OK",Aug-22,3692,3592,100,2.70000000
CN4009500000000,40,095,"Marshall County, OK",Aug-22,7357,7111,246,3.30000000
CN4009700000000,40,097,"Mayes County, OK",Aug-22,19467,18802,665,3.40000000
CN4009900000000,40,099,"Murray County, OK",Aug-22,6134,5916,218,3.60000000
CN4010100000000,40,101,"Muskogee County, OK",Aug-22,28146,27029,1117,4.00000000
CN4010300000000,40,103,"Noble County, OK",Aug-22,5629,5492,137,2.40000000
CN4010500000000,40,105,"Nowata County, OK",Aug-22,4665,4521,144,3.10000000
CN4010700000000,40,107,"Okfuskee County, OK",Aug-22,4364,4173,191,4.40000000
CN4010900000000,40,109,"Oklahoma County, OK",Aug-22,397250,384020,13230,3.30000000
CN4011100000000,40,111,"Okmulgee County, OK",Aug-22,15881,15156,725,4.60000000
CN4011300000000,40,113,"Osage County, OK",Aug-22,20919,20106,813,3.90000000
CN4011500000000,40,115,"Ottawa County, OK",Aug-22,14834,14359,475,3.20000000
CN4011700000000,40,117,"Pawnee County, OK",Aug-22,7489,7188,301,4.00000000
CN4011900000000,40,119,"Payne County, OK",Aug-22,38341,37021,1320,3.40000000
CN4012100000000,40,121,"Pittsburg County, OK",Aug-22,15967,15157,810,5.10000000
CN4012300000000,40,123,"Pontotoc County, OK",Aug-22,19068,18478,590,3.10000000
CN4012500000000,40,125,"Pottawatomie County, OK",Aug-22,32529,31201,1328,4.10000000
CN4012700000000,40,127,"Pushmataha County, OK",Aug-22,4658,4463,195,4.20000000
CN4012900000000,40,129,"Roger Mills County, OK",Aug-22,1762,1713,49,2.80000000
CN4013100000000,40,131,"Rogers County, OK",Aug-22,46400,44917,1483,3.20000000
CN4013300000000,40,133,"Seminole County, OK",Aug-22,9132,8663,469,5.10000000
CN4013500000000,40,135,"Sequoyah County, OK",Aug-22,16710,16065,645,3.90000000
CN4013700000000,40,137,"Stephens County, OK",Aug-22,18396,17712,684,3.70000000
CN4013900000000,40,139,"Texas County, OK",Aug-22,11574,11362,212,1.80000000
CN4014100000000,40,141,"Tillman County, OK",Aug-22,2809,2712,97,3.50000000
CN4014300000000,40,143,"Tulsa County, OK",Aug-22,332207,321039,11168,3.40000000
CN4014500000000,40,145,"Wagoner County, OK",Aug-22,39878,38555,1323,3.30000000
CN4014700000000,40,147,"Washington County, OK",Aug-22,22308,21494,814,3.60000000
CN4014900000000,40,149,"Washita County, OK",Aug-22,4988,4808,180,3.60000000
CN4015100000000,40,151,"Woods County, OK",Aug-22,4699,4614,85,1.80000000
CN4015300000000,40,153,"Woodward County, OK",Aug-22,8385,8106,279,3.30000000
CN4100100000000,41,001,"Baker County, OR",Aug-22,7583,7254,329,4.30000000
CN4100300000000,41,003,"Benton County, OR",Aug-22,47530,45759,1771,3.70000000
CN4100500000000,41,005,"Clackamas County, OR",Aug-22,232698,223820,8878,3.80000000
CN4100700000000,41,007,"Clatsop County, OR",Aug-22,20348,19452,896,4.40000000
CN4100900000000,41,009,"Columbia County, OR",Aug-22,25693,24453,1240,4.80000000
CN4101100000000,41,011,"Coos County, OR",Aug-22,26881,25341,1540,5.70000000
CN4101300000000,41,013,"Crook County, OR",Aug-22,11576,10959,617,5.30000000
CN4101500000000,41,015,"Curry County, OR",Aug-22,9449,8916,533,5.60000000
CN4101700000000,41,017,"Deschutes County, OR",Aug-22,105731,101535,4196,4.00000000
CN4101900000000,41,019,"Douglas County, OR",Aug-22,48299,45694,2605,5.40000000
CN4102100000000,41,021,"Gilliam County, OR",Aug-22,909,869,40,4.40000000
CN4102300000000,41,023,"Grant County, OR",Aug-22,3251,3097,154,4.70000000
CN4102500000000,41,025,"Harney County, OR",Aug-22,3899,3736,163,4.20000000
CN4102700000000,41,027,"Hood River County, OR",Aug-22,16132,15530,602,3.70000000
CN4102900000000,41,029,"Jackson County, OR",Aug-22,109805,104481,5324,4.80000000
CN4103100000000,41,031,"Jefferson County, OR",Aug-22,10675,10103,572,5.40000000
CN4103300000000,41,033,"Josephine County, OR",Aug-22,37663,35514,2149,5.70000000
CN4103500000000,41,035,"Klamath County, OR",Aug-22,30498,28677,1821,6.00000000
CN4103700000000,41,037,"Lake County, OR",Aug-22,3779,3587,192,5.10000000
CN4103900000000,41,039,"Lane County, OR",Aug-22,183587,174794,8793,4.80000000
CN4104100000000,41,041,"Lincoln County, OR",Aug-22,22082,20885,1197,5.40000000
CN4104300000000,41,043,"Linn County, OR",Aug-22,61908,58960,2948,4.80000000
CN4104500000000,41,045,"Malheur County, OR",Aug-22,12803,12228,575,4.50000000
CN4104700000000,41,047,"Marion County, OR",Aug-22,170963,163486,7477,4.40000000
CN4104900000000,41,049,"Morrow County, OR",Aug-22,6137,5891,246,4.00000000
CN4105100000000,41,051,"Multnomah County, OR",Aug-22,480769,460761,20008,4.20000000
CN4105300000000,41,053,"Polk County, OR",Aug-22,42783,40942,1841,4.30000000
CN4105500000000,41,055,"Sherman County, OR",Aug-22,991,957,34,3.40000000
CN4105700000000,41,057,"Tillamook County, OR",Aug-22,12964,12405,559,4.30000000
CN4105900000000,41,059,"Umatilla County, OR",Aug-22,38332,36631,1701,4.40000000
CN4106100000000,41,061,"Union County, OR",Aug-22,12399,11855,544,4.40000000
CN4106300000000,41,063,"Wallowa County, OR",Aug-22,3889,3728,161,4.10000000
CN4106500000000,41,065,"Wasco County, OR",Aug-22,13731,13164,567,4.10000000
CN4106700000000,41,067,"Washington County, OR",Aug-22,342264,330364,11900,3.50000000
CN4106900000000,41,069,"Wheeler County, OR",Aug-22,717,693,24,3.30000000
CN4107100000000,41,071,"Yamhill County, OR",Aug-22,57894,55643,2251,3.90000000
CN4200100000000,42,001,"Adams County, PA",Aug-22,55279,53278,2001,3.60000000
CN4200300000000,42,003,"Allegheny County, PA",Aug-22,638186,609285,28901,4.50000000
CN4200500000000,42,005,"Armstrong County, PA",Aug-22,31536,29739,1797,5.70000000
CN4200700000000,42,007,"Beaver County, PA",Aug-22,82944,78041,4903,5.90000000
CN4200900000000,42,009,"Bedford County, PA",Aug-22,23890,22821,1069,4.50000000
CN4201100000000,42,011,"Berks County, PA",Aug-22,212155,201880,10275,4.80000000
CN4201300000000,42,013,"Blair County, PA",Aug-22,60373,57507,2866,4.70000000
CN4201500000000,42,015,"Bradford County, PA",Aug-22,27941,26720,1221,4.40000000
CN4201700000000,42,017,"Bucks County, PA",Aug-22,350537,336389,14148,4.00000000
CN4201900000000,42,019,"Butler County, PA",Aug-22,99591,95282,4309,4.30000000
CN4202100000000,42,021,"Cambria County, PA",Aug-22,55726,52398,3328,6.00000000
CN4202300000000,42,023,"Cameron County, PA",Aug-22,1984,1864,120,6.00000000
CN4202500000000,42,025,"Carbon County, PA",Aug-22,33080,31279,1801,5.40000000
CN4202700000000,42,027,"Centre County, PA",Aug-22,75820,72962,2858,3.80000000
CN4202900000000,42,029,"Chester County, PA",Aug-22,294735,284492,10243,3.50000000
CN4203100000000,42,031,"Clarion County, PA",Aug-22,16552,15679,873,5.30000000
CN4203300000000,42,033,"Clearfield County, PA",Aug-22,35345,33397,1948,5.50000000
CN4203500000000,42,035,"Clinton County, PA",Aug-22,17012,16112,900,5.30000000
CN4203700000000,42,037,"Columbia County, PA",Aug-22,32974,31424,1550,4.70000000
CN4203900000000,42,039,"Crawford County, PA",Aug-22,37645,35678,1967,5.20000000
CN4204100000000,42,041,"Cumberland County, PA",Aug-22,138778,133822,4956,3.60000000
CN4204300000000,42,043,"Dauphin County, PA",Aug-22,150369,143916,6453,4.30000000
CN4204500000000,42,045,"Delaware County, PA",Aug-22,299042,285178,13864,4.60000000
CN4204700000000,42,047,"Elk County, PA",Aug-22,14969,14151,818,5.50000000
CN4204900000000,42,049,"Erie County, PA",Aug-22,127744,120931,6813,5.30000000
CN4205100000000,42,051,"Fayette County, PA",Aug-22,55931,52124,3807,6.80000000
CN4205300000000,42,053,"Forest County, PA",Aug-22,1718,1599,119,6.90000000
CN4205500000000,42,055,"Franklin County, PA",Aug-22,78090,75056,3034,3.90000000
CN4205700000000,42,057,"Fulton County, PA",Aug-22,7142,6840,302,4.20000000
CN4205900000000,42,059,"Greene County, PA",Aug-22,15438,14512,926,6.00000000
CN4206100000000,42,061,"Huntingdon County, PA",Aug-22,19277,18191,1086,5.60000000
CN4206300000000,42,063,"Indiana County, PA",Aug-22,35858,33715,2143,6.00000000
CN4206500000000,42,065,"Jefferson County, PA",Aug-22,19725,18760,965,4.90000000
CN4206700000000,42,067,"Juniata County, PA",Aug-22,12826,12285,541,4.20000000
CN4206900000000,42,069,"Lackawanna County, PA",Aug-22,105482,99852,5630,5.30000000
CN4207100000000,42,071,"Lancaster County, PA",Aug-22,288715,277664,11051,3.80000000
CN4207300000000,42,073,"Lawrence County, PA",Aug-22,39424,37217,2207,5.60000000
CN4207500000000,42,075,"Lebanon County, PA",Aug-22,74144,71107,3037,4.10000000
CN4207700000000,42,077,"Lehigh County, PA",Aug-22,200682,191049,9633,4.80000000
CN4207900000000,42,079,"Luzerne County, PA",Aug-22,158954,149403,9551,6.00000000
CN4208100000000,42,081,"Lycoming County, PA",Aug-22,54630,51932,2698,4.90000000
CN4208300000000,42,083,"McKean County, PA",Aug-22,16767,15785,982,5.90000000
CN4208500000000,42,085,"Mercer County, PA",Aug-22,47896,45249,2647,5.50000000
CN4208700000000,42,087,"Mifflin County, PA",Aug-22,20870,19844,1026,4.90000000
CN4208900000000,42,089,"Monroe County, PA",Aug-22,83726,78298,5428,6.50000000
CN4209100000000,42,091,"Montgomery County, PA",Aug-22,466178,448900,17278,3.70000000
CN4209300000000,42,093,"Montour County, PA",Aug-22,8968,8635,333,3.70000000
CN4209500000000,42,095,"Northampton County, PA",Aug-22,166797,159387,7410,4.40000000
CN4209700000000,42,097,"Northumberland County, PA",Aug-22,42198,40009,2189,5.20000000
CN4209900000000,42,099,"Perry County, PA",Aug-22,25342,24393,949,3.70000000
CN4210100000000,42,101,"Philadelphia County/city, PA",Aug-22,729251,682376,46875,6.40000000
CN4210300000000,42,103,"Pike County, PA",Aug-22,26166,24583,1583,6.00000000
CN4210500000000,42,105,"Potter County, PA",Aug-22,7139,6742,397,5.60000000
CN4210700000000,42,107,"Schuylkill County, PA",Aug-22,65185,61595,3590,5.50000000
CN4210900000000,42,109,"Snyder County, PA",Aug-22,19433,18589,844,4.30000000
CN4211100000000,42,111,"Somerset County, PA",Aug-22,32228,30363,1865,5.80000000
CN4211300000000,42,113,"Sullivan County, PA",Aug-22,2605,2458,147,5.60000000
CN4211500000000,42,115,"Susquehanna County, PA",Aug-22,20535,19711,824,4.00000000
CN4211700000000,42,117,"Tioga County, PA",Aug-22,18838,17838,1000,5.30000000
CN4211900000000,42,119,"Union County, PA",Aug-22,19570,18800,770,3.90000000
CN4212100000000,42,121,"Venango County, PA",Aug-22,21355,20209,1146,5.40000000
CN4212300000000,42,123,"Warren County, PA",Aug-22,17568,16700,868,4.90000000
CN4212500000000,42,125,"Washington County, PA",Aug-22,105771,100640,5131,4.90000000
CN4212700000000,42,127,"Wayne County, PA",Aug-22,23696,22547,1149,4.80000000
CN4212900000000,42,129,"Westmoreland County, PA",Aug-22,177689,168992,8697,4.90000000
CN4213100000000,42,131,"Wyoming County, PA",Aug-22,13539,12843,696,5.10000000
CN4213300000000,42,133,"York County, PA",Aug-22,240450,230572,9878,4.10000000
CN4400100000000,44,001,"Bristol County, RI",Aug-22,27026,26126,900,3.30000000
CN4400300000000,44,003,"Kent County, RI",Aug-22,95406,91951,3455,3.60000000
CN4400500000000,44,005,"Newport County, RI",Aug-22,45839,44332,1507,3.30000000
CN4400700000000,44,007,"Providence County, RI",Aug-22,341057,326412,14645,4.30000000
CN4400900000000,44,009,"Washington County, RI",Aug-22,71845,69441,2404,3.30000000
CN4500100000000,45,001,"Abbeville County, SC",Aug-22,9354,8970,384,4.10000000
CN4500300000000,45,003,"Aiken County, SC",Aug-22,73904,71712,2192,3.00000000
CN4500500000000,45,005,"Allendale County, SC",Aug-22,2284,2147,137,6.00000000
CN4500700000000,45,007,"Anderson County, SC",Aug-22,91423,88629,2794,3.10000000
CN4500900000000,45,009,"Bamberg County, SC",Aug-22,4399,4127,272,6.20000000
CN4501100000000,45,011,"Barnwell County, SC",Aug-22,7497,7113,384,5.10000000
CN4501300000000,45,013,"Beaufort County, SC",Aug-22,77697,75357,2340,3.00000000
CN4501500000000,45,015,"Berkeley County, SC",Aug-22,111438,108261,3177,2.90000000
CN4501700000000,45,017,"Calhoun County, SC",Aug-22,6344,6116,228,3.60000000
CN4501900000000,45,019,"Charleston County, SC",Aug-22,218616,212709,5907,2.70000000
CN4502100000000,45,021,"Cherokee County, SC",Aug-22,24312,23303,1009,4.20000000
CN4502300000000,45,023,"Chester County, SC",Aug-22,13528,12896,632,4.70000000
CN4502500000000,45,025,"Chesterfield County, SC",Aug-22,21235,20439,796,3.70000000
CN4502700000000,45,027,"Clarendon County, SC",Aug-22,12267,11760,507,4.10000000
CN4502900000000,45,029,"Colleton County, SC",Aug-22,15890,15340,550,3.50000000
CN4503100000000,45,031,"Darlington County, SC",Aug-22,29088,28039,1049,3.60000000
CN4503300000000,45,033,"Dillon County, SC",Aug-22,12862,12239,623,4.80000000
CN4503500000000,45,035,"Dorchester County, SC",Aug-22,80828,78603,2225,2.80000000
CN4503700000000,45,037,"Edgefield County, SC",Aug-22,10351,10037,314,3.00000000
CN4503900000000,45,039,"Fairfield County, SC",Aug-22,9168,8692,476,5.20000000
CN4504100000000,45,041,"Florence County, SC",Aug-22,64440,62259,2181,3.40000000
CN4504300000000,45,043,"Georgetown County, SC",Aug-22,26319,25335,984,3.70000000
CN4504500000000,45,045,"Greenville County, SC",Aug-22,259541,252421,7120,2.70000000
CN4504700000000,45,047,"Greenwood County, SC",Aug-22,29383,28284,1099,3.70000000
CN4504900000000,45,049,"Hampton County, SC",Aug-22,8024,7805,219,2.70000000
CN4505100000000,45,051,"Horry County, SC",Aug-22,153577,147796,5781,3.80000000
CN4505300000000,45,053,"Jasper County, SC",Aug-22,13328,12928,400,3.00000000
CN4505500000000,45,055,"Kershaw County, SC",Aug-22,29052,28089,963,3.30000000
CN4505700000000,45,057,"Lancaster County, SC",Aug-22,43959,42365,1594,3.60000000
CN4505900000000,45,059,"Laurens County, SC",Aug-22,30026,29033,993,3.30000000
CN4506100000000,45,061,"Lee County, SC",Aug-22,6357,6040,317,5.00000000
CN4506300000000,45,063,"Lexington County, SC",Aug-22,149351,145428,3923,2.60000000
CN4506500000000,45,065,"McCormick County, SC",Aug-22,3313,3171,142,4.30000000
CN4506700000000,45,067,"Marion County, SC",Aug-22,12785,12106,679,5.30000000
CN4506900000000,45,069,"Marlboro County, SC",Aug-22,8491,7881,610,7.20000000
CN4507100000000,45,071,"Newberry County, SC",Aug-22,19041,18551,490,2.60000000
CN4507300000000,45,073,"Oconee County, SC",Aug-22,34050,32982,1068,3.10000000
CN4507500000000,45,075,"Orangeburg County, SC",Aug-22,32270,30426,1844,5.70000000
CN4507700000000,45,077,"Pickens County, SC",Aug-22,57742,56079,1663,2.90000000
CN4507900000000,45,079,"Richland County, SC",Aug-22,195050,188552,6498,3.30000000
CN4508100000000,45,081,"Saluda County, SC",Aug-22,8331,8102,229,2.70000000
CN4508300000000,45,083,"Spartanburg County, SC",Aug-22,156594,151747,4847,3.10000000
CN4508500000000,45,085,"Sumter County, SC",Aug-22,41035,39443,1592,3.90000000
CN4508700000000,45,087,"Union County, SC",Aug-22,11451,10836,615,5.40000000
CN4508900000000,45,089,"Williamsburg County, SC",Aug-22,10807,10231,576,5.30000000
CN4509100000000,45,091,"York County, SC",Aug-22,149347,144618,4729,3.20000000
CN4600300000000,46,003,"Aurora County, SD",Aug-22,1452,1422,30,2.10000000
CN4600500000000,46,005,"Beadle County, SD",Aug-22,9253,9044,209,2.30000000
CN4600700000000,46,007,"Bennett County, SD",Aug-22,1089,1051,38,3.50000000
CN4600900000000,46,009,"Bon Homme County, SD",Aug-22,2829,2770,59,2.10000000
CN4601100000000,46,011,"Brookings County, SD",Aug-22,18512,18022,490,2.60000000
CN4601300000000,46,013,"Brown County, SD",Aug-22,19833,19325,508,2.60000000
CN4601500000000,46,015,"Brule County, SD",Aug-22,2735,2681,54,2.00000000
CN4601700000000,46,017,"Buffalo County, SD",Aug-22,750,703,47,6.30000000
CN4601900000000,46,019,"Butte County, SD",Aug-22,5031,4911,120,2.40000000
CN4602100000000,46,021,"Campbell County, SD",Aug-22,761,741,20,2.60000000
CN4602300000000,46,023,"Charles Mix County, SD",Aug-22,3835,3729,106,2.80000000
CN4602500000000,46,025,"Clark County, SD",Aug-22,1944,1900,44,2.30000000
CN4602700000000,46,027,"Clay County, SD",Aug-22,6882,6686,196,2.80000000
CN4602900000000,46,029,"Codington County, SD",Aug-22,16114,15746,368,2.30000000
CN4603100000000,46,031,"Corson County, SD",Aug-22,1245,1186,59,4.70000000
CN4603300000000,46,033,"Custer County, SD",Aug-22,4331,4210,121,2.80000000
CN4603500000000,46,035,"Davison County, SD",Aug-22,11083,10840,243,2.20000000
CN4603700000000,46,037,"Day County, SD",Aug-22,2665,2589,76,2.90000000
CN4603900000000,46,039,"Deuel County, SD",Aug-22,2371,2310,61,2.60000000
CN4604100000000,46,041,"Dewey County, SD",Aug-22,2291,2047,244,10.70000000
CN4604300000000,46,043,"Douglas County, SD",Aug-22,1493,1459,34,2.30000000
CN4604500000000,46,045,"Edmunds County, SD",Aug-22,1946,1901,45,2.30000000
CN4604700000000,46,047,"Fall River County, SD",Aug-22,3164,3075,89,2.80000000
CN4604900000000,46,049,"Faulk County, SD",Aug-22,1047,1020,27,2.60000000
CN4605100000000,46,051,"Grant County, SD",Aug-22,4337,4242,95,2.20000000
CN4605300000000,46,053,"Gregory County, SD",Aug-22,2100,2055,45,2.10000000
CN4605500000000,46,055,"Haakon County, SD",Aug-22,1038,1017,21,2.00000000
CN4605700000000,46,057,"Hamlin County, SD",Aug-22,3578,3505,73,2.00000000
CN4605900000000,46,059,"Hand County, SD",Aug-22,1737,1700,37,2.10000000
CN4606100000000,46,061,"Hanson County, SD",Aug-22,1760,1715,45,2.60000000
CN4606300000000,46,063,"Harding County, SD",Aug-22,703,686,17,2.40000000
CN4606500000000,46,065,"Hughes County, SD",Aug-22,10009,9816,193,1.90000000
CN4606700000000,46,067,"Hutchinson County, SD",Aug-22,3550,3470,80,2.30000000
CN4606900000000,46,069,"Hyde County, SD",Aug-22,658,640,18,2.70000000
CN4607100000000,46,071,"Jackson County, SD",Aug-22,1294,1254,40,3.10000000
CN4607300000000,46,073,"Jerauld County, SD",Aug-22,1418,1395,23,1.60000000
CN4607500000000,46,075,"Jones County, SD",Aug-22,566,550,16,2.80000000
CN4607700000000,46,077,"Kingsbury County, SD",Aug-22,2876,2814,62,2.20000000
CN4607900000000,46,079,"Lake County, SD",Aug-22,6577,6396,181,2.80000000
CN4608100000000,46,081,"Lawrence County, SD",Aug-22,14496,14163,333,2.30000000
CN4608300000000,46,083,"Lincoln County, SD",Aug-22,38420,37669,751,2.00000000
CN4608500000000,46,085,"Lyman County, SD",Aug-22,1768,1712,56,3.20000000
CN4608700000000,46,087,"McCook County, SD",Aug-22,3139,3080,59,1.90000000
CN4608900000000,46,089,"McPherson County, SD",Aug-22,960,926,34,3.50000000
CN4609100000000,46,091,"Marshall County, SD",Aug-22,2437,2369,68,2.80000000
CN4609300000000,46,093,"Meade County, SD",Aug-22,15168,14818,350,2.30000000
CN4609500000000,46,095,"Mellette County, SD",Aug-22,740,699,41,5.50000000
CN4609700000000,46,097,"Miner County, SD",Aug-22,1195,1168,27,2.30000000
CN4609900000000,46,099,"Minnehaha County, SD",Aug-22,119282,116858,2424,2.00000000
CN4610100000000,46,101,"Moody County, SD",Aug-22,3987,3864,123,3.10000000
CN4610200000000,46,102,"Oglala Lakota County, SD",Aug-22,4152,3811,341,8.20000000
CN4610300000000,46,103,"Pennington County, SD",Aug-22,62775,61309,1466,2.30000000
CN4610500000000,46,105,"Perkins County, SD",Aug-22,1425,1390,35,2.50000000
CN4610700000000,46,107,"Potter County, SD",Aug-22,1046,1019,27,2.60000000
CN4610900000000,46,109,"Roberts County, SD",Aug-22,4669,4508,161,3.40000000
CN4611100000000,46,111,"Sanborn County, SD",Aug-22,1168,1143,25,2.10000000
CN4611500000000,46,115,"Spink County, SD",Aug-22,2997,2919,78,2.60000000
CN4611700000000,46,117,"Stanley County, SD",Aug-22,1923,1883,40,2.10000000
CN4611900000000,46,119,"Sully County, SD",Aug-22,798,780,18,2.30000000
CN4612100000000,46,121,"Todd County, SD",Aug-22,3101,2953,148,4.80000000
CN4612300000000,46,123,"Tripp County, SD",Aug-22,2997,2934,63,2.10000000
CN4612500000000,46,125,"Turner County, SD",Aug-22,4799,4696,103,2.10000000
CN4612700000000,46,127,"Union County, SD",Aug-22,8584,8351,233,2.70000000
CN4612900000000,46,129,"Walworth County, SD",Aug-22,2171,2091,80,3.70000000
CN4613500000000,46,135,"Yankton County, SD",Aug-22,11747,11485,262,2.20000000
CN4613700000000,46,137,"Ziebach County, SD",Aug-22,915,864,51,5.60000000
CN4700100000000,47,001,"Anderson County, TN",Aug-22,35324,34178,1146,3.20000000
CN4700300000000,47,003,"Bedford County, TN",Aug-22,21222,20481,741,3.50000000
CN4700500000000,47,005,"Benton County, TN",Aug-22,6737,6449,288,4.30000000
CN4700700000000,47,007,"Bledsoe County, TN",Aug-22,4273,4045,228,5.30000000
CN4700900000000,47,009,"Blount County, TN",Aug-22,65575,63646,1929,2.90000000
CN4701100000000,47,011,"Bradley County, TN",Aug-22,50024,48283,1741,3.50000000
CN4701300000000,47,013,"Campbell County, TN",Aug-22,14993,14385,608,4.10000000
CN4701500000000,47,015,"Cannon County, TN",Aug-22,6860,6649,211,3.10000000
CN4701700000000,47,017,"Carroll County, TN",Aug-22,11175,10739,436,3.90000000
CN4701900000000,47,019,"Carter County, TN",Aug-22,24023,23152,871,3.60000000
CN4702100000000,47,021,"Cheatham County, TN",Aug-22,22640,22071,569,2.50000000
CN4702300000000,47,023,"Chester County, TN",Aug-22,8446,8200,246,2.90000000
CN4702500000000,47,025,"Claiborne County, TN",Aug-22,12752,12269,483,3.80000000
CN4702700000000,47,027,"Clay County, TN",Aug-22,2770,2652,118,4.30000000
CN4702900000000,47,029,"Cocke County, TN",Aug-22,14681,13992,689,4.70000000
CN4703100000000,47,031,"Coffee County, TN",Aug-22,24934,24094,840,3.40000000
CN4703300000000,47,033,"Crockett County, TN",Aug-22,6779,6570,209,3.10000000
CN4703500000000,47,035,"Cumberland County, TN",Aug-22,22516,21550,966,4.30000000
CN4703700000000,47,037,"Davidson County, TN",Aug-22,412986,401168,11818,2.90000000
CN4703900000000,47,039,"Decatur County, TN",Aug-22,4211,4012,199,4.70000000
CN4704100000000,47,041,"DeKalb County, TN",Aug-22,7826,7536,290,3.70000000
CN4704300000000,47,043,"Dickson County, TN",Aug-22,27894,27070,824,3.00000000
CN4704500000000,47,045,"Dyer County, TN",Aug-22,15785,15184,601,3.80000000
CN4704700000000,47,047,"Fayette County, TN",Aug-22,19386,18718,668,3.40000000
CN4704900000000,47,049,"Fentress County, TN",Aug-22,7439,7160,279,3.80000000
CN4705100000000,47,051,"Franklin County, TN",Aug-22,19144,18489,655,3.40000000
CN4705300000000,47,053,"Gibson County, TN",Aug-22,20970,20229,741,3.50000000
CN4705500000000,47,055,"Giles County, TN",Aug-22,14535,14040,495,3.40000000
CN4705700000000,47,057,"Grainger County, TN",Aug-22,9742,9389,353,3.60000000
CN4705900000000,47,059,"Greene County, TN",Aug-22,28065,26981,1084,3.90000000
CN4706100000000,47,061,"Grundy County, TN",Aug-22,5050,4830,220,4.40000000
CN4706300000000,47,063,"Hamblen County, TN",Aug-22,27910,26945,965,3.50000000
CN4706500000000,47,065,"Hamilton County, TN",Aug-22,183167,176970,6197,3.40000000
CN4706700000000,47,067,"Hancock County, TN",Aug-22,2269,2179,90,4.00000000
CN4706900000000,47,069,"Hardeman County, TN",Aug-22,8732,8326,406,4.60000000
CN4707100000000,47,071,"Hardin County, TN",Aug-22,9912,9524,388,3.90000000
CN4707300000000,47,073,"Hawkins County, TN",Aug-22,23170,22258,912,3.90000000
CN4707500000000,47,075,"Haywood County, TN",Aug-22,7538,7158,380,5.00000000
CN4707700000000,47,077,"Henderson County, TN",Aug-22,11717,11301,416,3.60000000
CN4707900000000,47,079,"Henry County, TN",Aug-22,14304,13777,527,3.70000000
CN4708100000000,47,081,"Hickman County, TN",Aug-22,11760,11426,334,2.80000000
CN4708300000000,47,083,"Houston County, TN",Aug-22,3191,3043,148,4.60000000
CN4708500000000,47,085,"Humphreys County, TN",Aug-22,8669,8360,309,3.60000000
CN4708700000000,47,087,"Jackson County, TN",Aug-22,4749,4566,183,3.90000000
CN4708900000000,47,089,"Jefferson County, TN",Aug-22,24804,23954,850,3.40000000
CN4709100000000,47,091,"Johnson County, TN",Aug-22,7614,7370,244,3.20000000
CN4709300000000,47,093,"Knox County, TN",Aug-22,251381,244205,7176,2.90000000
CN4709500000000,47,095,"Lake County, TN",Aug-22,1611,1525,86,5.30000000
CN4709700000000,47,097,"Lauderdale County, TN",Aug-22,9529,9042,487,5.10000000
CN4709900000000,47,099,"Lawrence County, TN",Aug-22,19155,18456,699,3.60000000
CN4710100000000,47,101,"Lewis County, TN",Aug-22,5708,5501,207,3.60000000
CN4710300000000,47,103,"Lincoln County, TN",Aug-22,15975,15444,531,3.30000000
CN4710500000000,47,105,"Loudon County, TN",Aug-22,24374,23611,763,3.10000000
CN4710700000000,47,107,"McMinn County, TN",Aug-22,21306,20424,882,4.10000000
CN4710900000000,47,109,"McNairy County, TN",Aug-22,8233,7839,394,4.80000000
CN4711100000000,47,111,"Macon County, TN",Aug-22,11634,11283,351,3.00000000
CN4711300000000,47,113,"Madison County, TN",Aug-22,48731,46995,1736,3.60000000
CN4711500000000,47,115,"Marion County, TN",Aug-22,12286,11817,469,3.80000000
CN4711700000000,47,117,"Marshall County, TN",Aug-22,15481,14952,529,3.40000000
CN4711900000000,47,119,"Maury County, TN",Aug-22,53008,51314,1694,3.20000000
CN4712100000000,47,121,"Meigs County, TN",Aug-22,5145,4904,241,4.70000000
CN4712300000000,47,123,"Monroe County, TN",Aug-22,20867,20115,752,3.60000000
CN4712500000000,47,125,"Montgomery County, TN",Aug-22,87017,83721,3296,3.80000000
CN4712700000000,47,127,"Moore County, TN",Aug-22,3558,3468,90,2.50000000
CN4712900000000,47,129,"Morgan County, TN",Aug-22,7830,7542,288,3.70000000
CN4713100000000,47,131,"Obion County, TN",Aug-22,12110,11629,481,4.00000000
CN4713300000000,47,133,"Overton County, TN",Aug-22,9932,9625,307,3.10000000
CN4713500000000,47,135,"Perry County, TN",Aug-22,2734,2581,153,5.60000000
CN4713700000000,47,137,"Pickett County, TN",Aug-22,2154,2075,79,3.70000000
CN4713900000000,47,139,"Polk County, TN",Aug-22,7023,6766,257,3.70000000
CN4714100000000,47,141,"Putnam County, TN",Aug-22,35090,33908,1182,3.40000000
CN4714300000000,47,143,"Rhea County, TN",Aug-22,13821,13171,650,4.70000000
CN4714500000000,47,145,"Roane County, TN",Aug-22,23762,22905,857,3.60000000
CN4714700000000,47,147,"Robertson County, TN",Aug-22,39147,38038,1109,2.80000000
CN4714900000000,47,149,"Rutherford County, TN",Aug-22,195241,189961,5280,2.70000000
CN4715100000000,47,151,"Scott County, TN",Aug-22,7972,7605,367,4.60000000
CN4715300000000,47,153,"Sequatchie County, TN",Aug-22,6182,5933,249,4.00000000
CN4715500000000,47,155,"Sevier County, TN",Aug-22,56937,55447,1490,2.60000000
CN4715700000000,47,157,"Shelby County, TN",Aug-22,446084,422299,23785,5.30000000
CN4715900000000,47,159,"Smith County, TN",Aug-22,9751,9466,285,2.90000000
CN4716100000000,47,161,"Stewart County, TN",Aug-22,5329,5123,206,3.90000000
CN4716300000000,47,163,"Sullivan County, TN",Aug-22,68829,66439,2390,3.50000000
CN4716500000000,47,165,"Sumner County, TN",Aug-22,108754,105829,2925,2.70000000
CN4716700000000,47,167,"Tipton County, TN",Aug-22,27867,26846,1021,3.70000000
CN4716900000000,47,169,"Trousdale County, TN",Aug-22,5708,5548,160,2.80000000
CN4717100000000,47,171,"Unicoi County, TN",Aug-22,7038,6725,313,4.40000000
CN4717300000000,47,173,"Union County, TN",Aug-22,7877,7603,274,3.50000000
CN4717500000000,47,175,"Van Buren County, TN",Aug-22,2040,1949,91,4.50000000
CN4717700000000,47,177,"Warren County, TN",Aug-22,16538,15844,694,4.20000000
CN4717900000000,47,179,"Washington County, TN",Aug-22,61065,59104,1961,3.20000000
CN4718100000000,47,181,"Wayne County, TN",Aug-22,6308,6015,293,4.60000000
CN4718300000000,47,183,"Weakley County, TN",Aug-22,15117,14609,508,3.40000000
CN4718500000000,47,185,"White County, TN",Aug-22,11489,11088,401,3.50000000
CN4718700000000,47,187,"Williamson County, TN",Aug-22,138158,134969,3189,2.30000000
CN4718900000000,47,189,"Wilson County, TN",Aug-22,81830,79685,2145,2.60000000
CN4800100000000,48,001,"Anderson County, TX",Aug-22,23407,22602,805,3.40000000
CN4800300000000,48,003,"Andrews County, TX",Aug-22,8649,8323,326,3.80000000
CN4800500000000,48,005,"Angelina County, TX",Aug-22,35483,33734,1749,4.90000000
CN4800700000000,48,007,"Aransas County, TX",Aug-22,9271,8740,531,5.70000000
CN4800900000000,48,009,"Archer County, TX",Aug-22,4001,3866,135,3.40000000
CN4801100000000,48,011,"Armstrong County, TX",Aug-22,922,897,25,2.70000000
CN4801300000000,48,013,"Atascosa County, TX",Aug-22,22170,21211,959,4.30000000
CN4801500000000,48,015,"Austin County, TX",Aug-22,14135,13558,577,4.10000000
CN4801700000000,48,017,"Bailey County, TX",Aug-22,2375,2281,94,4.00000000
CN4801900000000,48,019,"Bandera County, TX",Aug-22,10458,10065,393,3.80000000
CN4802100000000,48,021,"Bastrop County, TX",Aug-22,46761,45125,1636,3.50000000
CN4802300000000,48,023,"Baylor County, TX",Aug-22,1840,1791,49,2.70000000
CN4802500000000,48,025,"Bee County, TX",Aug-22,8719,8106,613,7.00000000
CN4802700000000,48,027,"Bell County, TX",Aug-22,147563,140715,6848,4.60000000
CN4802900000000,48,029,"Bexar County, TX",Aug-22,959843,922257,37586,3.90000000
CN4803100000000,48,031,"Blanco County, TX",Aug-22,7123,6935,188,2.60000000
CN4803300000000,48,033,"Borden County, TX",Aug-22,712,701,11,1.50000000
CN4803500000000,48,035,"Bosque County, TX",Aug-22,8693,8367,326,3.80000000
CN4803700000000,48,037,"Bowie County, TX",Aug-22,39132,37242,1890,4.80000000
CN4803900000000,48,039,"Brazoria County, TX",Aug-22,185108,175615,9493,5.10000000
CN4804100000000,48,041,"Brazos County, TX",Aug-22,118050,114073,3977,3.40000000
CN4804300000000,48,043,"Brewster County, TX",Aug-22,4101,3962,139,3.40000000
CN4804500000000,48,045,"Briscoe County, TX",Aug-22,580,561,19,3.30000000
CN4804700000000,48,047,"Brooks County, TX",Aug-22,2436,2286,150,6.20000000
CN4804900000000,48,049,"Brown County, TX",Aug-22,14956,14326,630,4.20000000
CN4805100000000,48,051,"Burleson County, TX",Aug-22,8198,7875,323,3.90000000
CN4805300000000,48,053,"Burnet County, TX",Aug-22,24958,24236,722,2.90000000
CN4805500000000,48,055,"Caldwell County, TX",Aug-22,20643,19908,735,3.60000000
CN4805700000000,48,057,"Calhoun County, TX",Aug-22,12091,11633,458,3.80000000
CN4805900000000,48,059,"Callahan County, TX",Aug-22,6151,5932,219,3.60000000
CN4806100000000,48,061,"Cameron County, TX",Aug-22,175452,164207,11245,6.40000000
CN4806300000000,48,063,"Camp County, TX",Aug-22,5224,4983,241,4.60000000
CN4806500000000,48,065,"Carson County, TX",Aug-22,2957,2872,85,2.90000000
CN4806700000000,48,067,"Cass County, TX",Aug-22,12186,11575,611,5.00000000
CN4806900000000,48,069,"Castro County, TX",Aug-22,3334,3231,103,3.10000000
CN4807100000000,48,071,"Chambers County, TX",Aug-22,21133,19850,1283,6.10000000
CN4807300000000,48,073,"Cherokee County, TX",Aug-22,20373,19400,973,4.80000000
CN4807500000000,48,075,"Childress County, TX",Aug-22,3000,2917,83,2.80000000
CN4807700000000,48,077,"Clay County, TX",Aug-22,4850,4665,185,3.80000000
CN4807900000000,48,079,"Cochran County, TX",Aug-22,1075,1017,58,5.40000000
CN4808100000000,48,081,"Coke County, TX",Aug-22,1399,1344,55,3.90000000
CN4808300000000,48,083,"Coleman County, TX",Aug-22,2937,2805,132,4.50000000
CN4808500000000,48,085,"Collin County, TX",Aug-22,627175,607220,19955,3.20000000
CN4808700000000,48,087,"Collingsworth County, TX",Aug-22,1095,1056,39,3.60000000
CN4808900000000,48,089,"Colorado County, TX",Aug-22,10319,9966,353,3.40000000
CN4809100000000,48,091,"Comal County, TX",Aug-22,80759,77898,2861,3.50000000
CN4809300000000,48,093,"Comanche County, TX",Aug-22,6319,6090,229,3.60000000
CN4809500000000,48,095,"Concho County, TX",Aug-22,1379,1338,41,3.00000000
CN4809700000000,48,097,"Cooke County, TX",Aug-22,19402,18741,661,3.40000000
CN4809900000000,48,099,"Coryell County, TX",Aug-22,24358,23249,1109,4.60000000
CN4810100000000,48,101,"Cottle County, TX",Aug-22,652,628,24,3.70000000
CN4810300000000,48,103,"Crane County, TX",Aug-22,1553,1459,94,6.10000000
CN4810500000000,48,105,"Crockett County, TX",Aug-22,1379,1318,61,4.40000000
CN4810700000000,48,107,"Crosby County, TX",Aug-22,2420,2312,108,4.50000000
CN4810900000000,48,109,"Culberson County, TX",Aug-22,1079,1049,30,2.80000000
CN4811100000000,48,111,"Dallam County, TX",Aug-22,3781,3690,91,2.40000000
CN4811300000000,48,113,"Dallas County, TX",Aug-22,1428666,1372330,56336,3.90000000
CN4811500000000,48,115,"Dawson County, TX",Aug-22,4462,4241,221,5.00000000
CN4811700000000,48,117,"Deaf Smith County, TX",Aug-22,8945,8682,263,2.90000000
CN4811900000000,48,119,"Delta County, TX",Aug-22,2440,2340,100,4.10000000
CN4812100000000,48,121,"Denton County, TX",Aug-22,553061,535184,17877,3.20000000
CN4812300000000,48,123,"DeWitt County, TX",Aug-22,9549,9220,329,3.40000000
CN4812500000000,48,125,"Dickens County, TX",Aug-22,754,718,36,4.80000000
CN4812700000000,48,127,"Dimmit County, TX",Aug-22,5663,5414,249,4.40000000
CN4812900000000,48,129,"Donley County, TX",Aug-22,1472,1420,52,3.50000000
CN4813100000000,48,131,"Duval County, TX",Aug-22,5444,5178,266,4.90000000
CN4813300000000,48,133,"Eastland County, TX",Aug-22,6845,6535,310,4.50000000
CN4813500000000,48,135,"Ector County, TX",Aug-22,80279,76383,3896,4.90000000
CN4813700000000,48,137,"Edwards County, TX",Aug-22,1301,1268,33,2.50000000
CN4813900000000,48,139,"Ellis County, TX",Aug-22,103708,100054,3654,3.50000000
CN4814100000000,48,141,"El Paso County, TX",Aug-22,361423,344712,16711,4.60000000
CN4814300000000,48,143,"Erath County, TX",Aug-22,20551,19841,710,3.50000000
CN4814500000000,48,145,"Falls County, TX",Aug-22,6761,6480,281,4.20000000
CN4814700000000,48,147,"Fannin County, TX",Aug-22,17336,16788,548,3.20000000
CN4814900000000,48,149,"Fayette County, TX",Aug-22,11594,11183,411,3.50000000
CN4815100000000,48,151,"Fisher County, TX",Aug-22,1591,1539,52,3.30000000
CN4815300000000,48,153,"Floyd County, TX",Aug-22,2482,2379,103,4.10000000
CN4815500000000,48,155,"Foard County, TX",Aug-22,626,609,17,2.70000000
CN4815700000000,48,157,"Fort Bend County, TX",Aug-22,419005,401261,17744,4.20000000
CN4815900000000,48,159,"Franklin County, TX",Aug-22,5174,5000,174,3.40000000
CN4816100000000,48,161,"Freestone County, TX",Aug-22,6230,5873,357,5.70000000
CN4816300000000,48,163,"Frio County, TX",Aug-22,9314,8993,321,3.40000000
CN4816500000000,48,165,"Gaines County, TX",Aug-22,9830,9534,296,3.00000000
CN4816700000000,48,167,"Galveston County, TX",Aug-22,169573,161272,8301,4.90000000
CN4816900000000,48,169,"Garza County, TX",Aug-22,2018,1900,118,5.80000000
CN4817100000000,48,171,"Gillespie County, TX",Aug-22,14807,14445,362,2.40000000
CN4817300000000,48,173,"Glasscock County, TX",Aug-22,814,794,20,2.50000000
CN4817500000000,48,175,"Goliad County, TX",Aug-22,3125,2971,154,4.90000000
CN4817700000000,48,177,"Gonzales County, TX",Aug-22,9579,9269,310,3.20000000
CN4817900000000,48,179,"Gray County, TX",Aug-22,7680,7310,370,4.80000000
CN4818100000000,48,181,"Grayson County, TX",Aug-22,67045,64611,2434,3.60000000
CN4818300000000,48,183,"Gregg County, TX",Aug-22,56371,53685,2686,4.80000000
CN4818500000000,48,185,"Grimes County, TX",Aug-22,10950,10386,564,5.20000000
CN4818700000000,48,187,"Guadalupe County, TX",Aug-22,83836,80921,2915,3.50000000
CN4818900000000,48,189,"Hale County, TX",Aug-22,11905,11284,621,5.20000000
CN4819100000000,48,191,"Hall County, TX",Aug-22,1089,1048,41,3.80000000
CN4819300000000,48,193,"Hamilton County, TX",Aug-22,3756,3618,138,3.70000000
CN4819500000000,48,195,"Hansford County, TX",Aug-22,2609,2543,66,2.50000000
CN4819700000000,48,197,"Hardeman County, TX",Aug-22,1731,1668,63,3.60000000
CN4819900000000,48,199,"Hardin County, TX",Aug-22,24754,23303,1451,5.90000000
CN4820100000000,48,201,"Harris County, TX",Aug-22,2346162,2236505,109657,4.70000000
CN4820300000000,48,203,"Harrison County, TX",Aug-22,28159,26782,1377,4.90000000
CN4820500000000,48,205,"Hartley County, TX",Aug-22,2742,2693,49,1.80000000
CN4820700000000,48,207,"Haskell County, TX",Aug-22,2765,2688,77,2.80000000
CN4820900000000,48,209,"Hays County, TX",Aug-22,134212,130111,4101,3.10000000
CN4821100000000,48,211,"Hemphill County, TX",Aug-22,1537,1488,49,3.20000000
CN4821300000000,48,213,"Henderson County, TX",Aug-22,39162,37694,1468,3.70000000
CN4821500000000,48,215,"Hidalgo County, TX",Aug-22,368834,340683,28151,7.60000000
CN4821700000000,48,217,"Hill County, TX",Aug-22,17101,16432,669,3.90000000
CN4821900000000,48,219,"Hockley County, TX",Aug-22,10866,10437,429,3.90000000
CN4822100000000,48,221,"Hood County, TX",Aug-22,29726,28576,1150,3.90000000
CN4822300000000,48,223,"Hopkins County, TX",Aug-22,17978,17392,586,3.30000000
CN4822500000000,48,225,"Houston County, TX",Aug-22,10913,10528,385,3.50000000
CN4822700000000,48,227,"Howard County, TX",Aug-22,13291,12573,718,5.40000000
CN4822900000000,48,229,"Hudspeth County, TX",Aug-22,1849,1774,75,4.10000000
CN4823100000000,48,231,"Hunt County, TX",Aug-22,46978,45145,1833,3.90000000
CN4823300000000,48,233,"Hutchinson County, TX",Aug-22,8127,7745,382,4.70000000
CN4823500000000,48,235,"Irion County, TX",Aug-22,772,750,22,2.80000000
CN4823700000000,48,237,"Jack County, TX",Aug-22,3440,3307,133,3.90000000
CN4823900000000,48,239,"Jackson County, TX",Aug-22,7052,6803,249,3.50000000
CN4824100000000,48,241,"Jasper County, TX",Aug-22,12766,11863,903,7.10000000
CN4824300000000,48,243,"Jeff Davis County, TX",Aug-22,1059,1026,33,3.10000000
CN4824500000000,48,245,"Jefferson County, TX",Aug-22,101139,93617,7522,7.40000000
CN4824700000000,48,247,"Jim Hogg County, TX",Aug-22,1797,1694,103,5.70000000
CN4824900000000,48,249,"Jim Wells County, TX",Aug-22,15332,14301,1031,6.70000000
CN4825100000000,48,251,"Johnson County, TX",Aug-22,88215,85057,3158,3.60000000
CN4825300000000,48,253,"Jones County, TX",Aug-22,5713,5450,263,4.60000000
CN4825500000000,48,255,"Karnes County, TX",Aug-22,6892,6660,232,3.40000000
CN4825700000000,48,257,"Kaufman County, TX",Aug-22,75360,72473,2887,3.80000000
CN4825900000000,48,259,"Kendall County, TX",Aug-22,23357,22636,721,3.10000000
CN4826100000000,48,261,"Kenedy County, TX",Aug-22,189,180,9,4.80000000
CN4826300000000,48,263,"Kent County, TX",Aug-22,460,449,11,2.40000000
CN4826500000000,48,265,"Kerr County, TX",Aug-22,22140,21360,780,3.50000000
CN4826700000000,48,267,"Kimble County, TX",Aug-22,1945,1887,58,3.00000000
CN4826900000000,48,269,"King County, TX",Aug-22,632,627,5,0.80000000
CN4827100000000,48,271,"Kinney County, TX",Aug-22,1183,1125,58,4.90000000
CN4827300000000,48,273,"Kleberg County, TX",Aug-22,12791,12106,685,5.40000000
CN4827500000000,48,275,"Knox County, TX",Aug-22,1449,1389,60,4.10000000
CN4827700000000,48,277,"Lamar County, TX",Aug-22,24160,23090,1070,4.40000000
CN4827900000000,48,279,"Lamb County, TX",Aug-22,5211,5001,210,4.00000000
CN4828100000000,48,281,"Lampasas County, TX",Aug-22,9317,8975,342,3.70000000
CN4828300000000,48,283,"La Salle County, TX",Aug-22,3899,3775,124,3.20000000
CN4828500000000,48,285,"Lavaca County, TX",Aug-22,8654,8352,302,3.50000000
CN4828700000000,48,287,"Lee County, TX",Aug-22,8902,8603,299,3.40000000
CN4828900000000,48,289,"Leon County, TX",Aug-22,6141,5799,342,5.60000000
CN4829100000000,48,291,"Liberty County, TX",Aug-22,35557,33169,2388,6.70000000
CN4829300000000,48,293,"Limestone County, TX",Aug-22,8567,8167,400,4.70000000
CN4829500000000,48,295,"Lipscomb County, TX",Aug-22,1452,1413,39,2.70000000
CN4829700000000,48,297,"Live Oak County, TX",Aug-22,4715,4480,235,5.00000000
CN4829900000000,48,299,"Llano County, TX",Aug-22,9237,8889,348,3.80000000
CN4830100000000,48,301,"Loving County, TX",Aug-22,540,535,5,0.90000000
CN4830300000000,48,303,"Lubbock County, TX",Aug-22,161980,156397,5583,3.40000000
CN4830500000000,48,305,"Lynn County, TX",Aug-22,2863,2756,107,3.70000000
CN4830700000000,48,307,"McCulloch County, TX",Aug-22,3100,2957,143,4.60000000
CN4830900000000,48,309,"McLennan County, TX",Aug-22,125388,120809,4579,3.70000000
CN4831100000000,48,311,"McMullen County, TX",Aug-22,807,788,19,2.40000000
CN4831300000000,48,313,"Madison County, TX",Aug-22,4733,4517,216,4.60000000
CN4831500000000,48,315,"Marion County, TX",Aug-22,4268,4028,240,5.60000000
CN4831700000000,48,317,"Martin County, TX",Aug-22,2678,2592,86,3.20000000
CN4831900000000,48,319,"Mason County, TX",Aug-22,1845,1782,63,3.40000000
CN4832100000000,48,321,"Matagorda County, TX",Aug-22,16276,15077,1199,7.40000000
CN4832300000000,48,323,"Maverick County, TX",Aug-22,22544,20732,1812,8.00000000
CN4832500000000,48,325,"Medina County, TX",Aug-22,22287,21405,882,4.00000000
CN4832700000000,48,327,"Menard County, TX",Aug-22,798,770,28,3.50000000
CN4832900000000,48,329,"Midland County, TX",Aug-22,100914,97554,3360,3.30000000
CN4833100000000,48,331,"Milam County, TX",Aug-22,10291,9840,451,4.40000000
CN4833300000000,48,333,"Mills County, TX",Aug-22,1914,1834,80,4.20000000
CN4833500000000,48,335,"Mitchell County, TX",Aug-22,2285,2178,107,4.70000000
CN4833700000000,48,337,"Montague County, TX",Aug-22,9243,8908,335,3.60000000
CN4833900000000,48,339,"Montgomery County, TX",Aug-22,302050,289601,12449,4.10000000
CN4834100000000,48,341,"Moore County, TX",Aug-22,11067,10785,282,2.50000000
CN4834300000000,48,343,"Morris County, TX",Aug-22,4432,4089,343,7.70000000
CN4834500000000,48,345,"Motley County, TX",Aug-22,460,440,20,4.30000000
CN4834700000000,48,347,"Nacogdoches County, TX",Aug-22,27837,26615,1222,4.40000000
CN4834900000000,48,349,"Navarro County, TX",Aug-22,23970,23039,931,3.90000000
CN4835100000000,48,351,"Newton County, TX",Aug-22,4865,4490,375,7.70000000
CN4835300000000,48,353,"Nolan County, TX",Aug-22,6987,6732,255,3.60000000
CN4835500000000,48,355,"Nueces County, TX",Aug-22,163331,154764,8567,5.20000000
CN4835700000000,48,357,"Ochiltree County, TX",Aug-22,3958,3828,130,3.30000000
CN4835900000000,48,359,"Oldham County, TX",Aug-22,919,894,25,2.70000000
CN4836100000000,48,361,"Orange County, TX",Aug-22,34768,32442,2326,6.70000000
CN4836300000000,48,363,"Palo Pinto County, TX",Aug-22,12737,12228,509,4.00000000
CN4836500000000,48,365,"Panola County, TX",Aug-22,9579,9120,459,4.80000000
CN4836700000000,48,367,"Parker County, TX",Aug-22,73936,71507,2429,3.30000000
CN4836900000000,48,369,"Parmer County, TX",Aug-22,4960,4839,121,2.40000000
CN4837100000000,48,371,"Pecos County, TX",Aug-22,5774,5493,281,4.90000000
CN4837300000000,48,373,"Polk County, TX",Aug-22,18331,17187,1144,6.20000000
CN4837500000000,48,375,"Potter County, TX",Aug-22,53887,52162,1725,3.20000000
CN4837700000000,48,377,"Presidio County, TX",Aug-22,3170,2926,244,7.70000000
CN4837900000000,48,379,"Rains County, TX",Aug-22,6541,6328,213,3.30000000
CN4838100000000,48,381,"Randall County, TX",Aug-22,74317,72216,2101,2.80000000
CN4838300000000,48,383,"Reagan County, TX",Aug-22,1596,1524,72,4.50000000
CN4838500000000,48,385,"Real County, TX",Aug-22,1164,1109,55,4.70000000
CN4838700000000,48,387,"Red River County, TX",Aug-22,5432,5142,290,5.30000000
CN4838900000000,48,389,"Reeves County, TX",Aug-22,9246,8914,332,3.60000000
CN4839100000000,48,391,"Refugio County, TX",Aug-22,3026,2871,155,5.10000000
CN4839300000000,48,393,"Roberts County, TX",Aug-22,399,385,14,3.50000000
CN4839500000000,48,395,"Robertson County, TX",Aug-22,7389,7071,318,4.30000000
CN4839700000000,48,397,"Rockwall County, TX",Aug-22,59417,57449,1968,3.30000000
CN4839900000000,48,399,"Runnels County, TX",Aug-22,4602,4445,157,3.40000000
CN4840100000000,48,401,"Rusk County, TX",Aug-22,22216,21193,1023,4.60000000
CN4840300000000,48,403,"Sabine County, TX",Aug-22,4025,3715,310,7.70000000
CN4840500000000,48,405,"San Augustine County, TX",Aug-22,2980,2770,210,7.00000000
CN4840700000000,48,407,"San Jacinto County, TX",Aug-22,11994,11339,655,5.50000000
CN4840900000000,48,409,"San Patricio County, TX",Aug-22,29246,27226,2020,6.90000000
CN4841100000000,48,411,"San Saba County, TX",Aug-22,2072,1997,75,3.60000000
CN4841300000000,48,413,"Schleicher County, TX",Aug-22,1127,1085,42,3.70000000
CN4841500000000,48,415,"Scurry County, TX",Aug-22,5819,5524,295,5.10000000
CN4841700000000,48,417,"Shackelford County, TX",Aug-22,1878,1828,50,2.70000000
CN4841900000000,48,419,"Shelby County, TX",Aug-22,11729,11243,486,4.10000000
CN4842100000000,48,421,"Sherman County, TX",Aug-22,1451,1417,34,2.30000000
CN4842300000000,48,423,"Smith County, TX",Aug-22,110862,106617,4245,3.80000000
CN4842500000000,48,425,"Somervell County, TX",Aug-22,4542,4357,185,4.10000000
CN4842700000000,48,427,"Starr County, TX",Aug-22,23966,20846,3120,13.00000000
CN4842900000000,48,429,"Stephens County, TX",Aug-22,4235,4081,154,3.60000000
CN4843100000000,48,431,"Sterling County, TX",Aug-22,555,536,19,3.40000000
CN4843300000000,48,433,"Stonewall County, TX",Aug-22,613,593,20,3.30000000
CN4843500000000,48,435,"Sutton County, TX",Aug-22,1109,1049,60,5.40000000
CN4843700000000,48,437,"Swisher County, TX",Aug-22,2615,2513,102,3.90000000
CN4843900000000,48,439,"Tarrant County, TX",Aug-22,1131215,1088089,43126,3.80000000
CN4844100000000,48,441,"Taylor County, TX",Aug-22,67197,64917,2280,3.40000000
CN4844300000000,48,443,"Terrell County, TX",Aug-22,427,414,13,3.00000000
CN4844500000000,48,445,"Terry County, TX",Aug-22,4652,4444,208,4.50000000
CN4844700000000,48,447,"Throckmorton County, TX",Aug-22,1488,1468,20,1.30000000
CN4844900000000,48,449,"Titus County, TX",Aug-22,13604,12996,608,4.50000000
CN4845100000000,48,451,"Tom Green County, TX",Aug-22,53583,51688,1895,3.50000000
CN4845300000000,48,453,"Travis County, TX",Aug-22,797944,774523,23421,2.90000000
CN4845500000000,48,455,"Trinity County, TX",Aug-22,5188,4886,302,5.80000000
CN4845700000000,48,457,"Tyler County, TX",Aug-22,7488,7026,462,6.20000000
CN4845900000000,48,459,"Upshur County, TX",Aug-22,17630,16831,799,4.50000000
CN4846100000000,48,461,"Upton County, TX",Aug-22,1744,1680,64,3.70000000
CN4846300000000,48,463,"Uvalde County, TX",Aug-22,11239,10705,534,4.80000000
CN4846500000000,48,465,"Val Verde County, TX",Aug-22,21913,20872,1041,4.80000000
CN4846700000000,48,467,"Van Zandt County, TX",Aug-22,27701,26700,1001,3.60000000
CN4846900000000,48,469,"Victoria County, TX",Aug-22,40206,38379,1827,4.50000000
CN4847100000000,48,471,"Walker County, TX",Aug-22,23109,21937,1172,5.10000000
CN4847300000000,48,473,"Waller County, TX",Aug-22,25475,24315,1160,4.60000000
CN4847500000000,48,475,"Ward County, TX",Aug-22,6302,6043,259,4.10000000
CN4847700000000,48,477,"Washington County, TX",Aug-22,14852,14239,613,4.10000000
CN4847900000000,48,479,"Webb County, TX",Aug-22,117635,112761,4874,4.10000000
CN4848100000000,48,481,"Wharton County, TX",Aug-22,21075,20213,862,4.10000000
CN4848300000000,48,483,"Wheeler County, TX",Aug-22,1927,1846,81,4.20000000
CN4848500000000,48,485,"Wichita County, TX",Aug-22,55272,53056,2216,4.00000000
CN4848700000000,48,487,"Wilbarger County, TX",Aug-22,4745,4496,249,5.20000000
CN4848900000000,48,489,"Willacy County, TX",Aug-22,7200,6532,668,9.30000000
CN4849100000000,48,491,"Williamson County, TX",Aug-22,352838,342271,10567,3.00000000
CN4849300000000,48,493,"Wilson County, TX",Aug-22,25467,24644,823,3.20000000
CN4849500000000,48,495,"Winkler County, TX",Aug-22,3625,3448,177,4.90000000
CN4849700000000,48,497,"Wise County, TX",Aug-22,34008,32808,1200,3.50000000
CN4849900000000,48,499,"Wood County, TX",Aug-22,17840,17014,826,4.60000000
CN4850100000000,48,501,"Yoakum County, TX",Aug-22,3090,2943,147,4.80000000
CN4850300000000,48,503,"Young County, TX",Aug-22,8052,7784,268,3.30000000
CN4850500000000,48,505,"Zapata County, TX",Aug-22,4526,4161,365,8.10000000
CN4850700000000,48,507,"Zavala County, TX",Aug-22,3195,2889,306,9.60000000
CN4900100000000,49,001,"Beaver County, UT",Aug-22,2791,2725,66,2.40000000
CN4900300000000,49,003,"Box Elder County, UT",Aug-22,27762,27205,557,2.00000000
CN4900500000000,49,005,"Cache County, UT",Aug-22,68750,67494,1256,1.80000000
CN4900700000000,49,007,"Carbon County, UT",Aug-22,8513,8247,266,3.10000000
CN4900900000000,49,009,"Daggett County, UT",Aug-22,470,457,13,2.80000000
CN4901100000000,49,011,"Davis County, UT",Aug-22,185629,181968,3661,2.00000000
CN4901300000000,49,013,"Duchesne County, UT",Aug-22,7984,7756,228,2.90000000
CN4901500000000,49,015,"Emery County, UT",Aug-22,4554,4431,123,2.70000000
CN4901700000000,49,017,"Garfield County, UT",Aug-22,3203,3097,106,3.30000000
CN4901900000000,49,019,"Grand County, UT",Aug-22,7518,7373,145,1.90000000
CN4902100000000,49,021,"Iron County, UT",Aug-22,27106,26495,611,2.30000000
CN4902300000000,49,023,"Juab County, UT",Aug-22,6429,6315,114,1.80000000
CN4902500000000,49,025,"Kane County, UT",Aug-22,4339,4250,89,2.10000000
CN4902700000000,49,027,"Millard County, UT",Aug-22,6123,5991,132,2.20000000
CN4902900000000,49,029,"Morgan County, UT",Aug-22,5992,5884,108,1.80000000
CN4903100000000,49,031,"Piute County, UT",Aug-22,514,497,17,3.30000000
CN4903300000000,49,033,"Rich County, UT",Aug-22,1551,1528,23,1.50000000
CN4903500000000,49,035,"Salt Lake County, UT",Aug-22,675348,661183,14165,2.10000000
CN4903700000000,49,037,"San Juan County, UT",Aug-22,5660,5449,211,3.70000000
CN4903900000000,49,039,"Sanpete County, UT",Aug-22,13173,12838,335,2.50000000
CN4904100000000,49,041,"Sevier County, UT",Aug-22,10364,10110,254,2.50000000
CN4904300000000,49,043,"Summit County, UT",Aug-22,26071,25589,482,1.80000000
CN4904500000000,49,045,"Tooele County, UT",Aug-22,38029,37152,877,2.30000000
CN4904700000000,49,047,"Uintah County, UT",Aug-22,14232,13745,487,3.40000000
CN4904900000000,49,049,"Utah County, UT",Aug-22,346141,339484,6657,1.90000000
CN4905100000000,49,051,"Wasatch County, UT",Aug-22,18029,17663,366,2.00000000
CN4905300000000,49,053,"Washington County, UT",Aug-22,86890,84862,2028,2.30000000
CN4905500000000,49,055,"Wayne County, UT",Aug-22,1589,1548,41,2.60000000
CN4905700000000,49,057,"Weber County, UT",Aug-22,135972,132994,2978,2.20000000
CN5000100000000,50,001,"Addison County, VT",Aug-22,21145,20763,382,1.80000000
CN5000300000000,50,003,"Bennington County, VT",Aug-22,17471,17036,435,2.50000000
CN5000500000000,50,005,"Caledonia County, VT",Aug-22,14484,14131,353,2.40000000
CN5000700000000,50,007,"Chittenden County, VT",Aug-22,96890,95362,1528,1.60000000
CN5000900000000,50,009,"Essex County, VT",Aug-22,2649,2553,96,3.60000000
CN5001100000000,50,011,"Franklin County, VT",Aug-22,27682,27082,600,2.20000000
CN5001300000000,50,013,"Grand Isle County, VT",Aug-22,4089,4000,89,2.20000000
CN5001500000000,50,015,"Lamoille County, VT",Aug-22,13935,13625,310,2.20000000
CN5001700000000,50,017,"Orange County, VT",Aug-22,15888,15607,281,1.80000000
CN5001900000000,50,019,"Orleans County, VT",Aug-22,12705,12309,396,3.10000000
CN5002100000000,50,021,"Rutland County, VT",Aug-22,29759,28971,788,2.60000000
CN5002300000000,50,023,"Washington County, VT",Aug-22,34079,33466,613,1.80000000
CN5002500000000,50,025,"Windham County, VT",Aug-22,20860,20389,471,2.30000000
CN5002700000000,50,027,"Windsor County, VT",Aug-22,28743,28249,494,1.70000000
CN5100100000000,51,001,"Accomack County, VA",Aug-22,16236,15714,522,3.20000000
CN5100300000000,51,003,"Albemarle County, VA",Aug-22,55840,54219,1621,2.90000000
CN5100500000000,51,005,"Alleghany County, VA",Aug-22,6833,6607,226,3.30000000
CN5100700000000,51,007,"Amelia County, VA",Aug-22,6088,5881,207,3.40000000
CN5100900000000,51,009,"Amherst County, VA",Aug-22,14621,14118,503,3.40000000
CN5101100000000,51,011,"Appomattox County, VA",Aug-22,7041,6800,241,3.40000000
CN5101300000000,51,013,"Arlington County, VA",Aug-22,152674,149293,3381,2.20000000
CN5101500000000,51,015,"Augusta County, VA",Aug-22,37053,35983,1070,2.90000000
CN5101700000000,51,017,"Bath County, VA",Aug-22,2413,2346,67,2.80000000
CN5101900000000,51,019,"Bedford County, VA",Aug-22,37885,36698,1187,3.10000000
CN5102100000000,51,021,"Bland County, VA",Aug-22,2818,2738,80,2.80000000
CN5102300000000,51,023,"Botetourt County, VA",Aug-22,17049,16574,475,2.80000000
CN5102500000000,51,025,"Brunswick County, VA",Aug-22,6020,5720,300,5.00000000
CN5102700000000,51,027,"Buchanan County, VA",Aug-22,6500,6159,341,5.20000000
CN5102900000000,51,029,"Buckingham County, VA",Aug-22,6214,5946,268,4.30000000
CN5103100000000,51,031,"Campbell County, VA",Aug-22,25441,24554,887,3.50000000
CN5103300000000,51,033,"Caroline County, VA",Aug-22,14854,14281,573,3.90000000
CN5103500000000,51,035,"Carroll County, VA",Aug-22,13758,13278,480,3.50000000
CN5103600000000,51,036,"Charles City County, VA",Aug-22,3477,3366,111,3.20000000
CN5103700000000,51,037,"Charlotte County, VA",Aug-22,5756,5591,165,2.90000000
CN5104100000000,51,041,"Chesterfield County, VA",Aug-22,186545,180677,5868,3.10000000
CN5104300000000,51,043,"Clarke County, VA",Aug-22,7511,7302,209,2.80000000
CN5104500000000,51,045,"Craig County, VA",Aug-22,2234,2159,75,3.40000000
CN5104700000000,51,047,"Culpeper County, VA",Aug-22,24921,24166,755,3.00000000
CN5104900000000,51,049,"Cumberland County, VA",Aug-22,4819,4636,183,3.80000000
CN5105100000000,51,051,"Dickenson County, VA",Aug-22,5137,4933,204,4.00000000
CN5105300000000,51,053,"Dinwiddie County, VA",Aug-22,13347,12830,517,3.90000000
CN5105700000000,51,057,"Essex County, VA",Aug-22,5379,5177,202,3.80000000
CN5105900000000,51,059,"Fairfax County, VA",Aug-22,621859,605302,16557,2.70000000
CN5106100000000,51,061,"Fauquier County, VA",Aug-22,36907,35879,1028,2.80000000
CN5106300000000,51,063,"Floyd County, VA",Aug-22,8362,8136,226,2.70000000
CN5106500000000,51,065,"Fluvanna County, VA",Aug-22,13651,13264,387,2.80000000
CN5106700000000,51,067,"Franklin County, VA",Aug-22,25581,24767,814,3.20000000
CN5106900000000,51,069,"Frederick County, VA",Aug-22,49662,48382,1280,2.60000000
CN5107100000000,51,071,"Giles County, VA",Aug-22,7964,7709,255,3.20000000
CN5107300000000,51,073,"Gloucester County, VA",Aug-22,19196,18640,556,2.90000000
CN5107500000000,51,075,"Goochland County, VA",Aug-22,11389,11060,329,2.90000000
CN5107700000000,51,077,"Grayson County, VA",Aug-22,8656,8441,215,2.50000000
CN5107900000000,51,079,"Greene County, VA",Aug-22,10214,9957,257,2.50000000
CN5108100000000,51,081,"Greensville County, VA",Aug-22,4624,4451,173,3.70000000
CN5108300000000,51,083,"Halifax County, VA",Aug-22,16190,15539,651,4.00000000
CN5108500000000,51,085,"Hanover County, VA",Aug-22,57842,56289,1553,2.70000000
CN5108700000000,51,087,"Henrico County, VA",Aug-22,178548,172882,5666,3.20000000
CN5108900000000,51,089,"Henry County, VA",Aug-22,25868,25015,853,3.30000000
CN5109100000000,51,091,"Highland County, VA",Aug-22,1297,1266,31,2.40000000
CN5109300000000,51,093,"Isle of Wight County, VA",Aug-22,19390,18797,593,3.10000000
CN5109500000000,51,095,"James City County, VA",Aug-22,36346,35222,1124,3.10000000
CN5109700000000,51,097,"King and Queen County, VA",Aug-22,4008,3900,108,2.70000000
CN5109900000000,51,099,"King George County, VA",Aug-22,14565,14170,395,2.70000000
CN5110100000000,51,101,"King William County, VA",Aug-22,9231,8951,280,3.00000000
CN5110300000000,51,103,"Lancaster County, VA",Aug-22,5775,5593,182,3.20000000
CN5110500000000,51,105,"Lee County, VA",Aug-22,8703,8382,321,3.70000000
CN5110700000000,51,107,"Loudoun County, VA",Aug-22,226319,220477,5842,2.60000000
CN5110900000000,51,109,"Louisa County, VA",Aug-22,21351,20742,609,2.90000000
CN5111100000000,51,111,"Lunenburg County, VA",Aug-22,5338,5144,194,3.60000000
CN5111300000000,51,113,"Madison County, VA",Aug-22,7569,7396,173,2.30000000
CN5111500000000,51,115,"Mathews County, VA",Aug-22,4018,3899,119,3.00000000
CN5111700000000,51,117,"Mecklenburg County, VA",Aug-22,13664,13156,508,3.70000000
CN5111900000000,51,119,"Middlesex County, VA",Aug-22,5503,5347,156,2.80000000
CN5112100000000,51,121,"Montgomery County, VA",Aug-22,50966,49475,1491,2.90000000
CN5112500000000,51,125,"Nelson County, VA",Aug-22,7118,6898,220,3.10000000
CN5112700000000,51,127,"New Kent County, VA",Aug-22,12728,12410,318,2.50000000
CN5113100000000,51,131,"Northampton County, VA",Aug-22,5886,5685,201,3.40000000
CN5113300000000,51,133,"Northumberland County, VA",Aug-22,5943,5728,215,3.60000000
CN5113500000000,51,135,"Nottoway County, VA",Aug-22,7470,7226,244,3.30000000
CN5113700000000,51,137,"Orange County, VA",Aug-22,17832,17278,554,3.10000000
CN5113900000000,51,139,"Page County, VA",Aug-22,12770,12367,403,3.20000000
CN5114100000000,51,141,"Patrick County, VA",Aug-22,7458,7183,275,3.70000000
CN5114300000000,51,143,"Pittsylvania County, VA",Aug-22,32018,30980,1038,3.20000000
CN5114500000000,51,145,"Powhatan County, VA",Aug-22,14117,13725,392,2.80000000
CN5114700000000,51,147,"Prince Edward County, VA",Aug-22,11223,10781,442,3.90000000
CN5114900000000,51,149,"Prince George County, VA",Aug-22,14875,14284,591,4.00000000
CN5115300000000,51,153,"Prince William County, VA",Aug-22,244675,237247,7428,3.00000000
CN5115500000000,51,155,"Pulaski County, VA",Aug-22,16296,15785,511,3.10000000
CN5115700000000,51,157,"Rappahannock County, VA",Aug-22,3625,3524,101,2.80000000
CN5115900000000,51,159,"Richmond County, VA",Aug-22,4141,4030,111,2.70000000
CN5116100000000,51,161,"Roanoke County, VA",Aug-22,48006,46658,1348,2.80000000
CN5116300000000,51,163,"Rockbridge County, VA",Aug-22,11460,11131,329,2.90000000
CN5116500000000,51,165,"Rockingham County, VA",Aug-22,41482,40325,1157,2.80000000
CN5116700000000,51,167,"Russell County, VA",Aug-22,11275,10883,392,3.50000000
CN5116900000000,51,169,"Scott County, VA",Aug-22,8975,8679,296,3.30000000
CN5117100000000,51,171,"Shenandoah County, VA",Aug-22,23088,22437,651,2.80000000
CN5117300000000,51,173,"Smyth County, VA",Aug-22,15484,15047,437,2.80000000
CN5117500000000,51,175,"Southampton County, VA",Aug-22,9242,8980,262,2.80000000
CN5117700000000,51,177,"Spotsylvania County, VA",Aug-22,67692,65519,2173,3.20000000
CN5117900000000,51,179,"Stafford County, VA",Aug-22,73799,71462,2337,3.20000000
CN5118100000000,51,181,"Surry County, VA",Aug-22,3600,3488,112,3.10000000
CN5118300000000,51,183,"Sussex County, VA",Aug-22,3643,3444,199,5.50000000
CN5118500000000,51,185,"Tazewell County, VA",Aug-22,15925,15268,657,4.10000000
CN5118700000000,51,187,"Warren County, VA",Aug-22,20200,19598,602,3.00000000
CN5119100000000,51,191,"Washington County, VA",Aug-22,25740,24926,814,3.20000000
CN5119300000000,51,193,"Westmoreland County, VA",Aug-22,10127,9801,326,3.20000000
CN5119500000000,51,195,"Wise County, VA",Aug-22,14393,13808,585,4.10000000
CN5119700000000,51,197,"Wythe County, VA",Aug-22,14834,14395,439,3.00000000
CN5119900000000,51,199,"York County, VA",Aug-22,32620,31663,957,2.90000000
CN5151000000000,51,510,"Alexandria city, VA",Aug-22,98150,95649,2501,2.50000000
CN5152000000000,51,520,"Bristol city, VA",Aug-22,7376,7101,275,3.70000000
CN5153000000000,51,530,"Buena Vista city, VA",Aug-22,3213,3109,104,3.20000000
CN5154000000000,51,540,"Charlottesville city, VA",Aug-22,24741,23996,745,3.00000000
CN5155000000000,51,550,"Chesapeake city, VA",Aug-22,122056,118096,3960,3.20000000
CN5157000000000,51,570,"Colonial Heights city, VA",Aug-22,8242,7927,315,3.80000000
CN5158000000000,51,580,"Covington city, VA",Aug-22,2390,2289,101,4.20000000
CN5159000000000,51,590,"Danville city, VA",Aug-22,19888,18842,1046,5.30000000
CN5159500000000,51,595,"Emporia city, VA",Aug-22,2583,2426,157,6.10000000
CN5160000000000,51,600,"Fairfax city, VA",Aug-22,12554,12236,318,2.50000000
CN5161000000000,51,610,"Falls Church city, VA",Aug-22,8329,8133,196,2.40000000
CN5162000000000,51,620,"Franklin city, VA",Aug-22,3613,3423,190,5.30000000
CN5163000000000,51,630,"Fredericksburg city, VA",Aug-22,14017,13498,519,3.70000000
CN5164000000000,51,640,"Galax city, VA",Aug-22,3035,2950,85,2.80000000
CN5165000000000,51,650,"Hampton city, VA",Aug-22,63674,60805,2869,4.50000000
CN5166000000000,51,660,"Harrisonburg city, VA",Aug-22,24043,23102,941,3.90000000
CN5167000000000,51,670,"Hopewell city, VA",Aug-22,9386,8846,540,5.80000000
CN5167800000000,51,678,"Lexington city, VA",Aug-22,2248,2144,104,4.60000000
CN5168000000000,51,680,"Lynchburg city, VA",Aug-22,35330,33688,1642,4.60000000
CN5168300000000,51,683,"Manassas city, VA",Aug-22,21193,20576,617,2.90000000
CN5168500000000,51,685,"Manassas Park city, VA",Aug-22,9530,9276,254,2.70000000
CN5169000000000,51,690,"Martinsville city, VA",Aug-22,5991,5662,329,5.50000000
CN5170000000000,51,700,"Newport News city, VA",Aug-22,87464,83649,3815,4.40000000
CN5171000000000,51,710,"Norfolk city, VA",Aug-22,108850,104336,4514,4.10000000
CN5172000000000,51,720,"Norton city, VA",Aug-22,1783,1711,72,4.00000000
CN5173000000000,51,730,"Petersburg city, VA",Aug-22,12414,11433,981,7.90000000
CN5173500000000,51,735,"Poquoson city, VA",Aug-22,6277,6107,170,2.70000000
CN5174000000000,51,740,"Portsmouth city, VA",Aug-22,43703,41608,2095,4.80000000
CN5175000000000,51,750,"Radford city, VA",Aug-22,8837,8490,347,3.90000000
CN5176000000000,51,760,"Richmond city, VA",Aug-22,116742,111961,4781,4.10000000
CN5177000000000,51,770,"Roanoke city, VA",Aug-22,47340,45607,1733,3.70000000
CN5177500000000,51,775,"Salem city, VA",Aug-22,12417,12030,387,3.10000000
CN5179000000000,51,790,"Staunton city, VA",Aug-22,12039,11647,392,3.30000000
CN5180000000000,51,800,"Suffolk city, VA",Aug-22,44957,43399,1558,3.50000000
CN5181000000000,51,810,"Virginia Beach city, VA",Aug-22,228007,221177,6830,3.00000000
CN5182000000000,51,820,"Waynesboro city, VA",Aug-22,10452,10092,360,3.40000000
CN5183000000000,51,830,"Williamsburg city, VA",Aug-22,6714,6410,304,4.50000000
CN5184000000000,51,840,"Winchester city, VA",Aug-22,14602,14168,434,3.00000000
CN5300100000000,53,001,"Adams County, WA",Aug-22,11016,10614,402,3.60000000
CN5300300000000,53,003,"Asotin County, WA",Aug-22,10542,10173,369,3.50000000
CN5300500000000,53,005,"Benton County, WA",Aug-22,107828,102992,4836,4.50000000
CN5300700000000,53,007,"Chelan County, WA",Aug-22,47444,45452,1992,4.20000000
CN5300900000000,53,009,"Clallam County, WA",Aug-22,29907,28298,1609,5.40000000
CN5301100000000,53,011,"Clark County, WA",Aug-22,254567,243326,11241,4.40000000
CN5301300000000,53,013,"Columbia County, WA",Aug-22,1851,1771,80,4.30000000
CN5301500000000,53,015,"Cowlitz County, WA",Aug-22,49192,46570,2622,5.30000000
CN5301700000000,53,017,"Douglas County, WA",Aug-22,22567,21510,1057,4.70000000
CN5301900000000,53,019,"Ferry County, WA",Aug-22,2318,2127,191,8.20000000
CN5302100000000,53,021,"Franklin County, WA",Aug-22,46222,43769,2453,5.30000000
CN5302300000000,53,023,"Garfield County, WA",Aug-22,838,791,47,5.60000000
CN5302500000000,53,025,"Grant County, WA",Aug-22,49383,46857,2526,5.10000000
CN5302700000000,53,027,"Grays Harbor County, WA",Aug-22,28543,26697,1846,6.50000000
CN5302900000000,53,029,"Island County, WA",Aug-22,36713,35012,1701,4.60000000
CN5303100000000,53,031,"Jefferson County, WA",Aug-22,12837,12187,650,5.10000000
CN5303300000000,53,033,"King County, WA",Aug-22,1314221,1274672,39549,3.00000000
CN5303500000000,53,035,"Kitsap County, WA",Aug-22,128343,122924,5419,4.20000000
CN5303700000000,53,037,"Kittitas County, WA",Aug-22,21227,20021,1206,5.70000000
CN5303900000000,53,039,"Klickitat County, WA",Aug-22,10230,9699,531,5.20000000
CN5304100000000,53,041,"Lewis County, WA",Aug-22,35140,33236,1904,5.40000000
CN5304300000000,53,043,"Lincoln County, WA",Aug-22,4779,4571,208,4.40000000
CN5304500000000,53,045,"Mason County, WA",Aug-22,24946,23430,1516,6.10000000
CN5304700000000,53,047,"Okanogan County, WA",Aug-22,20320,19260,1060,5.20000000
CN5304900000000,53,049,"Pacific County, WA",Aug-22,8674,8121,553,6.40000000
CN5305100000000,53,051,"Pend Oreille County, WA",Aug-22,5158,4835,323,6.30000000
CN5305300000000,53,053,"Pierce County, WA",Aug-22,451501,429302,22199,4.90000000
CN5305500000000,53,055,"San Juan County, WA",Aug-22,8377,8080,297,3.50000000
CN5305700000000,53,057,"Skagit County, WA",Aug-22,63244,60181,3063,4.80000000
CN5305900000000,53,059,"Skamania County, WA",Aug-22,5666,5401,265,4.70000000
CN5306100000000,53,061,"Snohomish County, WA",Aug-22,448456,433214,15242,3.40000000
CN5306300000000,53,063,"Spokane County, WA",Aug-22,264119,252720,11399,4.30000000
CN5306500000000,53,065,"Stevens County, WA",Aug-22,19141,18069,1072,5.60000000
CN5306700000000,53,067,"Thurston County, WA",Aug-22,145902,139531,6371,4.40000000
CN5306900000000,53,069,"Wahkiakum County, WA",Aug-22,1352,1266,86,6.40000000
CN5307100000000,53,071,"Walla Walla County, WA",Aug-22,31764,30502,1262,4.00000000
CN5307300000000,53,073,"Whatcom County, WA",Aug-22,115704,110261,5443,4.70000000
CN5307500000000,53,075,"Whitman County, WA",Aug-22,23946,22889,1057,4.40000000
CN5307700000000,53,077,"Yakima County, WA",Aug-22,137825,130091,7734,5.60000000
CN5400100000000,54,001,"Barbour County, WV",Aug-22,7238,6872,366,5.10000000
CN5400300000000,54,003,"Berkeley County, WV",Aug-22,61385,59389,1996,3.30000000
CN5400500000000,54,005,"Boone County, WV",Aug-22,7304,6945,359,4.90000000
CN5400700000000,54,007,"Braxton County, WV",Aug-22,5030,4710,320,6.40000000
CN5400900000000,54,009,"Brooke County, WV",Aug-22,9976,9447,529,5.30000000
CN5401100000000,54,011,"Cabell County, WV",Aug-22,41653,39977,1676,4.00000000
CN5401300000000,54,013,"Calhoun County, WV",Aug-22,2615,2401,214,8.20000000
CN5401500000000,54,015,"Clay County, WV",Aug-22,3048,2851,197,6.50000000
CN5401700000000,54,017,"Doddridge County, WV",Aug-22,3798,3679,119,3.10000000
CN5401900000000,54,019,"Fayette County, WV",Aug-22,16467,15630,837,5.10000000
CN5402100000000,54,021,"Gilmer County, WV",Aug-22,2258,2119,139,6.20000000
CN5402300000000,54,023,"Grant County, WV",Aug-22,5845,5615,230,3.90000000
CN5402500000000,54,025,"Greenbrier County, WV",Aug-22,15544,14952,592,3.80000000
CN5402700000000,54,027,"Hampshire County, WV",Aug-22,11057,10734,323,2.90000000
CN5402900000000,54,029,"Hancock County, WV",Aug-22,13276,12467,809,6.10000000
CN5403100000000,54,031,"Hardy County, WV",Aug-22,5592,5352,240,4.30000000
CN5403300000000,54,033,"Harrison County, WV",Aug-22,33913,32599,1314,3.90000000
CN5403500000000,54,035,"Jackson County, WV",Aug-22,12235,11664,571,4.70000000
CN5403700000000,54,037,"Jefferson County, WV",Aug-22,30865,30017,848,2.70000000
CN5403900000000,54,039,"Kanawha County, WV",Aug-22,82442,79036,3406,4.10000000
CN5404100000000,54,041,"Lewis County, WV",Aug-22,6161,5797,364,5.90000000
CN5404300000000,54,043,"Lincoln County, WV",Aug-22,7112,6707,405,5.70000000
CN5404500000000,54,045,"Logan County, WV",Aug-22,11138,10567,571,5.10000000
CN5404700000000,54,047,"McDowell County, WV",Aug-22,4277,3942,335,7.80000000
CN5404900000000,54,049,"Marion County, WV",Aug-22,25487,24241,1246,4.90000000
CN5405100000000,54,051,"Marshall County, WV",Aug-22,13413,12731,682,5.10000000
CN5405300000000,54,053,"Mason County, WV",Aug-22,10022,9492,530,5.30000000
CN5405500000000,54,055,"Mercer County, WV",Aug-22,20579,19491,1088,5.30000000
CN5405700000000,54,057,"Mineral County, WV",Aug-22,12010,11502,508,4.20000000
CN5405900000000,54,059,"Mingo County, WV",Aug-22,6080,5595,485,8.00000000
CN5406100000000,54,061,"Monongalia County, WV",Aug-22,57612,55528,2084,3.60000000
CN5406300000000,54,063,"Monroe County, WV",Aug-22,5997,5801,196,3.30000000
CN5406500000000,54,065,"Morgan County, WV",Aug-22,8572,8315,257,3.00000000
CN5406700000000,54,067,"Nicholas County, WV",Aug-22,9271,8795,476,5.10000000
CN5406900000000,54,069,"Ohio County, WV",Aug-22,20478,19607,871,4.30000000
CN5407100000000,54,071,"Pendleton County, WV",Aug-22,3678,3579,99,2.70000000
CN5407300000000,54,073,"Pleasants County, WV",Aug-22,2729,2569,160,5.90000000
CN5407500000000,54,075,"Pocahontas County, WV",Aug-22,4224,4090,134,3.20000000
CN5407700000000,54,077,"Preston County, WV",Aug-22,15957,15274,683,4.30000000
CN5407900000000,54,079,"Putnam County, WV",Aug-22,26960,26021,939,3.50000000
CN5408100000000,54,081,"Raleigh County, WV",Aug-22,31018,29770,1248,4.00000000
CN5408300000000,54,083,"Randolph County, WV",Aug-22,11783,11212,571,4.80000000
CN5408500000000,54,085,"Ritchie County, WV",Aug-22,4286,4089,197,4.60000000
CN5408700000000,54,087,"Roane County, WV",Aug-22,5001,4656,345,6.90000000
CN5408900000000,54,089,"Summers County, WV",Aug-22,4554,4381,173,3.80000000
CN5409100000000,54,091,"Taylor County, WV",Aug-22,7995,7648,347,4.30000000
CN5409300000000,54,093,"Tucker County, WV",Aug-22,3393,3254,139,4.10000000
CN5409500000000,54,095,"Tyler County, WV",Aug-22,3010,2797,213,7.10000000
CN5409700000000,54,097,"Upshur County, WV",Aug-22,9708,9203,505,5.20000000
CN5409900000000,54,099,"Wayne County, WV",Aug-22,15657,14951,706,4.50000000
CN5410100000000,54,101,"Webster County, WV",Aug-22,3150,2988,162,5.10000000
CN5410300000000,54,103,"Wetzel County, WV",Aug-22,6844,6421,423,6.20000000
CN5410500000000,54,105,"Wirt County, WV",Aug-22,2299,2153,146,6.40000000
CN5410700000000,54,107,"Wood County, WV",Aug-22,37570,35928,1642,4.40000000
CN5410900000000,54,109,"Wyoming County, WV",Aug-22,7507,7138,369,4.90000000
CN5500100000000,55,001,"Adams County, WI",Aug-22,7925,7518,407,5.10000000
CN5500300000000,55,003,"Ashland County, WI",Aug-22,7895,7562,333,4.20000000
CN5500500000000,55,005,"Barron County, WI",Aug-22,24030,23254,776,3.20000000
CN5500700000000,55,007,"Bayfield County, WI",Aug-22,7717,7346,371,4.80000000
CN5500900000000,55,009,"Brown County, WI",Aug-22,142806,138506,4300,3.00000000
CN5501100000000,55,011,"Buffalo County, WI",Aug-22,6013,5784,229,3.80000000
CN5501300000000,55,013,"Burnett County, WI",Aug-22,7367,7063,304,4.10000000
CN5501500000000,55,015,"Calumet County, WI",Aug-22,27754,27032,722,2.60000000
CN5501700000000,55,017,"Chippewa County, WI",Aug-22,33390,32315,1075,3.20000000
CN5501900000000,55,019,"Clark County, WI",Aug-22,17339,16883,456,2.60000000
CN5502100000000,55,021,"Columbia County, WI",Aug-22,31625,30732,893,2.80000000
CN5502300000000,55,023,"Crawford County, WI",Aug-22,7110,6881,229,3.20000000
CN5502500000000,55,025,"Dane County, WI",Aug-22,330166,322062,8104,2.50000000
CN5502700000000,55,027,"Dodge County, WI",Aug-22,48114,46787,1327,2.80000000
CN5502900000000,55,029,"Door County, WI",Aug-22,17109,16641,468,2.70000000
CN5503100000000,55,031,"Douglas County, WI",Aug-22,23371,22429,942,4.00000000
CN5503300000000,55,033,"Dunn County, WI",Aug-22,23154,22383,771,3.30000000
CN5503500000000,55,035,"Eau Claire County, WI",Aug-22,59889,58157,1732,2.90000000
CN5503700000000,55,037,"Florence County, WI",Aug-22,2172,2098,74,3.40000000
CN5503900000000,55,039,"Fond du Lac County, WI",Aug-22,57540,55817,1723,3.00000000
CN5504100000000,55,041,"Forest County, WI",Aug-22,3822,3631,191,5.00000000
CN5504300000000,55,043,"Grant County, WI",Aug-22,25767,25007,760,2.90000000
CN5504500000000,55,045,"Green County, WI",Aug-22,20570,20051,519,2.50000000
CN5504700000000,55,047,"Green Lake County, WI",Aug-22,9426,9100,326,3.50000000
CN5504900000000,55,049,"Iowa County, WI",Aug-22,13344,13009,335,2.50000000
CN5505100000000,55,051,"Iron County, WI",Aug-22,2493,2360,133,5.30000000
CN5505300000000,55,053,"Jackson County, WI",Aug-22,9374,9028,346,3.70000000
CN5505500000000,55,055,"Jefferson County, WI",Aug-22,46564,45213,1351,2.90000000
CN5505700000000,55,057,"Juneau County, WI",Aug-22,13252,12789,463,3.50000000
CN5505900000000,55,059,"Kenosha County, WI",Aug-22,93576,90104,3472,3.70000000
CN5506100000000,55,061,"Kewaunee County, WI",Aug-22,10700,10444,256,2.40000000
CN5506300000000,55,063,"La Crosse County, WI",Aug-22,65959,64214,1745,2.60000000
CN5506500000000,55,065,"Lafayette County, WI",Aug-22,9921,9669,252,2.50000000
CN5506700000000,55,067,"Langlade County, WI",Aug-22,9307,8927,380,4.10000000
CN5506900000000,55,069,"Lincoln County, WI",Aug-22,14859,14335,524,3.50000000
CN5507100000000,55,071,"Manitowoc County, WI",Aug-22,40429,39251,1178,2.90000000
CN5507300000000,55,073,"Marathon County, WI",Aug-22,74063,71954,2109,2.80000000
CN5507500000000,55,075,"Marinette County, WI",Aug-22,19183,18380,803,4.20000000
CN5507700000000,55,077,"Marquette County, WI",Aug-22,7676,7415,261,3.40000000
CN5507800000000,55,078,"Menominee County, WI",Aug-22,1553,1416,137,8.80000000
CN5507900000000,55,079,"Milwaukee County, WI",Aug-22,470939,448971,21968,4.70000000
CN5508100000000,55,081,"Monroe County, WI",Aug-22,23226,22572,654,2.80000000
CN5508300000000,55,083,"Oconto County, WI",Aug-22,20631,19956,675,3.30000000
CN5508500000000,55,085,"Oneida County, WI",Aug-22,18758,18187,571,3.00000000
CN5508700000000,55,087,"Outagamie County, WI",Aug-22,105698,102608,3090,2.90000000
CN5508900000000,55,089,"Ozaukee County, WI",Aug-22,49601,48196,1405,2.80000000
CN5509100000000,55,091,"Pepin County, WI",Aug-22,4054,3944,110,2.70000000
CN5509300000000,55,093,"Pierce County, WI",Aug-22,25400,24615,785,3.10000000
CN5509500000000,55,095,"Polk County, WI",Aug-22,24697,23917,780,3.20000000
CN5509700000000,55,097,"Portage County, WI",Aug-22,36883,35716,1167,3.20000000
CN5509900000000,55,099,"Price County, WI",Aug-22,6265,6042,223,3.60000000
CN5510100000000,55,101,"Racine County, WI",Aug-22,98994,94757,4237,4.30000000
CN5510300000000,55,103,"Richland County, WI",Aug-22,8896,8646,250,2.80000000
CN5510500000000,55,105,"Rock County, WI",Aug-22,86629,83152,3477,4.00000000
CN5510700000000,55,107,"Rusk County, WI",Aug-22,6405,6178,227,3.50000000
CN5510900000000,55,109,"St. Croix County, WI",Aug-22,51774,50288,1486,2.90000000
CN5511100000000,55,111,"Sauk County, WI",Aug-22,34979,33938,1041,3.00000000
CN5511300000000,55,113,"Sawyer County, WI",Aug-22,8399,8066,333,4.00000000
CN5511500000000,55,115,"Shawano County, WI",Aug-22,20441,19789,652,3.20000000
CN5511700000000,55,117,"Sheboygan County, WI",Aug-22,62573,60882,1691,2.70000000
CN5511900000000,55,119,"Taylor County, WI",Aug-22,10630,10340,290,2.70000000
CN5512100000000,55,121,"Trempealeau County, WI",Aug-22,14627,14204,423,2.90000000
CN5512300000000,55,123,"Vernon County, WI",Aug-22,14880,14484,396,2.70000000
CN5512500000000,55,125,"Vilas County, WI",Aug-22,11189,10798,391,3.50000000
CN5512700000000,55,127,"Walworth County, WI",Aug-22,57400,55518,1882,3.30000000
CN5512900000000,55,129,"Washburn County, WI",Aug-22,7937,7654,283,3.60000000
CN5513100000000,55,131,"Washington County, WI",Aug-22,77572,75472,2100,2.70000000
CN5513300000000,55,133,"Waukesha County, WI",Aug-22,227527,220936,6591,2.90000000
CN5513500000000,55,135,"Waupaca County, WI",Aug-22,25634,24795,839,3.30000000
CN5513700000000,55,137,"Waushara County, WI",Aug-22,11085,10707,378,3.40000000
CN5513900000000,55,139,"Winnebago County, WI",Aug-22,92620,89838,2782,3.00000000
CN5514100000000,55,141,"Wood County, WI",Aug-22,33922,32683,1239,3.70000000
CN5600100000000,56,001,"Albany County, WY",Aug-22,20514,19959,555,2.70000000
CN5600300000000,56,003,"Big Horn County, WY",Aug-22,5295,5114,181,3.40000000
CN5600500000000,56,005,"Campbell County, WY",Aug-22,21575,20854,721,3.30000000
CN5600700000000,56,007,"Carbon County, WY",Aug-22,7674,7436,238,3.10000000
CN5600900000000,56,009,"Converse County, WY",Aug-22,7443,7236,207,2.80000000
CN5601100000000,56,011,"Crook County, WY",Aug-22,4003,3862,141,3.50000000
CN5601300000000,56,013,"Fremont County, WY",Aug-22,18684,18015,669,3.60000000
CN5601500000000,56,015,"Goshen County, WY",Aug-22,6319,6163,156,2.50000000
CN5601700000000,56,017,"Hot Springs County, WY",Aug-22,2251,2192,59,2.60000000
CN5601900000000,56,019,"Johnson County, WY",Aug-22,4337,4215,122,2.80000000
CN5602100000000,56,021,"Laramie County, WY",Aug-22,49572,48072,1500,3.00000000
CN5602300000000,56,023,"Lincoln County, WY",Aug-22,9523,9270,253,2.70000000
CN5602500000000,56,025,"Natrona County, WY",Aug-22,38362,36883,1479,3.90000000
CN5602700000000,56,027,"Niobrara County, WY",Aug-22,1221,1190,31,2.50000000
CN5602900000000,56,029,"Park County, WY",Aug-22,16502,16052,450,2.70000000
CN5603100000000,56,031,"Platte County, WY",Aug-22,4326,4188,138,3.20000000
CN5603300000000,56,033,"Sheridan County, WY",Aug-22,16003,15553,450,2.80000000
CN5603500000000,56,035,"Sublette County, WY",Aug-22,3984,3849,135,3.40000000
CN5603700000000,56,037,"Sweetwater County, WY",Aug-22,18666,17948,718,3.80000000
CN5603900000000,56,039,"Teton County, WY",Aug-22,17900,17598,302,1.70000000
CN5604100000000,56,041,"Uinta County, WY",Aug-22,8628,8329,299,3.50000000
CN5604300000000,56,043,"Washakie County, WY",Aug-22,3811,3678,133,3.50000000
CN5604500000000,56,045,"Weston County, WY",Aug-22,3643,3562,81,2.20000000
CN7200100000000,72,001,"Adjuntas Municipio, PR",Aug-22 p,4331,3992,339,7.80000000
CN7200300000000,72,003,"Aguada Municipio, PR",Aug-22 p,12800,11931,869,6.80000000
CN7200500000000,72,005,"Aguadilla Municipio, PR",Aug-22 p,15523,14332,1191,7.70000000
CN7200700000000,72,007,"Aguas Buenas Municipio, PR",Aug-22 p,7037,6561,476,6.80000000
CN7200900000000,72,009,"Aibonito Municipio, PR",Aug-22 p,6855,6329,526,7.70000000
CN7201100000000,72,011,"Anasco Municipio, PR",Aug-22 p,9601,9031,570,5.90000000
CN7201300000000,72,013,"Arecibo Municipio, PR",Aug-22 p,25332,23643,1689,6.70000000
CN7201500000000,72,015,"Arroyo Municipio, PR",Aug-22 p,4939,4558,381,7.70000000
CN7201700000000,72,017,"Barceloneta Municipio, PR",Aug-22 p,6340,5817,523,8.20000000
CN7201900000000,72,019,"Barranquitas Municipio, PR",Aug-22 p,7833,7237,596,7.60000000
CN7202100000000,72,021,"Bayamon Municipio, PR",Aug-22 p,69447,65992,3455,5.00000000
CN7202300000000,72,023,"Cabo Rojo Municipio, PR",Aug-22 p,15040,14085,955,6.30000000
CN7202500000000,72,025,"Caguas Municipio, PR",Aug-22 p,51117,48622,2495,4.90000000
CN7202700000000,72,027,"Camuy Municipio, PR",Aug-22 p,10225,9543,682,6.70000000
CN7202900000000,72,029,"Canovanas Municipio, PR",Aug-22 p,17438,16616,822,4.70000000
CN7203100000000,72,031,"Carolina Municipio, PR",Aug-22 p,65636,62503,3133,4.80000000
CN7203300000000,72,033,"Catano Municipio, PR",Aug-22 p,8307,7863,444,5.30000000
CN7203500000000,72,035,"Cayey Municipio, PR",Aug-22 p,17312,16445,867,5.00000000
CN7203700000000,72,037,"Ceiba Municipio, PR",Aug-22 p,3816,3571,245,6.40000000
CN7203900000000,72,039,"Ciales Municipio, PR",Aug-22 p,3938,3559,379,9.60000000
CN7204100000000,72,041,"Cidra Municipio, PR",Aug-22 p,16506,15758,748,4.50000000
CN7204300000000,72,043,"Coamo Municipio, PR",Aug-22 p,10855,10030,825,7.60000000
CN7204500000000,72,045,"Comerio Municipio, PR",Aug-22 p,5256,4861,395,7.50000000
CN7204700000000,72,047,"Corozal Municipio, PR",Aug-22 p,9499,8754,745,7.80000000
CN7204900000000,72,049,"Culebra Municipio, PR",Aug-22 p,978,955,23,2.40000000
CN7205100000000,72,051,"Dorado Municipio, PR",Aug-22 p,14456,13849,607,4.20000000
CN7205300000000,72,053,"Fajardo Municipio, PR",Aug-22 p,11278,10519,759,6.70000000
CN7205400000000,72,054,"Florida Municipio, PR",Aug-22 p,3517,3218,299,8.50000000
CN7205500000000,72,055,"Guanica Municipio, PR",Aug-22 p,4127,3709,418,10.10000000
CN7205700000000,72,057,"Guayama Municipio, PR",Aug-22 p,11695,10896,799,6.80000000
CN7205900000000,72,059,"Guayanilla Municipio, PR",Aug-22 p,5201,4717,484,9.30000000
CN7206100000000,72,061,"Guaynabo Municipio, PR",Aug-22 p,40604,39422,1182,2.90000000
CN7206300000000,72,063,"Gurabo Municipio, PR",Aug-22 p,20177,19345,832,4.10000000
CN7206500000000,72,065,"Hatillo Municipio, PR",Aug-22 p,14346,13308,1038,7.20000000
CN7206700000000,72,067,"Hormigueros Municipio, PR",Aug-22 p,5858,5484,374,6.40000000
CN7206900000000,72,069,"Humacao Municipio, PR",Aug-22 p,18705,17555,1150,6.10000000
CN7207100000000,72,071,"Isabela Municipio, PR",Aug-22 p,12727,11886,841,6.60000000
CN7207300000000,72,073,"Jayuya Municipio, PR",Aug-22 p,4527,4134,393,8.70000000
CN7207500000000,72,075,"Juana Diaz Municipio, PR",Aug-22 p,16917,15777,1140,6.70000000
CN7207700000000,72,077,"Juncos Municipio, PR",Aug-22 p,13321,12494,827,6.20000000
CN7207900000000,72,079,"Lajas Municipio, PR",Aug-22 p,5650,5082,568,10.10000000
CN7208100000000,72,081,"Lares Municipio, PR",Aug-22 p,7724,6687,1037,13.40000000
CN7208300000000,72,083,"Las Marias Municipio, PR",Aug-22 p,2938,2506,432,14.70000000
CN7208500000000,72,085,"Las Piedras Municipio, PR",Aug-22 p,12293,11550,743,6.00000000
CN7208700000000,72,087,"Loiza Municipio, PR",Aug-22 p,8870,8361,509,5.70000000
CN7208900000000,72,089,"Luquillo Municipio, PR",Aug-22 p,6552,6146,406,6.20000000
CN7209100000000,72,091,"Manati Municipio, PR",Aug-22 p,12059,11307,752,6.20000000
CN7209300000000,72,093,"Maricao Municipio, PR",Aug-22 p,2016,1831,185,9.20000000
CN7209500000000,72,095,"Maunabo Municipio, PR",Aug-22 p,2976,2703,273,9.20000000
CN7209700000000,72,097,"Mayaguez Municipio, PR",Aug-22 p,23418,21747,1671,7.10000000
CN7209900000000,72,099,"Moca Municipio, PR",Aug-22 p,11317,10404,913,8.10000000
CN7210100000000,72,101,"Morovis Municipio, PR",Aug-22 p,8711,8040,671,7.70000000
CN7210300000000,72,103,"Naguabo Municipio, PR",Aug-22 p,8839,8302,537,6.10000000
CN7210500000000,72,105,"Naranjito Municipio, PR",Aug-22 p,7600,7042,558,7.30000000
CN7210700000000,72,107,"Orocovis Municipio, PR",Aug-22 p,5213,4748,465,8.90000000
CN7210900000000,72,109,"Patillas Municipio, PR",Aug-22 p,4422,4022,400,9.00000000
CN7211100000000,72,111,"Penuelas Municipio, PR",Aug-22 p,6148,5568,580,9.40000000
CN7211300000000,72,113,"Ponce Municipio, PR",Aug-22 p,48868,45359,3509,7.20000000
CN7211500000000,72,115,"Quebradillas Municipio, PR",Aug-22 p,6446,5929,517,8.00000000
CN7211700000000,72,117,"Rincon Municipio, PR",Aug-22 p,4919,4597,322,6.50000000
CN7211900000000,72,119,"Rio Grande Municipio, PR",Aug-22 p,18247,17193,1054,5.80000000
CN7212100000000,72,121,"Sabana Grande Municipio, PR",Aug-22 p,6413,5869,544,8.50000000
CN7212300000000,72,123,"Salinas Municipio, PR",Aug-22 p,7445,6761,684,9.20000000
CN7212500000000,72,125,"San German Municipio, PR",Aug-22 p,10380,9590,790,7.60000000
CN7212700000000,72,127,"San Juan Municipio, PR",Aug-22 p,142699,136664,6035,4.20000000
CN7212900000000,72,129,"San Lorenzo Municipio, PR",Aug-22 p,12409,11617,792,6.40000000
CN7213100000000,72,131,"San Sebastian Municipio, PR",Aug-22 p,10899,9782,1117,10.20000000
CN7213300000000,72,133,"Santa Isabel Municipio, PR",Aug-22 p,8255,7550,705,8.50000000
CN7213500000000,72,135,"Toa Alta Municipio, PR",Aug-22 p,29855,28547,1308,4.40000000
CN7213700000000,72,137,"Toa Baja Municipio, PR",Aug-22 p,31013,29618,1395,4.50000000
CN7213900000000,72,139,"Trujillo Alto Municipio, PR",Aug-22 p,29057,28001,1056,3.60000000
CN7214100000000,72,141,"Utuado Municipio, PR",Aug-22 p,7071,6492,579,8.20000000
CN7214300000000,72,143,"Vega Alta Municipio, PR",Aug-22 p,10581,9803,778,7.40000000
CN7214500000000,72,145,"Vega Baja Municipio, PR",Aug-22 p,14034,12952,1082,7.70000000
CN7214700000000,72,147,"Vieques Municipio, PR",Aug-22 p,2633,2437,196,7.40000000
CN7214900000000,72,149,"Villalba Municipio, PR",Aug-22 p,7755,6967,788,10.20000000
CN7215100000000,72,151,"Yabucoa Municipio, PR",Aug-22 p,9090,8377,713,7.80000000
CN7215300000000,72,153,"Yauco Municipio, PR",Aug-22 p,10276,9309,967,9.40000000
CN0100100000000,01,001,"Autauga County, AL",Sep-22,26894,26286,608,2.30000000
CN0100300000000,01,003,"Baldwin County, AL",Sep-22,99788,97406,2382,2.40000000
CN0100500000000,01,005,"Barbour County, AL",Sep-22,8560,8222,338,3.90000000
CN0100700000000,01,007,"Bibb County, AL",Sep-22,8812,8586,226,2.60000000
CN0100900000000,01,009,"Blount County, AL",Sep-22,26020,25467,553,2.10000000
CN0101100000000,01,011,"Bullock County, AL",Sep-22,4575,4452,123,2.70000000
CN0101300000000,01,013,"Butler County, AL",Sep-22,9010,8690,320,3.60000000
CN0101500000000,01,015,"Calhoun County, AL",Sep-22,46465,45071,1394,3.00000000
CN0101700000000,01,017,"Chambers County, AL",Sep-22,16015,15612,403,2.50000000
CN0101900000000,01,019,"Cherokee County, AL",Sep-22,11581,11312,269,2.30000000
CN0102100000000,01,021,"Chilton County, AL",Sep-22,20469,20033,436,2.10000000
CN0102300000000,01,023,"Choctaw County, AL",Sep-22,4459,4298,161,3.60000000
CN0102500000000,01,025,"Clarke County, AL",Sep-22,7894,7478,416,5.30000000
CN0102700000000,01,027,"Clay County, AL",Sep-22,6417,6270,147,2.30000000
CN0102900000000,01,029,"Cleburne County, AL",Sep-22,6303,6153,150,2.40000000
CN0103100000000,01,031,"Coffee County, AL",Sep-22,22042,21493,549,2.50000000
CN0103300000000,01,033,"Colbert County, AL",Sep-22,23794,23072,722,3.00000000
CN0103500000000,01,035,"Conecuh County, AL",Sep-22,4274,4124,150,3.50000000
CN0103700000000,01,037,"Coosa County, AL",Sep-22,4578,4460,118,2.60000000
CN0103900000000,01,039,"Covington County, AL",Sep-22,15602,15213,389,2.50000000
CN0104100000000,01,041,"Crenshaw County, AL",Sep-22,5993,5838,155,2.60000000
CN0104300000000,01,043,"Cullman County, AL",Sep-22,40804,40007,797,2.00000000
CN0104500000000,01,045,"Dale County, AL",Sep-22,21273,20738,535,2.50000000
CN0104700000000,01,047,"Dallas County, AL",Sep-22,13883,13003,880,6.30000000
CN0104900000000,01,049,"DeKalb County, AL",Sep-22,32030,31326,704,2.20000000
CN0105100000000,01,051,"Elmore County, AL",Sep-22,38363,37511,852,2.20000000
CN0105300000000,01,053,"Escambia County, AL",Sep-22,14538,14071,467,3.20000000
CN0105500000000,01,055,"Etowah County, AL",Sep-22,39535,38339,1196,3.00000000
CN0105700000000,01,057,"Fayette County, AL",Sep-22,6661,6484,177,2.70000000
CN0105900000000,01,059,"Franklin County, AL",Sep-22,14900,14580,320,2.10000000
CN0106100000000,01,061,"Geneva County, AL",Sep-22,11283,11007,276,2.40000000
CN0106300000000,01,063,"Greene County, AL",Sep-22,2844,2696,148,5.20000000
CN0106500000000,01,065,"Hale County, AL",Sep-22,6053,5791,262,4.30000000
CN0106700000000,01,067,"Henry County, AL",Sep-22,7012,6831,181,2.60000000
CN0106900000000,01,069,"Houston County, AL",Sep-22,47641,46438,1203,2.50000000
CN0107100000000,01,071,"Jackson County, AL",Sep-22,23536,22979,557,2.40000000
CN0107300000000,01,073,"Jefferson County, AL",Sep-22,325795,317373,8422,2.60000000
CN0107500000000,01,075,"Lamar County, AL",Sep-22,5843,5714,129,2.20000000
CN0107700000000,01,077,"Lauderdale County, AL",Sep-22,42748,41660,1088,2.50000000
CN0107900000000,01,079,"Lawrence County, AL",Sep-22,14612,14277,335,2.30000000
CN0108100000000,01,081,"Lee County, AL",Sep-22,79159,77352,1807,2.30000000
CN0108300000000,01,083,"Limestone County, AL",Sep-22,47703,46710,993,2.10000000
CN0108500000000,01,085,"Lowndes County, AL",Sep-22,3588,3352,236,6.60000000
CN0108700000000,01,087,"Macon County, AL",Sep-22,7989,7668,321,4.00000000
CN0108900000000,01,089,"Madison County, AL",Sep-22,196401,192167,4234,2.20000000
CN0109100000000,01,091,"Marengo County, AL",Sep-22,7924,7651,273,3.40000000
CN0109300000000,01,093,"Marion County, AL",Sep-22,13978,13652,326,2.30000000
CN0109500000000,01,095,"Marshall County, AL",Sep-22,45905,45002,903,2.00000000
CN0109700000000,01,097,"Mobile County, AL",Sep-22,190725,184187,6538,3.40000000
CN0109900000000,01,099,"Monroe County, AL",Sep-22,7588,7271,317,4.20000000
CN0110100000000,01,101,"Montgomery County, AL",Sep-22,107827,104265,3562,3.30000000
CN0110300000000,01,103,"Morgan County, AL",Sep-22,60257,59006,1251,2.10000000
CN0110500000000,01,105,"Perry County, AL",Sep-22,3237,3051,186,5.70000000
CN0110700000000,01,107,"Pickens County, AL",Sep-22,7703,7458,245,3.20000000
CN0110900000000,01,109,"Pike County, AL",Sep-22,16434,15985,449,2.70000000
CN0111100000000,01,111,"Randolph County, AL",Sep-22,9832,9596,236,2.40000000
CN0111300000000,01,113,"Russell County, AL",Sep-22,23918,23306,612,2.60000000
CN0111500000000,01,115,"St. Clair County, AL",Sep-22,42541,41613,928,2.20000000
CN0111700000000,01,117,"Shelby County, AL",Sep-22,122207,120032,2175,1.80000000
CN0111900000000,01,119,"Sumter County, AL",Sep-22,4689,4528,161,3.40000000
CN0112100000000,01,121,"Talladega County, AL",Sep-22,36484,35358,1126,3.10000000
CN0112300000000,01,123,"Tallapoosa County, AL",Sep-22,18322,17807,515,2.80000000
CN0112500000000,01,125,"Tuscaloosa County, AL",Sep-22,103176,100614,2562,2.50000000
CN0112700000000,01,127,"Walker County, AL",Sep-22,25743,25048,695,2.70000000
CN0112900000000,01,129,"Washington County, AL",Sep-22,6611,6385,226,3.40000000
CN0113100000000,01,131,"Wilcox County, AL",Sep-22,2652,2418,234,8.80000000
CN0113300000000,01,133,"Winston County, AL",Sep-22,10436,10194,242,2.30000000
CN0201300000000,02,013,"Aleutians East Borough, AK",Sep-22,2975,2934,41,1.40000000
CN0201600000000,02,016,"Aleutians West Census Area, AK",Sep-22,3544,3438,106,3.00000000
CN0202000000000,02,020,"Anchorage Borough/municipality, AK",Sep-22,151345,146953,4392,2.90000000
CN0205000000000,02,050,"Bethel Census Area, AK",Sep-22,6788,6175,613,9.00000000
CN0206000000000,02,060,"Bristol Bay Borough, AK",Sep-22,384,373,11,2.90000000
CN0206300000000,02,063,"Chugach Census Area, AK",Sep-22,3750,3648,102,2.70000000
CN0206600000000,02,066,"Copper River Census Area, AK",Sep-22,1524,1411,113,7.40000000
CN0206800000000,02,068,"Denali Borough, AK",Sep-22,1032,985,47,4.60000000
CN0207000000000,02,070,"Dillingham Census Area, AK",Sep-22,1807,1715,92,5.10000000
CN0209000000000,02,090,"Fairbanks North Star Borough, AK",Sep-22,45313,43999,1314,2.90000000
CN0210000000000,02,100,"Haines Borough, AK",Sep-22,1084,1028,56,5.20000000
CN0210500000000,02,105,"Hoonah-Angoon Census Area, AK",Sep-22,1355,1302,53,3.90000000
CN0211000000000,02,110,"Juneau Borough/city, AK",Sep-22,17173,16789,384,2.20000000
CN0212200000000,02,122,"Kenai Peninsula Borough, AK",Sep-22,28181,27059,1122,4.00000000
CN0213000000000,02,130,"Ketchikan Gateway Borough, AK",Sep-22,7025,6790,235,3.30000000
CN0215000000000,02,150,"Kodiak Island Borough, AK",Sep-22,6016,5824,192,3.20000000
CN0215800000000,02,158,"Kusilvak Census Area, AK",Sep-22,2324,2022,302,13.00000000
CN0216400000000,02,164,"Lake and Peninsula Borough, AK",Sep-22,749,714,35,4.70000000
CN0217000000000,02,170,"Matanuska-Susitna Borough, AK",Sep-22,49806,47845,1961,3.90000000
CN0218000000000,02,180,"Nome Census Area, AK",Sep-22,4188,3891,297,7.10000000
CN0218500000000,02,185,"North Slope Borough, AK",Sep-22,2822,2681,141,5.00000000
CN0218800000000,02,188,"Northwest Arctic Borough, AK",Sep-22,2871,2611,260,9.10000000
CN0219500000000,02,195,"Petersburg Borough, AK",Sep-22,1670,1602,68,4.10000000
CN0219800000000,02,198,"Prince of Wales-Hyder Census Area, AK",Sep-22,2834,2689,145,5.10000000
CN0222000000000,02,220,"Sitka Borough/city, AK",Sep-22,5121,5028,93,1.80000000
CN0223000000000,02,230,"Skagway Municipality, AK",Sep-22,685,651,34,5.00000000
CN0224000000000,02,240,"Southeast Fairbanks Census Area, AK",Sep-22,3229,3093,136,4.20000000
CN0227500000000,02,275,"Wrangell Borough/city, AK",Sep-22,946,910,36,3.80000000
CN0228200000000,02,282,"Yakutat Borough/city, AK",Sep-22,325,314,11,3.40000000
CN0229000000000,02,290,"Yukon-Koyukuk Census Area, AK",Sep-22,2380,2205,175,7.40000000
CN0400100000000,04,001,"Apache County, AZ",Sep-22,18825,17149,1676,8.90000000
CN0400300000000,04,003,"Cochise County, AZ",Sep-22,49783,47539,2244,4.50000000
CN0400500000000,04,005,"Coconino County, AZ",Sep-22,77689,74092,3597,4.60000000
CN0400700000000,04,007,"Gila County, AZ",Sep-22,20851,19942,909,4.40000000
CN0400900000000,04,009,"Graham County, AZ",Sep-22,16362,15779,583,3.60000000
CN0401100000000,04,011,"Greenlee County, AZ",Sep-22,4447,4307,140,3.10000000
CN0401200000000,04,012,"La Paz County, AZ",Sep-22,9235,8778,457,4.90000000
CN0401300000000,04,013,"Maricopa County, AZ",Sep-22,2387364,2303959,83405,3.50000000
CN0401500000000,04,015,"Mohave County, AZ",Sep-22,89995,85602,4393,4.90000000
CN0401700000000,04,017,"Navajo County, AZ",Sep-22,40797,38481,2316,5.70000000
CN0401900000000,04,019,"Pima County, AZ",Sep-22,490384,470475,19909,4.10000000
CN0402100000000,04,021,"Pinal County, AZ",Sep-22,200582,192412,8170,4.10000000
CN0402300000000,04,023,"Santa Cruz County, AZ",Sep-22,19603,17647,1956,10.00000000
CN0402500000000,04,025,"Yavapai County, AZ",Sep-22,110311,106391,3920,3.60000000
CN0402700000000,04,027,"Yuma County, AZ",Sep-22,105512,87492,18020,17.10000000
CN0500100000000,05,001,"Arkansas County, AR",Sep-22,9569,9264,305,3.20000000
CN0500300000000,05,003,"Ashley County, AR",Sep-22,6866,6401,465,6.80000000
CN0500500000000,05,005,"Baxter County, AR",Sep-22,16770,16119,651,3.90000000
CN0500700000000,05,007,"Benton County, AR",Sep-22,147699,143828,3871,2.60000000
CN0500900000000,05,009,"Boone County, AR",Sep-22,15823,15312,511,3.20000000
CN0501100000000,05,011,"Bradley County, AR",Sep-22,4122,3900,222,5.40000000
CN0501300000000,05,013,"Calhoun County, AR",Sep-22,2375,2297,78,3.30000000
CN0501500000000,05,015,"Carroll County, AR",Sep-22,12882,12495,387,3.00000000
CN0501700000000,05,017,"Chicot County, AR",Sep-22,2988,2767,221,7.40000000
CN0501900000000,05,019,"Clark County, AR",Sep-22,8718,8331,387,4.40000000
CN0502100000000,05,021,"Clay County, AR",Sep-22,5472,5256,216,3.90000000
CN0502300000000,05,023,"Cleburne County, AR",Sep-22,9108,8718,390,4.30000000
CN0502500000000,05,025,"Cleveland County, AR",Sep-22,3125,2999,126,4.00000000
CN0502700000000,05,027,"Columbia County, AR",Sep-22,8767,8359,408,4.70000000
CN0502900000000,05,029,"Conway County, AR",Sep-22,8428,8100,328,3.90000000
CN0503100000000,05,031,"Craighead County, AR",Sep-22,56253,54552,1701,3.00000000
CN0503300000000,05,033,"Crawford County, AR",Sep-22,26188,25300,888,3.40000000
CN0503500000000,05,035,"Crittenden County, AR",Sep-22,20884,19948,936,4.50000000
CN0503700000000,05,037,"Cross County, AR",Sep-22,6930,6660,270,3.90000000
CN0503900000000,05,039,"Dallas County, AR",Sep-22,2703,2589,114,4.20000000
CN0504100000000,05,041,"Desha County, AR",Sep-22,4971,4688,283,5.70000000
CN0504300000000,05,043,"Drew County, AR",Sep-22,7245,6888,357,4.90000000
CN0504500000000,05,045,"Faulkner County, AR",Sep-22,62127,60149,1978,3.20000000
CN0504700000000,05,047,"Franklin County, AR",Sep-22,7489,7223,266,3.60000000
CN0504900000000,05,049,"Fulton County, AR",Sep-22,5006,4823,183,3.70000000
CN0505100000000,05,051,"Garland County, AR",Sep-22,40645,38896,1749,4.30000000
CN0505300000000,05,053,"Grant County, AR",Sep-22,8331,8048,283,3.40000000
CN0505500000000,05,055,"Greene County, AR",Sep-22,19632,19001,631,3.20000000
CN0505700000000,05,057,"Hempstead County, AR",Sep-22,9382,9069,313,3.30000000
CN0505900000000,05,059,"Hot Spring County, AR",Sep-22,13649,13122,527,3.90000000
CN0506100000000,05,061,"Howard County, AR",Sep-22,5446,5257,189,3.50000000
CN0506300000000,05,063,"Independence County, AR",Sep-22,16609,16030,579,3.50000000
CN0506500000000,05,065,"Izard County, AR",Sep-22,4628,4393,235,5.10000000
CN0506700000000,05,067,"Jackson County, AR",Sep-22,5500,5213,287,5.20000000
CN0506900000000,05,069,"Jefferson County, AR",Sep-22,25938,24410,1528,5.90000000
CN0507100000000,05,071,"Johnson County, AR",Sep-22,10151,9719,432,4.30000000
CN0507300000000,05,073,"Lafayette County, AR",Sep-22,2305,2194,111,4.80000000
CN0507500000000,05,075,"Lawrence County, AR",Sep-22,6817,6549,268,3.90000000
CN0507700000000,05,077,"Lee County, AR",Sep-22,2578,2449,129,5.00000000
CN0507900000000,05,079,"Lincoln County, AR",Sep-22,3754,3581,173,4.60000000
CN0508100000000,05,081,"Little River County, AR",Sep-22,5317,5099,218,4.10000000
CN0508300000000,05,083,"Logan County, AR",Sep-22,8334,7992,342,4.10000000
CN0508500000000,05,085,"Lonoke County, AR",Sep-22,33758,32720,1038,3.10000000
CN0508700000000,05,087,"Madison County, AR",Sep-22,7662,7455,207,2.70000000
CN0508900000000,05,089,"Marion County, AR",Sep-22,6402,6147,255,4.00000000
CN0509100000000,05,091,"Miller County, AR",Sep-22,19187,18405,782,4.10000000
CN0509300000000,05,093,"Mississippi County, AR",Sep-22,16564,15587,977,5.90000000
CN0509500000000,05,095,"Monroe County, AR",Sep-22,2520,2405,115,4.60000000
CN0509700000000,05,097,"Montgomery County, AR",Sep-22,2971,2830,141,4.70000000
CN0509900000000,05,099,"Nevada County, AR",Sep-22,3450,3311,139,4.00000000
CN0510100000000,05,101,"Newton County, AR",Sep-22,3198,3099,99,3.10000000
CN0510300000000,05,103,"Ouachita County, AR",Sep-22,9635,9237,398,4.10000000
CN0510500000000,05,105,"Perry County, AR",Sep-22,4173,4015,158,3.80000000
CN0510700000000,05,107,"Phillips County, AR",Sep-22,5581,5149,432,7.70000000
CN0510900000000,05,109,"Pike County, AR",Sep-22,4178,4026,152,3.60000000
CN0511100000000,05,111,"Poinsett County, AR",Sep-22,9789,9440,349,3.60000000
CN0511300000000,05,113,"Polk County, AR",Sep-22,7810,7515,295,3.80000000
CN0511500000000,05,115,"Pope County, AR",Sep-22,27558,26454,1104,4.00000000
CN0511700000000,05,117,"Prairie County, AR",Sep-22,3570,3456,114,3.20000000
CN0511900000000,05,119,"Pulaski County, AR",Sep-22,186681,179397,7284,3.90000000
CN0512100000000,05,121,"Randolph County, AR",Sep-22,7166,6915,251,3.50000000
CN0512300000000,05,123,"St. Francis County, AR",Sep-22,7669,7238,431,5.60000000
CN0512500000000,05,125,"Saline County, AR",Sep-22,59022,57236,1786,3.00000000
CN0512700000000,05,127,"Scott County, AR",Sep-22,4144,4018,126,3.00000000
CN0512900000000,05,129,"Searcy County, AR",Sep-22,3075,2946,129,4.20000000
CN0513100000000,05,131,"Sebastian County, AR",Sep-22,55056,53203,1853,3.40000000
CN0513300000000,05,133,"Sevier County, AR",Sep-22,5464,5244,220,4.00000000
CN0513500000000,05,135,"Sharp County, AR",Sep-22,5902,5647,255,4.30000000
CN0513700000000,05,137,"Stone County, AR",Sep-22,4616,4418,198,4.30000000
CN0513900000000,05,139,"Union County, AR",Sep-22,14842,14040,802,5.40000000
CN0514100000000,05,141,"Van Buren County, AR",Sep-22,6032,5763,269,4.50000000
CN0514300000000,05,143,"Washington County, AR",Sep-22,130578,127241,3337,2.60000000
CN0514500000000,05,145,"White County, AR",Sep-22,34154,32905,1249,3.70000000
CN0514700000000,05,147,"Woodruff County, AR",Sep-22,2814,2710,104,3.70000000
CN0514900000000,05,149,"Yell County, AR",Sep-22,7935,7619,316,4.00000000
CN0600100000000,06,001,"Alameda County, CA",Sep-22,830759,806778,23981,2.90000000
CN0600300000000,06,003,"Alpine County, CA",Sep-22,456,434,22,4.80000000
CN0600500000000,06,005,"Amador County, CA",Sep-22,14563,14006,557,3.80000000
CN0600700000000,06,007,"Butte County, CA",Sep-22,93146,89638,3508,3.80000000
CN0600900000000,06,009,"Calaveras County, CA",Sep-22,22208,21548,660,3.00000000
CN0601100000000,06,011,"Colusa County, CA",Sep-22,11479,10689,790,6.90000000
CN0601300000000,06,013,"Contra Costa County, CA",Sep-22,555001,537872,17129,3.10000000
CN0601500000000,06,015,"Del Norte County, CA",Sep-22,9593,9177,416,4.30000000
CN0601700000000,06,017,"El Dorado County, CA",Sep-22,93002,90439,2563,2.80000000
CN0601900000000,06,019,"Fresno County, CA",Sep-22,454462,429599,24863,5.50000000
CN0602100000000,06,021,"Glenn County, CA",Sep-22,12741,12166,575,4.50000000
CN0602300000000,06,023,"Humboldt County, CA",Sep-22,61164,59194,1970,3.20000000
CN0602500000000,06,025,"Imperial County, CA",Sep-22,70527,59116,11411,16.20000000
CN0602700000000,06,027,"Inyo County, CA",Sep-22,8388,8154,234,2.80000000
CN0602900000000,06,029,"Kern County, CA",Sep-22,392062,367833,24229,6.20000000
CN0603100000000,06,031,"Kings County, CA",Sep-22,56341,53088,3253,5.80000000
CN0603300000000,06,033,"Lake County, CA",Sep-22,29103,27864,1239,4.30000000
CN0603500000000,06,035,"Lassen County, CA",Sep-22,9229,8927,302,3.30000000
CN0603700000000,06,037,"Los Angeles County, CA",Sep-22,4958064,4744505,213559,4.30000000
CN0603900000000,06,039,"Madera County, CA",Sep-22,63094,59826,3268,5.20000000
CN0604100000000,06,041,"Marin County, CA",Sep-22,130071,127241,2830,2.20000000
CN0604300000000,06,043,"Mariposa County, CA",Sep-22,7471,7197,274,3.70000000
CN0604500000000,06,045,"Mendocino County, CA",Sep-22,38197,36992,1205,3.20000000
CN0604700000000,06,047,"Merced County, CA",Sep-22,118877,111687,7190,6.00000000
CN0604900000000,06,049,"Modoc County, CA",Sep-22,3268,3148,120,3.70000000
CN0605100000000,06,051,"Mono County, CA",Sep-22,8755,8458,297,3.40000000
CN0605300000000,06,053,"Monterey County, CA",Sep-22,219546,210660,8886,4.00000000
CN0605500000000,06,055,"Napa County, CA",Sep-22,70680,68816,1864,2.60000000
CN0605700000000,06,057,"Nevada County, CA",Sep-22,48585,47253,1332,2.70000000
CN0605900000000,06,059,"Orange County, CA",Sep-22,1603817,1559905,43912,2.70000000
CN0606100000000,06,061,"Placer County, CA",Sep-22,193161,188269,4892,2.50000000
CN0606300000000,06,063,"Plumas County, CA",Sep-22,7827,7477,350,4.50000000
CN0606500000000,06,065,"Riverside County, CA",Sep-22,1166571,1120111,46460,4.00000000
CN0606700000000,06,067,"Sacramento County, CA",Sep-22,726112,700221,25891,3.60000000
CN0606900000000,06,069,"San Benito County, CA",Sep-22,33104,31797,1307,3.90000000
CN0607100000000,06,071,"San Bernardino County, CA",Sep-22,1020265,981060,39205,3.80000000
CN0607300000000,06,073,"San Diego County, CA",Sep-22,1584222,1535439,48783,3.10000000
CN0607500000000,06,075,"San Francisco County/city, CA",Sep-22,577253,564972,12281,2.10000000
CN0607700000000,06,077,"San Joaquin County, CA",Sep-22,338517,322022,16495,4.90000000
CN0607900000000,06,079,"San Luis Obispo County, CA",Sep-22,137436,134050,3386,2.50000000
CN0608100000000,06,081,"San Mateo County, CA",Sep-22,456801,447851,8950,2.00000000
CN0608300000000,06,083,"Santa Barbara County, CA",Sep-22,226559,220483,6076,2.70000000
CN0608500000000,06,085,"Santa Clara County, CA",Sep-22,1058516,1036013,22503,2.10000000
CN0608700000000,06,087,"Santa Cruz County, CA",Sep-22,137339,132606,4733,3.40000000
CN0608900000000,06,089,"Shasta County, CA",Sep-22,73993,71194,2799,3.80000000
CN0609100000000,06,091,"Sierra County, CA",Sep-22,1417,1381,36,2.50000000
CN0609300000000,06,093,"Siskiyou County, CA",Sep-22,16761,16022,739,4.40000000
CN0609500000000,06,095,"Solano County, CA",Sep-22,201649,193922,7727,3.80000000
CN0609700000000,06,097,"Sonoma County, CA",Sep-22,250800,244400,6400,2.60000000
CN0609900000000,06,099,"Stanislaus County, CA",Sep-22,241570,230028,11542,4.80000000
CN0610100000000,06,101,"Sutter County, CA",Sep-22,45909,43474,2435,5.30000000
CN0610300000000,06,103,"Tehama County, CA",Sep-22,26305,25237,1068,4.10000000
CN0610500000000,06,105,"Trinity County, CA",Sep-22,4610,4453,157,3.40000000
CN0610700000000,06,107,"Tulare County, CA",Sep-22,205462,189983,15479,7.50000000
CN0610900000000,06,109,"Tuolumne County, CA",Sep-22,19949,19193,756,3.80000000
CN0611100000000,06,111,"Ventura County, CA",Sep-22,414007,400399,13608,3.30000000
CN0611300000000,06,113,"Yolo County, CA",Sep-22,108957,105576,3381,3.10000000
CN0611500000000,06,115,"Yuba County, CA",Sep-22,31048,29517,1531,4.90000000
CN0800100000000,08,001,"Adams County, CO",Sep-22,285695,275017,10678,3.70000000
CN0800300000000,08,003,"Alamosa County, CO",Sep-22,8650,8339,311,3.60000000
CN0800500000000,08,005,"Arapahoe County, CO",Sep-22,380616,367755,12861,3.40000000
CN0800700000000,08,007,"Archuleta County, CO",Sep-22,7390,7180,210,2.80000000
CN0800900000000,08,009,"Baca County, CO",Sep-22,2092,2058,34,1.60000000
CN0801100000000,08,011,"Bent County, CO",Sep-22,1903,1830,73,3.80000000
CN0801300000000,08,013,"Boulder County, CO",Sep-22,206151,201039,5112,2.50000000
CN0801400000000,08,014,"Broomfield County/city, CO",Sep-22,42922,41751,1171,2.70000000
CN0801500000000,08,015,"Chaffee County, CO",Sep-22,10747,10481,266,2.50000000
CN0801700000000,08,017,"Cheyenne County, CO",Sep-22,1088,1070,18,1.70000000
CN0801900000000,08,019,"Clear Creek County, CO",Sep-22,6252,6048,204,3.30000000
CN0802100000000,08,021,"Conejos County, CO",Sep-22,4153,4020,133,3.20000000
CN0802300000000,08,023,"Costilla County, CO",Sep-22,1906,1831,75,3.90000000
CN0802500000000,08,025,"Crowley County, CO",Sep-22,1438,1381,57,4.00000000
CN0802700000000,08,027,"Custer County, CO",Sep-22,2548,2482,66,2.60000000
CN0802900000000,08,029,"Delta County, CO",Sep-22,14057,13587,470,3.30000000
CN0803100000000,08,031,"Denver County/city, CO",Sep-22,442831,427413,15418,3.50000000
CN0803300000000,08,033,"Dolores County, CO",Sep-22,1170,1138,32,2.70000000
CN0803500000000,08,035,"Douglas County, CO",Sep-22,209950,204610,5340,2.50000000
CN0803700000000,08,037,"Eagle County, CO",Sep-22,37664,36796,868,2.30000000
CN0803900000000,08,039,"Elbert County, CO",Sep-22,16151,15748,403,2.50000000
CN0804100000000,08,041,"El Paso County, CO",Sep-22,362137,349361,12776,3.50000000
CN0804300000000,08,043,"Fremont County, CO",Sep-22,15868,15110,758,4.80000000
CN0804500000000,08,045,"Garfield County, CO",Sep-22,32610,31709,901,2.80000000
CN0804700000000,08,047,"Gilpin County, CO",Sep-22,3995,3874,121,3.00000000
CN0804900000000,08,049,"Grand County, CO",Sep-22,10001,9754,247,2.50000000
CN0805100000000,08,051,"Gunnison County, CO",Sep-22,12099,11858,241,2.00000000
CN0805300000000,08,053,"Hinsdale County, CO",Sep-22,542,531,11,2.00000000
CN0805500000000,08,055,"Huerfano County, CO",Sep-22,2647,2469,178,6.70000000
CN0805700000000,08,057,"Jackson County, CO",Sep-22,991,973,18,1.80000000
CN0805900000000,08,059,"Jefferson County, CO",Sep-22,347422,337337,10085,2.90000000
CN0806100000000,08,061,"Kiowa County, CO",Sep-22,889,874,15,1.70000000
CN0806300000000,08,063,"Kit Carson County, CO",Sep-22,4009,3934,75,1.90000000
CN0806500000000,08,065,"Lake County, CO",Sep-22,5120,4989,131,2.60000000
CN0806700000000,08,067,"La Plata County, CO",Sep-22,32432,31527,905,2.80000000
CN0806900000000,08,069,"Larimer County, CO",Sep-22,215582,209795,5787,2.70000000
CN0807100000000,08,071,"Las Animas County, CO",Sep-22,6493,6187,306,4.70000000
CN0807300000000,08,073,"Lincoln County, CO",Sep-22,2280,2215,65,2.90000000
CN0807500000000,08,075,"Logan County, CO",Sep-22,10595,10317,278,2.60000000
CN0807700000000,08,077,"Mesa County, CO",Sep-22,79509,76789,2720,3.40000000
CN0807900000000,08,079,"Mineral County, CO",Sep-22,412,399,13,3.20000000
CN0808100000000,08,081,"Moffat County, CO",Sep-22,7051,6853,198,2.80000000
CN0808300000000,08,083,"Montezuma County, CO",Sep-22,13723,13270,453,3.30000000
CN0808500000000,08,085,"Montrose County, CO",Sep-22,23037,22343,694,3.00000000
CN0808700000000,08,087,"Morgan County, CO",Sep-22,15826,15306,520,3.30000000
CN0808900000000,08,089,"Otero County, CO",Sep-22,8198,7837,361,4.40000000
CN0809100000000,08,091,"Ouray County, CO",Sep-22,3076,3007,69,2.20000000
CN0809300000000,08,093,"Park County, CO",Sep-22,11829,11516,313,2.60000000
CN0809500000000,08,095,"Phillips County, CO",Sep-22,2434,2387,47,1.90000000
CN0809700000000,08,097,"Pitkin County, CO",Sep-22,11220,10887,333,3.00000000
CN0809900000000,08,099,"Prowers County, CO",Sep-22,6310,6148,162,2.60000000
CN0810100000000,08,101,"Pueblo County, CO",Sep-22,79496,75469,4027,5.10000000
CN0810300000000,08,103,"Rio Blanco County, CO",Sep-22,2896,2792,104,3.60000000
CN0810500000000,08,105,"Rio Grande County, CO",Sep-22,5442,5221,221,4.10000000
CN0810700000000,08,107,"Routt County, CO",Sep-22,15923,15543,380,2.40000000
CN0810900000000,08,109,"Saguache County, CO",Sep-22,3464,3351,113,3.30000000
CN0811100000000,08,111,"San Juan County, CO",Sep-22,793,782,11,1.40000000
CN0811300000000,08,113,"San Miguel County, CO",Sep-22,6612,6479,133,2.00000000
CN0811500000000,08,115,"Sedgwick County, CO",Sep-22,1184,1160,24,2.00000000
CN0811700000000,08,117,"Summit County, CO",Sep-22,22241,21748,493,2.20000000
CN0811900000000,08,119,"Teller County, CO",Sep-22,13574,13168,406,3.00000000
CN0812100000000,08,121,"Washington County, CO",Sep-22,2702,2639,63,2.30000000
CN0812300000000,08,123,"Weld County, CO",Sep-22,169846,164039,5807,3.40000000
CN0812500000000,08,125,"Yuma County, CO",Sep-22,5562,5454,108,1.90000000
CN0900100000000,09,001,"Fairfield County, CT",Sep-22,479005,460447,18558,3.90000000
CN0900300000000,09,003,"Hartford County, CT",Sep-22,477494,458369,19125,4.00000000
CN0900500000000,09,005,"Litchfield County, CT",Sep-22,104387,100919,3468,3.30000000
CN0900700000000,09,007,"Middlesex County, CT",Sep-22,93432,90434,2998,3.20000000
CN0900900000000,09,009,"New Haven County, CT",Sep-22,465959,446659,19300,4.10000000
CN0901100000000,09,011,"New London County, CT",Sep-22,132338,126830,5508,4.20000000
CN0901300000000,09,013,"Tolland County, CT",Sep-22,85958,83205,2753,3.20000000
CN0901500000000,09,015,"Windham County, CT",Sep-22,63148,60744,2404,3.80000000
CN1000100000000,10,001,"Kent County, DE",Sep-22,80304,76765,3539,4.40000000
CN1000300000000,10,003,"New Castle County, DE",Sep-22,302893,291746,11147,3.70000000
CN1000500000000,10,005,"Sussex County, DE",Sep-22,112670,108711,3959,3.50000000
CN1100100000000,11,001,District of Columbia,Sep-22,388623,372724,15899,4.10000000
CN1200100000000,12,001,"Alachua County, FL",Sep-22,146304,142776,3528,2.40000000
CN1200300000000,12,003,"Baker County, FL",Sep-22,12885,12568,317,2.50000000
CN1200500000000,12,005,"Bay County, FL",Sep-22,90589,88537,2052,2.30000000
CN1200700000000,12,007,"Bradford County, FL",Sep-22,11339,11025,314,2.80000000
CN1200900000000,12,009,"Brevard County, FL",Sep-22,303624,296019,7605,2.50000000
CN1201100000000,12,011,"Broward County, FL",Sep-22,1083770,1055916,27854,2.60000000
CN1201300000000,12,013,"Calhoun County, FL",Sep-22,5094,4948,146,2.90000000
CN1201500000000,12,015,"Charlotte County, FL",Sep-22,76669,74382,2287,3.00000000
CN1201700000000,12,017,"Citrus County, FL",Sep-22,47712,45793,1919,4.00000000
CN1201900000000,12,019,"Clay County, FL",Sep-22,115093,112447,2646,2.30000000
CN1202100000000,12,021,"Collier County, FL",Sep-22,188545,183656,4889,2.60000000
CN1202300000000,12,023,"Columbia County, FL",Sep-22,30017,29179,838,2.80000000
CN1202700000000,12,027,"DeSoto County, FL",Sep-22,15590,15178,412,2.60000000
CN1202900000000,12,029,"Dixie County, FL",Sep-22,6246,6075,171,2.70000000
CN1203100000000,12,031,"Duval County, FL",Sep-22,522381,508538,13843,2.60000000
CN1203300000000,12,033,"Escambia County, FL",Sep-22,153172,149124,4048,2.60000000
CN1203500000000,12,035,"Flagler County, FL",Sep-22,51092,49562,1530,3.00000000
CN1203700000000,12,037,"Franklin County, FL",Sep-22,4875,4760,115,2.40000000
CN1203900000000,12,039,"Gadsden County, FL",Sep-22,21038,20381,657,3.10000000
CN1204100000000,12,041,"Gilchrist County, FL",Sep-22,7600,7399,201,2.60000000
CN1204300000000,12,043,"Glades County, FL",Sep-22,5218,5068,150,2.90000000
CN1204500000000,12,045,"Gulf County, FL",Sep-22,5579,5451,128,2.30000000
CN1204700000000,12,047,"Hamilton County, FL",Sep-22,4250,4097,153,3.60000000
CN1204900000000,12,049,"Hardee County, FL",Sep-22,9072,8759,313,3.50000000
CN1205100000000,12,051,"Hendry County, FL",Sep-22,16134,15361,773,4.80000000
CN1205300000000,12,053,"Hernando County, FL",Sep-22,77776,75254,2522,3.20000000
CN1205500000000,12,055,"Highlands County, FL",Sep-22,34365,32943,1422,4.10000000
CN1205700000000,12,057,"Hillsborough County, FL",Sep-22,813945,793876,20069,2.50000000
CN1205900000000,12,059,"Holmes County, FL",Sep-22,7223,7034,189,2.60000000
CN1206100000000,12,061,"Indian River County, FL",Sep-22,67899,65774,2125,3.10000000
CN1206300000000,12,063,"Jackson County, FL",Sep-22,17436,16943,493,2.80000000
CN1206500000000,12,065,"Jefferson County, FL",Sep-22,5913,5751,162,2.70000000
CN1206700000000,12,067,"Lafayette County, FL",Sep-22,2853,2779,74,2.60000000
CN1206900000000,12,069,"Lake County, FL",Sep-22,171278,166605,4673,2.70000000
CN1207100000000,12,071,"Lee County, FL",Sep-22,373546,363873,9673,2.60000000
CN1207300000000,12,073,"Leon County, FL",Sep-22,162804,158620,4184,2.60000000
CN1207500000000,12,075,"Levy County, FL",Sep-22,17544,17038,506,2.90000000
CN1207700000000,12,077,"Liberty County, FL",Sep-22,2687,2610,77,2.90000000
CN1207900000000,12,079,"Madison County, FL",Sep-22,8155,7920,235,2.90000000
CN1208100000000,12,081,"Manatee County, FL",Sep-22,191850,186933,4917,2.60000000
CN1208300000000,12,083,"Marion County, FL",Sep-22,145820,141126,4694,3.20000000
CN1208500000000,12,085,"Martin County, FL",Sep-22,77478,75595,1883,2.40000000
CN1208600000000,12,086,"Miami-Dade County, FL",Sep-22,1368450,1332910,35540,2.60000000
CN1208700000000,12,087,"Monroe County, FL",Sep-22,50598,49775,823,1.60000000
CN1208900000000,12,089,"Nassau County, FL",Sep-22,45595,44563,1032,2.30000000
CN1209100000000,12,091,"Okaloosa County, FL",Sep-22,103577,101341,2236,2.20000000
CN1209300000000,12,093,"Okeechobee County, FL",Sep-22,17736,17245,491,2.80000000
CN1209500000000,12,095,"Orange County, FL",Sep-22,791783,770900,20883,2.60000000
CN1209700000000,12,097,"Osceola County, FL",Sep-22,197327,191061,6266,3.20000000
CN1209900000000,12,099,"Palm Beach County, FL",Sep-22,773530,753105,20425,2.60000000
CN1210100000000,12,101,"Pasco County, FL",Sep-22,261488,254284,7204,2.80000000
CN1210300000000,12,103,"Pinellas County, FL",Sep-22,516468,504154,12314,2.40000000
CN1210500000000,12,105,"Polk County, FL",Sep-22,343058,332181,10877,3.20000000
CN1210700000000,12,107,"Putnam County, FL",Sep-22,27975,26970,1005,3.60000000
CN1210900000000,12,109,"St. Johns County, FL",Sep-22,151650,148531,3119,2.10000000
CN1211100000000,12,111,"St. Lucie County, FL",Sep-22,157710,152871,4839,3.10000000
CN1211300000000,12,113,"Santa Rosa County, FL",Sep-22,89813,87726,2087,2.30000000
CN1211500000000,12,115,"Sarasota County, FL",Sep-22,201168,196145,5023,2.50000000
CN1211700000000,12,117,"Seminole County, FL",Sep-22,263488,257122,6366,2.40000000
CN1211900000000,12,119,"Sumter County, FL",Sep-22,36431,34999,1432,3.90000000
CN1212100000000,12,121,"Suwannee County, FL",Sep-22,17820,17302,518,2.90000000
CN1212300000000,12,123,"Taylor County, FL",Sep-22,8017,7780,237,3.00000000
CN1212500000000,12,125,"Union County, FL",Sep-22,4826,4693,133,2.80000000
CN1212700000000,12,127,"Volusia County, FL",Sep-22,269284,261769,7515,2.80000000
CN1212900000000,12,129,"Wakulla County, FL",Sep-22,16451,16077,374,2.30000000
CN1213100000000,12,131,"Walton County, FL",Sep-22,35162,34352,810,2.30000000
CN1213300000000,12,133,"Washington County, FL",Sep-22,9932,9658,274,2.80000000
CN1300100000000,13,001,"Appling County, GA",Sep-22,8900,8605,295,3.30000000
CN1300300000000,13,003,"Atkinson County, GA",Sep-22,4528,4431,97,2.10000000
CN1300500000000,13,005,"Bacon County, GA",Sep-22,4689,4569,120,2.60000000
CN1300700000000,13,007,"Baker County, GA",Sep-22,1119,1080,39,3.50000000
CN1300900000000,13,009,"Baldwin County, GA",Sep-22,17735,17114,621,3.50000000
CN1301100000000,13,011,"Banks County, GA",Sep-22,10186,9993,193,1.90000000
CN1301300000000,13,013,"Barrow County, GA",Sep-22,43329,42424,905,2.10000000
CN1301500000000,13,015,"Bartow County, GA",Sep-22,52549,51311,1238,2.40000000
CN1301700000000,13,017,"Ben Hill County, GA",Sep-22,5477,5267,210,3.80000000
CN1301900000000,13,019,"Berrien County, GA",Sep-22,7579,7383,196,2.60000000
CN1302100000000,13,021,"Bibb County, GA",Sep-22,67274,65093,2181,3.20000000
CN1302300000000,13,023,"Bleckley County, GA",Sep-22,4582,4412,170,3.70000000
CN1302500000000,13,025,"Brantley County, GA",Sep-22,7412,7195,217,2.90000000
CN1302700000000,13,027,"Brooks County, GA",Sep-22,6721,6543,178,2.60000000
CN1302900000000,13,029,"Bryan County, GA",Sep-22,20248,19812,436,2.20000000
CN1303100000000,13,031,"Bulloch County, GA",Sep-22,37374,36328,1046,2.80000000
CN1303300000000,13,033,"Burke County, GA",Sep-22,9015,8588,427,4.70000000
CN1303500000000,13,035,"Butts County, GA",Sep-22,11393,11127,266,2.30000000
CN1303700000000,13,037,"Calhoun County, GA",Sep-22,2201,2143,58,2.60000000
CN1303900000000,13,039,"Camden County, GA",Sep-22,21714,21164,550,2.50000000
CN1304300000000,13,043,"Candler County, GA",Sep-22,6099,5977,122,2.00000000
CN1304500000000,13,045,"Carroll County, GA",Sep-22,57568,56132,1436,2.50000000
CN1304700000000,13,047,"Catoosa County, GA",Sep-22,33421,32700,721,2.20000000
CN1304900000000,13,049,"Charlton County, GA",Sep-22,4962,4824,138,2.80000000
CN1305100000000,13,051,"Chatham County, GA",Sep-22,144906,141120,3786,2.60000000
CN1305300000000,13,053,"Chattahoochee County, GA",Sep-22,1911,1834,77,4.00000000
CN1305500000000,13,055,"Chattooga County, GA",Sep-22,9226,8881,345,3.70000000
CN1305700000000,13,057,"Cherokee County, GA",Sep-22,143834,141001,2833,2.00000000
CN1305900000000,13,059,"Clarke County, GA",Sep-22,61147,59601,1546,2.50000000
CN1306100000000,13,061,"Clay County, GA",Sep-22,852,792,60,7.00000000
CN1306300000000,13,063,"Clayton County, GA",Sep-22,141546,136059,5487,3.90000000
CN1306500000000,13,065,"Clinch County, GA",Sep-22,2972,2907,65,2.20000000
CN1306700000000,13,067,"Cobb County, GA",Sep-22,434700,425065,9635,2.20000000
CN1306900000000,13,069,"Coffee County, GA",Sep-22,18155,17594,561,3.10000000
CN1307100000000,13,071,"Colquitt County, GA",Sep-22,21824,21298,526,2.40000000
CN1307300000000,13,073,"Columbia County, GA",Sep-22,76173,74331,1842,2.40000000
CN1307500000000,13,075,"Cook County, GA",Sep-22,8192,7980,212,2.60000000
CN1307700000000,13,077,"Coweta County, GA",Sep-22,78186,76448,1738,2.20000000
CN1307900000000,13,079,"Crawford County, GA",Sep-22,5505,5366,139,2.50000000
CN1308100000000,13,081,"Crisp County, GA",Sep-22,9294,8849,445,4.80000000
CN1308300000000,13,083,"Dade County, GA",Sep-22,8095,7922,173,2.10000000
CN1308500000000,13,085,"Dawson County, GA",Sep-22,13531,13260,271,2.00000000
CN1308700000000,13,087,"Decatur County, GA",Sep-22,11204,10858,346,3.10000000
CN1308900000000,13,089,"DeKalb County, GA",Sep-22,408183,396771,11412,2.80000000
CN1309100000000,13,091,"Dodge County, GA",Sep-22,7005,6796,209,3.00000000
CN1309300000000,13,093,"Dooly County, GA",Sep-22,4641,4459,182,3.90000000
CN1309500000000,13,095,"Dougherty County, GA",Sep-22,36862,35359,1503,4.10000000
CN1309700000000,13,097,"Douglas County, GA",Sep-22,75642,73485,2157,2.90000000
CN1309900000000,13,099,"Early County, GA",Sep-22,4200,4050,150,3.60000000
CN1310100000000,13,101,"Echols County, GA",Sep-22,1866,1830,36,1.90000000
CN1310300000000,13,103,"Effingham County, GA",Sep-22,33797,33086,711,2.10000000
CN1310500000000,13,105,"Elbert County, GA",Sep-22,7617,7372,245,3.20000000
CN1310700000000,13,107,"Emanuel County, GA",Sep-22,8570,8250,320,3.70000000
CN1310900000000,13,109,"Evans County, GA",Sep-22,5210,5086,124,2.40000000
CN1311100000000,13,111,"Fannin County, GA",Sep-22,11961,11694,267,2.20000000
CN1311300000000,13,113,"Fayette County, GA",Sep-22,59913,58620,1293,2.20000000
CN1311500000000,13,115,"Floyd County, GA",Sep-22,43769,42667,1102,2.50000000
CN1311700000000,13,117,"Forsyth County, GA",Sep-22,131090,128592,2498,1.90000000
CN1311900000000,13,119,"Franklin County, GA",Sep-22,10095,9835,260,2.60000000
CN1312100000000,13,121,"Fulton County, GA",Sep-22,579775,563370,16405,2.80000000
CN1312300000000,13,123,"Gilmer County, GA",Sep-22,12369,12055,314,2.50000000
CN1312500000000,13,125,"Glascock County, GA",Sep-22,1257,1224,33,2.60000000
CN1312700000000,13,127,"Glynn County, GA",Sep-22,39505,38542,963,2.40000000
CN1312900000000,13,129,"Gordon County, GA",Sep-22,29082,28431,651,2.20000000
CN1313100000000,13,131,"Grady County, GA",Sep-22,11044,10771,273,2.50000000
CN1313300000000,13,133,"Greene County, GA",Sep-22,7237,7035,202,2.80000000
CN1313500000000,13,135,"Gwinnett County, GA",Sep-22,504895,493359,11536,2.30000000
CN1313700000000,13,137,"Habersham County, GA",Sep-22,18566,18087,479,2.60000000
CN1313900000000,13,139,"Hall County, GA",Sep-22,106072,103937,2135,2.00000000
CN1314100000000,13,141,"Hancock County, GA",Sep-22,2507,2390,117,4.70000000
CN1314300000000,13,143,"Haralson County, GA",Sep-22,13100,12781,319,2.40000000
CN1314500000000,13,145,"Harris County, GA",Sep-22,16902,16519,383,2.30000000
CN1314700000000,13,147,"Hart County, GA",Sep-22,11701,11387,314,2.70000000
CN1314900000000,13,149,"Heard County, GA",Sep-22,5356,5224,132,2.50000000
CN1315100000000,13,151,"Henry County, GA",Sep-22,121189,117938,3251,2.70000000
CN1315300000000,13,153,"Houston County, GA",Sep-22,70918,69030,1888,2.70000000
CN1315500000000,13,155,"Irwin County, GA",Sep-22,3526,3408,118,3.30000000
CN1315700000000,13,157,"Jackson County, GA",Sep-22,44476,43688,788,1.80000000
CN1315900000000,13,159,"Jasper County, GA",Sep-22,7241,7092,149,2.10000000
CN1316100000000,13,161,"Jeff Davis County, GA",Sep-22,6123,5934,189,3.10000000
CN1316300000000,13,163,"Jefferson County, GA",Sep-22,6968,6738,230,3.30000000
CN1316500000000,13,165,"Jenkins County, GA",Sep-22,3147,3029,118,3.70000000
CN1316700000000,13,167,"Johnson County, GA",Sep-22,4007,3908,99,2.50000000
CN1316900000000,13,169,"Jones County, GA",Sep-22,13687,13354,333,2.40000000
CN1317100000000,13,171,"Lamar County, GA",Sep-22,8432,8214,218,2.60000000
CN1317300000000,13,173,"Lanier County, GA",Sep-22,3791,3688,103,2.70000000
CN1317500000000,13,175,"Laurens County, GA",Sep-22,19172,18530,642,3.30000000
CN1317700000000,13,177,"Lee County, GA",Sep-22,15156,14814,342,2.30000000
CN1317900000000,13,179,"Liberty County, GA",Sep-22,25949,25195,754,2.90000000
CN1318100000000,13,181,"Lincoln County, GA",Sep-22,3519,3406,113,3.20000000
CN1318300000000,13,183,"Long County, GA",Sep-22,8399,8185,214,2.50000000
CN1318500000000,13,185,"Lowndes County, GA",Sep-22,50666,49294,1372,2.70000000
CN1318700000000,13,187,"Lumpkin County, GA",Sep-22,17695,17336,359,2.00000000
CN1318900000000,13,189,"McDuffie County, GA",Sep-22,8415,8085,330,3.90000000
CN1319100000000,13,191,"McIntosh County, GA",Sep-22,6177,6016,161,2.60000000
CN1319300000000,13,193,"Macon County, GA",Sep-22,4517,4349,168,3.70000000
CN1319500000000,13,195,"Madison County, GA",Sep-22,14137,13810,327,2.30000000
CN1319700000000,13,197,"Marion County, GA",Sep-22,3266,3166,100,3.10000000
CN1319900000000,13,199,"Meriwether County, GA",Sep-22,9052,8746,306,3.40000000
CN1320100000000,13,201,"Miller County, GA",Sep-22,2714,2651,63,2.30000000
CN1320500000000,13,205,"Mitchell County, GA",Sep-22,7971,7689,282,3.50000000
CN1320700000000,13,207,"Monroe County, GA",Sep-22,13162,12850,312,2.40000000
CN1320900000000,13,209,"Montgomery County, GA",Sep-22,3727,3603,124,3.30000000
CN1321100000000,13,211,"Morgan County, GA",Sep-22,9768,9554,214,2.20000000
CN1321300000000,13,213,"Murray County, GA",Sep-22,15306,14805,501,3.30000000
CN1321500000000,13,215,"Muscogee County, GA",Sep-22,75936,73079,2857,3.80000000
CN1321700000000,13,217,"Newton County, GA",Sep-22,54587,52988,1599,2.90000000
CN1321900000000,13,219,"Oconee County, GA",Sep-22,21151,20784,367,1.70000000
CN1322100000000,13,221,"Oglethorpe County, GA",Sep-22,7291,7127,164,2.20000000
CN1322300000000,13,223,"Paulding County, GA",Sep-22,91968,89931,2037,2.20000000
CN1322500000000,13,225,"Peach County, GA",Sep-22,11895,11494,401,3.40000000
CN1322700000000,13,227,"Pickens County, GA",Sep-22,16012,15675,337,2.10000000
CN1322900000000,13,229,"Pierce County, GA",Sep-22,8516,8313,203,2.40000000
CN1323100000000,13,231,"Pike County, GA",Sep-22,9278,9061,217,2.30000000
CN1323300000000,13,233,"Polk County, GA",Sep-22,18456,17977,479,2.60000000
CN1323500000000,13,235,"Pulaski County, GA",Sep-22,4015,3902,113,2.80000000
CN1323700000000,13,237,"Putnam County, GA",Sep-22,8752,8499,253,2.90000000
CN1323900000000,13,239,"Quitman County, GA",Sep-22,760,724,36,4.70000000
CN1324100000000,13,241,"Rabun County, GA",Sep-22,7690,7508,182,2.40000000
CN1324300000000,13,243,"Randolph County, GA",Sep-22,2343,2253,90,3.80000000
CN1324500000000,13,245,"Richmond County, GA",Sep-22,82922,79657,3265,3.90000000
CN1324700000000,13,247,"Rockdale County, GA",Sep-22,45542,44155,1387,3.00000000
CN1324900000000,13,249,"Schley County, GA",Sep-22,2106,2042,64,3.00000000
CN1325100000000,13,251,"Screven County, GA",Sep-22,4959,4770,189,3.80000000
CN1325300000000,13,253,"Seminole County, GA",Sep-22,2967,2870,97,3.30000000
CN1325500000000,13,255,"Spalding County, GA",Sep-22,29519,28672,847,2.90000000
CN1325700000000,13,257,"Stephens County, GA",Sep-22,10408,10105,303,2.90000000
CN1325900000000,13,259,"Stewart County, GA",Sep-22,2566,2474,92,3.60000000
CN1326100000000,13,261,"Sumter County, GA",Sep-22,11992,11534,458,3.80000000
CN1326300000000,13,263,"Talbot County, GA",Sep-22,2796,2708,88,3.10000000
CN1326500000000,13,265,"Taliaferro County, GA",Sep-22,533,512,21,3.90000000
CN1326700000000,13,267,"Tattnall County, GA",Sep-22,9712,9474,238,2.50000000
CN1326900000000,13,269,"Taylor County, GA",Sep-22,2845,2735,110,3.90000000
CN1327100000000,13,271,"Telfair County, GA",Sep-22,3560,3358,202,5.70000000
CN1327300000000,13,273,"Terrell County, GA",Sep-22,3525,3371,154,4.40000000
CN1327500000000,13,275,"Thomas County, GA",Sep-22,17436,16935,501,2.90000000
CN1327700000000,13,277,"Tift County, GA",Sep-22,21466,20972,494,2.30000000
CN1327900000000,13,279,"Toombs County, GA",Sep-22,11746,11351,395,3.40000000
CN1328100000000,13,281,"Towns County, GA",Sep-22,4270,4134,136,3.20000000
CN1328300000000,13,283,"Treutlen County, GA",Sep-22,2555,2462,93,3.60000000
CN1328500000000,13,285,"Troup County, GA",Sep-22,37392,36475,917,2.50000000
CN1328700000000,13,287,"Turner County, GA",Sep-22,3208,3087,121,3.80000000
CN1328900000000,13,289,"Twiggs County, GA",Sep-22,2795,2678,117,4.20000000
CN1329100000000,13,291,"Union County, GA",Sep-22,11223,10971,252,2.20000000
CN1329300000000,13,293,"Upson County, GA",Sep-22,11754,11420,334,2.80000000
CN1329500000000,13,295,"Walker County, GA",Sep-22,31244,30456,788,2.50000000
CN1329700000000,13,297,"Walton County, GA",Sep-22,48291,47162,1129,2.30000000
CN1329900000000,13,299,"Ware County, GA",Sep-22,15136,14748,388,2.60000000
CN1330100000000,13,301,"Warren County, GA",Sep-22,2633,2543,90,3.40000000
CN1330300000000,13,303,"Washington County, GA",Sep-22,6537,6299,238,3.60000000
CN1330500000000,13,305,"Wayne County, GA",Sep-22,11632,11326,306,2.60000000
CN1330700000000,13,307,"Webster County, GA",Sep-22,968,940,28,2.90000000
CN1330900000000,13,309,"Wheeler County, GA",Sep-22,1613,1538,75,4.60000000
CN1331100000000,13,311,"White County, GA",Sep-22,16922,16585,337,2.00000000
CN1331300000000,13,313,"Whitfield County, GA",Sep-22,42917,41645,1272,3.00000000
CN1331500000000,13,315,"Wilcox County, GA",Sep-22,2700,2604,96,3.60000000
CN1331700000000,13,317,"Wilkes County, GA",Sep-22,3649,3517,132,3.60000000
CN1331900000000,13,319,"Wilkinson County, GA",Sep-22,3637,3527,110,3.00000000
CN1332100000000,13,321,"Worth County, GA",Sep-22,8815,8588,227,2.60000000
CN1500100000000,15,001,"Hawaii County, HI",Sep-22,93837,90526,3311,3.50000000
CN1500300000000,15,003,"Honolulu County/city, HI",Sep-22,456938,442071,14867,3.30000000
CN1500700000000,15,007,"Kauai County, HI",Sep-22,36838,35383,1455,3.90000000
CN1500900000000,15,009,"Maui County, HI",Sep-22,87633,84377,3256,3.70000000
CN1600100000000,16,001,"Ada County, ID",Sep-22,278266,271625,6641,2.40000000
CN1600300000000,16,003,"Adams County, ID",Sep-22,1871,1790,81,4.30000000
CN1600500000000,16,005,"Bannock County, ID",Sep-22,45022,43817,1205,2.70000000
CN1600700000000,16,007,"Bear Lake County, ID",Sep-22,3480,3401,79,2.30000000
CN1600900000000,16,009,"Benewah County, ID",Sep-22,4210,4070,140,3.30000000
CN1601100000000,16,011,"Bingham County, ID",Sep-22,26570,25934,636,2.40000000
CN1601300000000,16,013,"Blaine County, ID",Sep-22,13348,13041,307,2.30000000
CN1601500000000,16,015,"Boise County, ID",Sep-22,3841,3706,135,3.50000000
CN1601700000000,16,017,"Bonner County, ID",Sep-22,22519,21815,704,3.10000000
CN1601900000000,16,019,"Bonneville County, ID",Sep-22,63091,61668,1423,2.30000000
CN1602100000000,16,021,"Boundary County, ID",Sep-22,5864,5683,181,3.10000000
CN1602300000000,16,023,"Butte County, ID",Sep-22,1525,1477,48,3.10000000
CN1602500000000,16,025,"Camas County, ID",Sep-22,761,746,15,2.00000000
CN1602700000000,16,027,"Canyon County, ID",Sep-22,115784,112462,3322,2.90000000
CN1602900000000,16,029,"Caribou County, ID",Sep-22,4231,4132,99,2.30000000
CN1603100000000,16,031,"Cassia County, ID",Sep-22,13555,13267,288,2.10000000
CN1603300000000,16,033,"Clark County, ID",Sep-22,406,394,12,3.00000000
CN1603500000000,16,035,"Clearwater County, ID",Sep-22,3140,3000,140,4.50000000
CN1603700000000,16,037,"Custer County, ID",Sep-22,2472,2410,62,2.50000000
CN1603900000000,16,039,"Elmore County, ID",Sep-22,12699,12355,344,2.70000000
CN1604100000000,16,041,"Franklin County, ID",Sep-22,7817,7666,151,1.90000000
CN1604300000000,16,043,"Fremont County, ID",Sep-22,8717,8539,178,2.00000000
CN1604500000000,16,045,"Gem County, ID",Sep-22,9099,8867,232,2.50000000
CN1604700000000,16,047,"Gooding County, ID",Sep-22,8701,8487,214,2.50000000
CN1604900000000,16,049,"Idaho County, ID",Sep-22,7076,6846,230,3.30000000
CN1605100000000,16,051,"Jefferson County, ID",Sep-22,15352,15031,321,2.10000000
CN1605300000000,16,053,"Jerome County, ID",Sep-22,13114,12789,325,2.50000000
CN1605500000000,16,055,"Kootenai County, ID",Sep-22,85583,83066,2517,2.90000000
CN1605700000000,16,057,"Latah County, ID",Sep-22,21156,20681,475,2.20000000
CN1605900000000,16,059,"Lemhi County, ID",Sep-22,4011,3893,118,2.90000000
CN1606100000000,16,061,"Lewis County, ID",Sep-22,1722,1668,54,3.10000000
CN1606300000000,16,063,"Lincoln County, ID",Sep-22,2899,2814,85,2.90000000
CN1606500000000,16,065,"Madison County, ID",Sep-22,25069,24651,418,1.70000000
CN1606700000000,16,067,"Minidoka County, ID",Sep-22,12882,12601,281,2.20000000
CN1606900000000,16,069,"Nez Perce County, ID",Sep-22,21498,20970,528,2.50000000
CN1607100000000,16,071,"Oneida County, ID",Sep-22,2795,2733,62,2.20000000
CN1607300000000,16,073,"Owyhee County, ID",Sep-22,5936,5767,169,2.80000000
CN1607500000000,16,075,"Payette County, ID",Sep-22,12587,12232,355,2.80000000
CN1607700000000,16,077,"Power County, ID",Sep-22,4730,4618,112,2.40000000
CN1607900000000,16,079,"Shoshone County, ID",Sep-22,5512,5280,232,4.20000000
CN1608100000000,16,081,"Teton County, ID",Sep-22,8155,8022,133,1.60000000
CN1608300000000,16,083,"Twin Falls County, ID",Sep-22,44483,43355,1128,2.50000000
CN1608500000000,16,085,"Valley County, ID",Sep-22,6115,5923,192,3.10000000
CN1608700000000,16,087,"Washington County, ID",Sep-22,5050,4900,150,3.00000000
CN1700100000000,17,001,"Adams County, IL",Sep-22,30252,29329,923,3.10000000
CN1700300000000,17,003,"Alexander County, IL",Sep-22,1815,1690,125,6.90000000
CN1700500000000,17,005,"Bond County, IL",Sep-22,7507,7254,253,3.40000000
CN1700700000000,17,007,"Boone County, IL",Sep-22,25127,23716,1411,5.60000000
CN1700900000000,17,009,"Brown County, IL",Sep-22,3183,3125,58,1.80000000
CN1701100000000,17,011,"Bureau County, IL",Sep-22,16282,15663,619,3.80000000
CN1701300000000,17,013,"Calhoun County, IL",Sep-22,2181,2105,76,3.50000000
CN1701500000000,17,015,"Carroll County, IL",Sep-22,7739,7482,257,3.30000000
CN1701700000000,17,017,"Cass County, IL",Sep-22,5631,5419,212,3.80000000
CN1701900000000,17,019,"Champaign County, IL",Sep-22,109942,105978,3964,3.60000000
CN1702100000000,17,021,"Christian County, IL",Sep-22,13261,12681,580,4.40000000
CN1702300000000,17,023,"Clark County, IL",Sep-22,7254,6986,268,3.70000000
CN1702500000000,17,025,"Clay County, IL",Sep-22,5809,5579,230,4.00000000
CN1702700000000,17,027,"Clinton County, IL",Sep-22,19964,19444,520,2.60000000
CN1702900000000,17,029,"Coles County, IL",Sep-22,22993,22043,950,4.10000000
CN1703100000000,17,031,"Cook County, IL",Sep-22,2636926,2501242,135684,5.10000000
CN1703300000000,17,033,"Crawford County, IL",Sep-22,8565,8252,313,3.70000000
CN1703500000000,17,035,"Cumberland County, IL",Sep-22,6045,5859,186,3.10000000
CN1703700000000,17,037,"DeKalb County, IL",Sep-22,54215,52056,2159,4.00000000
CN1703900000000,17,039,"De Witt County, IL",Sep-22,7346,7080,266,3.60000000
CN1704100000000,17,041,"Douglas County, IL",Sep-22,10152,9853,299,2.90000000
CN1704300000000,17,043,"DuPage County, IL",Sep-22,511587,494942,16645,3.30000000
CN1704500000000,17,045,"Edgar County, IL",Sep-22,8829,8548,281,3.20000000
CN1704700000000,17,047,"Edwards County, IL",Sep-22,2471,2367,104,4.20000000
CN1704900000000,17,049,"Effingham County, IL",Sep-22,19469,18957,512,2.60000000
CN1705100000000,17,051,"Fayette County, IL",Sep-22,9777,9421,356,3.60000000
CN1705300000000,17,053,"Ford County, IL",Sep-22,6388,6166,222,3.50000000
CN1705500000000,17,055,"Franklin County, IL",Sep-22,15746,14935,811,5.20000000
CN1705700000000,17,057,"Fulton County, IL",Sep-22,14382,13759,623,4.30000000
CN1705900000000,17,059,"Gallatin County, IL",Sep-22,2014,1912,102,5.10000000
CN1706100000000,17,061,"Greene County, IL",Sep-22,5951,5739,212,3.60000000
CN1706300000000,17,063,"Grundy County, IL",Sep-22,25790,24731,1059,4.10000000
CN1706500000000,17,065,"Hamilton County, IL",Sep-22,4273,4150,123,2.90000000
CN1706700000000,17,067,"Hancock County, IL",Sep-22,8236,7949,287,3.50000000
CN1706900000000,17,069,"Hardin County, IL",Sep-22,1334,1264,70,5.20000000
CN1707100000000,17,071,"Henderson County, IL",Sep-22,3587,3473,114,3.20000000
CN1707300000000,17,073,"Henry County, IL",Sep-22,24475,23604,871,3.60000000
CN1707500000000,17,075,"Iroquois County, IL",Sep-22,12908,12447,461,3.60000000
CN1707700000000,17,077,"Jackson County, IL",Sep-22,27483,26400,1083,3.90000000
CN1707900000000,17,079,"Jasper County, IL",Sep-22,4858,4702,156,3.20000000
CN1708100000000,17,081,"Jefferson County, IL",Sep-22,16204,15458,746,4.60000000
CN1708300000000,17,083,"Jersey County, IL",Sep-22,10581,10250,331,3.10000000
CN1708500000000,17,085,"Jo Daviess County, IL",Sep-22,10675,10360,315,3.00000000
CN1708700000000,17,087,"Johnson County, IL",Sep-22,4167,3957,210,5.00000000
CN1708900000000,17,089,"Kane County, IL",Sep-22,265075,254278,10797,4.10000000
CN1709100000000,17,091,"Kankakee County, IL",Sep-22,52721,50014,2707,5.10000000
CN1709300000000,17,093,"Kendall County, IL",Sep-22,71425,68922,2503,3.50000000
CN1709500000000,17,095,"Knox County, IL",Sep-22,20271,19265,1006,5.00000000
CN1709700000000,17,097,"Lake County, IL",Sep-22,370962,357410,13552,3.70000000
CN1709900000000,17,099,"LaSalle County, IL",Sep-22,52326,49956,2370,4.50000000
CN1710100000000,17,101,"Lawrence County, IL",Sep-22,5475,5214,261,4.80000000
CN1710300000000,17,103,"Lee County, IL",Sep-22,16627,16051,576,3.50000000
CN1710500000000,17,105,"Livingston County, IL",Sep-22,15575,15023,552,3.50000000
CN1710700000000,17,107,"Logan County, IL",Sep-22,11742,11296,446,3.80000000
CN1710900000000,17,109,"McDonough County, IL",Sep-22,13186,12699,487,3.70000000
CN1711100000000,17,111,"McHenry County, IL",Sep-22,166962,161315,5647,3.40000000
CN1711300000000,17,113,"McLean County, IL",Sep-22,88348,85404,2944,3.30000000
CN1711500000000,17,115,"Macon County, IL",Sep-22,46753,44082,2671,5.70000000
CN1711700000000,17,117,"Macoupin County, IL",Sep-22,22142,21398,744,3.40000000
CN1711900000000,17,119,"Madison County, IL",Sep-22,131007,126293,4714,3.60000000
CN1712100000000,17,121,"Marion County, IL",Sep-22,16460,15720,740,4.50000000
CN1712300000000,17,123,"Marshall County, IL",Sep-22,5145,4935,210,4.10000000
CN1712500000000,17,125,"Mason County, IL",Sep-22,5881,5632,249,4.20000000
CN1712700000000,17,127,"Massac County, IL",Sep-22,5333,5084,249,4.70000000
CN1712900000000,17,129,"Menard County, IL",Sep-22,6285,6097,188,3.00000000
CN1713100000000,17,131,"Mercer County, IL",Sep-22,7804,7560,244,3.10000000
CN1713300000000,17,133,"Monroe County, IL",Sep-22,18687,18178,509,2.70000000
CN1713500000000,17,135,"Montgomery County, IL",Sep-22,11269,10778,491,4.40000000
CN1713700000000,17,137,"Morgan County, IL",Sep-22,15859,15291,568,3.60000000
CN1713900000000,17,139,"Moultrie County, IL",Sep-22,7439,7224,215,2.90000000
CN1714100000000,17,141,"Ogle County, IL",Sep-22,23676,22664,1012,4.30000000
CN1714300000000,17,143,"Peoria County, IL",Sep-22,82586,78246,4340,5.30000000
CN1714500000000,17,145,"Perry County, IL",Sep-22,8001,7641,360,4.50000000
CN1714700000000,17,147,"Piatt County, IL",Sep-22,8675,8422,253,2.90000000
CN1714900000000,17,149,"Pike County, IL",Sep-22,6849,6605,244,3.60000000
CN1715100000000,17,151,"Pope County, IL",Sep-22,1705,1629,76,4.50000000
CN1715300000000,17,153,"Pulaski County, IL",Sep-22,1720,1599,121,7.00000000
CN1715500000000,17,155,"Putnam County, IL",Sep-22,2916,2796,120,4.10000000
CN1715700000000,17,157,"Randolph County, IL",Sep-22,13724,13273,451,3.30000000
CN1715900000000,17,159,"Richland County, IL",Sep-22,7141,6887,254,3.60000000
CN1716100000000,17,161,"Rock Island County, IL",Sep-22,69505,66772,2733,3.90000000
CN1716300000000,17,163,"St. Clair County, IL",Sep-22,123342,117898,5444,4.40000000
CN1716500000000,17,165,"Saline County, IL",Sep-22,9133,8669,464,5.10000000
CN1716700000000,17,167,"Sangamon County, IL",Sep-22,99170,95307,3863,3.90000000
CN1716900000000,17,169,"Schuyler County, IL",Sep-22,3292,3189,103,3.10000000
CN1717100000000,17,171,"Scott County, IL",Sep-22,2346,2266,80,3.40000000
CN1717300000000,17,173,"Shelby County, IL",Sep-22,10335,9984,351,3.40000000
CN1717500000000,17,175,"Stark County, IL",Sep-22,2401,2308,93,3.90000000
CN1717700000000,17,177,"Stephenson County, IL",Sep-22,20768,19900,868,4.20000000
CN1717900000000,17,179,"Tazewell County, IL",Sep-22,61803,59539,2264,3.70000000
CN1718100000000,17,181,"Union County, IL",Sep-22,7295,6986,309,4.20000000
CN1718300000000,17,183,"Vermilion County, IL",Sep-22,31692,30114,1578,5.00000000
CN1718500000000,17,185,"Wabash County, IL",Sep-22,5607,5433,174,3.10000000
CN1718700000000,17,187,"Warren County, IL",Sep-22,7477,7213,264,3.50000000
CN1718900000000,17,189,"Washington County, IL",Sep-22,9842,9631,211,2.10000000
CN1719100000000,17,191,"Wayne County, IL",Sep-22,7005,6760,245,3.50000000
CN1719300000000,17,193,"White County, IL",Sep-22,6052,5816,236,3.90000000
CN1719500000000,17,195,"Whiteside County, IL",Sep-22,27520,26523,997,3.60000000
CN1719700000000,17,197,"Will County, IL",Sep-22,362768,347539,15229,4.20000000
CN1719900000000,17,199,"Williamson County, IL",Sep-22,31397,30155,1242,4.00000000
CN1720100000000,17,201,"Winnebago County, IL",Sep-22,134655,126561,8094,6.00000000
CN1720300000000,17,203,"Woodford County, IL",Sep-22,18225,17683,542,3.00000000
CN1800100000000,18,001,"Adams County, IN",Sep-22,17188,16922,266,1.50000000
CN1800300000000,18,003,"Allen County, IN",Sep-22,186652,182719,3933,2.10000000
CN1800500000000,18,005,"Bartholomew County, IN",Sep-22,43180,42407,773,1.80000000
CN1800700000000,18,007,"Benton County, IN",Sep-22,4357,4278,79,1.80000000
CN1800900000000,18,009,"Blackford County, IN",Sep-22,4842,4728,114,2.40000000
CN1801100000000,18,011,"Boone County, IN",Sep-22,38193,37608,585,1.50000000
CN1801300000000,18,013,"Brown County, IN",Sep-22,7929,7753,176,2.20000000
CN1801500000000,18,015,"Carroll County, IN",Sep-22,9902,9698,204,2.10000000
CN1801700000000,18,017,"Cass County, IN",Sep-22,17176,16760,416,2.40000000
CN1801900000000,18,019,"Clark County, IN",Sep-22,63171,61892,1279,2.00000000
CN1802100000000,18,021,"Clay County, IN",Sep-22,11608,11312,296,2.50000000
CN1802300000000,18,023,"Clinton County, IN",Sep-22,16955,16647,308,1.80000000
CN1802500000000,18,025,"Crawford County, IN",Sep-22,4830,4721,109,2.30000000
CN1802700000000,18,027,"Daviess County, IN",Sep-22,16395,16138,257,1.60000000
CN1802900000000,18,029,"Dearborn County, IN",Sep-22,25281,24792,489,1.90000000
CN1803100000000,18,031,"Decatur County, IN",Sep-22,14201,13941,260,1.80000000
CN1803300000000,18,033,"DeKalb County, IN",Sep-22,22196,21776,420,1.90000000
CN1803500000000,18,035,"Delaware County, IN",Sep-22,53298,52043,1255,2.40000000
CN1803700000000,18,037,"Dubois County, IN",Sep-22,21468,21100,368,1.70000000
CN1803900000000,18,039,"Elkhart County, IN",Sep-22,118389,116013,2376,2.00000000
CN1804100000000,18,041,"Fayette County, IN",Sep-22,8166,7894,272,3.30000000
CN1804300000000,18,043,"Floyd County, IN",Sep-22,42549,41768,781,1.80000000
CN1804500000000,18,045,"Fountain County, IN",Sep-22,7981,7826,155,1.90000000
CN1804700000000,18,047,"Franklin County, IN",Sep-22,11291,11084,207,1.80000000
CN1804900000000,18,049,"Fulton County, IN",Sep-22,9422,9209,213,2.30000000
CN1805100000000,18,051,"Gibson County, IN",Sep-22,19794,19469,325,1.60000000
CN1805300000000,18,053,"Grant County, IN",Sep-22,30458,29737,721,2.40000000
CN1805500000000,18,055,"Greene County, IN",Sep-22,13617,13279,338,2.50000000
CN1805700000000,18,057,"Hamilton County, IN",Sep-22,194105,190998,3107,1.60000000
CN1805900000000,18,059,"Hancock County, IN",Sep-22,42498,41719,779,1.80000000
CN1806100000000,18,061,"Harrison County, IN",Sep-22,20658,20274,384,1.90000000
CN1806300000000,18,063,"Hendricks County, IN",Sep-22,94297,92615,1682,1.80000000
CN1806500000000,18,065,"Henry County, IN",Sep-22,21966,21462,504,2.30000000
CN1806700000000,18,067,"Howard County, IN",Sep-22,33541,32182,1359,4.10000000
CN1806900000000,18,069,"Huntington County, IN",Sep-22,18369,17990,379,2.10000000
CN1807100000000,18,071,"Jackson County, IN",Sep-22,23182,22736,446,1.90000000
CN1807300000000,18,073,"Jasper County, IN",Sep-22,15594,15238,356,2.30000000
CN1807500000000,18,075,"Jay County, IN",Sep-22,8857,8673,184,2.10000000
CN1807700000000,18,077,"Jefferson County, IN",Sep-22,15019,14705,314,2.10000000
CN1807900000000,18,079,"Jennings County, IN",Sep-22,13314,13029,285,2.10000000
CN1808100000000,18,081,"Johnson County, IN",Sep-22,86259,84746,1513,1.80000000
CN1808300000000,18,083,"Knox County, IN",Sep-22,17736,17378,358,2.00000000
CN1808500000000,18,085,"Kosciusko County, IN",Sep-22,40173,39384,789,2.00000000
CN1808700000000,18,087,"LaGrange County, IN",Sep-22,21109,20714,395,1.90000000
CN1808900000000,18,089,"Lake County, IN",Sep-22,223534,215262,8272,3.70000000
CN1809100000000,18,091,"LaPorte County, IN",Sep-22,46046,44719,1327,2.90000000
CN1809300000000,18,093,"Lawrence County, IN",Sep-22,20977,20476,501,2.40000000
CN1809500000000,18,095,"Madison County, IN",Sep-22,59699,58242,1457,2.40000000
CN1809700000000,18,097,"Marion County, IN",Sep-22,503758,491480,12278,2.40000000
CN1809900000000,18,099,"Marshall County, IN",Sep-22,23190,22732,458,2.00000000
CN1810100000000,18,101,"Martin County, IN",Sep-22,5430,5322,108,2.00000000
CN1810300000000,18,103,"Miami County, IN",Sep-22,14022,13630,392,2.80000000
CN1810500000000,18,105,"Monroe County, IN",Sep-22,73148,71767,1381,1.90000000
CN1810700000000,18,107,"Montgomery County, IN",Sep-22,18680,18337,343,1.80000000
CN1810900000000,18,109,"Morgan County, IN",Sep-22,37240,36526,714,1.90000000
CN1811100000000,18,111,"Newton County, IN",Sep-22,6682,6511,171,2.60000000
CN1811300000000,18,113,"Noble County, IN",Sep-22,21719,21243,476,2.20000000
CN1811500000000,18,115,"Ohio County, IN",Sep-22,3137,3080,57,1.80000000
CN1811700000000,18,117,"Orange County, IN",Sep-22,8209,8004,205,2.50000000
CN1811900000000,18,119,"Owen County, IN",Sep-22,9694,9464,230,2.40000000
CN1812100000000,18,121,"Parke County, IN",Sep-22,7138,6983,155,2.20000000
CN1812300000000,18,123,"Perry County, IN",Sep-22,8718,8501,217,2.50000000
CN1812500000000,18,125,"Pike County, IN",Sep-22,5792,5682,110,1.90000000
CN1812700000000,18,127,"Porter County, IN",Sep-22,84383,82328,2055,2.40000000
CN1812900000000,18,129,"Posey County, IN",Sep-22,13045,12819,226,1.70000000
CN1813100000000,18,131,"Pulaski County, IN",Sep-22,6572,6448,124,1.90000000
CN1813300000000,18,133,"Putnam County, IN",Sep-22,16815,16449,366,2.20000000
CN1813500000000,18,135,"Randolph County, IN",Sep-22,11694,11449,245,2.10000000
CN1813700000000,18,137,"Ripley County, IN",Sep-22,12558,12284,274,2.20000000
CN1813900000000,18,139,"Rush County, IN",Sep-22,8884,8726,158,1.80000000
CN1814100000000,18,141,"St. Joseph County, IN",Sep-22,133671,130281,3390,2.50000000
CN1814300000000,18,143,"Scott County, IN",Sep-22,10581,10335,246,2.30000000
CN1814500000000,18,145,"Shelby County, IN",Sep-22,23607,23151,456,1.90000000
CN1814700000000,18,147,"Spencer County, IN",Sep-22,10528,10335,193,1.80000000
CN1814900000000,18,149,"Starke County, IN",Sep-22,9476,9210,266,2.80000000
CN1815100000000,18,151,"Steuben County, IN",Sep-22,20830,20489,341,1.60000000
CN1815300000000,18,153,"Sullivan County, IN",Sep-22,7872,7672,200,2.50000000
CN1815500000000,18,155,"Switzerland County, IN",Sep-22,4673,4574,99,2.10000000
CN1815700000000,18,157,"Tippecanoe County, IN",Sep-22,96138,94218,1920,2.00000000
CN1815900000000,18,159,"Tipton County, IN",Sep-22,8871,8651,220,2.50000000
CN1816100000000,18,161,"Union County, IN",Sep-22,3486,3428,58,1.70000000
CN1816300000000,18,163,"Vanderburgh County, IN",Sep-22,92080,90010,2070,2.20000000
CN1816500000000,18,165,"Vermillion County, IN",Sep-22,6546,6368,178,2.70000000
CN1816700000000,18,167,"Vigo County, IN",Sep-22,45628,44414,1214,2.70000000
CN1816900000000,18,169,"Wabash County, IN",Sep-22,14538,14245,293,2.00000000
CN1817100000000,18,171,"Warren County, IN",Sep-22,4081,4001,80,2.00000000
CN1817300000000,18,173,"Warrick County, IN",Sep-22,32453,31832,621,1.90000000
CN1817500000000,18,175,"Washington County, IN",Sep-22,13939,13672,267,1.90000000
CN1817700000000,18,177,"Wayne County, IN",Sep-22,29166,28495,671,2.30000000
CN1817900000000,18,179,"Wells County, IN",Sep-22,14163,13931,232,1.60000000
CN1818100000000,18,181,"White County, IN",Sep-22,12911,12679,232,1.80000000
CN1818300000000,18,183,"Whitley County, IN",Sep-22,17587,17278,309,1.80000000
CN1900100000000,19,001,"Adair County, IA",Sep-22,4480,4412,68,1.50000000
CN1900300000000,19,003,"Adams County, IA",Sep-22,2028,1985,43,2.10000000
CN1900500000000,19,005,"Allamakee County, IA",Sep-22,7027,6836,191,2.70000000
CN1900700000000,19,007,"Appanoose County, IA",Sep-22,5905,5764,141,2.40000000
CN1900900000000,19,009,"Audubon County, IA",Sep-22,3042,2987,55,1.80000000
CN1901100000000,19,011,"Benton County, IA",Sep-22,12971,12630,341,2.60000000
CN1901300000000,19,013,"Black Hawk County, IA",Sep-22,68945,67180,1765,2.60000000
CN1901500000000,19,015,"Boone County, IA",Sep-22,14976,14698,278,1.90000000
CN1901700000000,19,017,"Bremer County, IA",Sep-22,14128,13859,269,1.90000000
CN1901900000000,19,019,"Buchanan County, IA",Sep-22,11234,10968,266,2.40000000
CN1902100000000,19,021,"Buena Vista County, IA",Sep-22,12242,11992,250,2.00000000
CN1902300000000,19,023,"Butler County, IA",Sep-22,8079,7906,173,2.10000000
CN1902500000000,19,025,"Calhoun County, IA",Sep-22,4056,3970,86,2.10000000
CN1902700000000,19,027,"Carroll County, IA",Sep-22,10760,10590,170,1.60000000
CN1902900000000,19,029,"Cass County, IA",Sep-22,6742,6608,134,2.00000000
CN1903100000000,19,031,"Cedar County, IA",Sep-22,10624,10399,225,2.10000000
CN1903300000000,19,033,"Cerro Gordo County, IA",Sep-22,22358,21844,514,2.30000000
CN1903500000000,19,035,"Cherokee County, IA",Sep-22,6079,5968,111,1.80000000
CN1903700000000,19,037,"Chickasaw County, IA",Sep-22,6413,6293,120,1.90000000
CN1903900000000,19,039,"Clarke County, IA",Sep-22,4847,4731,116,2.40000000
CN1904100000000,19,041,"Clay County, IA",Sep-22,8604,8410,194,2.30000000
CN1904300000000,19,043,"Clayton County, IA",Sep-22,9646,9418,228,2.40000000
CN1904500000000,19,045,"Clinton County, IA",Sep-22,22121,21398,723,3.30000000
CN1904700000000,19,047,"Crawford County, IA",Sep-22,7808,7583,225,2.90000000
CN1904900000000,19,049,"Dallas County, IA",Sep-22,53635,52718,917,1.70000000
CN1905100000000,19,051,"Davis County, IA",Sep-22,4257,4171,86,2.00000000
CN1905300000000,19,053,"Decatur County, IA",Sep-22,4326,4237,89,2.10000000
CN1905500000000,19,055,"Delaware County, IA",Sep-22,10513,10322,191,1.80000000
CN1905700000000,19,057,"Des Moines County, IA",Sep-22,18197,17457,740,4.10000000
CN1905900000000,19,059,"Dickinson County, IA",Sep-22,10745,10520,225,2.10000000
CN1906100000000,19,061,"Dubuque County, IA",Sep-22,55567,54102,1465,2.60000000
CN1906300000000,19,063,"Emmet County, IA",Sep-22,4920,4808,112,2.30000000
CN1906500000000,19,065,"Fayette County, IA",Sep-22,10114,9880,234,2.30000000
CN1906700000000,19,067,"Floyd County, IA",Sep-22,8121,7934,187,2.30000000
CN1906900000000,19,069,"Franklin County, IA",Sep-22,5577,5466,111,2.00000000
CN1907100000000,19,071,"Fremont County, IA",Sep-22,3685,3596,89,2.40000000
CN1907300000000,19,073,"Greene County, IA",Sep-22,5347,5254,93,1.70000000
CN1907500000000,19,075,"Grundy County, IA",Sep-22,6392,6262,130,2.00000000
CN1907700000000,19,077,"Guthrie County, IA",Sep-22,5521,5393,128,2.30000000
CN1907900000000,19,079,"Hamilton County, IA",Sep-22,6942,6774,168,2.40000000
CN1908100000000,19,081,"Hancock County, IA",Sep-22,5695,5584,111,1.90000000
CN1908300000000,19,083,"Hardin County, IA",Sep-22,7844,7662,182,2.30000000
CN1908500000000,19,085,"Harrison County, IA",Sep-22,7152,6995,157,2.20000000
CN1908700000000,19,087,"Henry County, IA",Sep-22,9757,9514,243,2.50000000
CN1908900000000,19,089,"Howard County, IA",Sep-22,5145,5042,103,2.00000000
CN1909100000000,19,091,"Humboldt County, IA",Sep-22,4979,4881,98,2.00000000
CN1909300000000,19,093,"Ida County, IA",Sep-22,3918,3848,70,1.80000000
CN1909500000000,19,095,"Iowa County, IA",Sep-22,10068,9888,180,1.80000000
CN1909700000000,19,097,"Jackson County, IA",Sep-22,10699,10421,278,2.60000000
CN1909900000000,19,099,"Jasper County, IA",Sep-22,18644,18175,469,2.50000000
CN1910100000000,19,101,"Jefferson County, IA",Sep-22,10144,9926,218,2.10000000
CN1910300000000,19,103,"Johnson County, IA",Sep-22,88578,86810,1768,2.00000000
CN1910500000000,19,105,"Jones County, IA",Sep-22,10211,9954,257,2.50000000
CN1910700000000,19,107,"Keokuk County, IA",Sep-22,5129,4997,132,2.60000000
CN1910900000000,19,109,"Kossuth County, IA",Sep-22,8037,7885,152,1.90000000
CN1911100000000,19,111,"Lee County, IA",Sep-22,15316,14561,755,4.90000000
CN1911300000000,19,113,"Linn County, IA",Sep-22,120711,117123,3588,3.00000000
CN1911500000000,19,115,"Louisa County, IA",Sep-22,5861,5715,146,2.50000000
CN1911700000000,19,117,"Lucas County, IA",Sep-22,4670,4593,77,1.60000000
CN1911900000000,19,119,"Lyon County, IA",Sep-22,7046,6943,103,1.50000000
CN1912100000000,19,121,"Madison County, IA",Sep-22,8647,8436,211,2.40000000
CN1912300000000,19,123,"Mahaska County, IA",Sep-22,12358,12103,255,2.10000000
CN1912500000000,19,125,"Marion County, IA",Sep-22,19662,19334,328,1.70000000
CN1912700000000,19,127,"Marshall County, IA",Sep-22,16975,16358,617,3.60000000
CN1912900000000,19,129,"Mills County, IA",Sep-22,7172,7031,141,2.00000000
CN1913100000000,19,131,"Mitchell County, IA",Sep-22,5768,5665,103,1.80000000
CN1913300000000,19,133,"Monona County, IA",Sep-22,4368,4266,102,2.30000000
CN1913500000000,19,135,"Monroe County, IA",Sep-22,3961,3874,87,2.20000000
CN1913700000000,19,137,"Montgomery County, IA",Sep-22,4876,4769,107,2.20000000
CN1913900000000,19,139,"Muscatine County, IA",Sep-22,20880,20341,539,2.60000000
CN1914100000000,19,141,"O'Brien County, IA",Sep-22,8119,7969,150,1.80000000
CN1914300000000,19,143,"Osceola County, IA",Sep-22,3583,3526,57,1.60000000
CN1914500000000,19,145,"Page County, IA",Sep-22,6310,6165,145,2.30000000
CN1914700000000,19,147,"Palo Alto County, IA",Sep-22,4517,4424,93,2.10000000
CN1914900000000,19,149,"Plymouth County, IA",Sep-22,14660,14391,269,1.80000000
CN1915100000000,19,151,"Pocahontas County, IA",Sep-22,4637,4564,73,1.60000000
CN1915300000000,19,153,"Polk County, IA",Sep-22,275239,268623,6616,2.40000000
CN1915500000000,19,155,"Pottawattamie County, IA",Sep-22,48413,47253,1160,2.40000000
CN1915700000000,19,157,"Poweshiek County, IA",Sep-22,10985,10748,237,2.20000000
CN1915900000000,19,159,"Ringgold County, IA",Sep-22,2395,2345,50,2.10000000
CN1916100000000,19,161,"Sac County, IA",Sep-22,5275,5172,103,2.00000000
CN1916300000000,19,163,"Scott County, IA",Sep-22,91896,89170,2726,3.00000000
CN1916500000000,19,165,"Shelby County, IA",Sep-22,6260,6137,123,2.00000000
CN1916700000000,19,167,"Sioux County, IA",Sep-22,22197,21881,316,1.40000000
CN1916900000000,19,169,"Story County, IA",Sep-22,60643,59549,1094,1.80000000
CN1917100000000,19,171,"Tama County, IA",Sep-22,9093,8891,202,2.20000000
CN1917300000000,19,173,"Taylor County, IA",Sep-22,3075,3021,54,1.80000000
CN1917500000000,19,175,"Union County, IA",Sep-22,6140,5997,143,2.30000000
CN1917700000000,19,177,"Van Buren County, IA",Sep-22,3670,3583,87,2.40000000
CN1917900000000,19,179,"Wapello County, IA",Sep-22,17119,16650,469,2.70000000
CN1918100000000,19,181,"Warren County, IA",Sep-22,29142,28541,601,2.10000000
CN1918300000000,19,183,"Washington County, IA",Sep-22,11822,11586,236,2.00000000
CN1918500000000,19,185,"Wayne County, IA",Sep-22,2812,2753,59,2.10000000
CN1918700000000,19,187,"Webster County, IA",Sep-22,18407,17897,510,2.80000000
CN1918900000000,19,189,"Winnebago County, IA",Sep-22,4900,4784,116,2.40000000
CN1919100000000,19,191,"Winneshiek County, IA",Sep-22,11888,11654,234,2.00000000
CN1919300000000,19,193,"Woodbury County, IA",Sep-22,55920,54644,1276,2.30000000
CN1919500000000,19,195,"Worth County, IA",Sep-22,3972,3888,84,2.10000000
CN1919700000000,19,197,"Wright County, IA",Sep-22,6687,6544,143,2.10000000
CN2000100000000,20,001,"Allen County, KS",Sep-22,6389,6220,169,2.60000000
CN2000300000000,20,003,"Anderson County, KS",Sep-22,4382,4294,88,2.00000000
CN2000500000000,20,005,"Atchison County, KS",Sep-22,6791,6585,206,3.00000000
CN2000700000000,20,007,"Barber County, KS",Sep-22,2246,2203,43,1.90000000
CN2000900000000,20,009,"Barton County, KS",Sep-22,12980,12662,318,2.40000000
CN2001100000000,20,011,"Bourbon County, KS",Sep-22,6085,5892,193,3.20000000
CN2001300000000,20,013,"Brown County, KS",Sep-22,5014,4909,105,2.10000000
CN2001500000000,20,015,"Butler County, KS",Sep-22,32624,31788,836,2.60000000
CN2001700000000,20,017,"Chase County, KS",Sep-22,1416,1388,28,2.00000000
CN2001900000000,20,019,"Chautauqua County, KS",Sep-22,1455,1416,39,2.70000000
CN2002100000000,20,021,"Cherokee County, KS",Sep-22,10005,9767,238,2.40000000
CN2002300000000,20,023,"Cheyenne County, KS",Sep-22,1271,1243,28,2.20000000
CN2002500000000,20,025,"Clark County, KS",Sep-22,1093,1073,20,1.80000000
CN2002700000000,20,027,"Clay County, KS",Sep-22,3783,3700,83,2.20000000
CN2002900000000,20,029,"Cloud County, KS",Sep-22,3807,3717,90,2.40000000
CN2003100000000,20,031,"Coffey County, KS",Sep-22,3781,3665,116,3.10000000
CN2003300000000,20,033,"Comanche County, KS",Sep-22,892,872,20,2.20000000
CN2003500000000,20,035,"Cowley County, KS",Sep-22,16588,16127,461,2.80000000
CN2003700000000,20,037,"Crawford County, KS",Sep-22,19150,18629,521,2.70000000
CN2003900000000,20,039,"Decatur County, KS",Sep-22,1179,1147,32,2.70000000
CN2004100000000,20,041,"Dickinson County, KS",Sep-22,8840,8622,218,2.50000000
CN2004300000000,20,043,"Doniphan County, KS",Sep-22,4092,3992,100,2.40000000
CN2004500000000,20,045,"Douglas County, KS",Sep-22,65261,63678,1583,2.40000000
CN2004700000000,20,047,"Edwards County, KS",Sep-22,1364,1335,29,2.10000000
CN2004900000000,20,049,"Elk County, KS",Sep-22,1217,1188,29,2.40000000
CN2005100000000,20,051,"Ellis County, KS",Sep-22,17048,16725,323,1.90000000
CN2005300000000,20,053,"Ellsworth County, KS",Sep-22,2538,2484,54,2.10000000
CN2005500000000,20,055,"Finney County, KS",Sep-22,20647,20262,385,1.90000000
CN2005700000000,20,057,"Ford County, KS",Sep-22,18198,17852,346,1.90000000
CN2005900000000,20,059,"Franklin County, KS",Sep-22,14798,14470,328,2.20000000
CN2006100000000,20,061,"Geary County, KS",Sep-22,11336,10916,420,3.70000000
CN2006300000000,20,063,"Gove County, KS",Sep-22,1375,1343,32,2.30000000
CN2006500000000,20,065,"Graham County, KS",Sep-22,1212,1181,31,2.60000000
CN2006700000000,20,067,"Grant County, KS",Sep-22,2804,2736,68,2.40000000
CN2006900000000,20,069,"Gray County, KS",Sep-22,3275,3216,59,1.80000000
CN2007100000000,20,071,"Greeley County, KS",Sep-22,807,795,12,1.50000000
CN2007300000000,20,073,"Greenwood County, KS",Sep-22,3038,2976,62,2.00000000
CN2007500000000,20,075,"Hamilton County, KS",Sep-22,1612,1587,25,1.60000000
CN2007700000000,20,077,"Harper County, KS",Sep-22,2781,2725,56,2.00000000
CN2007900000000,20,079,"Harvey County, KS",Sep-22,17039,16637,402,2.40000000
CN2008100000000,20,081,"Haskell County, KS",Sep-22,2130,2091,39,1.80000000
CN2008300000000,20,083,"Hodgeman County, KS",Sep-22,988,969,19,1.90000000
CN2008500000000,20,085,"Jackson County, KS",Sep-22,7162,7018,144,2.00000000
CN2008700000000,20,087,"Jefferson County, KS",Sep-22,10185,9950,235,2.30000000
CN2008900000000,20,089,"Jewell County, KS",Sep-22,1175,1144,31,2.60000000
CN2009100000000,20,091,"Johnson County, KS",Sep-22,345433,337898,7535,2.20000000
CN2009300000000,20,093,"Kearny County, KS",Sep-22,2010,1974,36,1.80000000
CN2009500000000,20,095,"Kingman County, KS",Sep-22,3249,3173,76,2.30000000
CN2009700000000,20,097,"Kiowa County, KS",Sep-22,1281,1255,26,2.00000000
CN2009900000000,20,099,"Labette County, KS",Sep-22,9365,9101,264,2.80000000
CN2010100000000,20,101,"Lane County, KS",Sep-22,723,704,19,2.60000000
CN2010300000000,20,103,"Leavenworth County, KS",Sep-22,37012,36026,986,2.70000000
CN2010500000000,20,105,"Lincoln County, KS",Sep-22,1732,1698,34,2.00000000
CN2010700000000,20,107,"Linn County, KS",Sep-22,4284,4142,142,3.30000000
CN2010900000000,20,109,"Logan County, KS",Sep-22,1638,1606,32,2.00000000
CN2011100000000,20,111,"Lyon County, KS",Sep-22,17116,16726,390,2.30000000
CN2011300000000,20,113,"McPherson County, KS",Sep-22,17622,17302,320,1.80000000
CN2011500000000,20,115,"Marion County, KS",Sep-22,5994,5855,139,2.30000000
CN2011700000000,20,117,"Marshall County, KS",Sep-22,5435,5335,100,1.80000000
CN2011900000000,20,119,"Meade County, KS",Sep-22,2193,2156,37,1.70000000
CN2012100000000,20,121,"Miami County, KS",Sep-22,17808,17397,411,2.30000000
CN2012300000000,20,123,"Mitchell County, KS",Sep-22,3317,3251,66,2.00000000
CN2012500000000,20,125,"Montgomery County, KS",Sep-22,14303,13878,425,3.00000000
CN2012700000000,20,127,"Morris County, KS",Sep-22,3133,3063,70,2.20000000
CN2012900000000,20,129,"Morton County, KS",Sep-22,1177,1152,25,2.10000000
CN2013100000000,20,131,"Nemaha County, KS",Sep-22,5677,5584,93,1.60000000
CN2013300000000,20,133,"Neosho County, KS",Sep-22,6062,5856,206,3.40000000
CN2013500000000,20,135,"Ness County, KS",Sep-22,1341,1312,29,2.20000000
CN2013700000000,20,137,"Norton County, KS",Sep-22,2583,2537,46,1.80000000
CN2013900000000,20,139,"Osage County, KS",Sep-22,7877,7671,206,2.60000000
CN2014100000000,20,141,"Osborne County, KS",Sep-22,1875,1841,34,1.80000000
CN2014300000000,20,143,"Ottawa County, KS",Sep-22,3022,2949,73,2.40000000
CN2014500000000,20,145,"Pawnee County, KS",Sep-22,2678,2618,60,2.20000000
CN2014700000000,20,147,"Phillips County, KS",Sep-22,2671,2612,59,2.20000000
CN2014900000000,20,149,"Pottawatomie County, KS",Sep-22,12664,12397,267,2.10000000
CN2015100000000,20,151,"Pratt County, KS",Sep-22,4852,4748,104,2.10000000
CN2015300000000,20,153,"Rawlins County, KS",Sep-22,1538,1510,28,1.80000000
CN2015500000000,20,155,"Reno County, KS",Sep-22,29208,28447,761,2.60000000
CN2015700000000,20,157,"Republic County, KS",Sep-22,2357,2312,45,1.90000000
CN2015900000000,20,159,"Rice County, KS",Sep-22,5366,5261,105,2.00000000
CN2016100000000,20,161,"Riley County, KS",Sep-22,35181,34317,864,2.50000000
CN2016300000000,20,163,"Rooks County, KS",Sep-22,2388,2325,63,2.60000000
CN2016500000000,20,165,"Rush County, KS",Sep-22,1596,1567,29,1.80000000
CN2016700000000,20,167,"Russell County, KS",Sep-22,3303,3227,76,2.30000000
CN2016900000000,20,169,"Saline County, KS",Sep-22,30064,29402,662,2.20000000
CN2017100000000,20,171,"Scott County, KS",Sep-22,2696,2642,54,2.00000000
CN2017300000000,20,173,"Sedgwick County, KS",Sep-22,254904,247377,7527,3.00000000
CN2017500000000,20,175,"Seward County, KS",Sep-22,9912,9683,229,2.30000000
CN2017700000000,20,177,"Shawnee County, KS",Sep-22,90509,88189,2320,2.60000000
CN2017900000000,20,179,"Sheridan County, KS",Sep-22,1447,1419,28,1.90000000
CN2018100000000,20,181,"Sherman County, KS",Sep-22,2760,2701,59,2.10000000
CN2018300000000,20,183,"Smith County, KS",Sep-22,2018,1981,37,1.80000000
CN2018500000000,20,185,"Stafford County, KS",Sep-22,1895,1855,40,2.10000000
CN2018700000000,20,187,"Stanton County, KS",Sep-22,1110,1091,19,1.70000000
CN2018900000000,20,189,"Stevens County, KS",Sep-22,2926,2878,48,1.60000000
CN2019100000000,20,191,"Sumner County, KS",Sep-22,10734,10433,301,2.80000000
CN2019300000000,20,193,"Thomas County, KS",Sep-22,4222,4132,90,2.10000000
CN2019500000000,20,195,"Trego County, KS",Sep-22,1339,1307,32,2.40000000
CN2019700000000,20,197,"Wabaunsee County, KS",Sep-22,3680,3597,83,2.30000000
CN2019900000000,20,199,"Wallace County, KS",Sep-22,825,808,17,2.10000000
CN2020100000000,20,201,"Washington County, KS",Sep-22,3015,2964,51,1.70000000
CN2020300000000,20,203,"Wichita County, KS",Sep-22,1073,1048,25,2.30000000
CN2020500000000,20,205,"Wilson County, KS",Sep-22,3770,3663,107,2.80000000
CN2020700000000,20,207,"Woodson County, KS",Sep-22,1465,1420,45,3.10000000
CN2020900000000,20,209,"Wyandotte County, KS",Sep-22,77348,74817,2531,3.30000000
CN2100100000000,21,001,"Adair County, KY",Sep-22,7330,7040,290,4.00000000
CN2100300000000,21,003,"Allen County, KY",Sep-22,8985,8681,304,3.40000000
CN2100500000000,21,005,"Anderson County, KY",Sep-22,11869,11542,327,2.80000000
CN2100700000000,21,007,"Ballard County, KY",Sep-22,3412,3269,143,4.20000000
CN2100900000000,21,009,"Barren County, KY",Sep-22,17743,17121,622,3.50000000
CN2101100000000,21,011,"Bath County, KY",Sep-22,4638,4436,202,4.40000000
CN2101300000000,21,013,"Bell County, KY",Sep-22,8054,7685,369,4.60000000
CN2101500000000,21,015,"Boone County, KY",Sep-22,71770,69765,2005,2.80000000
CN2101700000000,21,017,"Bourbon County, KY",Sep-22,9668,9381,287,3.00000000
CN2101900000000,21,019,"Boyd County, KY",Sep-22,17152,16371,781,4.60000000
CN2102100000000,21,021,"Boyle County, KY",Sep-22,12464,12024,440,3.50000000
CN2102300000000,21,023,"Bracken County, KY",Sep-22,3747,3622,125,3.30000000
CN2102500000000,21,025,"Breathitt County, KY",Sep-22,3188,2965,223,7.00000000
CN2102700000000,21,027,"Breckinridge County, KY",Sep-22,7974,7611,363,4.60000000
CN2102900000000,21,029,"Bullitt County, KY",Sep-22,43892,42632,1260,2.90000000
CN2103100000000,21,031,"Butler County, KY",Sep-22,4982,4805,177,3.60000000
CN2103300000000,21,033,"Caldwell County, KY",Sep-22,5964,5777,187,3.10000000
CN2103500000000,21,035,"Calloway County, KY",Sep-22,16952,16351,601,3.50000000
CN2103700000000,21,037,"Campbell County, KY",Sep-22,50359,48905,1454,2.90000000
CN2103900000000,21,039,"Carlisle County, KY",Sep-22,2206,2142,64,2.90000000
CN2104100000000,21,041,"Carroll County, KY",Sep-22,5485,5329,156,2.80000000
CN2104300000000,21,043,"Carter County, KY",Sep-22,9730,9147,583,6.00000000
CN2104500000000,21,045,"Casey County, KY",Sep-22,6731,6516,215,3.20000000
CN2104700000000,21,047,"Christian County, KY",Sep-22,25143,24027,1116,4.40000000
CN2104900000000,21,049,"Clark County, KY",Sep-22,17299,16731,568,3.30000000
CN2105100000000,21,051,"Clay County, KY",Sep-22,5143,4867,276,5.40000000
CN2105300000000,21,053,"Clinton County, KY",Sep-22,3997,3851,146,3.70000000
CN2105500000000,21,055,"Crittenden County, KY",Sep-22,3774,3635,139,3.70000000
CN2105700000000,21,057,"Cumberland County, KY",Sep-22,3434,3347,87,2.50000000
CN2105900000000,21,059,"Daviess County, KY",Sep-22,46779,45048,1731,3.70000000
CN2106100000000,21,061,"Edmonson County, KY",Sep-22,4736,4534,202,4.30000000
CN2106300000000,21,063,"Elliott County, KY",Sep-22,1838,1715,123,6.70000000
CN2106500000000,21,065,"Estill County, KY",Sep-22,5175,4965,210,4.10000000
CN2106700000000,21,067,"Fayette County, KY",Sep-22,175976,171131,4845,2.80000000
CN2106900000000,21,069,"Fleming County, KY",Sep-22,5994,5776,218,3.60000000
CN2107100000000,21,071,"Floyd County, KY",Sep-22,10865,10271,594,5.50000000
CN2107300000000,21,073,"Franklin County, KY",Sep-22,24880,24143,737,3.00000000
CN2107500000000,21,075,"Fulton County, KY",Sep-22,2081,1997,84,4.00000000
CN2107700000000,21,077,"Gallatin County, KY",Sep-22,3989,3863,126,3.20000000
CN2107900000000,21,079,"Garrard County, KY",Sep-22,7689,7431,258,3.40000000
CN2108100000000,21,081,"Grant County, KY",Sep-22,11597,11241,356,3.10000000
CN2108300000000,21,083,"Graves County, KY",Sep-22,15508,14943,565,3.60000000
CN2108500000000,21,085,"Grayson County, KY",Sep-22,10590,10173,417,3.90000000
CN2108700000000,21,087,"Green County, KY",Sep-22,5332,5179,153,2.90000000
CN2108900000000,21,089,"Greenup County, KY",Sep-22,12891,12244,647,5.00000000
CN2109100000000,21,091,"Hancock County, KY",Sep-22,3940,3743,197,5.00000000
CN2109300000000,21,093,"Hardin County, KY",Sep-22,47412,45738,1674,3.50000000
CN2109500000000,21,095,"Harlan County, KY",Sep-22,6525,6138,387,5.90000000
CN2109700000000,21,097,"Harrison County, KY",Sep-22,8891,8627,264,3.00000000
CN2109900000000,21,099,"Hart County, KY",Sep-22,7522,7259,263,3.50000000
CN2110100000000,21,101,"Henderson County, KY",Sep-22,20982,20307,675,3.20000000
CN2110300000000,21,103,"Henry County, KY",Sep-22,8323,8097,226,2.70000000
CN2110500000000,21,105,"Hickman County, KY",Sep-22,1673,1612,61,3.60000000
CN2110700000000,21,107,"Hopkins County, KY",Sep-22,17770,17074,696,3.90000000
CN2110900000000,21,109,"Jackson County, KY",Sep-22,4170,3958,212,5.10000000
CN2111100000000,21,111,"Jefferson County, KY",Sep-22,403957,391829,12128,3.00000000
CN2111300000000,21,113,"Jessamine County, KY",Sep-22,26621,25840,781,2.90000000
CN2111500000000,21,115,"Johnson County, KY",Sep-22,6557,6196,361,5.50000000
CN2111700000000,21,117,"Kenton County, KY",Sep-22,87259,84686,2573,2.90000000
CN2111900000000,21,119,"Knott County, KY",Sep-22,4271,4025,246,5.80000000
CN2112100000000,21,121,"Knox County, KY",Sep-22,10113,9617,496,4.90000000
CN2112300000000,21,123,"Larue County, KY",Sep-22,5793,5571,222,3.80000000
CN2112500000000,21,125,"Laurel County, KY",Sep-22,25568,24601,967,3.80000000
CN2112700000000,21,127,"Lawrence County, KY",Sep-22,5524,5286,238,4.30000000
CN2112900000000,21,129,"Lee County, KY",Sep-22,1992,1898,94,4.70000000
CN2113100000000,21,131,"Leslie County, KY",Sep-22,2512,2358,154,6.10000000
CN2113300000000,21,133,"Letcher County, KY",Sep-22,6114,5751,363,5.90000000
CN2113500000000,21,135,"Lewis County, KY",Sep-22,4606,4316,290,6.30000000
CN2113700000000,21,137,"Lincoln County, KY",Sep-22,9162,8758,404,4.40000000
CN2113900000000,21,139,"Livingston County, KY",Sep-22,3568,3422,146,4.10000000
CN2114100000000,21,141,"Logan County, KY",Sep-22,12502,12123,379,3.00000000
CN2114300000000,21,143,"Lyon County, KY",Sep-22,3050,2932,118,3.90000000
CN2114500000000,21,145,"McCracken County, KY",Sep-22,29289,28240,1049,3.60000000
CN2114700000000,21,147,"McCreary County, KY",Sep-22,4906,4678,228,4.60000000
CN2114900000000,21,149,"McLean County, KY",Sep-22,4046,3890,156,3.90000000
CN2115100000000,21,151,"Madison County, KY",Sep-22,47509,46014,1495,3.10000000
CN2115300000000,21,153,"Magoffin County, KY",Sep-22,3285,2995,290,8.80000000
CN2115500000000,21,155,"Marion County, KY",Sep-22,9244,8980,264,2.90000000
CN2115700000000,21,157,"Marshall County, KY",Sep-22,14354,13850,504,3.50000000
CN2115900000000,21,159,"Martin County, KY",Sep-22,2245,2083,162,7.20000000
CN2116100000000,21,161,"Mason County, KY",Sep-22,6527,6241,286,4.40000000
CN2116300000000,21,163,"Meade County, KY",Sep-22,11715,11267,448,3.80000000
CN2116500000000,21,165,"Menifee County, KY",Sep-22,2323,2211,112,4.80000000
CN2116700000000,21,167,"Mercer County, KY",Sep-22,9861,9533,328,3.30000000
CN2116900000000,21,169,"Metcalfe County, KY",Sep-22,3893,3742,151,3.90000000
CN2117100000000,21,171,"Monroe County, KY",Sep-22,4611,4478,133,2.90000000
CN2117300000000,21,173,"Montgomery County, KY",Sep-22,11690,11224,466,4.00000000
CN2117500000000,21,175,"Morgan County, KY",Sep-22,4311,4140,171,4.00000000
CN2117700000000,21,177,"Muhlenberg County, KY",Sep-22,9528,9006,522,5.50000000
CN2117900000000,21,179,"Nelson County, KY",Sep-22,23788,23091,697,2.90000000
CN2118100000000,21,181,"Nicholas County, KY",Sep-22,3352,3237,115,3.40000000
CN2118300000000,21,183,"Ohio County, KY",Sep-22,9068,8617,451,5.00000000
CN2118500000000,21,185,"Oldham County, KY",Sep-22,34123,33256,867,2.50000000
CN2118700000000,21,187,"Owen County, KY",Sep-22,5094,4943,151,3.00000000
CN2118900000000,21,189,"Owsley County, KY",Sep-22,1042,973,69,6.60000000
CN2119100000000,21,191,"Pendleton County, KY",Sep-22,6872,6672,200,2.90000000
CN2119300000000,21,193,"Perry County, KY",Sep-22,7978,7605,373,4.70000000
CN2119500000000,21,195,"Pike County, KY",Sep-22,18732,17836,896,4.80000000
CN2119700000000,21,197,"Powell County, KY",Sep-22,5201,5004,197,3.80000000
CN2119900000000,21,199,"Pulaski County, KY",Sep-22,26104,24998,1106,4.20000000
CN2120100000000,21,201,"Robertson County, KY",Sep-22,824,791,33,4.00000000
CN2120300000000,21,203,"Rockcastle County, KY",Sep-22,6566,6307,259,3.90000000
CN2120500000000,21,205,"Rowan County, KY",Sep-22,9977,9572,405,4.10000000
CN2120700000000,21,207,"Russell County, KY",Sep-22,6108,5831,277,4.50000000
CN2120900000000,21,209,"Scott County, KY",Sep-22,30412,29596,816,2.70000000
CN2121100000000,21,211,"Shelby County, KY",Sep-22,26501,25808,693,2.60000000
CN2121300000000,21,213,"Simpson County, KY",Sep-22,8954,8690,264,2.90000000
CN2121500000000,21,215,"Spencer County, KY",Sep-22,10805,10505,300,2.80000000
CN2121700000000,21,217,"Taylor County, KY",Sep-22,12561,12159,402,3.20000000
CN2121900000000,21,219,"Todd County, KY",Sep-22,5549,5387,162,2.90000000
CN2122100000000,21,221,"Trigg County, KY",Sep-22,6135,5897,238,3.90000000
CN2122300000000,21,223,"Trimble County, KY",Sep-22,3909,3786,123,3.10000000
CN2122500000000,21,225,"Union County, KY",Sep-22,6021,5799,222,3.70000000
CN2122700000000,21,227,"Warren County, KY",Sep-22,65665,63605,2060,3.10000000
CN2122900000000,21,229,"Washington County, KY",Sep-22,6168,5994,174,2.80000000
CN2123100000000,21,231,"Wayne County, KY",Sep-22,7084,6748,336,4.70000000
CN2123300000000,21,233,"Webster County, KY",Sep-22,5305,5126,179,3.40000000
CN2123500000000,21,235,"Whitley County, KY",Sep-22,14162,13614,548,3.90000000
CN2123700000000,21,237,"Wolfe County, KY",Sep-22,2238,2133,105,4.70000000
CN2123900000000,21,239,"Woodford County, KY",Sep-22,15101,14709,392,2.60000000
CN2200100000000,22,001,"Acadia Parish, LA",Sep-22,24166,23361,805,3.30000000
CN2200300000000,22,003,"Allen Parish, LA",Sep-22,8126,7823,303,3.70000000
CN2200500000000,22,005,"Ascension Parish, LA",Sep-22,65968,64150,1818,2.80000000
CN2200700000000,22,007,"Assumption Parish, LA",Sep-22,8775,8343,432,4.90000000
CN2200900000000,22,009,"Avoyelles Parish, LA",Sep-22,13220,12687,533,4.00000000
CN2201100000000,22,011,"Beauregard Parish, LA",Sep-22,14529,14095,434,3.00000000
CN2201300000000,22,013,"Bienville Parish, LA",Sep-22,4826,4623,203,4.20000000
CN2201500000000,22,015,"Bossier Parish, LA",Sep-22,58495,56911,1584,2.70000000
CN2201700000000,22,017,"Caddo Parish, LA",Sep-22,102875,98679,4196,4.10000000
CN2201900000000,22,019,"Calcasieu Parish, LA",Sep-22,98358,95148,3210,3.30000000
CN2202100000000,22,021,"Caldwell Parish, LA",Sep-22,3665,3539,126,3.40000000
CN2202300000000,22,023,"Cameron Parish, LA",Sep-22,3645,3556,89,2.40000000
CN2202500000000,22,025,"Catahoula Parish, LA",Sep-22,3422,3292,130,3.80000000
CN2202700000000,22,027,"Claiborne Parish, LA",Sep-22,5332,5150,182,3.40000000
CN2202900000000,22,029,"Concordia Parish, LA",Sep-22,7022,6723,299,4.30000000
CN2203100000000,22,031,"De Soto Parish, LA",Sep-22,10999,10609,390,3.50000000
CN2203300000000,22,033,"East Baton Rouge Parish, LA",Sep-22,230346,222732,7614,3.30000000
CN2203500000000,22,035,"East Carroll Parish, LA",Sep-22,1643,1512,131,8.00000000
CN2203700000000,22,037,"East Feliciana Parish, LA",Sep-22,7765,7548,217,2.80000000
CN2203900000000,22,039,"Evangeline Parish, LA",Sep-22,11998,11549,449,3.70000000
CN2204100000000,22,041,"Franklin Parish, LA",Sep-22,7513,7169,344,4.60000000
CN2204300000000,22,043,"Grant Parish, LA",Sep-22,8405,8153,252,3.00000000
CN2204500000000,22,045,"Iberia Parish, LA",Sep-22,28059,26852,1207,4.30000000
CN2204700000000,22,047,"Iberville Parish, LA",Sep-22,13786,13131,655,4.80000000
CN2204900000000,22,049,"Jackson Parish, LA",Sep-22,6804,6608,196,2.90000000
CN2205100000000,22,051,"Jefferson Parish, LA",Sep-22,213758,206178,7580,3.50000000
CN2205300000000,22,053,"Jefferson Davis Parish, LA",Sep-22,12628,12235,393,3.10000000
CN2205500000000,22,055,"Lafayette Parish, LA",Sep-22,117936,114595,3341,2.80000000
CN2205700000000,22,057,"Lafourche Parish, LA",Sep-22,40425,39196,1229,3.00000000
CN2205900000000,22,059,"LaSalle Parish, LA",Sep-22,6683,6522,161,2.40000000
CN2206100000000,22,061,"Lincoln Parish, LA",Sep-22,20816,20140,676,3.20000000
CN2206300000000,22,063,"Livingston Parish, LA",Sep-22,70704,68841,1863,2.60000000
CN2206500000000,22,065,"Madison Parish, LA",Sep-22,3477,3310,167,4.80000000
CN2206700000000,22,067,"Morehouse Parish, LA",Sep-22,9914,9390,524,5.30000000
CN2206900000000,22,069,"Natchitoches Parish, LA",Sep-22,16771,16185,586,3.50000000
CN2207100000000,22,071,"Orleans Parish, LA",Sep-22,180039,171319,8720,4.80000000
CN2207300000000,22,073,"Ouachita Parish, LA",Sep-22,69343,66984,2359,3.40000000
CN2207500000000,22,075,"Plaquemines Parish, LA",Sep-22,9907,9618,289,2.90000000
CN2207700000000,22,077,"Pointe Coupee Parish, LA",Sep-22,9666,9310,356,3.70000000
CN2207900000000,22,079,"Rapides Parish, LA",Sep-22,56760,55118,1642,2.90000000
CN2208100000000,22,081,"Red River Parish, LA",Sep-22,3783,3665,118,3.10000000
CN2208300000000,22,083,"Richland Parish, LA",Sep-22,8128,7815,313,3.90000000
CN2208500000000,22,085,"Sabine Parish, LA",Sep-22,9223,8949,274,3.00000000
CN2208700000000,22,087,"St. Bernard Parish, LA",Sep-22,20335,19487,848,4.20000000
CN2208900000000,22,089,"St. Charles Parish, LA",Sep-22,25111,24359,752,3.00000000
CN2209100000000,22,091,"St. Helena Parish, LA",Sep-22,4242,3998,244,5.80000000
CN2209300000000,22,093,"St. James Parish, LA",Sep-22,9063,8640,423,4.70000000
CN2209500000000,22,095,"St. John the Baptist Parish, LA",Sep-22,19441,18448,993,5.10000000
CN2209700000000,22,097,"St. Landry Parish, LA",Sep-22,32301,30898,1403,4.30000000
CN2209900000000,22,099,"St. Martin Parish, LA",Sep-22,22388,21608,780,3.50000000
CN2210100000000,22,101,"St. Mary Parish, LA",Sep-22,18724,17884,840,4.50000000
CN2210300000000,22,103,"St. Tammany Parish, LA",Sep-22,121212,118009,3203,2.60000000
CN2210500000000,22,105,"Tangipahoa Parish, LA",Sep-22,56705,54264,2441,4.30000000
CN2210700000000,22,107,"Tensas Parish, LA",Sep-22,1230,1169,61,5.00000000
CN2210900000000,22,109,"Terrebonne Parish, LA",Sep-22,44527,42894,1633,3.70000000
CN2211100000000,22,111,"Union Parish, LA",Sep-22,9042,8720,322,3.60000000
CN2211300000000,22,113,"Vermilion Parish, LA",Sep-22,24351,23577,774,3.20000000
CN2211500000000,22,115,"Vernon Parish, LA",Sep-22,15811,15261,550,3.50000000
CN2211700000000,22,117,"Washington Parish, LA",Sep-22,16842,16166,676,4.00000000
CN2211900000000,22,119,"Webster Parish, LA",Sep-22,14290,13730,560,3.90000000
CN2212100000000,22,121,"West Baton Rouge Parish, LA",Sep-22,13806,13386,420,3.00000000
CN2212300000000,22,123,"West Carroll Parish, LA",Sep-22,3594,3424,170,4.70000000
CN2212500000000,22,125,"West Feliciana Parish, LA",Sep-22,5366,5236,130,2.40000000
CN2212700000000,22,127,"Winn Parish, LA",Sep-22,4556,4395,161,3.50000000
CN2300100000000,23,001,"Androscoggin County, ME",Sep-22,52968,51182,1786,3.40000000
CN2300300000000,23,003,"Aroostook County, ME",Sep-22,27398,26269,1129,4.10000000
CN2300500000000,23,005,"Cumberland County, ME",Sep-22,162999,158372,4627,2.80000000
CN2300700000000,23,007,"Franklin County, ME",Sep-22,13231,12717,514,3.90000000
CN2300900000000,23,009,"Hancock County, ME",Sep-22,28893,28026,867,3.00000000
CN2301100000000,23,011,"Kennebec County, ME",Sep-22,59673,57789,1884,3.20000000
CN2301300000000,23,013,"Knox County, ME",Sep-22,19104,18482,622,3.30000000
CN2301500000000,23,015,"Lincoln County, ME",Sep-22,16359,15880,479,2.90000000
CN2301700000000,23,017,"Oxford County, ME",Sep-22,25163,24197,966,3.80000000
CN2301900000000,23,019,"Penobscot County, ME",Sep-22,74706,72165,2541,3.40000000
CN2302100000000,23,021,"Piscataquis County, ME",Sep-22,7163,6865,298,4.20000000
CN2302300000000,23,023,"Sagadahoc County, ME",Sep-22,18622,18117,505,2.70000000
CN2302500000000,23,025,"Somerset County, ME",Sep-22,21476,20493,983,4.60000000
CN2302700000000,23,027,"Waldo County, ME",Sep-22,19926,19289,637,3.20000000
CN2302900000000,23,029,"Washington County, ME",Sep-22,12830,12266,564,4.40000000
CN2303100000000,23,031,"York County, ME",Sep-22,111149,108033,3116,2.80000000
CN2400100000000,24,001,"Allegany County, MD",Sep-22,29880,28512,1368,4.60000000
CN2400300000000,24,003,"Anne Arundel County, MD",Sep-22,317711,307560,10151,3.20000000
CN2400500000000,24,005,"Baltimore County, MD",Sep-22,450345,433379,16966,3.80000000
CN2400900000000,24,009,"Calvert County, MD",Sep-22,48889,47249,1640,3.40000000
CN2401100000000,24,011,"Caroline County, MD",Sep-22,18048,17479,569,3.20000000
CN2401300000000,24,013,"Carroll County, MD",Sep-22,96222,93405,2817,2.90000000
CN2401500000000,24,015,"Cecil County, MD",Sep-22,52789,50815,1974,3.70000000
CN2401700000000,24,017,"Charles County, MD",Sep-22,85741,82511,3230,3.80000000
CN2401900000000,24,019,"Dorchester County, MD",Sep-22,16639,15993,646,3.90000000
CN2402100000000,24,021,"Frederick County, MD",Sep-22,136282,131632,4650,3.40000000
CN2402300000000,24,023,"Garrett County, MD",Sep-22,15593,15072,521,3.30000000
CN2402500000000,24,025,"Harford County, MD",Sep-22,141912,137178,4734,3.30000000
CN2402700000000,24,027,"Howard County, MD",Sep-22,189843,184208,5635,3.00000000
CN2402900000000,24,029,"Kent County, MD",Sep-22,10399,10021,378,3.60000000
CN2403100000000,24,031,"Montgomery County, MD",Sep-22,546400,527762,18638,3.40000000
CN2403300000000,24,033,"Prince George's County, MD",Sep-22,493782,472572,21210,4.30000000
CN2403500000000,24,035,"Queen Anne's County, MD",Sep-22,28666,27801,865,3.00000000
CN2403700000000,24,037,"St. Mary's County, MD",Sep-22,57166,55198,1968,3.40000000
CN2403900000000,24,039,"Somerset County, MD",Sep-22,9234,8741,493,5.30000000
CN2404100000000,24,041,"Talbot County, MD",Sep-22,17935,17287,648,3.60000000
CN2404300000000,24,043,"Washington County, MD",Sep-22,72670,69940,2730,3.80000000
CN2404500000000,24,045,"Wicomico County, MD",Sep-22,51141,48979,2162,4.20000000
CN2404700000000,24,047,"Worcester County, MD",Sep-22,25087,23932,1155,4.60000000
CN2451000000000,24,510,"Baltimore city, MD",Sep-22,278615,264541,14074,5.10000000
CN2500100000000,25,001,"Barnstable County, MA",Sep-22,109328,105715,3613,3.30000000
CN2500300000000,25,003,"Berkshire County, MA",Sep-22,59334,57188,2146,3.60000000
CN2500500000000,25,005,"Bristol County, MA",Sep-22,293049,282010,11039,3.80000000
CN2500700000000,25,007,"Dukes County, MA",Sep-22,9867,9574,293,3.00000000
CN2500900000000,25,009,"Essex County, MA",Sep-22,414550,400534,14016,3.40000000
CN2501100000000,25,011,"Franklin County, MA",Sep-22,39483,38439,1044,2.60000000
CN2501300000000,25,013,"Hampden County, MA",Sep-22,221068,211701,9367,4.20000000
CN2501500000000,25,015,"Hampshire County, MA",Sep-22,88337,85926,2411,2.70000000
CN2501700000000,25,017,"Middlesex County, MA",Sep-22,904291,881330,22961,2.50000000
CN2501900000000,25,019,"Nantucket County/town, MA",Sep-22,8620,8397,223,2.60000000
CN2502100000000,25,021,"Norfolk County, MA",Sep-22,389542,378523,11019,2.80000000
CN2502300000000,25,023,"Plymouth County, MA",Sep-22,279765,270750,9015,3.20000000
CN2502500000000,25,025,"Suffolk County, MA",Sep-22,449235,435695,13540,3.00000000
CN2502700000000,25,027,"Worcester County, MA",Sep-22,431569,417365,14204,3.30000000
CN2600100000000,26,001,"Alcona County, MI",Sep-22,3987,3764,223,5.60000000
CN2600300000000,26,003,"Alger County, MI",Sep-22,3398,3203,195,5.70000000
CN2600500000000,26,005,"Allegan County, MI",Sep-22,62764,60735,2029,3.20000000
CN2600700000000,26,007,"Alpena County, MI",Sep-22,13637,13082,555,4.10000000
CN2600900000000,26,009,"Antrim County, MI",Sep-22,10316,9811,505,4.90000000
CN2601100000000,26,011,"Arenac County, MI",Sep-22,5923,5566,357,6.00000000
CN2601300000000,26,013,"Baraga County, MI",Sep-22,3121,2935,186,6.00000000
CN2601500000000,26,015,"Barry County, MI",Sep-22,31978,30910,1068,3.30000000
CN2601700000000,26,017,"Bay County, MI",Sep-22,48732,46538,2194,4.50000000
CN2601900000000,26,019,"Benzie County, MI",Sep-22,9000,8635,365,4.10000000
CN2602100000000,26,021,"Berrien County, MI",Sep-22,71099,68138,2961,4.20000000
CN2602300000000,26,023,"Branch County, MI",Sep-22,19411,18669,742,3.80000000
CN2602500000000,26,025,"Calhoun County, MI",Sep-22,59934,57122,2812,4.70000000
CN2602700000000,26,027,"Cass County, MI",Sep-22,24049,23100,949,3.90000000
CN2602900000000,26,029,"Charlevoix County, MI",Sep-22,12603,12116,487,3.90000000
CN2603100000000,26,031,"Cheboygan County, MI",Sep-22,10711,10289,422,3.90000000
CN2603300000000,26,033,"Chippewa County, MI",Sep-22,16700,15928,772,4.60000000
CN2603500000000,26,035,"Clare County, MI",Sep-22,11465,10776,689,6.00000000
CN2603700000000,26,037,"Clinton County, MI",Sep-22,40766,39418,1348,3.30000000
CN2603900000000,26,039,"Crawford County, MI",Sep-22,5484,5173,311,5.70000000
CN2604100000000,26,041,"Delta County, MI",Sep-22,16725,15983,742,4.40000000
CN2604300000000,26,043,"Dickinson County, MI",Sep-22,12166,11702,464,3.80000000
CN2604500000000,26,045,"Eaton County, MI",Sep-22,56143,54131,2012,3.60000000
CN2604700000000,26,047,"Emmet County, MI",Sep-22,16985,16288,697,4.10000000
CN2604900000000,26,049,"Genesee County, MI",Sep-22,176161,166441,9720,5.50000000
CN2605100000000,26,051,"Gladwin County, MI",Sep-22,9928,9398,530,5.30000000
CN2605300000000,26,053,"Gogebic County, MI",Sep-22,5605,5364,241,4.30000000
CN2605500000000,26,055,"Grand Traverse County, MI",Sep-22,51024,49393,1631,3.20000000
CN2605700000000,26,057,"Gratiot County, MI",Sep-22,17390,16704,686,3.90000000
CN2605900000000,26,059,"Hillsdale County, MI",Sep-22,20060,19244,816,4.10000000
CN2606100000000,26,061,"Houghton County, MI",Sep-22,16500,15846,654,4.00000000
CN2606300000000,26,063,"Huron County, MI",Sep-22,15257,14668,589,3.90000000
CN2606500000000,26,065,"Ingham County, MI",Sep-22,147157,141416,5741,3.90000000
CN2606700000000,26,067,"Ionia County, MI",Sep-22,30389,29367,1022,3.40000000
CN2606900000000,26,069,"Iosco County, MI",Sep-22,10531,9984,547,5.20000000
CN2607100000000,26,071,"Iron County, MI",Sep-22,4866,4636,230,4.70000000
CN2607300000000,26,073,"Isabella County, MI",Sep-22,33339,31978,1361,4.10000000
CN2607500000000,26,075,"Jackson County, MI",Sep-22,72714,69777,2937,4.00000000
CN2607700000000,26,077,"Kalamazoo County, MI",Sep-22,131669,126778,4891,3.70000000
CN2607900000000,26,079,"Kalkaska County, MI",Sep-22,8085,7688,397,4.90000000
CN2608100000000,26,081,"Kent County, MI",Sep-22,360243,348584,11659,3.20000000
CN2608300000000,26,083,"Keweenaw County, MI",Sep-22,927,879,48,5.20000000
CN2608500000000,26,085,"Lake County, MI",Sep-22,4272,4025,247,5.80000000
CN2608700000000,26,087,"Lapeer County, MI",Sep-22,40452,39202,1250,3.10000000
CN2608900000000,26,089,"Leelanau County, MI",Sep-22,10734,10359,375,3.50000000
CN2609100000000,26,091,"Lenawee County, MI",Sep-22,44595,42840,1755,3.90000000
CN2609300000000,26,093,"Livingston County, MI",Sep-22,103515,101309,2206,2.10000000
CN2609500000000,26,095,"Luce County, MI",Sep-22,2177,2069,108,5.00000000
CN2609700000000,26,097,"Mackinac County, MI",Sep-22,5885,5721,164,2.80000000
CN2609900000000,26,099,"Macomb County, MI",Sep-22,444194,429067,15127,3.40000000
CN2610100000000,26,101,"Manistee County, MI",Sep-22,10450,9930,520,5.00000000
CN2610300000000,26,103,"Marquette County, MI",Sep-22,31702,30373,1329,4.20000000
CN2610500000000,26,105,"Mason County, MI",Sep-22,13395,12800,595,4.40000000
CN2610700000000,26,107,"Mecosta County, MI",Sep-22,18975,18091,884,4.70000000
CN2610900000000,26,109,"Menominee County, MI",Sep-22,10594,10207,387,3.70000000
CN2611100000000,26,111,"Midland County, MI",Sep-22,38806,37293,1513,3.90000000
CN2611300000000,26,113,"Missaukee County, MI",Sep-22,7003,6722,281,4.00000000
CN2611500000000,26,115,"Monroe County, MI",Sep-22,73498,70321,3177,4.30000000
CN2611700000000,26,117,"Montcalm County, MI",Sep-22,27965,26861,1104,3.90000000
CN2611900000000,26,119,"Montmorency County, MI",Sep-22,3092,2889,203,6.60000000
CN2612100000000,26,121,"Muskegon County, MI",Sep-22,77108,73083,4025,5.20000000
CN2612300000000,26,123,"Newaygo County, MI",Sep-22,23769,22812,957,4.00000000
CN2612500000000,26,125,"Oakland County, MI",Sep-22,669112,652664,16448,2.50000000
CN2612700000000,26,127,"Oceana County, MI",Sep-22,12541,11903,638,5.10000000
CN2612900000000,26,129,"Ogemaw County, MI",Sep-22,8367,7868,499,6.00000000
CN2613100000000,26,131,"Ontonagon County, MI",Sep-22,2141,2008,133,6.20000000
CN2613300000000,26,133,"Osceola County, MI",Sep-22,11935,11486,449,3.80000000
CN2613500000000,26,135,"Oscoda County, MI",Sep-22,2707,2499,208,7.70000000
CN2613700000000,26,137,"Otsego County, MI",Sep-22,11686,11156,530,4.50000000
CN2613900000000,26,139,"Ottawa County, MI",Sep-22,162762,157865,4897,3.00000000
CN2614100000000,26,141,"Presque Isle County, MI",Sep-22,5072,4795,277,5.50000000
CN2614300000000,26,143,"Roscommon County, MI",Sep-22,7558,6977,581,7.70000000
CN2614500000000,26,145,"Saginaw County, MI",Sep-22,82229,77876,4353,5.30000000
CN2614700000000,26,147,"St. Clair County, MI",Sep-22,74809,72518,2291,3.10000000
CN2614900000000,26,149,"St. Joseph County, MI",Sep-22,28326,27155,1171,4.10000000
CN2615100000000,26,151,"Sanilac County, MI",Sep-22,19683,18807,876,4.50000000
CN2615300000000,26,153,"Schoolcraft County, MI",Sep-22,3264,3074,190,5.80000000
CN2615500000000,26,155,"Shiawassee County, MI",Sep-22,32524,31232,1292,4.00000000
CN2615700000000,26,157,"Tuscola County, MI",Sep-22,23144,22109,1035,4.50000000
CN2615900000000,26,159,"Van Buren County, MI",Sep-22,34822,33323,1499,4.30000000
CN2616100000000,26,161,"Washtenaw County, MI",Sep-22,196854,190280,6574,3.30000000
CN2616300000000,26,163,"Wayne County, MI",Sep-22,792005,760310,31695,4.00000000
CN2616500000000,26,165,"Wexford County, MI",Sep-22,14744,14097,647,4.40000000
CN2700100000000,27,001,"Aitkin County, MN",Sep-22,7290,7117,173,2.40000000
CN2700300000000,27,003,"Anoka County, MN",Sep-22,200373,196615,3758,1.90000000
CN2700500000000,27,005,"Becker County, MN",Sep-22,18369,18050,319,1.70000000
CN2700700000000,27,007,"Beltrami County, MN",Sep-22,23804,23345,459,1.90000000
CN2700900000000,27,009,"Benton County, MN",Sep-22,21537,21123,414,1.90000000
CN2701100000000,27,011,"Big Stone County, MN",Sep-22,2324,2284,40,1.70000000
CN2701300000000,27,013,"Blue Earth County, MN",Sep-22,39656,39109,547,1.40000000
CN2701500000000,27,015,"Brown County, MN",Sep-22,13154,12932,222,1.70000000
CN2701700000000,27,017,"Carlton County, MN",Sep-22,17364,17005,359,2.10000000
CN2701900000000,27,019,"Carver County, MN",Sep-22,59798,58921,877,1.50000000
CN2702100000000,27,021,"Cass County, MN",Sep-22,16728,16398,330,2.00000000
CN2702300000000,27,023,"Chippewa County, MN",Sep-22,6258,6163,95,1.50000000
CN2702500000000,27,025,"Chisago County, MN",Sep-22,30055,29496,559,1.90000000
CN2702700000000,27,027,"Clay County, MN",Sep-22,36650,36148,502,1.40000000
CN2702900000000,27,029,"Clearwater County, MN",Sep-22,4423,4293,130,2.90000000
CN2703100000000,27,031,"Cook County, MN",Sep-22,2949,2893,56,1.90000000
CN2703300000000,27,033,"Cottonwood County, MN",Sep-22,6491,6374,117,1.80000000
CN2703500000000,27,035,"Crow Wing County, MN",Sep-22,31887,31283,604,1.90000000
CN2703700000000,27,037,"Dakota County, MN",Sep-22,244480,240323,4157,1.70000000
CN2703900000000,27,039,"Dodge County, MN",Sep-22,11843,11682,161,1.40000000
CN2704100000000,27,041,"Douglas County, MN",Sep-22,20783,20488,295,1.40000000
CN2704300000000,27,043,"Faribault County, MN",Sep-22,6745,6613,132,2.00000000
CN2704500000000,27,045,"Fillmore County, MN",Sep-22,11332,11163,169,1.50000000
CN2704700000000,27,047,"Freeborn County, MN",Sep-22,14827,14543,284,1.90000000
CN2704900000000,27,049,"Goodhue County, MN",Sep-22,25844,25393,451,1.70000000
CN2705100000000,27,051,"Grant County, MN",Sep-22,3085,3046,39,1.30000000
CN2705300000000,27,053,"Hennepin County, MN",Sep-22,712214,698700,13514,1.90000000
CN2705500000000,27,055,"Houston County, MN",Sep-22,10153,10007,146,1.40000000
CN2705700000000,27,057,"Hubbard County, MN",Sep-22,10137,9907,230,2.30000000
CN2705900000000,27,059,"Isanti County, MN",Sep-22,21754,21332,422,1.90000000
CN2706100000000,27,061,"Itasca County, MN",Sep-22,20475,19958,517,2.50000000
CN2706300000000,27,063,"Jackson County, MN",Sep-22,5187,5111,76,1.50000000
CN2706500000000,27,065,"Kanabec County, MN",Sep-22,8933,8742,191,2.10000000
CN2706700000000,27,067,"Kandiyohi County, MN",Sep-22,22165,21769,396,1.80000000
CN2706900000000,27,069,"Kittson County, MN",Sep-22,2139,2101,38,1.80000000
CN2707100000000,27,071,"Koochiching County, MN",Sep-22,5446,5305,141,2.60000000
CN2707300000000,27,073,"Lac qui Parle County, MN",Sep-22,3160,3114,46,1.50000000
CN2707500000000,27,075,"Lake County, MN",Sep-22,5446,5197,249,4.60000000
CN2707700000000,27,077,"Lake of the Woods County, MN",Sep-22,2294,2236,58,2.50000000
CN2707900000000,27,079,"Le Sueur County, MN",Sep-22,15800,15541,259,1.60000000
CN2708100000000,27,081,"Lincoln County, MN",Sep-22,2809,2768,41,1.50000000
CN2708300000000,27,083,"Lyon County, MN",Sep-22,13572,13360,212,1.60000000
CN2708500000000,27,085,"McLeod County, MN",Sep-22,18450,18120,330,1.80000000
CN2708700000000,27,087,"Mahnomen County, MN",Sep-22,2122,2058,64,3.00000000
CN2708900000000,27,089,"Marshall County, MN",Sep-22,5060,4976,84,1.70000000
CN2709100000000,27,091,"Martin County, MN",Sep-22,9004,8852,152,1.70000000
CN2709300000000,27,093,"Meeker County, MN",Sep-22,12811,12610,201,1.60000000
CN2709500000000,27,095,"Mille Lacs County, MN",Sep-22,12571,12291,280,2.20000000
CN2709700000000,27,097,"Morrison County, MN",Sep-22,16835,16502,333,2.00000000
CN2709900000000,27,099,"Mower County, MN",Sep-22,20018,19672,346,1.70000000
CN2710100000000,27,101,"Murray County, MN",Sep-22,4374,4310,64,1.50000000
CN2710300000000,27,103,"Nicollet County, MN",Sep-22,20362,20101,261,1.30000000
CN2710500000000,27,105,"Nobles County, MN",Sep-22,10870,10722,148,1.40000000
CN2710700000000,27,107,"Norman County, MN",Sep-22,3079,3015,64,2.10000000
CN2710900000000,27,109,"Olmsted County, MN",Sep-22,91681,90289,1392,1.50000000
CN2711100000000,27,111,"Otter Tail County, MN",Sep-22,30434,29968,466,1.50000000
CN2711300000000,27,113,"Pennington County, MN",Sep-22,8508,8353,155,1.80000000
CN2711500000000,27,115,"Pine County, MN",Sep-22,13852,13545,307,2.20000000
CN2711700000000,27,117,"Pipestone County, MN",Sep-22,4327,4261,66,1.50000000
CN2711900000000,27,119,"Polk County, MN",Sep-22,15453,15175,278,1.80000000
CN2712100000000,27,121,"Pope County, MN",Sep-22,6138,6055,83,1.40000000
CN2712300000000,27,123,"Ramsey County, MN",Sep-22,288234,282406,5828,2.00000000
CN2712500000000,27,125,"Red Lake County, MN",Sep-22,2117,2072,45,2.10000000
CN2712700000000,27,127,"Redwood County, MN",Sep-22,7125,7007,118,1.70000000
CN2712900000000,27,129,"Renville County, MN",Sep-22,7964,7780,184,2.30000000
CN2713100000000,27,131,"Rice County, MN",Sep-22,36200,35634,566,1.60000000
CN2713300000000,27,133,"Rock County, MN",Sep-22,5881,5816,65,1.10000000
CN2713500000000,27,135,"Roseau County, MN",Sep-22,7654,7535,119,1.60000000
CN2713700000000,27,137,"St. Louis County, MN",Sep-22,99529,97367,2162,2.20000000
CN2713900000000,27,139,"Scott County, MN",Sep-22,85118,83786,1332,1.60000000
CN2714100000000,27,141,"Sherburne County, MN",Sep-22,53378,52435,943,1.80000000
CN2714300000000,27,143,"Sibley County, MN",Sep-22,7999,7846,153,1.90000000
CN2714500000000,27,145,"Stearns County, MN",Sep-22,89464,87965,1499,1.70000000
CN2714700000000,27,147,"Steele County, MN",Sep-22,18852,18496,356,1.90000000
CN2714900000000,27,149,"Stevens County, MN",Sep-22,5058,4998,60,1.20000000
CN2715100000000,27,151,"Swift County, MN",Sep-22,4486,4404,82,1.80000000
CN2715300000000,27,153,"Todd County, MN",Sep-22,12854,12624,230,1.80000000
CN2715500000000,27,155,"Traverse County, MN",Sep-22,1554,1538,16,1.00000000
CN2715700000000,27,157,"Wabasha County, MN",Sep-22,12084,11907,177,1.50000000
CN2715900000000,27,159,"Wadena County, MN",Sep-22,5747,5612,135,2.30000000
CN2716100000000,27,161,"Waseca County, MN",Sep-22,8481,8301,180,2.10000000
CN2716300000000,27,163,"Washington County, MN",Sep-22,146170,143805,2365,1.60000000
CN2716500000000,27,165,"Watonwan County, MN",Sep-22,6119,6030,89,1.50000000
CN2716700000000,27,167,"Wilkin County, MN",Sep-22,3224,3177,47,1.50000000
CN2716900000000,27,169,"Winona County, MN",Sep-22,26928,26534,394,1.50000000
CN2717100000000,27,171,"Wright County, MN",Sep-22,76976,75796,1180,1.50000000
CN2717300000000,27,173,"Yellow Medicine County, MN",Sep-22,4745,4667,78,1.60000000
CN2800100000000,28,001,"Adams County, MS",Sep-22,10458,9906,552,5.30000000
CN2800300000000,28,003,"Alcorn County, MS",Sep-22,15104,14602,502,3.30000000
CN2800500000000,28,005,"Amite County, MS",Sep-22,4304,4075,229,5.30000000
CN2800700000000,28,007,"Attala County, MS",Sep-22,7050,6772,278,3.90000000
CN2800900000000,28,009,"Benton County, MS",Sep-22,3134,2985,149,4.80000000
CN2801100000000,28,011,"Bolivar County, MS",Sep-22,11043,10528,515,4.70000000
CN2801300000000,28,013,"Calhoun County, MS",Sep-22,5360,5147,213,4.00000000
CN2801500000000,28,015,"Carroll County, MS",Sep-22,3506,3363,143,4.10000000
CN2801700000000,28,017,"Chickasaw County, MS",Sep-22,6831,6517,314,4.60000000
CN2801900000000,28,019,"Choctaw County, MS",Sep-22,3619,3503,116,3.20000000
CN2802100000000,28,021,"Claiborne County, MS",Sep-22,2898,2636,262,9.00000000
CN2802300000000,28,023,"Clarke County, MS",Sep-22,5559,5309,250,4.50000000
CN2802500000000,28,025,"Clay County, MS",Sep-22,8171,7783,388,4.70000000
CN2802700000000,28,027,"Coahoma County, MS",Sep-22,7636,7189,447,5.90000000
CN2802900000000,28,029,"Copiah County, MS",Sep-22,10565,10104,461,4.40000000
CN2803100000000,28,031,"Covington County, MS",Sep-22,8211,7958,253,3.10000000
CN2803300000000,28,033,"DeSoto County, MS",Sep-22,96149,93322,2827,2.90000000
CN2803500000000,28,035,"Forrest County, MS",Sep-22,33342,32160,1182,3.50000000
CN2803700000000,28,037,"Franklin County, MS",Sep-22,2601,2469,132,5.10000000
CN2803900000000,28,039,"George County, MS",Sep-22,8487,8069,418,4.90000000
CN2804100000000,28,041,"Greene County, MS",Sep-22,4125,3882,243,5.90000000
CN2804300000000,28,043,"Grenada County, MS",Sep-22,9210,8895,315,3.40000000
CN2804500000000,28,045,"Hancock County, MS",Sep-22,19270,18546,724,3.80000000
CN2804700000000,28,047,"Harrison County, MS",Sep-22,88427,85291,3136,3.50000000
CN2804900000000,28,049,"Hinds County, MS",Sep-22,100429,96466,3963,3.90000000
CN2805100000000,28,051,"Holmes County, MS",Sep-22,4924,4588,336,6.80000000
CN2805300000000,28,053,"Humphreys County, MS",Sep-22,1896,1737,159,8.40000000
CN2805500000000,28,055,"Issaquena County, MS",Sep-22,311,287,24,7.70000000
CN2805700000000,28,057,"Itawamba County, MS",Sep-22,10260,9945,315,3.10000000
CN2805900000000,28,059,"Jackson County, MS",Sep-22,59239,56811,2428,4.10000000
CN2806100000000,28,061,"Jasper County, MS",Sep-22,5678,5395,283,5.00000000
CN2806300000000,28,063,"Jefferson County, MS",Sep-22,1871,1609,262,14.00000000
CN2806500000000,28,065,"Jefferson Davis County, MS",Sep-22,3837,3644,193,5.00000000
CN2806700000000,28,067,"Jones County, MS",Sep-22,24283,23330,953,3.90000000
CN2806900000000,28,069,"Kemper County, MS",Sep-22,3198,2996,202,6.30000000
CN2807100000000,28,071,"Lafayette County, MS",Sep-22,30162,29344,818,2.70000000
CN2807300000000,28,073,"Lamar County, MS",Sep-22,31712,30835,877,2.80000000
CN2807500000000,28,075,"Lauderdale County, MS",Sep-22,28591,27500,1091,3.80000000
CN2807700000000,28,077,"Lawrence County, MS",Sep-22,4602,4387,215,4.70000000
CN2807900000000,28,079,"Leake County, MS",Sep-22,7843,7546,297,3.80000000
CN2808100000000,28,081,"Lee County, MS",Sep-22,41027,39737,1290,3.10000000
CN2808300000000,28,083,"Leflore County, MS",Sep-22,9924,9411,513,5.20000000
CN2808500000000,28,085,"Lincoln County, MS",Sep-22,14505,13998,507,3.50000000
CN2808700000000,28,087,"Lowndes County, MS",Sep-22,25448,24450,998,3.90000000
CN2808900000000,28,089,"Madison County, MS",Sep-22,52574,51039,1535,2.90000000
CN2809100000000,28,091,"Marion County, MS",Sep-22,10341,9955,386,3.70000000
CN2809300000000,28,093,"Marshall County, MS",Sep-22,14595,14052,543,3.70000000
CN2809500000000,28,095,"Monroe County, MS",Sep-22,16004,15433,571,3.60000000
CN2809700000000,28,097,"Montgomery County, MS",Sep-22,3868,3708,160,4.10000000
CN2809900000000,28,099,"Neshoba County, MS",Sep-22,9842,9453,389,4.00000000
CN2810100000000,28,101,"Newton County, MS",Sep-22,8204,7899,305,3.70000000
CN2810300000000,28,103,"Noxubee County, MS",Sep-22,3438,3214,224,6.50000000
CN2810500000000,28,105,"Oktibbeha County, MS",Sep-22,22958,22121,837,3.60000000
CN2810700000000,28,107,"Panola County, MS",Sep-22,12521,11958,563,4.50000000
CN2810900000000,28,109,"Pearl River County, MS",Sep-22,23683,22821,862,3.60000000
CN2811100000000,28,111,"Perry County, MS",Sep-22,4237,4047,190,4.50000000
CN2811300000000,28,113,"Pike County, MS",Sep-22,14175,13499,676,4.80000000
CN2811500000000,28,115,"Pontotoc County, MS",Sep-22,14984,14505,479,3.20000000
CN2811700000000,28,117,"Prentiss County, MS",Sep-22,11417,11075,342,3.00000000
CN2811900000000,28,119,"Quitman County, MS",Sep-22,2256,2127,129,5.70000000
CN2812100000000,28,121,"Rankin County, MS",Sep-22,75375,73316,2059,2.70000000
CN2812300000000,28,123,"Scott County, MS",Sep-22,12251,11876,375,3.10000000
CN2812500000000,28,125,"Sharkey County, MS",Sep-22,1303,1228,75,5.80000000
CN2812700000000,28,127,"Simpson County, MS",Sep-22,10384,10012,372,3.60000000
CN2812900000000,28,129,"Smith County, MS",Sep-22,6495,6277,218,3.40000000
CN2813100000000,28,131,"Stone County, MS",Sep-22,6946,6689,257,3.70000000
CN2813300000000,28,133,"Sunflower County, MS",Sep-22,7255,6812,443,6.10000000
CN2813500000000,28,135,"Tallahatchie County, MS",Sep-22,4530,4353,177,3.90000000
CN2813700000000,28,137,"Tate County, MS",Sep-22,12381,11937,444,3.60000000
CN2813900000000,28,139,"Tippah County, MS",Sep-22,9867,9566,301,3.10000000
CN2814100000000,28,141,"Tishomingo County, MS",Sep-22,8300,8019,281,3.40000000
CN2814300000000,28,143,"Tunica County, MS",Sep-22,4233,4032,201,4.70000000
CN2814500000000,28,145,"Union County, MS",Sep-22,14503,14106,397,2.70000000
CN2814700000000,28,147,"Walthall County, MS",Sep-22,4917,4674,243,4.90000000
CN2814900000000,28,149,"Warren County, MS",Sep-22,19068,18274,794,4.20000000
CN2815100000000,28,151,"Washington County, MS",Sep-22,15242,14405,837,5.50000000
CN2815300000000,28,153,"Wayne County, MS",Sep-22,7282,6943,339,4.70000000
CN2815500000000,28,155,"Webster County, MS",Sep-22,3960,3812,148,3.70000000
CN2815700000000,28,157,"Wilkinson County, MS",Sep-22,2571,2394,177,6.90000000
CN2815900000000,28,159,"Winston County, MS",Sep-22,6986,6678,308,4.40000000
CN2816100000000,28,161,"Yalobusha County, MS",Sep-22,5051,4867,184,3.60000000
CN2816300000000,28,163,"Yazoo County, MS",Sep-22,8706,8288,418,4.80000000
CN2900100000000,29,001,"Adair County, MO",Sep-22,10063,9860,203,2.00000000
CN2900300000000,29,003,"Andrew County, MO",Sep-22,9559,9429,130,1.40000000
CN2900500000000,29,005,"Atchison County, MO",Sep-22,2656,2615,41,1.50000000
CN2900700000000,29,007,"Audrain County, MO",Sep-22,10017,9793,224,2.20000000
CN2900900000000,29,009,"Barry County, MO",Sep-22,14459,14194,265,1.80000000
CN2901100000000,29,011,"Barton County, MO",Sep-22,5232,5144,88,1.70000000
CN2901300000000,29,013,"Bates County, MO",Sep-22,7561,7429,132,1.70000000
CN2901500000000,29,015,"Benton County, MO",Sep-22,7351,7166,185,2.50000000
CN2901700000000,29,017,"Bollinger County, MO",Sep-22,5262,5160,102,1.90000000
CN2901900000000,29,019,"Boone County, MO",Sep-22,100743,99327,1416,1.40000000
CN2902100000000,29,021,"Buchanan County, MO",Sep-22,42928,42202,726,1.70000000
CN2902300000000,29,023,"Butler County, MO",Sep-22,18228,17875,353,1.90000000
CN2902500000000,29,025,"Caldwell County, MO",Sep-22,4208,4133,75,1.80000000
CN2902700000000,29,027,"Callaway County, MO",Sep-22,21196,20856,340,1.60000000
CN2902900000000,29,029,"Camden County, MO",Sep-22,19684,19291,393,2.00000000
CN2903100000000,29,031,"Cape Girardeau County, MO",Sep-22,40190,39534,656,1.60000000
CN2903300000000,29,033,"Carroll County, MO",Sep-22,4381,4304,77,1.80000000
CN2903500000000,29,035,"Carter County, MO",Sep-22,2540,2488,52,2.00000000
CN2903700000000,29,037,"Cass County, MO",Sep-22,54420,53478,942,1.70000000
CN2903900000000,29,039,"Cedar County, MO",Sep-22,5768,5659,109,1.90000000
CN2904100000000,29,041,"Chariton County, MO",Sep-22,3733,3682,51,1.40000000
CN2904300000000,29,043,"Christian County, MO",Sep-22,46781,46102,679,1.50000000
CN2904500000000,29,045,"Clark County, MO",Sep-22,3034,2960,74,2.40000000
CN2904700000000,29,047,"Clay County, MO",Sep-22,137368,134929,2439,1.80000000
CN2904900000000,29,049,"Clinton County, MO",Sep-22,10507,10320,187,1.80000000
CN2905100000000,29,051,"Cole County, MO",Sep-22,38471,37933,538,1.40000000
CN2905300000000,29,053,"Cooper County, MO",Sep-22,7171,7054,117,1.60000000
CN2905500000000,29,055,"Crawford County, MO",Sep-22,10900,10698,202,1.90000000
CN2905700000000,29,057,"Dade County, MO",Sep-22,3513,3461,52,1.50000000
CN2905900000000,29,059,"Dallas County, MO",Sep-22,7134,6997,137,1.90000000
CN2906100000000,29,061,"Daviess County, MO",Sep-22,4020,3955,65,1.60000000
CN2906300000000,29,063,"DeKalb County, MO",Sep-22,4115,4039,76,1.80000000
CN2906500000000,29,065,"Dent County, MO",Sep-22,6114,5978,136,2.20000000
CN2906700000000,29,067,"Douglas County, MO",Sep-22,5113,5019,94,1.80000000
CN2906900000000,29,069,"Dunklin County, MO",Sep-22,11162,10828,334,3.00000000
CN2907100000000,29,071,"Franklin County, MO",Sep-22,52804,51948,856,1.60000000
CN2907300000000,29,073,"Gasconade County, MO",Sep-22,7653,7534,119,1.60000000
CN2907500000000,29,075,"Gentry County, MO",Sep-22,3239,3196,43,1.30000000
CN2907700000000,29,077,"Greene County, MO",Sep-22,153247,150898,2349,1.50000000
CN2907900000000,29,079,"Grundy County, MO",Sep-22,4102,4024,78,1.90000000
CN2908100000000,29,081,"Harrison County, MO",Sep-22,3749,3690,59,1.60000000
CN2908300000000,29,083,"Henry County, MO",Sep-22,10255,10078,177,1.70000000
CN2908500000000,29,085,"Hickory County, MO",Sep-22,4168,4097,71,1.70000000
CN2908700000000,29,087,"Holt County, MO",Sep-22,2477,2448,29,1.20000000
CN2908900000000,29,089,"Howard County, MO",Sep-22,4726,4649,77,1.60000000
CN2909100000000,29,091,"Howell County, MO",Sep-22,16075,15717,358,2.20000000
CN2909300000000,29,093,"Iron County, MO",Sep-22,3494,3390,104,3.00000000
CN2909500000000,29,095,"Jackson County, MO",Sep-22,356554,348538,8016,2.20000000
CN2909700000000,29,097,"Jasper County, MO",Sep-22,57338,56341,997,1.70000000
CN2909900000000,29,099,"Jefferson County, MO",Sep-22,117702,115717,1985,1.70000000
CN2910100000000,29,101,"Johnson County, MO",Sep-22,22900,22485,415,1.80000000
CN2910300000000,29,103,"Knox County, MO",Sep-22,1731,1702,29,1.70000000
CN2910500000000,29,105,"Laclede County, MO",Sep-22,16540,16237,303,1.80000000
CN2910700000000,29,107,"Lafayette County, MO",Sep-22,16620,16316,304,1.80000000
CN2910900000000,29,109,"Lawrence County, MO",Sep-22,17175,16887,288,1.70000000
CN2911100000000,29,111,"Lewis County, MO",Sep-22,4766,4686,80,1.70000000
CN2911300000000,29,113,"Lincoln County, MO",Sep-22,29185,28675,510,1.70000000
CN2911500000000,29,115,"Linn County, MO",Sep-22,5183,5079,104,2.00000000
CN2911700000000,29,117,"Livingston County, MO",Sep-22,7270,7175,95,1.30000000
CN2911900000000,29,119,"McDonald County, MO",Sep-22,10878,10689,189,1.70000000
CN2912100000000,29,121,"Macon County, MO",Sep-22,7240,7123,117,1.60000000
CN2912300000000,29,123,"Madison County, MO",Sep-22,5397,5286,111,2.10000000
CN2912500000000,29,125,"Maries County, MO",Sep-22,3861,3796,65,1.70000000
CN2912700000000,29,127,"Marion County, MO",Sep-22,13837,13607,230,1.70000000
CN2912900000000,29,129,"Mercer County, MO",Sep-22,1759,1729,30,1.70000000
CN2913100000000,29,131,"Miller County, MO",Sep-22,13040,12831,209,1.60000000
CN2913300000000,29,133,"Mississippi County, MO",Sep-22,5258,5133,125,2.40000000
CN2913500000000,29,135,"Moniteau County, MO",Sep-22,6973,6873,100,1.40000000
CN2913700000000,29,137,"Monroe County, MO",Sep-22,3863,3793,70,1.80000000
CN2913900000000,29,139,"Montgomery County, MO",Sep-22,5881,5783,98,1.70000000
CN2914100000000,29,141,"Morgan County, MO",Sep-22,8709,8540,169,1.90000000
CN2914300000000,29,143,"New Madrid County, MO",Sep-22,8241,8059,182,2.20000000
CN2914500000000,29,145,"Newton County, MO",Sep-22,27161,26684,477,1.80000000
CN2914700000000,29,147,"Nodaway County, MO",Sep-22,11265,11098,167,1.50000000
CN2914900000000,29,149,"Oregon County, MO",Sep-22,3797,3714,83,2.20000000
CN2915100000000,29,151,"Osage County, MO",Sep-22,6943,6851,92,1.30000000
CN2915300000000,29,153,"Ozark County, MO",Sep-22,3520,3429,91,2.60000000
CN2915500000000,29,155,"Pemiscot County, MO",Sep-22,5903,5723,180,3.00000000
CN2915700000000,29,157,"Perry County, MO",Sep-22,9543,9401,142,1.50000000
CN2915900000000,29,159,"Pettis County, MO",Sep-22,20317,19954,363,1.80000000
CN2916100000000,29,161,"Phelps County, MO",Sep-22,20286,19949,337,1.70000000
CN2916300000000,29,163,"Pike County, MO",Sep-22,7266,7150,116,1.60000000
CN2916500000000,29,165,"Platte County, MO",Sep-22,59482,58521,961,1.60000000
CN2916700000000,29,167,"Polk County, MO",Sep-22,14547,14268,279,1.90000000
CN2916900000000,29,169,"Pulaski County, MO",Sep-22,14572,14267,305,2.10000000
CN2917100000000,29,171,"Putnam County, MO",Sep-22,2186,2152,34,1.60000000
CN2917300000000,29,173,"Ralls County, MO",Sep-22,5450,5364,86,1.60000000
CN2917500000000,29,175,"Randolph County, MO",Sep-22,10308,10117,191,1.90000000
CN2917700000000,29,177,"Ray County, MO",Sep-22,10725,10512,213,2.00000000
CN2917900000000,29,179,"Reynolds County, MO",Sep-22,2908,2844,64,2.20000000
CN2918100000000,29,181,"Ripley County, MO",Sep-22,5172,5056,116,2.20000000
CN2918300000000,29,183,"St. Charles County, MO",Sep-22,229117,225721,3396,1.50000000
CN2918500000000,29,185,"St. Clair County, MO",Sep-22,3830,3753,77,2.00000000
CN2918600000000,29,186,"Ste. Genevieve County, MO",Sep-22,9492,9346,146,1.50000000
CN2918700000000,29,187,"St. Francois County, MO",Sep-22,25549,24919,630,2.50000000
CN2918900000000,29,189,"St. Louis County, MO",Sep-22,525596,515916,9680,1.80000000
CN2919500000000,29,195,"Saline County, MO",Sep-22,10359,10178,181,1.70000000
CN2919700000000,29,197,"Schuyler County, MO",Sep-22,1830,1804,26,1.40000000
CN2919900000000,29,199,"Scotland County, MO",Sep-22,2306,2272,34,1.50000000
CN2920100000000,29,201,"Scott County, MO",Sep-22,20128,19788,340,1.70000000
CN2920300000000,29,203,"Shannon County, MO",Sep-22,3348,3269,79,2.40000000
CN2920500000000,29,205,"Shelby County, MO",Sep-22,2979,2939,40,1.30000000
CN2920700000000,29,207,"Stoddard County, MO",Sep-22,13247,12983,264,2.00000000
CN2920900000000,29,209,"Stone County, MO",Sep-22,13779,13455,324,2.40000000
CN2921100000000,29,211,"Sullivan County, MO",Sep-22,2507,2461,46,1.80000000
CN2921300000000,29,213,"Taney County, MO",Sep-22,26567,25910,657,2.50000000
CN2921500000000,29,215,"Texas County, MO",Sep-22,9287,9091,196,2.10000000
CN2921700000000,29,217,"Vernon County, MO",Sep-22,9129,8965,164,1.80000000
CN2921900000000,29,219,"Warren County, MO",Sep-22,18729,18400,329,1.80000000
CN2922100000000,29,221,"Washington County, MO",Sep-22,10116,9895,221,2.20000000
CN2922300000000,29,223,"Wayne County, MO",Sep-22,4798,4681,117,2.40000000
CN2922500000000,29,225,"Webster County, MO",Sep-22,17420,17149,271,1.60000000
CN2922700000000,29,227,"Worth County, MO",Sep-22,1167,1152,15,1.30000000
CN2922900000000,29,229,"Wright County, MO",Sep-22,7686,7534,152,2.00000000
CN2951000000000,29,510,"St. Louis city, MO",Sep-22,148631,144855,3776,2.50000000
CN3000100000000,30,001,"Beaverhead County, MT",Sep-22,5184,5083,101,1.90000000
CN3000300000000,30,003,"Big Horn County, MT",Sep-22,4751,4531,220,4.60000000
CN3000500000000,30,005,"Blaine County, MT",Sep-22,2165,2103,62,2.90000000
CN3000700000000,30,007,"Broadwater County, MT",Sep-22,2748,2662,86,3.10000000
CN3000900000000,30,009,"Carbon County, MT",Sep-22,5840,5703,137,2.30000000
CN3001100000000,30,011,"Carter County, MT",Sep-22,645,632,13,2.00000000
CN3001300000000,30,013,"Cascade County, MT",Sep-22,38825,37892,933,2.40000000
CN3001500000000,30,015,"Chouteau County, MT",Sep-22,2360,2301,59,2.50000000
CN3001700000000,30,017,"Custer County, MT",Sep-22,6499,6371,128,2.00000000
CN3001900000000,30,019,"Daniels County, MT",Sep-22,854,837,17,2.00000000
CN3002100000000,30,021,"Dawson County, MT",Sep-22,4587,4498,89,1.90000000
CN3002300000000,30,023,"Deer Lodge County, MT",Sep-22,5364,5257,107,2.00000000
CN3002500000000,30,025,"Fallon County, MT",Sep-22,1651,1629,22,1.30000000
CN3002700000000,30,027,"Fergus County, MT",Sep-22,5898,5774,124,2.10000000
CN3002900000000,30,029,"Flathead County, MT",Sep-22,52208,50888,1320,2.50000000
CN3003100000000,30,031,"Gallatin County, MT",Sep-22,79008,77666,1342,1.70000000
CN3003300000000,30,033,"Garfield County, MT",Sep-22,701,687,14,2.00000000
CN3003500000000,30,035,"Glacier County, MT",Sep-22,6048,5785,263,4.30000000
CN3003700000000,30,037,"Golden Valley County, MT",Sep-22,369,361,8,2.20000000
CN3003900000000,30,039,"Granite County, MT",Sep-22,1664,1618,46,2.80000000
CN3004100000000,30,041,"Hill County, MT",Sep-22,7586,7416,170,2.20000000
CN3004300000000,30,043,"Jefferson County, MT",Sep-22,6074,5938,136,2.20000000
CN3004500000000,30,045,"Judith Basin County, MT",Sep-22,971,947,24,2.50000000
CN3004700000000,30,047,"Lake County, MT",Sep-22,14369,13987,382,2.70000000
CN3004900000000,30,049,"Lewis and Clark County, MT",Sep-22,38644,37830,814,2.10000000
CN3005100000000,30,051,"Liberty County, MT",Sep-22,931,907,24,2.60000000
CN3005300000000,30,053,"Lincoln County, MT",Sep-22,8492,8167,325,3.80000000
CN3005500000000,30,055,"McCone County, MT",Sep-22,926,909,17,1.80000000
CN3005700000000,30,057,"Madison County, MT",Sep-22,4697,4596,101,2.20000000
CN3005900000000,30,059,"Meagher County, MT",Sep-22,978,960,18,1.80000000
CN3006100000000,30,061,"Mineral County, MT",Sep-22,1856,1782,74,4.00000000
CN3006300000000,30,063,"Missoula County, MT",Sep-22,67096,65600,1496,2.20000000
CN3006500000000,30,065,"Musselshell County, MT",Sep-22,2351,2287,64,2.70000000
CN3006700000000,30,067,"Park County, MT",Sep-22,10613,10374,239,2.30000000
CN3006900000000,30,069,"Petroleum County, MT",Sep-22,259,251,8,3.10000000
CN3007100000000,30,071,"Phillips County, MT",Sep-22,1784,1731,53,3.00000000
CN3007300000000,30,073,"Pondera County, MT",Sep-22,2539,2482,57,2.20000000
CN3007500000000,30,075,"Powder River County, MT",Sep-22,980,962,18,1.80000000
CN3007700000000,30,077,"Powell County, MT",Sep-22,2978,2914,64,2.10000000
CN3007900000000,30,079,"Prairie County, MT",Sep-22,474,465,9,1.90000000
CN3008100000000,30,081,"Ravalli County, MT",Sep-22,21765,21243,522,2.40000000
CN3008300000000,30,083,"Richland County, MT",Sep-22,5601,5450,151,2.70000000
CN3008500000000,30,085,"Roosevelt County, MT",Sep-22,4256,4126,130,3.10000000
CN3008700000000,30,087,"Rosebud County, MT",Sep-22,3513,3409,104,3.00000000
CN3008900000000,30,089,"Sanders County, MT",Sep-22,5405,5226,179,3.30000000
CN3009100000000,30,091,"Sheridan County, MT",Sep-22,1727,1695,32,1.90000000
CN3009300000000,30,093,"Silver Bow County, MT",Sep-22,18011,17568,443,2.50000000
CN3009500000000,30,095,"Stillwater County, MT",Sep-22,5487,5373,114,2.10000000
CN3009700000000,30,097,"Sweet Grass County, MT",Sep-22,1898,1862,36,1.90000000
CN3009900000000,30,099,"Teton County, MT",Sep-22,2735,2671,64,2.30000000
CN3010100000000,30,101,"Toole County, MT",Sep-22,2041,2000,41,2.00000000
CN3010300000000,30,103,"Treasure County, MT",Sep-22,351,344,7,2.00000000
CN3010500000000,30,105,"Valley County, MT",Sep-22,3904,3822,82,2.10000000
CN3010700000000,30,107,"Wheatland County, MT",Sep-22,707,686,21,3.00000000
CN3010900000000,30,109,"Wibaux County, MT",Sep-22,447,438,9,2.00000000
CN3011100000000,30,111,"Yellowstone County, MT",Sep-22,88315,86398,1917,2.20000000
CN3100100000000,31,001,"Adams County, NE",Sep-22,17084,16783,301,1.80000000
CN3100300000000,31,003,"Antelope County, NE",Sep-22,3590,3534,56,1.60000000
CN3100500000000,31,005,"Arthur County, NE",Sep-22,224,219,5,2.20000000
CN3100700000000,31,007,"Banner County, NE",Sep-22,380,367,13,3.40000000
CN3100900000000,31,009,"Blaine County, NE",Sep-22,244,236,8,3.30000000
CN3101100000000,31,011,"Boone County, NE",Sep-22,2912,2865,47,1.60000000
CN3101300000000,31,013,"Box Butte County, NE",Sep-22,5276,5171,105,2.00000000
CN3101500000000,31,015,"Boyd County, NE",Sep-22,1022,1000,22,2.20000000
CN3101700000000,31,017,"Brown County, NE",Sep-22,1391,1363,28,2.00000000
CN3101900000000,31,019,"Buffalo County, NE",Sep-22,28219,27714,505,1.80000000
CN3102100000000,31,021,"Burt County, NE",Sep-22,3589,3517,72,2.00000000
CN3102300000000,31,023,"Butler County, NE",Sep-22,4583,4506,77,1.70000000
CN3102500000000,31,025,"Cass County, NE",Sep-22,13783,13497,286,2.10000000
CN3102700000000,31,027,"Cedar County, NE",Sep-22,4648,4576,72,1.50000000
CN3102900000000,31,029,"Chase County, NE",Sep-22,2244,2208,36,1.60000000
CN3103100000000,31,031,"Cherry County, NE",Sep-22,3403,3348,55,1.60000000
CN3103300000000,31,033,"Cheyenne County, NE",Sep-22,4211,4122,89,2.10000000
CN3103500000000,31,035,"Clay County, NE",Sep-22,3058,3002,56,1.80000000
CN3103700000000,31,037,"Colfax County, NE",Sep-22,5728,5632,96,1.70000000
CN3103900000000,31,039,"Cuming County, NE",Sep-22,4920,4840,80,1.60000000
CN3104100000000,31,041,"Custer County, NE",Sep-22,6303,6215,88,1.40000000
CN3104300000000,31,043,"Dakota County, NE",Sep-22,10897,10674,223,2.00000000
CN3104500000000,31,045,"Dawes County, NE",Sep-22,5107,5027,80,1.60000000
CN3104700000000,31,047,"Dawson County, NE",Sep-22,13437,13155,282,2.10000000
CN3104900000000,31,049,"Deuel County, NE",Sep-22,980,958,22,2.20000000
CN3105100000000,31,051,"Dixon County, NE",Sep-22,2985,2936,49,1.60000000
CN3105300000000,31,053,"Dodge County, NE",Sep-22,20541,20161,380,1.80000000
CN3105500000000,31,055,"Douglas County, NE",Sep-22,309015,301847,7168,2.30000000
CN3105700000000,31,057,"Dundy County, NE",Sep-22,1121,1104,17,1.50000000
CN3105900000000,31,059,"Fillmore County, NE",Sep-22,3262,3207,55,1.70000000
CN3106100000000,31,061,"Franklin County, NE",Sep-22,1484,1453,31,2.10000000
CN3106300000000,31,063,"Frontier County, NE",Sep-22,1484,1459,25,1.70000000
CN3106500000000,31,065,"Furnas County, NE",Sep-22,2510,2466,44,1.80000000
CN3106700000000,31,067,"Gage County, NE",Sep-22,11127,10903,224,2.00000000
CN3106900000000,31,069,"Garden County, NE",Sep-22,1049,1027,22,2.10000000
CN3107100000000,31,071,"Garfield County, NE",Sep-22,1121,1101,20,1.80000000
CN3107300000000,31,073,"Gosper County, NE",Sep-22,1192,1168,24,2.00000000
CN3107500000000,31,075,"Grant County, NE",Sep-22,410,404,6,1.50000000
CN3107700000000,31,077,"Greeley County, NE",Sep-22,1196,1174,22,1.80000000
CN3107900000000,31,079,"Hall County, NE",Sep-22,32131,31470,661,2.10000000
CN3108100000000,31,081,"Hamilton County, NE",Sep-22,4800,4712,88,1.80000000
CN3108300000000,31,083,"Harlan County, NE",Sep-22,1787,1757,30,1.70000000
CN3108500000000,31,085,"Hayes County, NE",Sep-22,599,591,8,1.30000000
CN3108700000000,31,087,"Hitchcock County, NE",Sep-22,1300,1275,25,1.90000000
CN3108900000000,31,089,"Holt County, NE",Sep-22,5621,5521,100,1.80000000
CN3109100000000,31,091,"Hooker County, NE",Sep-22,459,450,9,2.00000000
CN3109300000000,31,093,"Howard County, NE",Sep-22,3391,3335,56,1.70000000
CN3109500000000,31,095,"Jefferson County, NE",Sep-22,4125,4054,71,1.70000000
CN3109700000000,31,097,"Johnson County, NE",Sep-22,2025,1975,50,2.50000000
CN3109900000000,31,099,"Kearney County, NE",Sep-22,3753,3690,63,1.70000000
CN3110100000000,31,101,"Keith County, NE",Sep-22,4708,4636,72,1.50000000
CN3110300000000,31,103,"Keya Paha County, NE",Sep-22,568,557,11,1.90000000
CN3110500000000,31,105,"Kimball County, NE",Sep-22,1952,1919,33,1.70000000
CN3110700000000,31,107,"Knox County, NE",Sep-22,4632,4552,80,1.70000000
CN3110900000000,31,109,"Lancaster County, NE",Sep-22,182094,178644,3450,1.90000000
CN3111100000000,31,111,"Lincoln County, NE",Sep-22,18458,18105,353,1.90000000
CN3111300000000,31,113,"Logan County, NE",Sep-22,475,467,8,1.70000000
CN3111500000000,31,115,"Loup County, NE",Sep-22,400,391,9,2.30000000
CN3111700000000,31,117,"McPherson County, NE",Sep-22,418,412,6,1.40000000
CN3111900000000,31,119,"Madison County, NE",Sep-22,20000,19650,350,1.80000000
CN3112100000000,31,121,"Merrick County, NE",Sep-22,4090,4013,77,1.90000000
CN3112300000000,31,123,"Morrill County, NE",Sep-22,2621,2574,47,1.80000000
CN3112500000000,31,125,"Nance County, NE",Sep-22,1918,1883,35,1.80000000
CN3112700000000,31,127,"Nemaha County, NE",Sep-22,3646,3569,77,2.10000000
CN3112900000000,31,129,"Nuckolls County, NE",Sep-22,2455,2413,42,1.70000000
CN3113100000000,31,131,"Otoe County, NE",Sep-22,8563,8400,163,1.90000000
CN3113300000000,31,133,"Pawnee County, NE",Sep-22,1508,1480,28,1.90000000
CN3113500000000,31,135,"Perkins County, NE",Sep-22,1844,1817,27,1.50000000
CN3113700000000,31,137,"Phelps County, NE",Sep-22,4900,4815,85,1.70000000
CN3113900000000,31,139,"Pierce County, NE",Sep-22,4185,4119,66,1.60000000
CN3114100000000,31,141,"Platte County, NE",Sep-22,18342,18027,315,1.70000000
CN3114300000000,31,143,"Polk County, NE",Sep-22,2879,2829,50,1.70000000
CN3114500000000,31,145,"Red Willow County, NE",Sep-22,5974,5869,105,1.80000000
CN3114700000000,31,147,"Richardson County, NE",Sep-22,4176,4098,78,1.90000000
CN3114900000000,31,149,"Rock County, NE",Sep-22,884,873,11,1.20000000
CN3115100000000,31,151,"Saline County, NE",Sep-22,7176,7032,144,2.00000000
CN3115300000000,31,153,"Sarpy County, NE",Sep-22,100656,98695,1961,1.90000000
CN3115500000000,31,155,"Saunders County, NE",Sep-22,11678,11468,210,1.80000000
CN3115700000000,31,157,"Scotts Bluff County, NE",Sep-22,18000,17605,395,2.20000000
CN3115900000000,31,159,"Seward County, NE",Sep-22,8949,8786,163,1.80000000
CN3116100000000,31,161,"Sheridan County, NE",Sep-22,2746,2699,47,1.70000000
CN3116300000000,31,163,"Sherman County, NE",Sep-22,1642,1614,28,1.70000000
CN3116500000000,31,165,"Sioux County, NE",Sep-22,752,739,13,1.70000000
CN3116700000000,31,167,"Stanton County, NE",Sep-22,3580,3520,60,1.70000000
CN3116900000000,31,169,"Thayer County, NE",Sep-22,2700,2654,46,1.70000000
CN3117100000000,31,171,"Thomas County, NE",Sep-22,423,414,9,2.10000000
CN3117300000000,31,173,"Thurston County, NE",Sep-22,3175,3079,96,3.00000000
CN3117500000000,31,175,"Valley County, NE",Sep-22,2088,2052,36,1.70000000
CN3117700000000,31,177,"Washington County, NE",Sep-22,11554,11347,207,1.80000000
CN3117900000000,31,179,"Wayne County, NE",Sep-22,5650,5553,97,1.70000000
CN3118100000000,31,181,"Webster County, NE",Sep-22,1673,1635,38,2.30000000
CN3118300000000,31,183,"Wheeler County, NE",Sep-22,546,538,8,1.50000000
CN3118500000000,31,185,"York County, NE",Sep-22,7468,7338,130,1.70000000
CN3200100000000,32,001,"Churchill County, NV",Sep-22,10965,10588,377,3.40000000
CN3200300000000,32,003,"Clark County, NV",Sep-22,1156865,1095494,61371,5.30000000
CN3200500000000,32,005,"Douglas County, NV",Sep-22,21833,21043,790,3.60000000
CN3200700000000,32,007,"Elko County, NV",Sep-22,26093,25316,777,3.00000000
CN3200900000000,32,009,"Esmeralda County, NV",Sep-22,405,391,14,3.50000000
CN3201100000000,32,011,"Eureka County, NV",Sep-22,904,877,27,3.00000000
CN3201300000000,32,013,"Humboldt County, NV",Sep-22,7849,7608,241,3.10000000
CN3201500000000,32,015,"Lander County, NV",Sep-22,3037,2957,80,2.60000000
CN3201700000000,32,017,"Lincoln County, NV",Sep-22,2094,2018,76,3.60000000
CN3201900000000,32,019,"Lyon County, NV",Sep-22,24008,22954,1054,4.40000000
CN3202100000000,32,021,"Mineral County, NV",Sep-22,2092,2017,75,3.60000000
CN3202300000000,32,023,"Nye County, NV",Sep-22,17564,16624,940,5.40000000
CN3202700000000,32,027,"Pershing County, NV",Sep-22,2399,2319,80,3.30000000
CN3202900000000,32,029,"Storey County, NV",Sep-22,2143,2063,80,3.70000000
CN3203100000000,32,031,"Washoe County, NV",Sep-22,261832,253785,8047,3.10000000
CN3203300000000,32,033,"White Pine County, NV",Sep-22,4602,4489,113,2.50000000
CN3251000000000,32,510,"Carson City, NV",Sep-22,26054,25175,879,3.40000000
CN3300100000000,33,001,"Belknap County, NH",Sep-22,31230,30487,743,2.40000000
CN3300300000000,33,003,"Carroll County, NH",Sep-22,23777,23209,568,2.40000000
CN3300500000000,33,005,"Cheshire County, NH",Sep-22,38974,37975,999,2.60000000
CN3300700000000,33,007,"Coos County, NH",Sep-22,14317,13859,458,3.20000000
CN3300900000000,33,009,"Grafton County, NH",Sep-22,48692,47603,1089,2.20000000
CN3301100000000,33,011,"Hillsborough County, NH",Sep-22,244267,238492,5775,2.40000000
CN3301300000000,33,013,"Merrimack County, NH",Sep-22,82271,80461,1810,2.20000000
CN3301500000000,33,015,"Rockingham County, NH",Sep-22,189845,185335,4510,2.40000000
CN3301700000000,33,017,"Strafford County, NH",Sep-22,73889,72222,1667,2.30000000
CN3301900000000,33,019,"Sullivan County, NH",Sep-22,22606,22080,526,2.30000000
CN3400100000000,34,001,"Atlantic County, NJ",Sep-22,129053,124219,4834,3.70000000
CN3400300000000,34,003,"Bergen County, NJ",Sep-22,493893,481359,12534,2.50000000
CN3400500000000,34,005,"Burlington County, NJ",Sep-22,248545,242608,5937,2.40000000
CN3400700000000,34,007,"Camden County, NJ",Sep-22,271089,262728,8361,3.10000000
CN3400900000000,34,009,"Cape May County, NJ",Sep-22,50974,49260,1714,3.40000000
CN3401100000000,34,011,"Cumberland County, NJ",Sep-22,68533,65963,2570,3.80000000
CN3401300000000,34,013,"Essex County, NJ",Sep-22,382499,368509,13990,3.70000000
CN3401500000000,34,015,"Gloucester County, NJ",Sep-22,161545,157191,4354,2.70000000
CN3401700000000,34,017,"Hudson County, NJ",Sep-22,369565,358711,10854,2.90000000
CN3401900000000,34,019,"Hunterdon County, NJ",Sep-22,67411,66083,1328,2.00000000
CN3402100000000,34,021,"Mercer County, NJ",Sep-22,212100,207172,4928,2.30000000
CN3402300000000,34,023,"Middlesex County, NJ",Sep-22,457176,446019,11157,2.40000000
CN3402500000000,34,025,"Monmouth County, NJ",Sep-22,344558,336610,7948,2.30000000
CN3402700000000,34,027,"Morris County, NJ",Sep-22,264796,259213,5583,2.10000000
CN3402900000000,34,029,"Ocean County, NJ",Sep-22,294957,287288,7669,2.60000000
CN3403100000000,34,031,"Passaic County, NJ",Sep-22,247215,238183,9032,3.70000000
CN3403300000000,34,033,"Salem County, NJ",Sep-22,30040,28969,1071,3.60000000
CN3403500000000,34,035,"Somerset County, NJ",Sep-22,176577,172715,3862,2.20000000
CN3403700000000,34,037,"Sussex County, NJ",Sep-22,76564,74592,1972,2.60000000
CN3403900000000,34,039,"Union County, NJ",Sep-22,284804,276369,8435,3.00000000
CN3404100000000,34,041,"Warren County, NJ",Sep-22,59270,57908,1362,2.30000000
CN3500100000000,35,001,"Bernalillo County, NM",Sep-22,332738,319178,13560,4.10000000
CN3500300000000,35,003,"Catron County, NM",Sep-22,1167,1102,65,5.60000000
CN3500500000000,35,005,"Chaves County, NM",Sep-22,27591,26235,1356,4.90000000
CN3500600000000,35,006,"Cibola County, NM",Sep-22,8386,7865,521,6.20000000
CN3500700000000,35,007,"Colfax County, NM",Sep-22,4061,3839,222,5.50000000
CN3500900000000,35,009,"Curry County, NM",Sep-22,22262,21494,768,3.40000000
CN3501100000000,35,011,"De Baca County, NM",Sep-22,697,673,24,3.40000000
CN3501300000000,35,013,"Dona Ana County, NM",Sep-22,99778,95006,4772,4.80000000
CN3501500000000,35,015,"Eddy County, NM",Sep-22,31176,30005,1171,3.80000000
CN3501700000000,35,017,"Grant County, NM",Sep-22,11563,11031,532,4.60000000
CN3501900000000,35,019,"Guadalupe County, NM",Sep-22,1850,1758,92,5.00000000
CN3502100000000,35,021,"Harding County, NM",Sep-22,284,274,10,3.50000000
CN3502300000000,35,023,"Hidalgo County, NM",Sep-22,1907,1844,63,3.30000000
CN3502500000000,35,025,"Lea County, NM",Sep-22,27730,26175,1555,5.60000000
CN3502700000000,35,027,"Lincoln County, NM",Sep-22,8759,8365,394,4.50000000
CN3502800000000,35,028,"Los Alamos County, NM",Sep-22,10347,10106,241,2.30000000
CN3502900000000,35,029,"Luna County, NM",Sep-22,10249,9273,976,9.50000000
CN3503100000000,35,031,"McKinley County, NM",Sep-22,24392,22907,1485,6.10000000
CN3503300000000,35,033,"Mora County, NM",Sep-22,2056,1945,111,5.40000000
CN3503500000000,35,035,"Otero County, NM",Sep-22,25787,24611,1176,4.60000000
CN3503700000000,35,037,"Quay County, NM",Sep-22,2842,2700,142,5.00000000
CN3503900000000,35,039,"Rio Arriba County, NM",Sep-22,16426,15629,797,4.90000000
CN3504100000000,35,041,"Roosevelt County, NM",Sep-22,8558,8217,341,4.00000000
CN3504300000000,35,043,"Sandoval County, NM",Sep-22,67321,64379,2942,4.40000000
CN3504500000000,35,045,"San Juan County, NM",Sep-22,49034,46455,2579,5.30000000
CN3504700000000,35,047,"San Miguel County, NM",Sep-22,11089,10494,595,5.40000000
CN3504900000000,35,049,"Santa Fe County, NM",Sep-22,72615,69804,2811,3.90000000
CN3505100000000,35,051,"Sierra County, NM",Sep-22,3995,3749,246,6.20000000
CN3505300000000,35,053,"Socorro County, NM",Sep-22,6104,5815,289,4.70000000
CN3505500000000,35,055,"Taos County, NM",Sep-22,14672,13858,814,5.50000000
CN3505700000000,35,057,"Torrance County, NM",Sep-22,5409,5082,327,6.00000000
CN3505900000000,35,059,"Union County, NM",Sep-22,1575,1529,46,2.90000000
CN3506100000000,35,061,"Valencia County, NM",Sep-22,30743,29230,1513,4.90000000
CN3600100000000,36,001,"Albany County, NY",Sep-22,159393,154904,4489,2.80000000
CN3600300000000,36,003,"Allegany County, NY",Sep-22,19687,19057,630,3.20000000
CN3600500000000,36,005,"Bronx County, NY",Sep-22,582457,540782,41675,7.20000000
CN3600700000000,36,007,"Broome County, NY",Sep-22,83696,80964,2732,3.30000000
CN3600900000000,36,009,"Cattaraugus County, NY",Sep-22,32958,31816,1142,3.50000000
CN3601100000000,36,011,"Cayuga County, NY",Sep-22,35662,34630,1032,2.90000000
CN3601300000000,36,013,"Chautauqua County, NY",Sep-22,52743,50913,1830,3.50000000
CN3601500000000,36,015,"Chemung County, NY",Sep-22,34984,33792,1192,3.40000000
CN3601700000000,36,017,"Chenango County, NY",Sep-22,22048,21459,589,2.70000000
CN3601900000000,36,019,"Clinton County, NY",Sep-22,35198,34141,1057,3.00000000
CN3602100000000,36,021,"Columbia County, NY",Sep-22,30838,30108,730,2.40000000
CN3602300000000,36,023,"Cortland County, NY",Sep-22,22835,22139,696,3.00000000
CN3602500000000,36,025,"Delaware County, NY",Sep-22,19019,18433,586,3.10000000
CN3602700000000,36,027,"Dutchess County, NY",Sep-22,145642,141555,4087,2.80000000
CN3602900000000,36,029,"Erie County, NY",Sep-22,446879,431997,14882,3.30000000
CN3603100000000,36,031,"Essex County, NY",Sep-22,16778,16318,460,2.70000000
CN3603300000000,36,033,"Franklin County, NY",Sep-22,18962,18396,566,3.00000000
CN3603500000000,36,035,"Fulton County, NY",Sep-22,22725,21932,793,3.50000000
CN3603700000000,36,037,"Genesee County, NY",Sep-22,30321,29559,762,2.50000000
CN3603900000000,36,039,"Greene County, NY",Sep-22,20489,19851,638,3.10000000
CN3604100000000,36,041,"Hamilton County, NY",Sep-22,2320,2258,62,2.70000000
CN3604300000000,36,043,"Herkimer County, NY",Sep-22,27797,26892,905,3.30000000
CN3604500000000,36,045,"Jefferson County, NY",Sep-22,45102,43648,1454,3.20000000
CN3604700000000,36,047,"Kings County, NY",Sep-22,1167087,1104078,63009,5.40000000
CN3604900000000,36,049,"Lewis County, NY",Sep-22,11822,11486,336,2.80000000
CN3605100000000,36,051,"Livingston County, NY",Sep-22,30550,29708,842,2.80000000
CN3605300000000,36,053,"Madison County, NY",Sep-22,33011,32098,913,2.80000000
CN3605500000000,36,055,"Monroe County, NY",Sep-22,367714,355817,11897,3.20000000
CN3605700000000,36,057,"Montgomery County, NY",Sep-22,22322,21500,822,3.70000000
CN3605900000000,36,059,"Nassau County, NY",Sep-22,733012,713501,19511,2.70000000
CN3606100000000,36,061,"New York County, NY",Sep-22,887531,850670,36861,4.20000000
CN3606300000000,36,063,"Niagara County, NY",Sep-22,98520,95212,3308,3.40000000
CN3606500000000,36,065,"Oneida County, NY",Sep-22,102000,98747,3253,3.20000000
CN3606700000000,36,067,"Onondaga County, NY",Sep-22,225117,218269,6848,3.00000000
CN3606900000000,36,069,"Ontario County, NY",Sep-22,56191,54744,1447,2.60000000
CN3607100000000,36,071,"Orange County, NY",Sep-22,191260,185669,5591,2.90000000
CN3607300000000,36,073,"Orleans County, NY",Sep-22,17363,16814,549,3.20000000
CN3607500000000,36,075,"Oswego County, NY",Sep-22,53009,51123,1886,3.60000000
CN3607700000000,36,077,"Otsego County, NY",Sep-22,27722,26948,774,2.80000000
CN3607900000000,36,079,"Putnam County, NY",Sep-22,51637,50251,1386,2.70000000
CN3608100000000,36,081,"Queens County, NY",Sep-22,1102123,1049791,52332,4.70000000
CN3608300000000,36,083,"Rensselaer County, NY",Sep-22,82176,79864,2312,2.80000000
CN3608500000000,36,085,"Richmond County, NY",Sep-22,219326,208686,10640,4.90000000
CN3608700000000,36,087,"Rockland County, NY",Sep-22,159478,155331,4147,2.60000000
CN3608900000000,36,089,"St. Lawrence County, NY",Sep-22,42960,41500,1460,3.40000000
CN3609100000000,36,091,"Saratoga County, NY",Sep-22,121500,118607,2893,2.40000000
CN3609300000000,36,093,"Schenectady County, NY",Sep-22,77926,75496,2430,3.10000000
CN3609500000000,36,095,"Schoharie County, NY",Sep-22,14739,14323,416,2.80000000
CN3609700000000,36,097,"Schuyler County, NY",Sep-22,8270,8045,225,2.70000000
CN3609900000000,36,099,"Seneca County, NY",Sep-22,15525,15124,401,2.60000000
CN3610100000000,36,101,"Steuben County, NY",Sep-22,41697,40435,1262,3.00000000
CN3610300000000,36,103,"Suffolk County, NY",Sep-22,804601,782153,22448,2.80000000
CN3610500000000,36,105,"Sullivan County, NY",Sep-22,38245,37155,1090,2.90000000
CN3610700000000,36,107,"Tioga County, NY",Sep-22,22670,22075,595,2.60000000
CN3610900000000,36,109,"Tompkins County, NY",Sep-22,49899,48615,1284,2.60000000
CN3611100000000,36,111,"Ulster County, NY",Sep-22,88844,86395,2449,2.80000000
CN3611300000000,36,113,"Warren County, NY",Sep-22,31421,30572,849,2.70000000
CN3611500000000,36,115,"Washington County, NY",Sep-22,27837,27099,738,2.70000000
CN3611700000000,36,117,"Wayne County, NY",Sep-22,43899,42705,1194,2.70000000
CN3611900000000,36,119,"Westchester County, NY",Sep-22,496390,481946,14444,2.90000000
CN3612100000000,36,121,"Wyoming County, NY",Sep-22,18449,17991,458,2.50000000
CN3612300000000,36,123,"Yates County, NY",Sep-22,11803,11521,282,2.40000000
CN3700100000000,37,001,"Alamance County, NC",Sep-22,83099,80333,2766,3.30000000
CN3700300000000,37,003,"Alexander County, NC",Sep-22,17678,17182,496,2.80000000
CN3700500000000,37,005,"Alleghany County, NC",Sep-22,4397,4255,142,3.20000000
CN3700700000000,37,007,"Anson County, NC",Sep-22,10154,9728,426,4.20000000
CN3700900000000,37,009,"Ashe County, NC",Sep-22,13266,12871,395,3.00000000
CN3701100000000,37,011,"Avery County, NC",Sep-22,7816,7603,213,2.70000000
CN3701300000000,37,013,"Beaufort County, NC",Sep-22,19711,19028,683,3.50000000
CN3701500000000,37,015,"Bertie County, NC",Sep-22,7295,6976,319,4.40000000
CN3701700000000,37,017,"Bladen County, NC",Sep-22,14005,13416,589,4.20000000
CN3701900000000,37,019,"Brunswick County, NC",Sep-22,56361,54011,2350,4.20000000
CN3702100000000,37,021,"Buncombe County, NC",Sep-22,140806,137129,3677,2.60000000
CN3702300000000,37,023,"Burke County, NC",Sep-22,40169,38926,1243,3.10000000
CN3702500000000,37,025,"Cabarrus County, NC",Sep-22,115181,111641,3540,3.10000000
CN3702700000000,37,027,"Caldwell County, NC",Sep-22,35773,34628,1145,3.20000000
CN3702900000000,37,029,"Camden County, NC",Sep-22,4593,4448,145,3.20000000
CN3703100000000,37,031,"Carteret County, NC",Sep-22,31743,30800,943,3.00000000
CN3703300000000,37,033,"Caswell County, NC",Sep-22,9772,9425,347,3.60000000
CN3703500000000,37,035,"Catawba County, NC",Sep-22,78089,75651,2438,3.10000000
CN3703700000000,37,037,"Chatham County, NC",Sep-22,38094,37069,1025,2.70000000
CN3703900000000,37,039,"Cherokee County, NC",Sep-22,10851,10472,379,3.50000000
CN3704100000000,37,041,"Chowan County, NC",Sep-22,5615,5405,210,3.70000000
CN3704300000000,37,043,"Clay County, NC",Sep-22,4014,3863,151,3.80000000
CN3704500000000,37,045,"Cleveland County, NC",Sep-22,48131,46389,1742,3.60000000
CN3704700000000,37,047,"Columbus County, NC",Sep-22,22932,22003,929,4.10000000
CN3704900000000,37,049,"Craven County, NC",Sep-22,41027,39654,1373,3.30000000
CN3705100000000,37,051,"Cumberland County, NC",Sep-22,128435,122174,6261,4.90000000
CN3705300000000,37,053,"Currituck County, NC",Sep-22,14584,14171,413,2.80000000
CN3705500000000,37,055,"Dare County, NC",Sep-22,21122,20492,630,3.00000000
CN3705700000000,37,057,"Davidson County, NC",Sep-22,80494,77978,2516,3.10000000
CN3705900000000,37,059,"Davie County, NC",Sep-22,20512,19895,617,3.00000000
CN3706100000000,37,061,"Duplin County, NC",Sep-22,24157,23367,790,3.30000000
CN3706300000000,37,063,"Durham County, NC",Sep-22,182055,177061,4994,2.70000000
CN3706500000000,37,065,"Edgecombe County, NC",Sep-22,19896,18547,1349,6.80000000
CN3706700000000,37,067,"Forsyth County, NC",Sep-22,186520,180189,6331,3.40000000
CN3706900000000,37,069,"Franklin County, NC",Sep-22,33623,32545,1078,3.20000000
CN3707100000000,37,071,"Gaston County, NC",Sep-22,113827,109980,3847,3.40000000
CN3707300000000,37,073,"Gates County, NC",Sep-22,5100,4933,167,3.30000000
CN3707500000000,37,075,"Graham County, NC",Sep-22,3026,2892,134,4.40000000
CN3707700000000,37,077,"Granville County, NC",Sep-22,30304,29454,850,2.80000000
CN3707900000000,37,079,"Greene County, NC",Sep-22,9408,9131,277,2.90000000
CN3708100000000,37,081,"Guilford County, NC",Sep-22,260338,250516,9822,3.80000000
CN3708300000000,37,083,"Halifax County, NC",Sep-22,18903,17836,1067,5.60000000
CN3708500000000,37,085,"Harnett County, NC",Sep-22,54817,52769,2048,3.70000000
CN3708700000000,37,087,"Haywood County, NC",Sep-22,29901,29080,821,2.70000000
CN3708900000000,37,089,"Henderson County, NC",Sep-22,55010,53482,1528,2.80000000
CN3709100000000,37,091,"Hertford County, NC",Sep-22,8476,8077,399,4.70000000
CN3709300000000,37,093,"Hoke County, NC",Sep-22,20411,19441,970,4.80000000
CN3709500000000,37,095,"Hyde County, NC",Sep-22,1818,1746,72,4.00000000
CN3709700000000,37,097,"Iredell County, NC",Sep-22,93867,91013,2854,3.00000000
CN3709900000000,37,099,"Jackson County, NC",Sep-22,20135,19493,642,3.20000000
CN3710100000000,37,101,"Johnston County, NC",Sep-22,106962,103775,3187,3.00000000
CN3710300000000,37,103,"Jones County, NC",Sep-22,4197,4070,127,3.00000000
CN3710500000000,37,105,"Lee County, NC",Sep-22,26100,25100,1000,3.80000000
CN3710700000000,37,107,"Lenoir County, NC",Sep-22,27032,26135,897,3.30000000
CN3710900000000,37,109,"Lincoln County, NC",Sep-22,46014,44761,1253,2.70000000
CN3711100000000,37,111,"McDowell County, NC",Sep-22,19669,19042,627,3.20000000
CN3711300000000,37,113,"Macon County, NC",Sep-22,15753,15276,477,3.00000000
CN3711500000000,37,115,"Madison County, NC",Sep-22,9983,9683,300,3.00000000
CN3711700000000,37,117,"Martin County, NC",Sep-22,8551,8204,347,4.10000000
CN3711900000000,37,119,"Mecklenburg County, NC",Sep-22,647714,626842,20872,3.20000000
CN3712100000000,37,121,"Mitchell County, NC",Sep-22,5926,5710,216,3.60000000
CN3712300000000,37,123,"Montgomery County, NC",Sep-22,11450,11077,373,3.30000000
CN3712500000000,37,125,"Moore County, NC",Sep-22,40700,39369,1331,3.30000000
CN3712700000000,37,127,"Nash County, NC",Sep-22,41444,39423,2021,4.90000000
CN3712900000000,37,129,"New Hanover County, NC",Sep-22,127822,124081,3741,2.90000000
CN3713100000000,37,131,"Northampton County, NC",Sep-22,7080,6773,307,4.30000000
CN3713300000000,37,133,"Onslow County, NC",Sep-22,66726,64139,2587,3.90000000
CN3713500000000,37,135,"Orange County, NC",Sep-22,82951,80800,2151,2.60000000
CN3713700000000,37,137,"Pamlico County, NC",Sep-22,5349,5181,168,3.10000000
CN3713900000000,37,139,"Pasquotank County, NC",Sep-22,16444,15794,650,4.00000000
CN3714100000000,37,141,"Pender County, NC",Sep-22,30318,29378,940,3.10000000
CN3714300000000,37,143,"Perquimans County, NC",Sep-22,4881,4695,186,3.80000000
CN3714500000000,37,145,"Person County, NC",Sep-22,19101,18484,617,3.20000000
CN3714700000000,37,147,"Pitt County, NC",Sep-22,88545,85287,3258,3.70000000
CN3714900000000,37,149,"Polk County, NC",Sep-22,9480,9176,304,3.20000000
CN3715100000000,37,151,"Randolph County, NC",Sep-22,65324,63179,2145,3.30000000
CN3715300000000,37,153,"Richmond County, NC",Sep-22,16253,15412,841,5.20000000
CN3715500000000,37,155,"Robeson County, NC",Sep-22,47500,44905,2595,5.50000000
CN3715700000000,37,157,"Rockingham County, NC",Sep-22,39464,37981,1483,3.80000000
CN3715900000000,37,159,"Rowan County, NC",Sep-22,67213,65022,2191,3.30000000
CN3716100000000,37,161,"Rutherford County, NC",Sep-22,24129,23048,1081,4.50000000
CN3716300000000,37,163,"Sampson County, NC",Sep-22,28053,27138,915,3.30000000
CN3716500000000,37,165,"Scotland County, NC",Sep-22,10953,10239,714,6.50000000
CN3716700000000,37,167,"Stanly County, NC",Sep-22,30307,29395,912,3.00000000
CN3716900000000,37,169,"Stokes County, NC",Sep-22,21413,20781,632,3.00000000
CN3717100000000,37,171,"Surry County, NC",Sep-22,31508,30524,984,3.10000000
CN3717300000000,37,173,"Swain County, NC",Sep-22,7376,7175,201,2.70000000
CN3717500000000,37,175,"Transylvania County, NC",Sep-22,14812,14372,440,3.00000000
CN3717700000000,37,177,"Tyrrell County, NC",Sep-22,1375,1312,63,4.60000000
CN3717900000000,37,179,"Union County, NC",Sep-22,129391,125722,3669,2.80000000
CN3718100000000,37,181,"Vance County, NC",Sep-22,16556,15580,976,5.90000000
CN3718300000000,37,183,"Wake County, NC",Sep-22,625147,607958,17189,2.70000000
CN3718500000000,37,185,"Warren County, NC",Sep-22,6621,6114,507,7.70000000
CN3718700000000,37,187,"Washington County, NC",Sep-22,4327,4123,204,4.70000000
CN3718900000000,37,189,"Watauga County, NC",Sep-22,29265,28430,835,2.90000000
CN3719100000000,37,191,"Wayne County, NC",Sep-22,51040,49241,1799,3.50000000
CN3719300000000,37,193,"Wilkes County, NC",Sep-22,26608,25697,911,3.40000000
CN3719500000000,37,195,"Wilson County, NC",Sep-22,32362,30709,1653,5.10000000
CN3719700000000,37,197,"Yadkin County, NC",Sep-22,17404,16893,511,2.90000000
CN3719900000000,37,199,"Yancey County, NC",Sep-22,8371,8088,283,3.40000000
CN3800100000000,38,001,"Adams County, ND",Sep-22,912,896,16,1.80000000
CN3800300000000,38,003,"Barnes County, ND",Sep-22,5337,5255,82,1.50000000
CN3800500000000,38,005,"Benson County, ND",Sep-22,2391,2332,59,2.50000000
CN3800700000000,38,007,"Billings County, ND",Sep-22,519,514,5,1.00000000
CN3800900000000,38,009,"Bottineau County, ND",Sep-22,3032,2965,67,2.20000000
CN3801100000000,38,011,"Bowman County, ND",Sep-22,1548,1529,19,1.20000000
CN3801300000000,38,013,"Burke County, ND",Sep-22,1049,1033,16,1.50000000
CN3801500000000,38,015,"Burleigh County, ND",Sep-22,51556,50783,773,1.50000000
CN3801700000000,38,017,"Cass County, ND",Sep-22,108254,106785,1469,1.40000000
CN3801900000000,38,019,"Cavalier County, ND",Sep-22,1857,1825,32,1.70000000
CN3802100000000,38,021,"Dickey County, ND",Sep-22,2201,2173,28,1.30000000
CN3802300000000,38,023,"Divide County, ND",Sep-22,1371,1359,12,0.90000000
CN3802500000000,38,025,"Dunn County, ND",Sep-22,3372,3338,34,1.00000000
CN3802700000000,38,027,"Eddy County, ND",Sep-22,1204,1178,26,2.20000000
CN3802900000000,38,029,"Emmons County, ND",Sep-22,1436,1389,47,3.30000000
CN3803100000000,38,031,"Foster County, ND",Sep-22,1502,1482,20,1.30000000
CN3803300000000,38,033,"Golden Valley County, ND",Sep-22,844,827,17,2.00000000
CN3803500000000,38,035,"Grand Forks County, ND",Sep-22,36838,36294,544,1.50000000
CN3803700000000,38,037,"Grant County, ND",Sep-22,1196,1180,16,1.30000000
CN3803900000000,38,039,"Griggs County, ND",Sep-22,1028,1016,12,1.20000000
CN3804100000000,38,041,"Hettinger County, ND",Sep-22,1435,1418,17,1.20000000
CN3804300000000,38,043,"Kidder County, ND",Sep-22,1311,1273,38,2.90000000
CN3804500000000,38,045,"LaMoure County, ND",Sep-22,2105,2079,26,1.20000000
CN3804700000000,38,047,"Logan County, ND",Sep-22,855,842,13,1.50000000
CN3804900000000,38,049,"McHenry County, ND",Sep-22,3123,3049,74,2.40000000
CN3805100000000,38,051,"McIntosh County, ND",Sep-22,1040,1025,15,1.40000000
CN3805300000000,38,053,"McKenzie County, ND",Sep-22,9385,9220,165,1.80000000
CN3805500000000,38,055,"McLean County, ND",Sep-22,4695,4586,109,2.30000000
CN3805700000000,38,057,"Mercer County, ND",Sep-22,3647,3552,95,2.60000000
CN3805900000000,38,059,"Morton County, ND",Sep-22,16932,16621,311,1.80000000
CN3806100000000,38,061,"Mountrail County, ND",Sep-22,6333,6252,81,1.30000000
CN3806300000000,38,063,"Nelson County, ND",Sep-22,1489,1457,32,2.10000000
CN3806500000000,38,065,"Oliver County, ND",Sep-22,873,857,16,1.80000000
CN3806700000000,38,067,"Pembina County, ND",Sep-22,3242,3155,87,2.70000000
CN3806900000000,38,069,"Pierce County, ND",Sep-22,1653,1617,36,2.20000000
CN3807100000000,38,071,"Ramsey County, ND",Sep-22,5608,5511,97,1.70000000
CN3807300000000,38,073,"Ransom County, ND",Sep-22,2661,2622,39,1.50000000
CN3807500000000,38,075,"Renville County, ND",Sep-22,1225,1205,20,1.60000000
CN3807700000000,38,077,"Richland County, ND",Sep-22,8692,8566,126,1.40000000
CN3807900000000,38,079,"Rolette County, ND",Sep-22,4736,4475,261,5.50000000
CN3808100000000,38,081,"Sargent County, ND",Sep-22,2283,2255,28,1.20000000
CN3808300000000,38,083,"Sheridan County, ND",Sep-22,647,635,12,1.90000000
CN3808500000000,38,085,"Sioux County, ND",Sep-22,1221,1194,27,2.20000000
CN3808700000000,38,087,"Slope County, ND",Sep-22,340,333,7,2.10000000
CN3808900000000,38,089,"Stark County, ND",Sep-22,17909,17609,300,1.70000000
CN3809100000000,38,091,"Steele County, ND",Sep-22,947,936,11,1.20000000
CN3809300000000,38,093,"Stutsman County, ND",Sep-22,10391,10234,157,1.50000000
CN3809500000000,38,095,"Towner County, ND",Sep-22,1118,1101,17,1.50000000
CN3809700000000,38,097,"Traill County, ND",Sep-22,4444,4375,69,1.60000000
CN3809900000000,38,099,"Walsh County, ND",Sep-22,5205,5084,121,2.30000000
CN3810100000000,38,101,"Ward County, ND",Sep-22,31720,31163,557,1.80000000
CN3810300000000,38,103,"Wells County, ND",Sep-22,1900,1860,40,2.10000000
CN3810500000000,38,105,"Williams County, ND",Sep-22,21936,21431,505,2.30000000
CN3900100000000,39,001,"Adams County, OH",Sep-22,11009,10517,492,4.50000000
CN3900300000000,39,003,"Allen County, OH",Sep-22,46684,44782,1902,4.10000000
CN3900500000000,39,005,"Ashland County, OH",Sep-22,26901,25974,927,3.40000000
CN3900700000000,39,007,"Ashtabula County, OH",Sep-22,43045,41368,1677,3.90000000
CN3900900000000,39,009,"Athens County, OH",Sep-22,27208,26098,1110,4.10000000
CN3901100000000,39,011,"Auglaize County, OH",Sep-22,24415,23666,749,3.10000000
CN3901300000000,39,013,"Belmont County, OH",Sep-22,27804,26515,1289,4.60000000
CN3901500000000,39,015,"Brown County, OH",Sep-22,19140,18375,765,4.00000000
CN3901700000000,39,017,"Butler County, OH",Sep-22,193692,187130,6562,3.40000000
CN3901900000000,39,019,"Carroll County, OH",Sep-22,12537,12025,512,4.10000000
CN3902100000000,39,021,"Champaign County, OH",Sep-22,19261,18615,646,3.40000000
CN3902300000000,39,023,"Clark County, OH",Sep-22,61458,59089,2369,3.90000000
CN3902500000000,39,025,"Clermont County, OH",Sep-22,106265,102691,3574,3.40000000
CN3902700000000,39,027,"Clinton County, OH",Sep-22,17842,17119,723,4.10000000
CN3902900000000,39,029,"Columbiana County, OH",Sep-22,45758,43822,1936,4.20000000
CN3903100000000,39,031,"Coshocton County, OH",Sep-22,13734,13104,630,4.60000000
CN3903300000000,39,033,"Crawford County, OH",Sep-22,17746,17000,746,4.20000000
CN3903500000000,39,035,"Cuyahoga County, OH",Sep-22,605547,576035,29512,4.90000000
CN3903700000000,39,037,"Darke County, OH",Sep-22,25628,24811,817,3.20000000
CN3903900000000,39,039,"Defiance County, OH",Sep-22,17709,17052,657,3.70000000
CN3904100000000,39,041,"Delaware County, OH",Sep-22,115441,112115,3326,2.90000000
CN3904300000000,39,043,"Erie County, OH",Sep-22,37158,35678,1480,4.00000000
CN3904500000000,39,045,"Fairfield County, OH",Sep-22,80108,77508,2600,3.20000000
CN3904700000000,39,047,"Fayette County, OH",Sep-22,13581,13104,477,3.50000000
CN3904900000000,39,049,"Franklin County, OH",Sep-22,707796,684211,23585,3.30000000
CN3905100000000,39,051,"Fulton County, OH",Sep-22,21878,21125,753,3.40000000
CN3905300000000,39,053,"Gallia County, OH",Sep-22,11736,11221,515,4.40000000
CN3905500000000,39,055,"Geauga County, OH",Sep-22,48642,46898,1744,3.60000000
CN3905700000000,39,057,"Greene County, OH",Sep-22,81835,79067,2768,3.40000000
CN3905900000000,39,059,"Guernsey County, OH",Sep-22,17783,17051,732,4.10000000
CN3906100000000,39,061,"Hamilton County, OH",Sep-22,410995,396366,14629,3.60000000
CN3906300000000,39,063,"Hancock County, OH",Sep-22,40654,39431,1223,3.00000000
CN3906500000000,39,065,"Hardin County, OH",Sep-22,13163,12633,530,4.00000000
CN3906700000000,39,067,"Harrison County, OH",Sep-22,6486,6195,291,4.50000000
CN3906900000000,39,069,"Henry County, OH",Sep-22,12967,12490,477,3.70000000
CN3907100000000,39,071,"Highland County, OH",Sep-22,17252,16515,737,4.30000000
CN3907300000000,39,073,"Hocking County, OH",Sep-22,12912,12430,482,3.70000000
CN3907500000000,39,075,"Holmes County, OH",Sep-22,21882,21332,550,2.50000000
CN3907700000000,39,077,"Huron County, OH",Sep-22,27670,26562,1108,4.00000000
CN3907900000000,39,079,"Jackson County, OH",Sep-22,12344,11776,568,4.60000000
CN3908100000000,39,081,"Jefferson County, OH",Sep-22,26896,25495,1401,5.20000000
CN3908300000000,39,083,"Knox County, OH",Sep-22,31171,30206,965,3.10000000
CN3908500000000,39,085,"Lake County, OH",Sep-22,125346,120472,4874,3.90000000
CN3908700000000,39,087,"Lawrence County, OH",Sep-22,23075,22077,998,4.30000000
CN3908900000000,39,089,"Licking County, OH",Sep-22,91934,88902,3032,3.30000000
CN3909100000000,39,091,"Logan County, OH",Sep-22,22091,21356,735,3.30000000
CN3909300000000,39,093,"Lorain County, OH",Sep-22,154483,147600,6883,4.50000000
CN3909500000000,39,095,"Lucas County, OH",Sep-22,206200,197111,9089,4.40000000
CN3909700000000,39,097,"Madison County, OH",Sep-22,20956,20323,633,3.00000000
CN3909900000000,39,099,"Mahoning County, OH",Sep-22,97024,92629,4395,4.50000000
CN3910100000000,39,101,"Marion County, OH",Sep-22,28422,27249,1173,4.10000000
CN3910300000000,39,103,"Medina County, OH",Sep-22,98329,94662,3667,3.70000000
CN3910500000000,39,105,"Meigs County, OH",Sep-22,8810,8357,453,5.10000000
CN3910700000000,39,107,"Mercer County, OH",Sep-22,22848,22237,611,2.70000000
CN3910900000000,39,109,"Miami County, OH",Sep-22,53182,51390,1792,3.40000000
CN3911100000000,39,111,"Monroe County, OH",Sep-22,5090,4812,278,5.50000000
CN3911300000000,39,113,"Montgomery County, OH",Sep-22,244923,235183,9740,4.00000000
CN3911500000000,39,115,"Morgan County, OH",Sep-22,6761,6462,299,4.40000000
CN3911700000000,39,117,"Morrow County, OH",Sep-22,16974,16375,599,3.50000000
CN3911900000000,39,119,"Muskingum County, OH",Sep-22,40443,38879,1564,3.90000000
CN3912100000000,39,121,"Noble County, OH",Sep-22,4559,4323,236,5.20000000
CN3912300000000,39,123,"Ottawa County, OH",Sep-22,21077,20194,883,4.20000000
CN3912500000000,39,125,"Paulding County, OH",Sep-22,8689,8402,287,3.30000000
CN3912700000000,39,127,"Perry County, OH",Sep-22,15887,15266,621,3.90000000
CN3912900000000,39,129,"Pickaway County, OH",Sep-22,26760,25839,921,3.40000000
CN3913100000000,39,131,"Pike County, OH",Sep-22,11095,10604,491,4.40000000
CN3913300000000,39,133,"Portage County, OH",Sep-22,83961,81059,2902,3.50000000
CN3913500000000,39,135,"Preble County, OH",Sep-22,21798,21122,676,3.10000000
CN3913700000000,39,137,"Putnam County, OH",Sep-22,18960,18427,533,2.80000000
CN3913900000000,39,139,"Richland County, OH",Sep-22,50929,48826,2103,4.10000000
CN3914100000000,39,141,"Ross County, OH",Sep-22,34912,33712,1200,3.40000000
CN3914300000000,39,143,"Sandusky County, OH",Sep-22,29981,28586,1395,4.70000000
CN3914500000000,39,145,"Scioto County, OH",Sep-22,29185,27807,1378,4.70000000
CN3914700000000,39,147,"Seneca County, OH",Sep-22,26615,25628,987,3.70000000
CN3914900000000,39,149,"Shelby County, OH",Sep-22,23740,22955,785,3.30000000
CN3915100000000,39,151,"Stark County, OH",Sep-22,179715,173020,6695,3.70000000
CN3915300000000,39,153,"Summit County, OH",Sep-22,261687,251630,10057,3.80000000
CN3915500000000,39,155,"Trumbull County, OH",Sep-22,81969,78149,3820,4.70000000
CN3915700000000,39,157,"Tuscarawas County, OH",Sep-22,44506,42987,1519,3.40000000
CN3915900000000,39,159,"Union County, OH",Sep-22,30215,29342,873,2.90000000
CN3916100000000,39,161,"Van Wert County, OH",Sep-22,14707,14246,461,3.10000000
CN3916300000000,39,163,"Vinton County, OH",Sep-22,5466,5240,226,4.10000000
CN3916500000000,39,165,"Warren County, OH",Sep-22,120647,116758,3889,3.20000000
CN3916700000000,39,167,"Washington County, OH",Sep-22,26913,25820,1093,4.10000000
CN3916900000000,39,169,"Wayne County, OH",Sep-22,60239,58507,1732,2.90000000
CN3917100000000,39,171,"Williams County, OH",Sep-22,18500,17944,556,3.00000000
CN3917300000000,39,173,"Wood County, OH",Sep-22,70281,67926,2355,3.40000000
CN3917500000000,39,175,"Wyandot County, OH",Sep-22,13112,12769,343,2.60000000
CN4000100000000,40,001,"Adair County, OK",Sep-22,8352,8056,296,3.50000000
CN4000300000000,40,003,"Alfalfa County, OK",Sep-22,2507,2446,61,2.40000000
CN4000500000000,40,005,"Atoka County, OK",Sep-22,5010,4789,221,4.40000000
CN4000700000000,40,007,"Beaver County, OK",Sep-22,2604,2551,53,2.00000000
CN4000900000000,40,009,"Beckham County, OK",Sep-22,9167,8874,293,3.20000000
CN4001100000000,40,011,"Blaine County, OK",Sep-22,4414,4309,105,2.40000000
CN4001300000000,40,013,"Bryan County, OK",Sep-22,23043,22366,677,2.90000000
CN4001500000000,40,015,"Caddo County, OK",Sep-22,11656,11231,425,3.60000000
CN4001700000000,40,017,"Canadian County, OK",Sep-22,80172,77927,2245,2.80000000
CN4001900000000,40,019,"Carter County, OK",Sep-22,21518,20690,828,3.80000000
CN4002100000000,40,021,"Cherokee County, OK",Sep-22,19822,19074,748,3.80000000
CN4002300000000,40,023,"Choctaw County, OK",Sep-22,5862,5567,295,5.00000000
CN4002500000000,40,025,"Cimarron County, OK",Sep-22,1463,1438,25,1.70000000
CN4002700000000,40,027,"Cleveland County, OK",Sep-22,148147,143990,4157,2.80000000
CN4002900000000,40,029,"Coal County, OK",Sep-22,2220,2144,76,3.40000000
CN4003100000000,40,031,"Comanche County, OK",Sep-22,47558,45608,1950,4.10000000
CN4003300000000,40,033,"Cotton County, OK",Sep-22,2629,2529,100,3.80000000
CN4003500000000,40,035,"Craig County, OK",Sep-22,5765,5574,191,3.30000000
CN4003700000000,40,037,"Creek County, OK",Sep-22,31796,30584,1212,3.80000000
CN4003900000000,40,039,"Custer County, OK",Sep-22,14493,14065,428,3.00000000
CN4004100000000,40,041,"Delaware County, OK",Sep-22,19043,18416,627,3.30000000
CN4004300000000,40,043,"Dewey County, OK",Sep-22,2852,2788,64,2.20000000
CN4004500000000,40,045,"Ellis County, OK",Sep-22,1975,1919,56,2.80000000
CN4004700000000,40,047,"Garfield County, OK",Sep-22,26460,25623,837,3.20000000
CN4004900000000,40,049,"Garvin County, OK",Sep-22,12772,12377,395,3.10000000
CN4005100000000,40,051,"Grady County, OK",Sep-22,27069,26229,840,3.10000000
CN4005300000000,40,053,"Grant County, OK",Sep-22,2687,2628,59,2.20000000
CN4005500000000,40,055,"Greer County, OK",Sep-22,1742,1670,72,4.10000000
CN4005700000000,40,057,"Harmon County, OK",Sep-22,1105,1069,36,3.30000000
CN4005900000000,40,059,"Harper County, OK",Sep-22,1676,1643,33,2.00000000
CN4006100000000,40,061,"Haskell County, OK",Sep-22,3906,3713,193,4.90000000
CN4006300000000,40,063,"Hughes County, OK",Sep-22,5014,4805,209,4.20000000
CN4006500000000,40,065,"Jackson County, OK",Sep-22,10572,10252,320,3.00000000
CN4006700000000,40,067,"Jefferson County, OK",Sep-22,2384,2307,77,3.20000000
CN4006900000000,40,069,"Johnston County, OK",Sep-22,3654,3498,156,4.30000000
CN4007100000000,40,071,"Kay County, OK",Sep-22,18265,17550,715,3.90000000
CN4007300000000,40,073,"Kingfisher County, OK",Sep-22,8769,8580,189,2.20000000
CN4007500000000,40,075,"Kiowa County, OK",Sep-22,3552,3430,122,3.40000000
CN4007700000000,40,077,"Latimer County, OK",Sep-22,3066,2849,217,7.10000000
CN4007900000000,40,079,"Le Flore County, OK",Sep-22,19301,18478,823,4.30000000
CN4008100000000,40,081,"Lincoln County, OK",Sep-22,16013,15471,542,3.40000000
CN4008300000000,40,083,"Logan County, OK",Sep-22,23174,22495,679,2.90000000
CN4008500000000,40,085,"Love County, OK",Sep-22,5830,5685,145,2.50000000
CN4008700000000,40,087,"McClain County, OK",Sep-22,20642,20019,623,3.00000000
CN4008900000000,40,089,"McCurtain County, OK",Sep-22,15718,15049,669,4.30000000
CN4009100000000,40,091,"McIntosh County, OK",Sep-22,7208,6816,392,5.40000000
CN4009300000000,40,093,"Major County, OK",Sep-22,3567,3465,102,2.90000000
CN4009500000000,40,095,"Marshall County, OK",Sep-22,7380,7126,254,3.40000000
CN4009700000000,40,097,"Mayes County, OK",Sep-22,19591,18937,654,3.30000000
CN4009900000000,40,099,"Murray County, OK",Sep-22,6113,5897,216,3.50000000
CN4010100000000,40,101,"Muskogee County, OK",Sep-22,28152,27047,1105,3.90000000
CN4010300000000,40,103,"Noble County, OK",Sep-22,5681,5544,137,2.40000000
CN4010500000000,40,105,"Nowata County, OK",Sep-22,4616,4476,140,3.00000000
CN4010700000000,40,107,"Okfuskee County, OK",Sep-22,4403,4210,193,4.40000000
CN4010900000000,40,109,"Oklahoma County, OK",Sep-22,397512,384483,13029,3.30000000
CN4011100000000,40,111,"Okmulgee County, OK",Sep-22,15726,15008,718,4.60000000
CN4011300000000,40,113,"Osage County, OK",Sep-22,20713,19932,781,3.80000000
CN4011500000000,40,115,"Ottawa County, OK",Sep-22,14690,14219,471,3.20000000
CN4011700000000,40,117,"Pawnee County, OK",Sep-22,7388,7096,292,4.00000000
CN4011900000000,40,119,"Payne County, OK",Sep-22,38509,37327,1182,3.10000000
CN4012100000000,40,121,"Pittsburg County, OK",Sep-22,15993,15202,791,4.90000000
CN4012300000000,40,123,"Pontotoc County, OK",Sep-22,19059,18506,553,2.90000000
CN4012500000000,40,125,"Pottawatomie County, OK",Sep-22,32828,31545,1283,3.90000000
CN4012700000000,40,127,"Pushmataha County, OK",Sep-22,4468,4282,186,4.20000000
CN4012900000000,40,129,"Roger Mills County, OK",Sep-22,1684,1635,49,2.90000000
CN4013100000000,40,131,"Rogers County, OK",Sep-22,46222,44743,1479,3.20000000
CN4013300000000,40,133,"Seminole County, OK",Sep-22,9213,8786,427,4.60000000
CN4013500000000,40,135,"Sequoyah County, OK",Sep-22,16546,15905,641,3.90000000
CN4013700000000,40,137,"Stephens County, OK",Sep-22,18575,17882,693,3.70000000
CN4013900000000,40,139,"Texas County, OK",Sep-22,11275,11067,208,1.80000000
CN4014100000000,40,141,"Tillman County, OK",Sep-22,2743,2651,92,3.40000000
CN4014300000000,40,143,"Tulsa County, OK",Sep-22,330812,319784,11028,3.30000000
CN4014500000000,40,145,"Wagoner County, OK",Sep-22,39656,38370,1286,3.20000000
CN4014700000000,40,147,"Washington County, OK",Sep-22,22102,21316,786,3.60000000
CN4014900000000,40,149,"Washita County, OK",Sep-22,4811,4640,171,3.60000000
CN4015100000000,40,151,"Woods County, OK",Sep-22,4660,4571,89,1.90000000
CN4015300000000,40,153,"Woodward County, OK",Sep-22,8206,7921,285,3.50000000
CN4100100000000,41,001,"Baker County, OR",Sep-22,7614,7302,312,4.10000000
CN4100300000000,41,003,"Benton County, OR",Sep-22,48336,46639,1697,3.50000000
CN4100500000000,41,005,"Clackamas County, OR",Sep-22,230389,222052,8337,3.60000000
CN4100700000000,41,007,"Clatsop County, OR",Sep-22,19835,19002,833,4.20000000
CN4100900000000,41,009,"Columbia County, OR",Sep-22,25468,24304,1164,4.60000000
CN4101100000000,41,011,"Coos County, OR",Sep-22,26576,25165,1411,5.30000000
CN4101300000000,41,013,"Crook County, OR",Sep-22,11477,10890,587,5.10000000
CN4101500000000,41,015,"Curry County, OR",Sep-22,9372,8880,492,5.20000000
CN4101700000000,41,017,"Deschutes County, OR",Sep-22,104832,100774,4058,3.90000000
CN4101900000000,41,019,"Douglas County, OR",Sep-22,48105,45681,2424,5.00000000
CN4102100000000,41,021,"Gilliam County, OR",Sep-22,866,834,32,3.70000000
CN4102300000000,41,023,"Grant County, OR",Sep-22,3227,3079,148,4.60000000
CN4102500000000,41,025,"Harney County, OR",Sep-22,3852,3694,158,4.10000000
CN4102700000000,41,027,"Hood River County, OR",Sep-22,15507,15040,467,3.00000000
CN4102900000000,41,029,"Jackson County, OR",Sep-22,108503,103737,4766,4.40000000
CN4103100000000,41,031,"Jefferson County, OR",Sep-22,10652,10116,536,5.00000000
CN4103300000000,41,033,"Josephine County, OR",Sep-22,37421,35491,1930,5.20000000
CN4103500000000,41,035,"Klamath County, OR",Sep-22,30503,28871,1632,5.40000000
CN4103700000000,41,037,"Lake County, OR",Sep-22,3715,3550,165,4.40000000
CN4103900000000,41,039,"Lane County, OR",Sep-22,184380,176163,8217,4.50000000
CN4104100000000,41,041,"Lincoln County, OR",Sep-22,21531,20438,1093,5.10000000
CN4104300000000,41,043,"Linn County, OR",Sep-22,61241,58501,2740,4.50000000
CN4104500000000,41,045,"Malheur County, OR",Sep-22,12678,12202,476,3.80000000
CN4104700000000,41,047,"Marion County, OR",Sep-22,169575,162739,6836,4.00000000
CN4104900000000,41,049,"Morrow County, OR",Sep-22,6177,5948,229,3.70000000
CN4105100000000,41,051,"Multnomah County, OR",Sep-22,475899,457527,18372,3.90000000
CN4105300000000,41,053,"Polk County, OR",Sep-22,42595,40880,1715,4.00000000
CN4105500000000,41,055,"Sherman County, OR",Sep-22,963,934,29,3.00000000
CN4105700000000,41,057,"Tillamook County, OR",Sep-22,12630,12104,526,4.20000000
CN4105900000000,41,059,"Umatilla County, OR",Sep-22,38903,37058,1845,4.70000000
CN4106100000000,41,061,"Union County, OR",Sep-22,12196,11666,530,4.30000000
CN4106300000000,41,063,"Wallowa County, OR",Sep-22,3802,3650,152,4.00000000
CN4106500000000,41,065,"Wasco County, OR",Sep-22,12954,12435,519,4.00000000
CN4106700000000,41,067,"Washington County, OR",Sep-22,339482,328075,11407,3.40000000
CN4106900000000,41,069,"Wheeler County, OR",Sep-22,733,713,20,2.70000000
CN4107100000000,41,071,"Yamhill County, OR",Sep-22,57367,55294,2073,3.60000000
CN4200100000000,42,001,"Adams County, PA",Sep-22,55170,53883,1287,2.30000000
CN4200300000000,42,003,"Allegheny County, PA",Sep-22,637678,616893,20785,3.30000000
CN4200500000000,42,005,"Armstrong County, PA",Sep-22,31196,30039,1157,3.70000000
CN4200700000000,42,007,"Beaver County, PA",Sep-22,82592,78983,3609,4.40000000
CN4200900000000,42,009,"Bedford County, PA",Sep-22,23735,22982,753,3.20000000
CN4201100000000,42,011,"Berks County, PA",Sep-22,211139,203840,7299,3.50000000
CN4201300000000,42,013,"Blair County, PA",Sep-22,59746,57827,1919,3.20000000
CN4201500000000,42,015,"Bradford County, PA",Sep-22,27685,26843,842,3.00000000
CN4201700000000,42,017,"Bucks County, PA",Sep-22,347945,337624,10321,3.00000000
CN4201900000000,42,019,"Butler County, PA",Sep-22,99272,96351,2921,2.90000000
CN4202100000000,42,021,"Cambria County, PA",Sep-22,55586,53417,2169,3.90000000
CN4202300000000,42,023,"Cameron County, PA",Sep-22,1953,1875,78,4.00000000
CN4202500000000,42,025,"Carbon County, PA",Sep-22,32873,31597,1276,3.90000000
CN4202700000000,42,027,"Centre County, PA",Sep-22,77837,75826,2011,2.60000000
CN4202900000000,42,029,"Chester County, PA",Sep-22,291448,284447,7001,2.40000000
CN4203100000000,42,031,"Clarion County, PA",Sep-22,16870,16280,590,3.50000000
CN4203300000000,42,033,"Clearfield County, PA",Sep-22,35167,33781,1386,3.90000000
CN4203500000000,42,035,"Clinton County, PA",Sep-22,17197,16557,640,3.70000000
CN4203700000000,42,037,"Columbia County, PA",Sep-22,33121,32019,1102,3.30000000
CN4203900000000,42,039,"Crawford County, PA",Sep-22,37437,36111,1326,3.50000000
CN4204100000000,42,041,"Cumberland County, PA",Sep-22,136953,133577,3376,2.50000000
CN4204300000000,42,043,"Dauphin County, PA",Sep-22,148495,143809,4686,3.20000000
CN4204500000000,42,045,"Delaware County, PA",Sep-22,299738,289407,10331,3.40000000
CN4204700000000,42,047,"Elk County, PA",Sep-22,14625,14099,526,3.60000000
CN4204900000000,42,049,"Erie County, PA",Sep-22,127440,122550,4890,3.80000000
CN4205100000000,42,051,"Fayette County, PA",Sep-22,55292,52705,2587,4.70000000
CN4205300000000,42,053,"Forest County, PA",Sep-22,1699,1619,80,4.70000000
CN4205500000000,42,055,"Franklin County, PA",Sep-22,77161,75050,2111,2.70000000
CN4205700000000,42,057,"Fulton County, PA",Sep-22,7020,6805,215,3.10000000
CN4205900000000,42,059,"Greene County, PA",Sep-22,15555,14930,625,4.00000000
CN4206100000000,42,061,"Huntingdon County, PA",Sep-22,19295,18519,776,4.00000000
CN4206300000000,42,063,"Indiana County, PA",Sep-22,36538,35145,1393,3.80000000
CN4206500000000,42,065,"Jefferson County, PA",Sep-22,19542,18891,651,3.30000000
CN4206700000000,42,067,"Juniata County, PA",Sep-22,12666,12298,368,2.90000000
CN4206900000000,42,069,"Lackawanna County, PA",Sep-22,104686,100698,3988,3.80000000
CN4207100000000,42,071,"Lancaster County, PA",Sep-22,285981,278475,7506,2.60000000
CN4207300000000,42,073,"Lawrence County, PA",Sep-22,39348,37744,1604,4.10000000
CN4207500000000,42,075,"Lebanon County, PA",Sep-22,74118,72081,2037,2.70000000
CN4207700000000,42,077,"Lehigh County, PA",Sep-22,200164,193081,7083,3.50000000
CN4207900000000,42,079,"Luzerne County, PA",Sep-22,157786,150656,7130,4.50000000
CN4208100000000,42,081,"Lycoming County, PA",Sep-22,54797,52803,1994,3.60000000
CN4208300000000,42,083,"McKean County, PA",Sep-22,16640,15972,668,4.00000000
CN4208500000000,42,085,"Mercer County, PA",Sep-22,47086,45228,1858,3.90000000
CN4208700000000,42,087,"Mifflin County, PA",Sep-22,20671,19928,743,3.60000000
CN4208900000000,42,089,"Monroe County, PA",Sep-22,82572,78519,4053,4.90000000
CN4209100000000,42,091,"Montgomery County, PA",Sep-22,463089,450741,12348,2.70000000
CN4209300000000,42,093,"Montour County, PA",Sep-22,9040,8799,241,2.70000000
CN4209500000000,42,095,"Northampton County, PA",Sep-22,166537,161083,5454,3.30000000
CN4209700000000,42,097,"Northumberland County, PA",Sep-22,41819,40249,1570,3.80000000
CN4209900000000,42,099,"Perry County, PA",Sep-22,24899,24268,631,2.50000000
CN4210100000000,42,101,"Philadelphia County/city, PA",Sep-22,728077,692395,35682,4.90000000
CN4210300000000,42,103,"Pike County, PA",Sep-22,25681,24462,1219,4.70000000
CN4210500000000,42,105,"Potter County, PA",Sep-22,7059,6782,277,3.90000000
CN4210700000000,42,107,"Schuylkill County, PA",Sep-22,64633,62066,2567,4.00000000
CN4210900000000,42,109,"Snyder County, PA",Sep-22,19602,19028,574,2.90000000
CN4211100000000,42,111,"Somerset County, PA",Sep-22,31929,30690,1239,3.90000000
CN4211300000000,42,113,"Sullivan County, PA",Sep-22,2522,2426,96,3.80000000
CN4211500000000,42,115,"Susquehanna County, PA",Sep-22,20244,19639,605,3.00000000
CN4211700000000,42,117,"Tioga County, PA",Sep-22,18902,18213,689,3.60000000
CN4211900000000,42,119,"Union County, PA",Sep-22,19640,19107,533,2.70000000
CN4212100000000,42,121,"Venango County, PA",Sep-22,21102,20305,797,3.80000000
CN4212300000000,42,123,"Warren County, PA",Sep-22,17403,16813,590,3.40000000
CN4212500000000,42,125,"Washington County, PA",Sep-22,105484,101806,3678,3.50000000
CN4212700000000,42,127,"Wayne County, PA",Sep-22,22323,21492,831,3.70000000
CN4212900000000,42,129,"Westmoreland County, PA",Sep-22,176766,170935,5831,3.30000000
CN4213100000000,42,131,"Wyoming County, PA",Sep-22,13402,12904,498,3.70000000
CN4213300000000,42,133,"York County, PA",Sep-22,239179,232375,6804,2.80000000
CN4400100000000,44,001,"Bristol County, RI",Sep-22,27059,26332,727,2.70000000
CN4400300000000,44,003,"Kent County, RI",Sep-22,95489,92677,2812,2.90000000
CN4400500000000,44,005,"Newport County, RI",Sep-22,45895,44683,1212,2.60000000
CN4400700000000,44,007,"Providence County, RI",Sep-22,341523,328992,12531,3.70000000
CN4400900000000,44,009,"Washington County, RI",Sep-22,71641,69690,1951,2.70000000
CN4500100000000,45,001,"Abbeville County, SC",Sep-22,9464,9123,341,3.60000000
CN4500300000000,45,003,"Aiken County, SC",Sep-22,73453,71330,2123,2.90000000
CN4500500000000,45,005,"Allendale County, SC",Sep-22,2243,2111,132,5.90000000
CN4500700000000,45,007,"Anderson County, SC",Sep-22,91514,88973,2541,2.80000000
CN4500900000000,45,009,"Bamberg County, SC",Sep-22,4553,4305,248,5.40000000
CN4501100000000,45,011,"Barnwell County, SC",Sep-22,7494,7149,345,4.60000000
CN4501300000000,45,013,"Beaufort County, SC",Sep-22,75715,73561,2154,2.80000000
CN4501500000000,45,015,"Berkeley County, SC",Sep-22,110872,107646,3226,2.90000000
CN4501700000000,45,017,"Calhoun County, SC",Sep-22,6337,6118,219,3.50000000
CN4501900000000,45,019,"Charleston County, SC",Sep-22,217590,212131,5459,2.50000000
CN4502100000000,45,021,"Cherokee County, SC",Sep-22,24168,23235,933,3.90000000
CN4502300000000,45,023,"Chester County, SC",Sep-22,13439,12878,561,4.20000000
CN4502500000000,45,025,"Chesterfield County, SC",Sep-22,21146,20416,730,3.50000000
CN4502700000000,45,027,"Clarendon County, SC",Sep-22,11827,11361,466,3.90000000
CN4502900000000,45,029,"Colleton County, SC",Sep-22,15803,15295,508,3.20000000
CN4503100000000,45,031,"Darlington County, SC",Sep-22,28863,27892,971,3.40000000
CN4503300000000,45,033,"Dillon County, SC",Sep-22,12804,12257,547,4.30000000
CN4503500000000,45,035,"Dorchester County, SC",Sep-22,80392,78187,2205,2.70000000
CN4503700000000,45,037,"Edgefield County, SC",Sep-22,10337,10001,336,3.30000000
CN4503900000000,45,039,"Fairfield County, SC",Sep-22,9108,8683,425,4.70000000
CN4504100000000,45,041,"Florence County, SC",Sep-22,64108,62099,2009,3.10000000
CN4504300000000,45,043,"Georgetown County, SC",Sep-22,25961,25095,866,3.30000000
CN4504500000000,45,045,"Greenville County, SC",Sep-22,260116,253385,6731,2.60000000
CN4504700000000,45,047,"Greenwood County, SC",Sep-22,29730,28685,1045,3.50000000
CN4504900000000,45,049,"Hampton County, SC",Sep-22,7833,7636,197,2.50000000
CN4505100000000,45,051,"Horry County, SC",Sep-22,150691,145421,5270,3.50000000
CN4505300000000,45,053,"Jasper County, SC",Sep-22,13106,12754,352,2.70000000
CN4505500000000,45,055,"Kershaw County, SC",Sep-22,28964,28062,902,3.10000000
CN4505700000000,45,057,"Lancaster County, SC",Sep-22,43860,42381,1479,3.40000000
CN4505900000000,45,059,"Laurens County, SC",Sep-22,30106,29172,934,3.10000000
CN4506100000000,45,061,"Lee County, SC",Sep-22,6319,6034,285,4.50000000
CN4506300000000,45,063,"Lexington County, SC",Sep-22,149065,145362,3703,2.50000000
CN4506500000000,45,065,"McCormick County, SC",Sep-22,3445,3324,121,3.50000000
CN4506700000000,45,067,"Marion County, SC",Sep-22,12612,11984,628,5.00000000
CN4506900000000,45,069,"Marlboro County, SC",Sep-22,8342,7807,535,6.40000000
CN4507100000000,45,071,"Newberry County, SC",Sep-22,18871,18393,478,2.50000000
CN4507300000000,45,073,"Oconee County, SC",Sep-22,34006,33050,956,2.80000000
CN4507500000000,45,075,"Orangeburg County, SC",Sep-22,32862,31130,1732,5.30000000
CN4507700000000,45,077,"Pickens County, SC",Sep-22,57971,56357,1614,2.80000000
CN4507900000000,45,079,"Richland County, SC",Sep-22,194209,188218,5991,3.10000000
CN4508100000000,45,081,"Saluda County, SC",Sep-22,8315,8089,226,2.70000000
CN4508300000000,45,083,"Spartanburg County, SC",Sep-22,156623,152181,4442,2.80000000
CN4508500000000,45,085,"Sumter County, SC",Sep-22,40716,39217,1499,3.70000000
CN4508700000000,45,087,"Union County, SC",Sep-22,11437,10876,561,4.90000000
CN4508900000000,45,089,"Williamsburg County, SC",Sep-22,10767,10274,493,4.60000000
CN4509100000000,45,091,"York County, SC",Sep-22,149119,144746,4373,2.90000000
CN4600300000000,46,003,"Aurora County, SD",Sep-22,1442,1418,24,1.70000000
CN4600500000000,46,005,"Beadle County, SD",Sep-22,9148,8993,155,1.70000000
CN4600700000000,46,007,"Bennett County, SD",Sep-22,1051,1024,27,2.60000000
CN4600900000000,46,009,"Bon Homme County, SD",Sep-22,2799,2750,49,1.80000000
CN4601100000000,46,011,"Brookings County, SD",Sep-22,19058,18734,324,1.70000000
CN4601300000000,46,013,"Brown County, SD",Sep-22,19988,19597,391,2.00000000
CN4601500000000,46,015,"Brule County, SD",Sep-22,2593,2553,40,1.50000000
CN4601700000000,46,017,"Buffalo County, SD",Sep-22,716,679,37,5.20000000
CN4601900000000,46,019,"Butte County, SD",Sep-22,5000,4903,97,1.90000000
CN4602100000000,46,021,"Campbell County, SD",Sep-22,755,739,16,2.10000000
CN4602300000000,46,023,"Charles Mix County, SD",Sep-22,3784,3705,79,2.10000000
CN4602500000000,46,025,"Clark County, SD",Sep-22,1877,1846,31,1.70000000
CN4602700000000,46,027,"Clay County, SD",Sep-22,7482,7348,134,1.80000000
CN4602900000000,46,029,"Codington County, SD",Sep-22,15923,15646,277,1.70000000
CN4603100000000,46,031,"Corson County, SD",Sep-22,1235,1204,31,2.50000000
CN4603300000000,46,033,"Custer County, SD",Sep-22,4185,4084,101,2.40000000
CN4603500000000,46,035,"Davison County, SD",Sep-22,11023,10838,185,1.70000000
CN4603700000000,46,037,"Day County, SD",Sep-22,2636,2581,55,2.10000000
CN4603900000000,46,039,"Deuel County, SD",Sep-22,2274,2225,49,2.20000000
CN4604100000000,46,041,"Dewey County, SD",Sep-22,2302,2177,125,5.40000000
CN4604300000000,46,043,"Douglas County, SD",Sep-22,1479,1452,27,1.80000000
CN4604500000000,46,045,"Edmunds County, SD",Sep-22,1955,1922,33,1.70000000
CN4604700000000,46,047,"Fall River County, SD",Sep-22,3133,3067,66,2.10000000
CN4604900000000,46,049,"Faulk County, SD",Sep-22,1037,1016,21,2.00000000
CN4605100000000,46,051,"Grant County, SD",Sep-22,4357,4284,73,1.70000000
CN4605300000000,46,053,"Gregory County, SD",Sep-22,2135,2099,36,1.70000000
CN4605500000000,46,055,"Haakon County, SD",Sep-22,1030,1011,19,1.80000000
CN4605700000000,46,057,"Hamlin County, SD",Sep-22,3540,3485,55,1.60000000
CN4605900000000,46,059,"Hand County, SD",Sep-22,1736,1709,27,1.60000000
CN4606100000000,46,061,"Hanson County, SD",Sep-22,1750,1716,34,1.90000000
CN4606300000000,46,063,"Harding County, SD",Sep-22,720,705,15,2.10000000
CN4606500000000,46,065,"Hughes County, SD",Sep-22,9930,9782,148,1.50000000
CN4606700000000,46,067,"Hutchinson County, SD",Sep-22,3524,3461,63,1.80000000
CN4606900000000,46,069,"Hyde County, SD",Sep-22,641,628,13,2.00000000
CN4607100000000,46,071,"Jackson County, SD",Sep-22,1234,1206,28,2.30000000
CN4607300000000,46,073,"Jerauld County, SD",Sep-22,1306,1288,18,1.40000000
CN4607500000000,46,075,"Jones County, SD",Sep-22,539,529,10,1.90000000
CN4607700000000,46,077,"Kingsbury County, SD",Sep-22,2852,2803,49,1.70000000
CN4607900000000,46,079,"Lake County, SD",Sep-22,6732,6605,127,1.90000000
CN4608100000000,46,081,"Lawrence County, SD",Sep-22,14353,14100,253,1.80000000
CN4608300000000,46,083,"Lincoln County, SD",Sep-22,38116,37554,562,1.50000000
CN4608500000000,46,085,"Lyman County, SD",Sep-22,1679,1643,36,2.10000000
CN4608700000000,46,087,"McCook County, SD",Sep-22,3116,3070,46,1.50000000
CN4608900000000,46,089,"McPherson County, SD",Sep-22,962,934,28,2.90000000
CN4609100000000,46,091,"Marshall County, SD",Sep-22,2439,2387,52,2.10000000
CN4609300000000,46,093,"Meade County, SD",Sep-22,14593,14307,286,2.00000000
CN4609500000000,46,095,"Mellette County, SD",Sep-22,733,714,19,2.60000000
CN4609700000000,46,097,"Miner County, SD",Sep-22,1174,1155,19,1.60000000
CN4609900000000,46,099,"Minnehaha County, SD",Sep-22,118350,116500,1850,1.60000000
CN4610100000000,46,101,"Moody County, SD",Sep-22,3987,3905,82,2.10000000
CN4610200000000,46,102,"Oglala Lakota County, SD",Sep-22,3905,3692,213,5.50000000
CN4610300000000,46,103,"Pennington County, SD",Sep-22,60275,59142,1133,1.90000000
CN4610500000000,46,105,"Perkins County, SD",Sep-22,1384,1354,30,2.20000000
CN4610700000000,46,107,"Potter County, SD",Sep-22,1021,1002,19,1.90000000
CN4610900000000,46,109,"Roberts County, SD",Sep-22,4645,4538,107,2.30000000
CN4611100000000,46,111,"Sanborn County, SD",Sep-22,1183,1161,22,1.90000000
CN4611500000000,46,115,"Spink County, SD",Sep-22,2950,2887,63,2.10000000
CN4611700000000,46,117,"Stanley County, SD",Sep-22,1909,1879,30,1.60000000
CN4611900000000,46,119,"Sully County, SD",Sep-22,792,779,13,1.60000000
CN4612100000000,46,121,"Todd County, SD",Sep-22,3035,2941,94,3.10000000
CN4612300000000,46,123,"Tripp County, SD",Sep-22,3019,2973,46,1.50000000
CN4612500000000,46,125,"Turner County, SD",Sep-22,4763,4680,83,1.70000000
CN4612700000000,46,127,"Union County, SD",Sep-22,8604,8427,177,2.10000000
CN4612900000000,46,129,"Walworth County, SD",Sep-22,2080,2019,61,2.90000000
CN4613500000000,46,135,"Yankton County, SD",Sep-22,11699,11490,209,1.80000000
CN4613700000000,46,137,"Ziebach County, SD",Sep-22,949,918,31,3.30000000
CN4700100000000,47,001,"Anderson County, TN",Sep-22,35378,34365,1013,2.90000000
CN4700300000000,47,003,"Bedford County, TN",Sep-22,20956,20308,648,3.10000000
CN4700500000000,47,005,"Benton County, TN",Sep-22,6632,6386,246,3.70000000
CN4700700000000,47,007,"Bledsoe County, TN",Sep-22,4259,4055,204,4.80000000
CN4700900000000,47,009,"Blount County, TN",Sep-22,65663,63931,1732,2.60000000
CN4701100000000,47,011,"Bradley County, TN",Sep-22,49729,48208,1521,3.10000000
CN4701300000000,47,013,"Campbell County, TN",Sep-22,14998,14445,553,3.70000000
CN4701500000000,47,015,"Cannon County, TN",Sep-22,6834,6660,174,2.50000000
CN4701700000000,47,017,"Carroll County, TN",Sep-22,11121,10737,384,3.50000000
CN4701900000000,47,019,"Carter County, TN",Sep-22,24067,23295,772,3.20000000
CN4702100000000,47,021,"Cheatham County, TN",Sep-22,22598,22084,514,2.30000000
CN4702300000000,47,023,"Chester County, TN",Sep-22,8360,8138,222,2.70000000
CN4702500000000,47,025,"Claiborne County, TN",Sep-22,12633,12232,401,3.20000000
CN4702700000000,47,027,"Clay County, TN",Sep-22,2723,2618,105,3.90000000
CN4702900000000,47,029,"Cocke County, TN",Sep-22,14343,13749,594,4.10000000
CN4703100000000,47,031,"Coffee County, TN",Sep-22,24637,23888,749,3.00000000
CN4703300000000,47,033,"Crockett County, TN",Sep-22,6670,6487,183,2.70000000
CN4703500000000,47,035,"Cumberland County, TN",Sep-22,22061,21226,835,3.80000000
CN4703700000000,47,037,"Davidson County, TN",Sep-22,412963,402540,10423,2.50000000
CN4703900000000,47,039,"Decatur County, TN",Sep-22,4155,3973,182,4.40000000
CN4704100000000,47,041,"DeKalb County, TN",Sep-22,7726,7471,255,3.30000000
CN4704300000000,47,043,"Dickson County, TN",Sep-22,27877,27149,728,2.60000000
CN4704500000000,47,045,"Dyer County, TN",Sep-22,15640,15103,537,3.40000000
CN4704700000000,47,047,"Fayette County, TN",Sep-22,19232,18641,591,3.10000000
CN4704900000000,47,049,"Fentress County, TN",Sep-22,7347,7100,247,3.40000000
CN4705100000000,47,051,"Franklin County, TN",Sep-22,18939,18350,589,3.10000000
CN4705300000000,47,053,"Gibson County, TN",Sep-22,20743,20096,647,3.10000000
CN4705500000000,47,055,"Giles County, TN",Sep-22,14375,13957,418,2.90000000
CN4705700000000,47,057,"Grainger County, TN",Sep-22,9724,9401,323,3.30000000
CN4705900000000,47,059,"Greene County, TN",Sep-22,27723,26794,929,3.40000000
CN4706100000000,47,061,"Grundy County, TN",Sep-22,5007,4808,199,4.00000000
CN4706300000000,47,063,"Hamblen County, TN",Sep-22,27914,27065,849,3.00000000
CN4706500000000,47,065,"Hamilton County, TN",Sep-22,181655,176287,5368,3.00000000
CN4706700000000,47,067,"Hancock County, TN",Sep-22,2240,2160,80,3.60000000
CN4706900000000,47,069,"Hardeman County, TN",Sep-22,8585,8240,345,4.00000000
CN4707100000000,47,071,"Hardin County, TN",Sep-22,9771,9426,345,3.50000000
CN4707300000000,47,073,"Hawkins County, TN",Sep-22,22889,22092,797,3.50000000
CN4707500000000,47,075,"Haywood County, TN",Sep-22,7390,7061,329,4.50000000
CN4707700000000,47,077,"Henderson County, TN",Sep-22,11593,11228,365,3.10000000
CN4707900000000,47,079,"Henry County, TN",Sep-22,14017,13556,461,3.30000000
CN4708100000000,47,081,"Hickman County, TN",Sep-22,11718,11428,290,2.50000000
CN4708300000000,47,083,"Houston County, TN",Sep-22,3142,3023,119,3.80000000
CN4708500000000,47,085,"Humphreys County, TN",Sep-22,8543,8281,262,3.10000000
CN4708700000000,47,087,"Jackson County, TN",Sep-22,4745,4585,160,3.40000000
CN4708900000000,47,089,"Jefferson County, TN",Sep-22,24822,24056,766,3.10000000
CN4709100000000,47,091,"Johnson County, TN",Sep-22,7528,7313,215,2.90000000
CN4709300000000,47,093,"Knox County, TN",Sep-22,251687,245553,6134,2.40000000
CN4709500000000,47,095,"Lake County, TN",Sep-22,1578,1503,75,4.80000000
CN4709700000000,47,097,"Lauderdale County, TN",Sep-22,9400,8966,434,4.60000000
CN4709900000000,47,099,"Lawrence County, TN",Sep-22,19003,18391,612,3.20000000
CN4710100000000,47,101,"Lewis County, TN",Sep-22,5622,5437,185,3.30000000
CN4710300000000,47,103,"Lincoln County, TN",Sep-22,15750,15286,464,2.90000000
CN4710500000000,47,105,"Loudon County, TN",Sep-22,24372,23677,695,2.90000000
CN4710700000000,47,107,"McMinn County, TN",Sep-22,21003,20221,782,3.70000000
CN4710900000000,47,109,"McNairy County, TN",Sep-22,8042,7696,346,4.30000000
CN4711100000000,47,111,"Macon County, TN",Sep-22,11553,11244,309,2.70000000
CN4711300000000,47,113,"Madison County, TN",Sep-22,48191,46719,1472,3.10000000
CN4711500000000,47,115,"Marion County, TN",Sep-22,12185,11765,420,3.40000000
CN4711700000000,47,117,"Marshall County, TN",Sep-22,15311,14847,464,3.00000000
CN4711900000000,47,119,"Maury County, TN",Sep-22,52891,51462,1429,2.70000000
CN4712100000000,47,121,"Meigs County, TN",Sep-22,5091,4883,208,4.10000000
CN4712300000000,47,123,"Monroe County, TN",Sep-22,20690,20018,672,3.20000000
CN4712500000000,47,125,"Montgomery County, TN",Sep-22,87308,84399,2909,3.30000000
CN4712700000000,47,127,"Moore County, TN",Sep-22,3595,3507,88,2.40000000
CN4712900000000,47,129,"Morgan County, TN",Sep-22,7836,7579,257,3.30000000
CN4713100000000,47,131,"Obion County, TN",Sep-22,11931,11513,418,3.50000000
CN4713300000000,47,133,"Overton County, TN",Sep-22,9917,9638,279,2.80000000
CN4713500000000,47,135,"Perry County, TN",Sep-22,2699,2571,128,4.70000000
CN4713700000000,47,137,"Pickett County, TN",Sep-22,2129,2063,66,3.10000000
CN4713900000000,47,139,"Polk County, TN",Sep-22,6965,6747,218,3.10000000
CN4714100000000,47,141,"Putnam County, TN",Sep-22,35126,34097,1029,2.90000000
CN4714300000000,47,143,"Rhea County, TN",Sep-22,13760,13210,550,4.00000000
CN4714500000000,47,145,"Roane County, TN",Sep-22,23783,23026,757,3.20000000
CN4714700000000,47,147,"Robertson County, TN",Sep-22,39064,38096,968,2.50000000
CN4714900000000,47,149,"Rutherford County, TN",Sep-22,195331,190729,4602,2.40000000
CN4715100000000,47,151,"Scott County, TN",Sep-22,7920,7566,354,4.50000000
CN4715300000000,47,153,"Sequatchie County, TN",Sep-22,6115,5894,221,3.60000000
CN4715500000000,47,155,"Sevier County, TN",Sep-22,55294,54003,1291,2.30000000
CN4715700000000,47,157,"Shelby County, TN",Sep-22,442384,422387,19997,4.50000000
CN4715900000000,47,159,"Smith County, TN",Sep-22,9731,9471,260,2.70000000
CN4716100000000,47,161,"Stewart County, TN",Sep-22,5270,5093,177,3.40000000
CN4716300000000,47,163,"Sullivan County, TN",Sep-22,68043,65942,2101,3.10000000
CN4716500000000,47,165,"Sumner County, TN",Sep-22,108723,106113,2610,2.40000000
CN4716700000000,47,167,"Tipton County, TN",Sep-22,27689,26818,871,3.10000000
CN4716900000000,47,169,"Trousdale County, TN",Sep-22,5697,5558,139,2.40000000
CN4717100000000,47,171,"Unicoi County, TN",Sep-22,7012,6747,265,3.80000000
CN4717300000000,47,173,"Union County, TN",Sep-22,7866,7619,247,3.10000000
CN4717500000000,47,175,"Van Buren County, TN",Sep-22,2022,1941,81,4.00000000
CN4717700000000,47,177,"Warren County, TN",Sep-22,16174,15591,583,3.60000000
CN4717900000000,47,179,"Washington County, TN",Sep-22,61325,59582,1743,2.80000000
CN4718100000000,47,181,"Wayne County, TN",Sep-22,6245,5977,268,4.30000000
CN4718300000000,47,183,"Weakley County, TN",Sep-22,15295,14863,432,2.80000000
CN4718500000000,47,185,"White County, TN",Sep-22,11376,11005,371,3.30000000
CN4718700000000,47,187,"Williamson County, TN",Sep-22,138104,135225,2879,2.10000000
CN4718900000000,47,189,"Wilson County, TN",Sep-22,81819,79922,1897,2.30000000
CN4800100000000,48,001,"Anderson County, TX",Sep-22,23343,22607,736,3.20000000
CN4800300000000,48,003,"Andrews County, TX",Sep-22,8592,8300,292,3.40000000
CN4800500000000,48,005,"Angelina County, TX",Sep-22,35442,33857,1585,4.50000000
CN4800700000000,48,007,"Aransas County, TX",Sep-22,9247,8751,496,5.40000000
CN4800900000000,48,009,"Archer County, TX",Sep-22,3969,3849,120,3.00000000
CN4801100000000,48,011,"Armstrong County, TX",Sep-22,907,885,22,2.40000000
CN4801300000000,48,013,"Atascosa County, TX",Sep-22,22148,21265,883,4.00000000
CN4801500000000,48,015,"Austin County, TX",Sep-22,14109,13579,530,3.80000000
CN4801700000000,48,017,"Bailey County, TX",Sep-22,2311,2219,92,4.00000000
CN4801900000000,48,019,"Bandera County, TX",Sep-22,10469,10094,375,3.60000000
CN4802100000000,48,021,"Bastrop County, TX",Sep-22,46678,45197,1481,3.20000000
CN4802300000000,48,023,"Baylor County, TX",Sep-22,1840,1793,47,2.60000000
CN4802500000000,48,025,"Bee County, TX",Sep-22,8663,8119,544,6.30000000
CN4802700000000,48,027,"Bell County, TX",Sep-22,147755,141421,6334,4.30000000
CN4802900000000,48,029,"Bexar County, TX",Sep-22,962333,927577,34756,3.60000000
CN4803100000000,48,031,"Blanco County, TX",Sep-22,7085,6905,180,2.50000000
CN4803300000000,48,033,"Borden County, TX",Sep-22,701,691,10,1.40000000
CN4803500000000,48,035,"Bosque County, TX",Sep-22,8633,8340,293,3.40000000
CN4803700000000,48,037,"Bowie County, TX",Sep-22,39038,37309,1729,4.40000000
CN4803900000000,48,039,"Brazoria County, TX",Sep-22,184935,176447,8488,4.60000000
CN4804100000000,48,041,"Brazos County, TX",Sep-22,122017,118368,3649,3.00000000
CN4804300000000,48,043,"Brewster County, TX",Sep-22,4068,3941,127,3.10000000
CN4804500000000,48,045,"Briscoe County, TX",Sep-22,563,544,19,3.40000000
CN4804700000000,48,047,"Brooks County, TX",Sep-22,2425,2279,146,6.00000000
CN4804900000000,48,049,"Brown County, TX",Sep-22,14998,14411,587,3.90000000
CN4805100000000,48,051,"Burleson County, TX",Sep-22,8442,8134,308,3.60000000
CN4805300000000,48,053,"Burnet County, TX",Sep-22,24732,24043,689,2.80000000
CN4805500000000,48,055,"Caldwell County, TX",Sep-22,20603,19945,658,3.20000000
CN4805700000000,48,057,"Calhoun County, TX",Sep-22,11917,11505,412,3.50000000
CN4805900000000,48,059,"Callahan County, TX",Sep-22,6129,5925,204,3.30000000
CN4806100000000,48,061,"Cameron County, TX",Sep-22,174068,163979,10089,5.80000000
CN4806300000000,48,063,"Camp County, TX",Sep-22,5283,5060,223,4.20000000
CN4806500000000,48,065,"Carson County, TX",Sep-22,2917,2838,79,2.70000000
CN4806700000000,48,067,"Cass County, TX",Sep-22,12141,11597,544,4.50000000
CN4806900000000,48,069,"Castro County, TX",Sep-22,3280,3184,96,2.90000000
CN4807100000000,48,071,"Chambers County, TX",Sep-22,21112,19952,1160,5.50000000
CN4807300000000,48,073,"Cherokee County, TX",Sep-22,20239,19378,861,4.30000000
CN4807500000000,48,075,"Childress County, TX",Sep-22,2956,2876,80,2.70000000
CN4807700000000,48,077,"Clay County, TX",Sep-22,4806,4635,171,3.60000000
CN4807900000000,48,079,"Cochran County, TX",Sep-22,1037,986,51,4.90000000
CN4808100000000,48,081,"Coke County, TX",Sep-22,1367,1317,50,3.70000000
CN4808300000000,48,083,"Coleman County, TX",Sep-22,2913,2790,123,4.20000000
CN4808500000000,48,085,"Collin County, TX",Sep-22,627500,608865,18635,3.00000000
CN4808700000000,48,087,"Collingsworth County, TX",Sep-22,1061,1026,35,3.30000000
CN4808900000000,48,089,"Colorado County, TX",Sep-22,10125,9794,331,3.30000000
CN4809100000000,48,091,"Comal County, TX",Sep-22,80990,78342,2648,3.30000000
CN4809300000000,48,093,"Comanche County, TX",Sep-22,6248,6042,206,3.30000000
CN4809500000000,48,095,"Concho County, TX",Sep-22,1326,1288,38,2.90000000
CN4809700000000,48,097,"Cooke County, TX",Sep-22,19250,18638,612,3.20000000
CN4809900000000,48,099,"Coryell County, TX",Sep-22,24403,23359,1044,4.30000000
CN4810100000000,48,101,"Cottle County, TX",Sep-22,606,584,22,3.60000000
CN4810300000000,48,103,"Crane County, TX",Sep-22,1554,1471,83,5.30000000
CN4810500000000,48,105,"Crockett County, TX",Sep-22,1351,1300,51,3.80000000
CN4810700000000,48,107,"Crosby County, TX",Sep-22,2375,2274,101,4.30000000
CN4810900000000,48,109,"Culberson County, TX",Sep-22,1061,1032,29,2.70000000
CN4811100000000,48,111,"Dallam County, TX",Sep-22,3677,3594,83,2.30000000
CN4811300000000,48,113,"Dallas County, TX",Sep-22,1428347,1376316,52031,3.60000000
CN4811500000000,48,115,"Dawson County, TX",Sep-22,4371,4167,204,4.70000000
CN4811700000000,48,117,"Deaf Smith County, TX",Sep-22,8769,8527,242,2.80000000
CN4811900000000,48,119,"Delta County, TX",Sep-22,2447,2348,99,4.00000000
CN4812100000000,48,121,"Denton County, TX",Sep-22,553311,536585,16726,3.00000000
CN4812300000000,48,123,"DeWitt County, TX",Sep-22,9476,9187,289,3.00000000
CN4812500000000,48,125,"Dickens County, TX",Sep-22,732,701,31,4.20000000
CN4812700000000,48,127,"Dimmit County, TX",Sep-22,5611,5388,223,4.00000000
CN4812900000000,48,129,"Donley County, TX",Sep-22,1475,1430,45,3.10000000
CN4813100000000,48,131,"Duval County, TX",Sep-22,5397,5162,235,4.40000000
CN4813300000000,48,133,"Eastland County, TX",Sep-22,6923,6637,286,4.10000000
CN4813500000000,48,135,"Ector County, TX",Sep-22,80671,77178,3493,4.30000000
CN4813700000000,48,137,"Edwards County, TX",Sep-22,1282,1250,32,2.50000000
CN4813900000000,48,139,"Ellis County, TX",Sep-22,103645,100291,3354,3.20000000
CN4814100000000,48,141,"El Paso County, TX",Sep-22,360606,344909,15697,4.40000000
CN4814300000000,48,143,"Erath County, TX",Sep-22,20556,19904,652,3.20000000
CN4814500000000,48,145,"Falls County, TX",Sep-22,6662,6408,254,3.80000000
CN4814700000000,48,147,"Fannin County, TX",Sep-22,17415,16764,651,3.70000000
CN4814900000000,48,149,"Fayette County, TX",Sep-22,11491,11097,394,3.40000000
CN4815100000000,48,151,"Fisher County, TX",Sep-22,1553,1503,50,3.20000000
CN4815300000000,48,153,"Floyd County, TX",Sep-22,2415,2314,101,4.20000000
CN4815500000000,48,155,"Foard County, TX",Sep-22,608,592,16,2.60000000
CN4815700000000,48,157,"Fort Bend County, TX",Sep-22,419634,403320,16314,3.90000000
CN4815900000000,48,159,"Franklin County, TX",Sep-22,5170,4992,178,3.40000000
CN4816100000000,48,161,"Freestone County, TX",Sep-22,6126,5795,331,5.40000000
CN4816300000000,48,163,"Frio County, TX",Sep-22,9211,8916,295,3.20000000
CN4816500000000,48,165,"Gaines County, TX",Sep-22,9666,9390,276,2.90000000
CN4816700000000,48,167,"Galveston County, TX",Sep-22,169622,162030,7592,4.50000000
CN4816900000000,48,169,"Garza County, TX",Sep-22,1975,1880,95,4.80000000
CN4817100000000,48,171,"Gillespie County, TX",Sep-22,14568,14224,344,2.40000000
CN4817300000000,48,173,"Glasscock County, TX",Sep-22,788,770,18,2.30000000
CN4817500000000,48,175,"Goliad County, TX",Sep-22,3138,2996,142,4.50000000
CN4817700000000,48,177,"Gonzales County, TX",Sep-22,9553,9261,292,3.10000000
CN4817900000000,48,179,"Gray County, TX",Sep-22,7613,7285,328,4.30000000
CN4818100000000,48,181,"Grayson County, TX",Sep-22,66975,64682,2293,3.40000000
CN4818300000000,48,183,"Gregg County, TX",Sep-22,56196,53766,2430,4.30000000
CN4818500000000,48,185,"Grimes County, TX",Sep-22,10921,10417,504,4.60000000
CN4818700000000,48,187,"Guadalupe County, TX",Sep-22,84000,81336,2664,3.20000000
CN4818900000000,48,189,"Hale County, TX",Sep-22,11854,11321,533,4.50000000
CN4819100000000,48,191,"Hall County, TX",Sep-22,1074,1033,41,3.80000000
CN4819300000000,48,193,"Hamilton County, TX",Sep-22,3706,3579,127,3.40000000
CN4819500000000,48,195,"Hansford County, TX",Sep-22,2556,2493,63,2.50000000
CN4819700000000,48,197,"Hardeman County, TX",Sep-22,1689,1632,57,3.40000000
CN4819900000000,48,199,"Hardin County, TX",Sep-22,24686,23365,1321,5.40000000
CN4820100000000,48,201,"Harris County, TX",Sep-22,2347785,2248229,99556,4.20000000
CN4820300000000,48,203,"Harrison County, TX",Sep-22,28003,26743,1260,4.50000000
CN4820500000000,48,205,"Hartley County, TX",Sep-22,2696,2649,47,1.70000000
CN4820700000000,48,207,"Haskell County, TX",Sep-22,2714,2644,70,2.60000000
CN4820900000000,48,209,"Hays County, TX",Sep-22,134312,130476,3836,2.90000000
CN4821100000000,48,211,"Hemphill County, TX",Sep-22,1507,1460,47,3.10000000
CN4821300000000,48,213,"Henderson County, TX",Sep-22,39186,37797,1389,3.50000000
CN4821500000000,48,215,"Hidalgo County, TX",Sep-22,369210,344602,24608,6.70000000
CN4821700000000,48,217,"Hill County, TX",Sep-22,17115,16490,625,3.70000000
CN4821900000000,48,219,"Hockley County, TX",Sep-22,10959,10577,382,3.50000000
CN4822100000000,48,221,"Hood County, TX",Sep-22,29658,28565,1093,3.70000000
CN4822300000000,48,223,"Hopkins County, TX",Sep-22,18059,17503,556,3.10000000
CN4822500000000,48,225,"Houston County, TX",Sep-22,10759,10407,352,3.30000000
CN4822700000000,48,227,"Howard County, TX",Sep-22,13296,12705,591,4.40000000
CN4822900000000,48,229,"Hudspeth County, TX",Sep-22,1819,1745,74,4.10000000
CN4823100000000,48,231,"Hunt County, TX",Sep-22,46998,45233,1765,3.80000000
CN4823300000000,48,233,"Hutchinson County, TX",Sep-22,8080,7720,360,4.50000000
CN4823500000000,48,235,"Irion County, TX",Sep-22,764,744,20,2.60000000
CN4823700000000,48,237,"Jack County, TX",Sep-22,3427,3301,126,3.70000000
CN4823900000000,48,239,"Jackson County, TX",Sep-22,6964,6735,229,3.30000000
CN4824100000000,48,241,"Jasper County, TX",Sep-22,12713,11896,817,6.40000000
CN4824300000000,48,243,"Jeff Davis County, TX",Sep-22,997,965,32,3.20000000
CN4824500000000,48,245,"Jefferson County, TX",Sep-22,100493,93855,6638,6.60000000
CN4824700000000,48,247,"Jim Hogg County, TX",Sep-22,1786,1691,95,5.30000000
CN4824900000000,48,249,"Jim Wells County, TX",Sep-22,15219,14288,931,6.10000000
CN4825100000000,48,251,"Johnson County, TX",Sep-22,87986,85089,2897,3.30000000
CN4825300000000,48,253,"Jones County, TX",Sep-22,5646,5410,236,4.20000000
CN4825500000000,48,255,"Karnes County, TX",Sep-22,6877,6674,203,3.00000000
CN4825700000000,48,257,"Kaufman County, TX",Sep-22,75359,72646,2713,3.60000000
CN4825900000000,48,259,"Kendall County, TX",Sep-22,23381,22689,692,3.00000000
CN4826100000000,48,261,"Kenedy County, TX",Sep-22,179,170,9,5.00000000
CN4826300000000,48,263,"Kent County, TX",Sep-22,452,439,13,2.90000000
CN4826500000000,48,265,"Kerr County, TX",Sep-22,21903,21160,743,3.40000000
CN4826700000000,48,267,"Kimble County, TX",Sep-22,1888,1834,54,2.90000000
CN4826900000000,48,269,"King County, TX",Sep-22,621,617,4,0.60000000
CN4827100000000,48,271,"Kinney County, TX",Sep-22,1175,1118,57,4.90000000
CN4827300000000,48,273,"Kleberg County, TX",Sep-22,12808,12192,616,4.80000000
CN4827500000000,48,275,"Knox County, TX",Sep-22,1405,1351,54,3.80000000
CN4827700000000,48,277,"Lamar County, TX",Sep-22,24229,23212,1017,4.20000000
CN4827900000000,48,279,"Lamb County, TX",Sep-22,5124,4933,191,3.70000000
CN4828100000000,48,281,"Lampasas County, TX",Sep-22,9325,9001,324,3.50000000
CN4828300000000,48,283,"La Salle County, TX",Sep-22,3829,3718,111,2.90000000
CN4828500000000,48,285,"Lavaca County, TX",Sep-22,8536,8259,277,3.20000000
CN4828700000000,48,287,"Lee County, TX",Sep-22,8856,8567,289,3.30000000
CN4828900000000,48,289,"Leon County, TX",Sep-22,6062,5748,314,5.20000000
CN4829100000000,48,291,"Liberty County, TX",Sep-22,35396,33291,2105,5.90000000
CN4829300000000,48,293,"Limestone County, TX",Sep-22,8443,8068,375,4.40000000
CN4829500000000,48,295,"Lipscomb County, TX",Sep-22,1450,1412,38,2.60000000
CN4829700000000,48,297,"Live Oak County, TX",Sep-22,4694,4484,210,4.50000000
CN4829900000000,48,299,"Llano County, TX",Sep-22,9165,8832,333,3.60000000
CN4830100000000,48,301,"Loving County, TX",Sep-22,563,559,4,0.70000000
CN4830300000000,48,303,"Lubbock County, TX",Sep-22,162373,157342,5031,3.10000000
CN4830500000000,48,305,"Lynn County, TX",Sep-22,2816,2721,95,3.40000000
CN4830700000000,48,307,"McCulloch County, TX",Sep-22,3059,2928,131,4.30000000
CN4830900000000,48,309,"McLennan County, TX",Sep-22,124412,120241,4171,3.40000000
CN4831100000000,48,311,"McMullen County, TX",Sep-22,787,772,15,1.90000000
CN4831300000000,48,313,"Madison County, TX",Sep-22,4704,4513,191,4.10000000
CN4831500000000,48,315,"Marion County, TX",Sep-22,4230,4026,204,4.80000000
CN4831700000000,48,317,"Martin County, TX",Sep-22,2653,2577,76,2.90000000
CN4831900000000,48,319,"Mason County, TX",Sep-22,1805,1747,58,3.20000000
CN4832100000000,48,321,"Matagorda County, TX",Sep-22,16144,15079,1065,6.60000000
CN4832300000000,48,323,"Maverick County, TX",Sep-22,22493,20882,1611,7.20000000
CN4832500000000,48,325,"Medina County, TX",Sep-22,22255,21448,807,3.60000000
CN4832700000000,48,327,"Menard County, TX",Sep-22,800,772,28,3.50000000
CN4832900000000,48,329,"Midland County, TX",Sep-22,101167,98124,3043,3.00000000
CN4833100000000,48,331,"Milam County, TX",Sep-22,10219,9786,433,4.20000000
CN4833300000000,48,333,"Mills County, TX",Sep-22,1852,1780,72,3.90000000
CN4833500000000,48,335,"Mitchell County, TX",Sep-22,2294,2195,99,4.30000000
CN4833700000000,48,337,"Montague County, TX",Sep-22,9269,8945,324,3.50000000
CN4833900000000,48,339,"Montgomery County, TX",Sep-22,302605,291052,11553,3.80000000
CN4834100000000,48,341,"Moore County, TX",Sep-22,11056,10790,266,2.40000000
CN4834300000000,48,343,"Morris County, TX",Sep-22,4367,4065,302,6.90000000
CN4834500000000,48,345,"Motley County, TX",Sep-22,441,422,19,4.30000000
CN4834700000000,48,347,"Nacogdoches County, TX",Sep-22,27895,26777,1118,4.00000000
CN4834900000000,48,349,"Navarro County, TX",Sep-22,23905,23056,849,3.60000000
CN4835100000000,48,351,"Newton County, TX",Sep-22,4825,4491,334,6.90000000
CN4835300000000,48,353,"Nolan County, TX",Sep-22,6982,6750,232,3.30000000
CN4835500000000,48,355,"Nueces County, TX",Sep-22,162891,155229,7662,4.70000000
CN4835700000000,48,357,"Ochiltree County, TX",Sep-22,3952,3825,127,3.20000000
CN4835900000000,48,359,"Oldham County, TX",Sep-22,903,880,23,2.50000000
CN4836100000000,48,361,"Orange County, TX",Sep-22,34611,32544,2067,6.00000000
CN4836300000000,48,363,"Palo Pinto County, TX",Sep-22,12627,12154,473,3.70000000
CN4836500000000,48,365,"Panola County, TX",Sep-22,9532,9113,419,4.40000000
CN4836700000000,48,367,"Parker County, TX",Sep-22,73810,71498,2312,3.10000000
CN4836900000000,48,369,"Parmer County, TX",Sep-22,4909,4801,108,2.20000000
CN4837100000000,48,371,"Pecos County, TX",Sep-22,5702,5457,245,4.30000000
CN4837300000000,48,373,"Polk County, TX",Sep-22,18389,17348,1041,5.70000000
CN4837500000000,48,375,"Potter County, TX",Sep-22,53633,52048,1585,3.00000000
CN4837700000000,48,377,"Presidio County, TX",Sep-22,3110,2913,197,6.30000000
CN4837900000000,48,379,"Rains County, TX",Sep-22,6609,6402,207,3.10000000
CN4838100000000,48,381,"Randall County, TX",Sep-22,73907,71948,1959,2.70000000
CN4838300000000,48,383,"Reagan County, TX",Sep-22,1582,1521,61,3.90000000
CN4838500000000,48,385,"Real County, TX",Sep-22,1064,1014,50,4.70000000
CN4838700000000,48,387,"Red River County, TX",Sep-22,5389,5138,251,4.70000000
CN4838900000000,48,389,"Reeves County, TX",Sep-22,9261,8944,317,3.40000000
CN4839100000000,48,391,"Refugio County, TX",Sep-22,2999,2866,133,4.40000000
CN4839300000000,48,393,"Roberts County, TX",Sep-22,387,374,13,3.40000000
CN4839500000000,48,395,"Robertson County, TX",Sep-22,7562,7285,277,3.70000000
CN4839700000000,48,397,"Rockwall County, TX",Sep-22,59478,57608,1870,3.10000000
CN4839900000000,48,399,"Runnels County, TX",Sep-22,4525,4386,139,3.10000000
CN4840100000000,48,401,"Rusk County, TX",Sep-22,22110,21193,917,4.10000000
CN4840300000000,48,403,"Sabine County, TX",Sep-22,3983,3709,274,6.90000000
CN4840500000000,48,405,"San Augustine County, TX",Sep-22,2962,2775,187,6.30000000
CN4840700000000,48,407,"San Jacinto County, TX",Sep-22,11976,11375,601,5.00000000
CN4840900000000,48,409,"San Patricio County, TX",Sep-22,29090,27257,1833,6.30000000
CN4841100000000,48,411,"San Saba County, TX",Sep-22,2087,2015,72,3.40000000
CN4841300000000,48,413,"Schleicher County, TX",Sep-22,1119,1080,39,3.50000000
CN4841500000000,48,415,"Scurry County, TX",Sep-22,5765,5507,258,4.50000000
CN4841700000000,48,417,"Shackelford County, TX",Sep-22,1826,1782,44,2.40000000
CN4841900000000,48,419,"Shelby County, TX",Sep-22,11540,11101,439,3.80000000
CN4842100000000,48,421,"Sherman County, TX",Sep-22,1436,1402,34,2.40000000
CN4842300000000,48,423,"Smith County, TX",Sep-22,111165,107229,3936,3.50000000
CN4842500000000,48,425,"Somervell County, TX",Sep-22,4528,4362,166,3.70000000
CN4842700000000,48,427,"Starr County, TX",Sep-22,23464,20758,2706,11.50000000
CN4842900000000,48,429,"Stephens County, TX",Sep-22,4241,4098,143,3.40000000
CN4843100000000,48,431,"Sterling County, TX",Sep-22,530,512,18,3.40000000
CN4843300000000,48,433,"Stonewall County, TX",Sep-22,594,575,19,3.20000000
CN4843500000000,48,435,"Sutton County, TX",Sep-22,1079,1025,54,5.00000000
CN4843700000000,48,437,"Swisher County, TX",Sep-22,2575,2482,93,3.60000000
CN4843900000000,48,439,"Tarrant County, TX",Sep-22,1129216,1089273,39943,3.50000000
CN4844100000000,48,441,"Taylor County, TX",Sep-22,66961,64872,2089,3.10000000
CN4844300000000,48,443,"Terrell County, TX",Sep-22,435,423,12,2.80000000
CN4844500000000,48,445,"Terry County, TX",Sep-22,4546,4361,185,4.10000000
CN4844700000000,48,447,"Throckmorton County, TX",Sep-22,1452,1434,18,1.20000000
CN4844900000000,48,449,"Titus County, TX",Sep-22,13689,13107,582,4.30000000
CN4845100000000,48,451,"Tom Green County, TX",Sep-22,53637,51884,1753,3.30000000
CN4845300000000,48,453,"Travis County, TX",Sep-22,799121,777024,22097,2.80000000
CN4845500000000,48,455,"Trinity County, TX",Sep-22,5201,4924,277,5.30000000
CN4845700000000,48,457,"Tyler County, TX",Sep-22,7436,7003,433,5.80000000
CN4845900000000,48,459,"Upshur County, TX",Sep-22,17578,16831,747,4.20000000
CN4846100000000,48,461,"Upton County, TX",Sep-22,1701,1644,57,3.40000000
CN4846300000000,48,463,"Uvalde County, TX",Sep-22,11019,10539,480,4.40000000
CN4846500000000,48,465,"Val Verde County, TX",Sep-22,21970,21083,887,4.00000000
CN4846700000000,48,467,"Van Zandt County, TX",Sep-22,27478,26575,903,3.30000000
CN4846900000000,48,469,"Victoria County, TX",Sep-22,40541,38841,1700,4.20000000
CN4847100000000,48,471,"Walker County, TX",Sep-22,23270,22215,1055,4.50000000
CN4847300000000,48,473,"Waller County, TX",Sep-22,25424,24370,1054,4.10000000
CN4847500000000,48,475,"Ward County, TX",Sep-22,6416,6182,234,3.60000000
CN4847700000000,48,477,"Washington County, TX",Sep-22,14753,14198,555,3.80000000
CN4847900000000,48,479,"Webb County, TX",Sep-22,117443,113003,4440,3.80000000
CN4848100000000,48,481,"Wharton County, TX",Sep-22,20898,20091,807,3.90000000
CN4848300000000,48,483,"Wheeler County, TX",Sep-22,1872,1798,74,4.00000000
CN4848500000000,48,485,"Wichita County, TX",Sep-22,55090,53118,1972,3.60000000
CN4848700000000,48,487,"Wilbarger County, TX",Sep-22,4669,4437,232,5.00000000
CN4848900000000,48,489,"Willacy County, TX",Sep-22,7037,6468,569,8.10000000
CN4849100000000,48,491,"Williamson County, TX",Sep-22,353279,343274,10005,2.80000000
CN4849300000000,48,493,"Wilson County, TX",Sep-22,25522,24747,775,3.00000000
CN4849500000000,48,495,"Winkler County, TX",Sep-22,3617,3462,155,4.30000000
CN4849700000000,48,497,"Wise County, TX",Sep-22,33890,32775,1115,3.30000000
CN4849900000000,48,499,"Wood County, TX",Sep-22,17790,17033,757,4.30000000
CN4850100000000,48,501,"Yoakum County, TX",Sep-22,3087,2954,133,4.30000000
CN4850300000000,48,503,"Young County, TX",Sep-22,7993,7745,248,3.10000000
CN4850500000000,48,505,"Zapata County, TX",Sep-22,4475,4152,323,7.20000000
CN4850700000000,48,507,"Zavala County, TX",Sep-22,3192,2916,276,8.60000000
CN4900100000000,49,001,"Beaver County, UT",Sep-22,2755,2693,62,2.30000000
CN4900300000000,49,003,"Box Elder County, UT",Sep-22,27655,27158,497,1.80000000
CN4900500000000,49,005,"Cache County, UT",Sep-22,71811,70700,1111,1.50000000
CN4900700000000,49,007,"Carbon County, UT",Sep-22,8469,8240,229,2.70000000
CN4900900000000,49,009,"Daggett County, UT",Sep-22,448,434,14,3.10000000
CN4901100000000,49,011,"Davis County, UT",Sep-22,185468,182205,3263,1.80000000
CN4901300000000,49,013,"Duchesne County, UT",Sep-22,8120,7923,197,2.40000000
CN4901500000000,49,015,"Emery County, UT",Sep-22,4521,4421,100,2.20000000
CN4901700000000,49,017,"Garfield County, UT",Sep-22,3120,3030,90,2.90000000
CN4901900000000,49,019,"Grand County, UT",Sep-22,7432,7306,126,1.70000000
CN4902100000000,49,021,"Iron County, UT",Sep-22,27795,27272,523,1.90000000
CN4902300000000,49,023,"Juab County, UT",Sep-22,6549,6452,97,1.50000000
CN4902500000000,49,025,"Kane County, UT",Sep-22,4224,4149,75,1.80000000
CN4902700000000,49,027,"Millard County, UT",Sep-22,5961,5846,115,1.90000000
CN4902900000000,49,029,"Morgan County, UT",Sep-22,5979,5884,95,1.60000000
CN4903100000000,49,031,"Piute County, UT",Sep-22,519,503,16,3.10000000
CN4903300000000,49,033,"Rich County, UT",Sep-22,1315,1291,24,1.80000000
CN4903500000000,49,035,"Salt Lake County, UT",Sep-22,671718,658928,12790,1.90000000
CN4903700000000,49,037,"San Juan County, UT",Sep-22,5756,5578,178,3.10000000
CN4903900000000,49,039,"Sanpete County, UT",Sep-22,13466,13169,297,2.20000000
CN4904100000000,49,041,"Sevier County, UT",Sep-22,10352,10136,216,2.10000000
CN4904300000000,49,043,"Summit County, UT",Sep-22,25492,25057,435,1.70000000
CN4904500000000,49,045,"Tooele County, UT",Sep-22,37815,37031,784,2.10000000
CN4904700000000,49,047,"Uintah County, UT",Sep-22,14267,13856,411,2.90000000
CN4904900000000,49,049,"Utah County, UT",Sep-22,352742,346736,6006,1.70000000
CN4905100000000,49,051,"Wasatch County, UT",Sep-22,17691,17366,325,1.80000000
CN4905300000000,49,053,"Washington County, UT",Sep-22,87792,86046,1746,2.00000000
CN4905500000000,49,055,"Wayne County, UT",Sep-22,1561,1519,42,2.70000000
CN4905700000000,49,057,"Weber County, UT",Sep-22,135796,133150,2646,1.90000000
CN5000100000000,50,001,"Addison County, VT",Sep-22,20591,20233,358,1.70000000
CN5000300000000,50,003,"Bennington County, VT",Sep-22,17464,17024,440,2.50000000
CN5000500000000,50,005,"Caledonia County, VT",Sep-22,14232,13903,329,2.30000000
CN5000700000000,50,007,"Chittenden County, VT",Sep-22,96541,94788,1753,1.80000000
CN5000900000000,50,009,"Essex County, VT",Sep-22,2613,2528,85,3.30000000
CN5001100000000,50,011,"Franklin County, VT",Sep-22,27447,26949,498,1.80000000
CN5001300000000,50,013,"Grand Isle County, VT",Sep-22,4043,3977,66,1.60000000
CN5001500000000,50,015,"Lamoille County, VT",Sep-22,13703,13372,331,2.40000000
CN5001700000000,50,017,"Orange County, VT",Sep-22,15427,15145,282,1.80000000
CN5001900000000,50,019,"Orleans County, VT",Sep-22,12674,12275,399,3.10000000
CN5002100000000,50,021,"Rutland County, VT",Sep-22,28961,28167,794,2.70000000
CN5002300000000,50,023,"Washington County, VT",Sep-22,33198,32568,630,1.90000000
CN5002500000000,50,025,"Windham County, VT",Sep-22,20447,19956,491,2.40000000
CN5002700000000,50,027,"Windsor County, VT",Sep-22,27952,27444,508,1.80000000
CN5100100000000,51,001,"Accomack County, VA",Sep-22,15850,15455,395,2.50000000
CN5100300000000,51,003,"Albemarle County, VA",Sep-22,56055,54760,1295,2.30000000
CN5100500000000,51,005,"Alleghany County, VA",Sep-22,6974,6792,182,2.60000000
CN5100700000000,51,007,"Amelia County, VA",Sep-22,5989,5832,157,2.60000000
CN5100900000000,51,009,"Amherst County, VA",Sep-22,14570,14157,413,2.80000000
CN5101100000000,51,011,"Appomattox County, VA",Sep-22,6993,6801,192,2.70000000
CN5101300000000,51,013,"Arlington County, VA",Sep-22,152125,149450,2675,1.80000000
CN5101500000000,51,015,"Augusta County, VA",Sep-22,36791,35967,824,2.20000000
CN5101700000000,51,017,"Bath County, VA",Sep-22,2468,2412,56,2.30000000
CN5101900000000,51,019,"Bedford County, VA",Sep-22,37704,36791,913,2.40000000
CN5102100000000,51,021,"Bland County, VA",Sep-22,2873,2809,64,2.20000000
CN5102300000000,51,023,"Botetourt County, VA",Sep-22,17014,16634,380,2.20000000
CN5102500000000,51,025,"Brunswick County, VA",Sep-22,6022,5763,259,4.30000000
CN5102700000000,51,027,"Buchanan County, VA",Sep-22,6576,6304,272,4.10000000
CN5102900000000,51,029,"Buckingham County, VA",Sep-22,6203,5985,218,3.50000000
CN5103100000000,51,031,"Campbell County, VA",Sep-22,25322,24650,672,2.70000000
CN5103300000000,51,033,"Caroline County, VA",Sep-22,14713,14266,447,3.00000000
CN5103500000000,51,035,"Carroll County, VA",Sep-22,13857,13479,378,2.70000000
CN5103600000000,51,036,"Charles City County, VA",Sep-22,3432,3343,89,2.60000000
CN5103700000000,51,037,"Charlotte County, VA",Sep-22,5846,5694,152,2.60000000
CN5104100000000,51,041,"Chesterfield County, VA",Sep-22,185640,180814,4826,2.60000000
CN5104300000000,51,043,"Clarke County, VA",Sep-22,7393,7234,159,2.20000000
CN5104500000000,51,045,"Craig County, VA",Sep-22,2221,2160,61,2.70000000
CN5104700000000,51,047,"Culpeper County, VA",Sep-22,24612,24026,586,2.40000000
CN5104900000000,51,049,"Cumberland County, VA",Sep-22,4790,4660,130,2.70000000
CN5105100000000,51,051,"Dickenson County, VA",Sep-22,5266,5094,172,3.30000000
CN5105300000000,51,053,"Dinwiddie County, VA",Sep-22,13166,12766,400,3.00000000
CN5105700000000,51,057,"Essex County, VA",Sep-22,5330,5157,173,3.20000000
CN5105900000000,51,059,"Fairfax County, VA",Sep-22,618793,605395,13398,2.20000000
CN5106100000000,51,061,"Fauquier County, VA",Sep-22,36451,35639,812,2.20000000
CN5106300000000,51,063,"Floyd County, VA",Sep-22,8404,8234,170,2.00000000
CN5106500000000,51,065,"Fluvanna County, VA",Sep-22,13737,13428,309,2.20000000
CN5106700000000,51,067,"Franklin County, VA",Sep-22,25447,24775,672,2.60000000
CN5106900000000,51,069,"Frederick County, VA",Sep-22,49373,48339,1034,2.10000000
CN5107100000000,51,071,"Giles County, VA",Sep-22,8101,7900,201,2.50000000
CN5107300000000,51,073,"Gloucester County, VA",Sep-22,19034,18588,446,2.30000000
CN5107500000000,51,075,"Goochland County, VA",Sep-22,11280,11013,267,2.40000000
CN5107700000000,51,077,"Grayson County, VA",Sep-22,8978,8806,172,1.90000000
CN5107900000000,51,079,"Greene County, VA",Sep-22,10261,10051,210,2.00000000
CN5108100000000,51,081,"Greensville County, VA",Sep-22,4628,4484,144,3.10000000
CN5108300000000,51,083,"Halifax County, VA",Sep-22,16292,15775,517,3.20000000
CN5108500000000,51,085,"Hanover County, VA",Sep-22,57499,56257,1242,2.20000000
CN5108700000000,51,087,"Henrico County, VA",Sep-22,177872,173131,4741,2.70000000
CN5108900000000,51,089,"Henry County, VA",Sep-22,25935,25251,684,2.60000000
CN5109100000000,51,091,"Highland County, VA",Sep-22,1250,1227,23,1.80000000
CN5109300000000,51,093,"Isle of Wight County, VA",Sep-22,19192,18730,462,2.40000000
CN5109500000000,51,095,"James City County, VA",Sep-22,36100,35207,893,2.50000000
CN5109700000000,51,097,"King and Queen County, VA",Sep-22,3973,3887,86,2.20000000
CN5109900000000,51,099,"King George County, VA",Sep-22,14700,14388,312,2.10000000
CN5110100000000,51,101,"King William County, VA",Sep-22,9132,8911,221,2.40000000
CN5110300000000,51,103,"Lancaster County, VA",Sep-22,5734,5589,145,2.50000000
CN5110500000000,51,105,"Lee County, VA",Sep-22,8864,8600,264,3.00000000
CN5110700000000,51,107,"Loudoun County, VA",Sep-22,225276,220573,4703,2.10000000
CN5110900000000,51,109,"Louisa County, VA",Sep-22,21448,20974,474,2.20000000
CN5111100000000,51,111,"Lunenburg County, VA",Sep-22,5343,5171,172,3.20000000
CN5111300000000,51,113,"Madison County, VA",Sep-22,7582,7447,135,1.80000000
CN5111500000000,51,115,"Mathews County, VA",Sep-22,3987,3891,96,2.40000000
CN5111700000000,51,117,"Mecklenburg County, VA",Sep-22,13556,13158,398,2.90000000
CN5111900000000,51,119,"Middlesex County, VA",Sep-22,5444,5320,124,2.30000000
CN5112100000000,51,121,"Montgomery County, VA",Sep-22,52186,50995,1191,2.30000000
CN5112500000000,51,125,"Nelson County, VA",Sep-22,7063,6895,168,2.40000000
CN5112700000000,51,127,"New Kent County, VA",Sep-22,12651,12388,263,2.10000000
CN5113100000000,51,131,"Northampton County, VA",Sep-22,5608,5441,167,3.00000000
CN5113300000000,51,133,"Northumberland County, VA",Sep-22,5829,5654,175,3.00000000
CN5113500000000,51,135,"Nottoway County, VA",Sep-22,7478,7278,200,2.70000000
CN5113700000000,51,137,"Orange County, VA",Sep-22,17663,17229,434,2.50000000
CN5113900000000,51,139,"Page County, VA",Sep-22,12730,12408,322,2.50000000
CN5114100000000,51,141,"Patrick County, VA",Sep-22,7475,7257,218,2.90000000
CN5114300000000,51,143,"Pittsylvania County, VA",Sep-22,32264,31450,814,2.50000000
CN5114500000000,51,145,"Powhatan County, VA",Sep-22,14019,13707,312,2.20000000
CN5114700000000,51,147,"Prince Edward County, VA",Sep-22,11230,10890,340,3.00000000
CN5114900000000,51,149,"Prince George County, VA",Sep-22,14767,14291,476,3.20000000
CN5115300000000,51,153,"Prince William County, VA",Sep-22,243445,237511,5934,2.40000000
CN5115500000000,51,155,"Pulaski County, VA",Sep-22,16671,16255,416,2.50000000
CN5115700000000,51,157,"Rappahannock County, VA",Sep-22,3548,3474,74,2.10000000
CN5115900000000,51,159,"Richmond County, VA",Sep-22,4139,4047,92,2.20000000
CN5116100000000,51,161,"Roanoke County, VA",Sep-22,48023,46940,1083,2.30000000
CN5116300000000,51,163,"Rockbridge County, VA",Sep-22,11488,11240,248,2.20000000
CN5116500000000,51,165,"Rockingham County, VA",Sep-22,41653,40743,910,2.20000000
CN5116700000000,51,167,"Russell County, VA",Sep-22,11507,11187,320,2.80000000
CN5116900000000,51,169,"Scott County, VA",Sep-22,8895,8654,241,2.70000000
CN5117100000000,51,171,"Shenandoah County, VA",Sep-22,23028,22488,540,2.30000000
CN5117300000000,51,173,"Smyth County, VA",Sep-22,15852,15505,347,2.20000000
CN5117500000000,51,175,"Southampton County, VA",Sep-22,9110,8895,215,2.40000000
CN5117700000000,51,177,"Spotsylvania County, VA",Sep-22,67287,65514,1773,2.60000000
CN5117900000000,51,179,"Stafford County, VA",Sep-22,73462,71591,1871,2.50000000
CN5118100000000,51,181,"Surry County, VA",Sep-22,3607,3516,91,2.50000000
CN5118300000000,51,183,"Sussex County, VA",Sep-22,3523,3373,150,4.30000000
CN5118500000000,51,185,"Tazewell County, VA",Sep-22,16302,15787,515,3.20000000
CN5118700000000,51,187,"Warren County, VA",Sep-22,20056,19554,502,2.50000000
CN5119100000000,51,191,"Washington County, VA",Sep-22,25520,24894,626,2.50000000
CN5119300000000,51,193,"Westmoreland County, VA",Sep-22,10034,9747,287,2.90000000
CN5119500000000,51,195,"Wise County, VA",Sep-22,14735,14284,451,3.10000000
CN5119700000000,51,197,"Wythe County, VA",Sep-22,14934,14584,350,2.30000000
CN5119900000000,51,199,"York County, VA",Sep-22,32469,31711,758,2.30000000
CN5151000000000,51,510,"Alexandria city, VA",Sep-22,97779,95730,2049,2.10000000
CN5152000000000,51,520,"Bristol city, VA",Sep-22,7321,7095,226,3.10000000
CN5153000000000,51,530,"Buena Vista city, VA",Sep-22,3293,3212,81,2.50000000
CN5154000000000,51,540,"Charlottesville city, VA",Sep-22,24897,24346,551,2.20000000
CN5155000000000,51,550,"Chesapeake city, VA",Sep-22,121536,118286,3250,2.70000000
CN5157000000000,51,570,"Colonial Heights city, VA",Sep-22,8196,7935,261,3.20000000
CN5158000000000,51,580,"Covington city, VA",Sep-22,2434,2350,84,3.50000000
CN5159000000000,51,590,"Danville city, VA",Sep-22,20079,19182,897,4.50000000
CN5159500000000,51,595,"Emporia city, VA",Sep-22,2555,2436,119,4.70000000
CN5160000000000,51,600,"Fairfax city, VA",Sep-22,12502,12236,266,2.10000000
CN5161000000000,51,610,"Falls Church city, VA",Sep-22,8295,8135,160,1.90000000
CN5162000000000,51,620,"Franklin city, VA",Sep-22,3561,3416,145,4.10000000
CN5163000000000,51,630,"Fredericksburg city, VA",Sep-22,13961,13528,433,3.10000000
CN5164000000000,51,640,"Galax city, VA",Sep-22,3074,3008,66,2.10000000
CN5165000000000,51,650,"Hampton city, VA",Sep-22,63299,60923,2376,3.80000000
CN5166000000000,51,660,"Harrisonburg city, VA",Sep-22,24286,23548,738,3.00000000
CN5167000000000,51,670,"Hopewell city, VA",Sep-22,9300,8864,436,4.70000000
CN5167800000000,51,678,"Lexington city, VA",Sep-22,2316,2232,84,3.60000000
CN5168000000000,51,680,"Lynchburg city, VA",Sep-22,35133,33885,1248,3.60000000
CN5168300000000,51,683,"Manassas city, VA",Sep-22,21089,20594,495,2.30000000
CN5168500000000,51,685,"Manassas Park city, VA",Sep-22,9486,9270,216,2.30000000
CN5169000000000,51,690,"Martinsville city, VA",Sep-22,6009,5727,282,4.70000000
CN5170000000000,51,700,"Newport News city, VA",Sep-22,87040,83852,3188,3.70000000
CN5171000000000,51,710,"Norfolk city, VA",Sep-22,108373,104592,3781,3.50000000
CN5172000000000,51,720,"Norton city, VA",Sep-22,1805,1751,54,3.00000000
CN5173000000000,51,730,"Petersburg city, VA",Sep-22,12245,11449,796,6.50000000
CN5173500000000,51,735,"Poquoson city, VA",Sep-22,6226,6086,140,2.20000000
CN5174000000000,51,740,"Portsmouth city, VA",Sep-22,43442,41697,1745,4.00000000
CN5175000000000,51,750,"Radford city, VA",Sep-22,9045,8774,271,3.00000000
CN5176000000000,51,760,"Richmond city, VA",Sep-22,115986,112041,3945,3.40000000
CN5177000000000,51,770,"Roanoke city, VA",Sep-22,47274,45895,1379,2.90000000
CN5177500000000,51,775,"Salem city, VA",Sep-22,12449,12122,327,2.60000000
CN5179000000000,51,790,"Staunton city, VA",Sep-22,11998,11707,291,2.40000000
CN5180000000000,51,800,"Suffolk city, VA",Sep-22,44716,43468,1248,2.80000000
CN5181000000000,51,810,"Virginia Beach city, VA",Sep-22,227124,221449,5675,2.50000000
CN5182000000000,51,820,"Waynesboro city, VA",Sep-22,10442,10158,284,2.70000000
CN5183000000000,51,830,"Williamsburg city, VA",Sep-22,6668,6419,249,3.70000000
CN5184000000000,51,840,"Winchester city, VA",Sep-22,14470,14117,353,2.40000000
CN5300100000000,53,001,"Adams County, WA",Sep-22,10659,10328,331,3.10000000
CN5300300000000,53,003,"Asotin County, WA",Sep-22,10568,10269,299,2.80000000
CN5300500000000,53,005,"Benton County, WA",Sep-22,107409,103375,4034,3.80000000
CN5300700000000,53,007,"Chelan County, WA",Sep-22,45797,44328,1469,3.20000000
CN5300900000000,53,009,"Clallam County, WA",Sep-22,29823,28461,1362,4.60000000
CN5301100000000,53,011,"Clark County, WA",Sep-22,252043,242596,9447,3.70000000
CN5301300000000,53,013,"Columbia County, WA",Sep-22,1806,1737,69,3.80000000
CN5301500000000,53,015,"Cowlitz County, WA",Sep-22,48791,46503,2288,4.70000000
CN5301700000000,53,017,"Douglas County, WA",Sep-22,22352,21558,794,3.60000000
CN5301900000000,53,019,"Ferry County, WA",Sep-22,2257,2095,162,7.20000000
CN5302100000000,53,021,"Franklin County, WA",Sep-22,45269,43266,2003,4.40000000
CN5302300000000,53,023,"Garfield County, WA",Sep-22,794,759,35,4.40000000
CN5302500000000,53,025,"Grant County, WA",Sep-22,49448,47403,2045,4.10000000
CN5302700000000,53,027,"Grays Harbor County, WA",Sep-22,28515,26865,1650,5.80000000
CN5302900000000,53,029,"Island County, WA",Sep-22,36335,34895,1440,4.00000000
CN5303100000000,53,031,"Jefferson County, WA",Sep-22,12768,12197,571,4.50000000
CN5303300000000,53,033,"King County, WA",Sep-22,1327433,1289001,38432,2.90000000
CN5303500000000,53,035,"Kitsap County, WA",Sep-22,127860,123278,4582,3.60000000
CN5303700000000,53,037,"Kittitas County, WA",Sep-22,22028,21051,977,4.40000000
CN5303900000000,53,039,"Klickitat County, WA",Sep-22,9867,9449,418,4.20000000
CN5304100000000,53,041,"Lewis County, WA",Sep-22,34637,33007,1630,4.70000000
CN5304300000000,53,043,"Lincoln County, WA",Sep-22,4665,4491,174,3.70000000
CN5304500000000,53,045,"Mason County, WA",Sep-22,24766,23440,1326,5.40000000
CN5304700000000,53,047,"Okanogan County, WA",Sep-22,19948,19054,894,4.50000000
CN5304900000000,53,049,"Pacific County, WA",Sep-22,8720,8133,587,6.70000000
CN5305100000000,53,051,"Pend Oreille County, WA",Sep-22,5147,4878,269,5.20000000
CN5305300000000,53,053,"Pierce County, WA",Sep-22,448297,429324,18973,4.20000000
CN5305500000000,53,055,"San Juan County, WA",Sep-22,8724,8475,249,2.90000000
CN5305700000000,53,057,"Skagit County, WA",Sep-22,62473,59931,2542,4.10000000
CN5305900000000,53,059,"Skamania County, WA",Sep-22,5615,5397,218,3.90000000
CN5306100000000,53,061,"Snohomish County, WA",Sep-22,452468,437750,14718,3.30000000
CN5306300000000,53,063,"Spokane County, WA",Sep-22,263925,254182,9743,3.70000000
CN5306500000000,53,065,"Stevens County, WA",Sep-22,19126,18211,915,4.80000000
CN5306700000000,53,067,"Thurston County, WA",Sep-22,144544,139122,5422,3.80000000
CN5306900000000,53,069,"Wahkiakum County, WA",Sep-22,1322,1245,77,5.80000000
CN5307100000000,53,071,"Walla Walla County, WA",Sep-22,31577,30519,1058,3.40000000
CN5307300000000,53,073,"Whatcom County, WA",Sep-22,114942,110412,4530,3.90000000
CN5307500000000,53,075,"Whitman County, WA",Sep-22,23476,22662,814,3.50000000
CN5307700000000,53,077,"Yakima County, WA",Sep-22,139081,132996,6085,4.40000000
CN5400100000000,54,001,"Barbour County, WV",Sep-22,7248,6981,267,3.70000000
CN5400300000000,54,003,"Berkeley County, WV",Sep-22,60881,59394,1487,2.40000000
CN5400500000000,54,005,"Boone County, WV",Sep-22,7148,6875,273,3.80000000
CN5400700000000,54,007,"Braxton County, WV",Sep-22,5004,4764,240,4.80000000
CN5400900000000,54,009,"Brooke County, WV",Sep-22,9886,9488,398,4.00000000
CN5401100000000,54,011,"Cabell County, WV",Sep-22,41322,40083,1239,3.00000000
CN5401300000000,54,013,"Calhoun County, WV",Sep-22,2596,2444,152,5.90000000
CN5401500000000,54,015,"Clay County, WV",Sep-22,2999,2850,149,5.00000000
CN5401700000000,54,017,"Doddridge County, WV",Sep-22,3831,3736,95,2.50000000
CN5401900000000,54,019,"Fayette County, WV",Sep-22,16217,15595,622,3.80000000
CN5402100000000,54,021,"Gilmer County, WV",Sep-22,2332,2240,92,3.90000000
CN5402300000000,54,023,"Grant County, WV",Sep-22,6029,5861,168,2.80000000
CN5402500000000,54,025,"Greenbrier County, WV",Sep-22,15770,15310,460,2.90000000
CN5402700000000,54,027,"Hampshire County, WV",Sep-22,11321,11077,244,2.20000000
CN5402900000000,54,029,"Hancock County, WV",Sep-22,13053,12445,608,4.70000000
CN5403100000000,54,031,"Hardy County, WV",Sep-22,5915,5740,175,3.00000000
CN5403300000000,54,033,"Harrison County, WV",Sep-22,33257,32274,983,3.00000000
CN5403500000000,54,035,"Jackson County, WV",Sep-22,11959,11547,412,3.40000000
CN5403700000000,54,037,"Jefferson County, WV",Sep-22,30944,30292,652,2.10000000
CN5403900000000,54,039,"Kanawha County, WV",Sep-22,80753,78190,2563,3.20000000
CN5404100000000,54,041,"Lewis County, WV",Sep-22,6027,5758,269,4.50000000
CN5404300000000,54,043,"Lincoln County, WV",Sep-22,7011,6713,298,4.30000000
CN5404500000000,54,045,"Logan County, WV",Sep-22,10952,10503,449,4.10000000
CN5404700000000,54,047,"McDowell County, WV",Sep-22,4282,4050,232,5.40000000
CN5404900000000,54,049,"Marion County, WV",Sep-22,25124,24211,913,3.60000000
CN5405100000000,54,051,"Marshall County, WV",Sep-22,13376,12848,528,3.90000000
CN5405300000000,54,053,"Mason County, WV",Sep-22,9985,9623,362,3.60000000
CN5405500000000,54,055,"Mercer County, WV",Sep-22,20930,20153,777,3.70000000
CN5405700000000,54,057,"Mineral County, WV",Sep-22,12196,11831,365,3.00000000
CN5405900000000,54,059,"Mingo County, WV",Sep-22,6082,5740,342,5.60000000
CN5406100000000,54,061,"Monongalia County, WV",Sep-22,57800,56321,1479,2.60000000
CN5406300000000,54,063,"Monroe County, WV",Sep-22,6303,6160,143,2.30000000
CN5406500000000,54,065,"Morgan County, WV",Sep-22,8703,8510,193,2.20000000
CN5406700000000,54,067,"Nicholas County, WV",Sep-22,9162,8818,344,3.80000000
CN5406900000000,54,069,"Ohio County, WV",Sep-22,20421,19775,646,3.20000000
CN5407100000000,54,071,"Pendleton County, WV",Sep-22,3865,3790,75,1.90000000
CN5407300000000,54,073,"Pleasants County, WV",Sep-22,2731,2607,124,4.50000000
CN5407500000000,54,075,"Pocahontas County, WV",Sep-22,4320,4216,104,2.40000000
CN5407700000000,54,077,"Preston County, WV",Sep-22,16268,15778,490,3.00000000
CN5407900000000,54,079,"Putnam County, WV",Sep-22,26869,26174,695,2.60000000
CN5408100000000,54,081,"Raleigh County, WV",Sep-22,30555,29654,901,2.90000000
CN5408300000000,54,083,"Randolph County, WV",Sep-22,11824,11384,440,3.70000000
CN5408500000000,54,085,"Ritchie County, WV",Sep-22,4334,4188,146,3.40000000
CN5408700000000,54,087,"Roane County, WV",Sep-22,4953,4706,247,5.00000000
CN5408900000000,54,089,"Summers County, WV",Sep-22,4588,4463,125,2.70000000
CN5409100000000,54,091,"Taylor County, WV",Sep-22,7864,7613,251,3.20000000
CN5409300000000,54,093,"Tucker County, WV",Sep-22,3354,3242,112,3.30000000
CN5409500000000,54,095,"Tyler County, WV",Sep-22,2959,2810,149,5.00000000
CN5409700000000,54,097,"Upshur County, WV",Sep-22,9704,9319,385,4.00000000
CN5409900000000,54,099,"Wayne County, WV",Sep-22,15476,14992,484,3.10000000
CN5410100000000,54,101,"Webster County, WV",Sep-22,3352,3221,131,3.90000000
CN5410300000000,54,103,"Wetzel County, WV",Sep-22,6772,6481,291,4.30000000
CN5410500000000,54,105,"Wirt County, WV",Sep-22,2303,2192,111,4.80000000
CN5410700000000,54,107,"Wood County, WV",Sep-22,37071,35852,1219,3.30000000
CN5410900000000,54,109,"Wyoming County, WV",Sep-22,7348,7084,264,3.60000000
CN5500100000000,55,001,"Adams County, WI",Sep-22,7736,7374,362,4.70000000
CN5500300000000,55,003,"Ashland County, WI",Sep-22,7592,7323,269,3.50000000
CN5500500000000,55,005,"Barron County, WI",Sep-22,23778,23040,738,3.10000000
CN5500700000000,55,007,"Bayfield County, WI",Sep-22,7390,7089,301,4.10000000
CN5500900000000,55,009,"Brown County, WI",Sep-22,141239,137122,4117,2.90000000
CN5501100000000,55,011,"Buffalo County, WI",Sep-22,5891,5678,213,3.60000000
CN5501300000000,55,013,"Burnett County, WI",Sep-22,7142,6858,284,4.00000000
CN5501500000000,55,015,"Calumet County, WI",Sep-22,27260,26548,712,2.60000000
CN5501700000000,55,017,"Chippewa County, WI",Sep-22,32874,31859,1015,3.10000000
CN5501900000000,55,019,"Clark County, WI",Sep-22,17020,16570,450,2.60000000
CN5502100000000,55,021,"Columbia County, WI",Sep-22,31676,30796,880,2.80000000
CN5502300000000,55,023,"Crawford County, WI",Sep-22,6995,6750,245,3.50000000
CN5502500000000,55,025,"Dane County, WI",Sep-22,332222,323782,8440,2.50000000
CN5502700000000,55,027,"Dodge County, WI",Sep-22,47406,46069,1337,2.80000000
CN5502900000000,55,029,"Door County, WI",Sep-22,16296,15836,460,2.80000000
CN5503100000000,55,031,"Douglas County, WI",Sep-22,23120,22254,866,3.70000000
CN5503300000000,55,033,"Dunn County, WI",Sep-22,24044,23309,735,3.10000000
CN5503500000000,55,035,"Eau Claire County, WI",Sep-22,59153,57552,1601,2.70000000
CN5503700000000,55,037,"Florence County, WI",Sep-22,2128,2051,77,3.60000000
CN5503900000000,55,039,"Fond du Lac County, WI",Sep-22,56400,54846,1554,2.80000000
CN5504100000000,55,041,"Forest County, WI",Sep-22,3765,3579,186,4.90000000
CN5504300000000,55,043,"Grant County, WI",Sep-22,26436,25637,799,3.00000000
CN5504500000000,55,045,"Green County, WI",Sep-22,20569,19991,578,2.80000000
CN5504700000000,55,047,"Green Lake County, WI",Sep-22,9283,8974,309,3.30000000
CN5504900000000,55,049,"Iowa County, WI",Sep-22,13256,12909,347,2.60000000
CN5505100000000,55,051,"Iron County, WI",Sep-22,2456,2332,124,5.00000000
CN5505300000000,55,053,"Jackson County, WI",Sep-22,9165,8826,339,3.70000000
CN5505500000000,55,055,"Jefferson County, WI",Sep-22,46091,44757,1334,2.90000000
CN5505700000000,55,057,"Juneau County, WI",Sep-22,13066,12637,429,3.30000000
CN5505900000000,55,059,"Kenosha County, WI",Sep-22,92345,89128,3217,3.50000000
CN5506100000000,55,061,"Kewaunee County, WI",Sep-22,10508,10222,286,2.70000000
CN5506300000000,55,063,"La Crosse County, WI",Sep-22,66711,64910,1801,2.70000000
CN5506500000000,55,065,"Lafayette County, WI",Sep-22,9920,9664,256,2.60000000
CN5506700000000,55,067,"Langlade County, WI",Sep-22,9118,8787,331,3.60000000
CN5506900000000,55,069,"Lincoln County, WI",Sep-22,14537,14106,431,3.00000000
CN5507100000000,55,071,"Manitowoc County, WI",Sep-22,40303,39109,1194,3.00000000
CN5507300000000,55,073,"Marathon County, WI",Sep-22,72679,70686,1993,2.70000000
CN5507500000000,55,075,"Marinette County, WI",Sep-22,18929,18210,719,3.80000000
CN5507700000000,55,077,"Marquette County, WI",Sep-22,7649,7397,252,3.30000000
CN5507800000000,55,078,"Menominee County, WI",Sep-22,1478,1391,87,5.90000000
CN5507900000000,55,079,"Milwaukee County, WI",Sep-22,463085,443323,19762,4.30000000
CN5508100000000,55,081,"Monroe County, WI",Sep-22,22797,22157,640,2.80000000
CN5508300000000,55,083,"Oconto County, WI",Sep-22,20290,19635,655,3.20000000
CN5508500000000,55,085,"Oneida County, WI",Sep-22,17966,17425,541,3.00000000
CN5508700000000,55,087,"Outagamie County, WI",Sep-22,103948,101157,2791,2.70000000
CN5508900000000,55,089,"Ozaukee County, WI",Sep-22,48858,47432,1426,2.90000000
CN5509100000000,55,091,"Pepin County, WI",Sep-22,3960,3853,107,2.70000000
CN5509300000000,55,093,"Pierce County, WI",Sep-22,24943,24201,742,3.00000000
CN5509500000000,55,095,"Polk County, WI",Sep-22,24315,23535,780,3.20000000
CN5509700000000,55,097,"Portage County, WI",Sep-22,37525,36384,1141,3.00000000
CN5509900000000,55,099,"Price County, WI",Sep-22,6078,5861,217,3.60000000
CN5510100000000,55,101,"Racine County, WI",Sep-22,96641,92972,3669,3.80000000
CN5510300000000,55,103,"Richland County, WI",Sep-22,8726,8470,256,2.90000000
CN5510500000000,55,105,"Rock County, WI",Sep-22,85426,82277,3149,3.70000000
CN5510700000000,55,107,"Rusk County, WI",Sep-22,6250,6030,220,3.50000000
CN5510900000000,55,109,"St. Croix County, WI",Sep-22,51026,49551,1475,2.90000000
CN5511100000000,55,111,"Sauk County, WI",Sep-22,33803,32809,994,2.90000000
CN5511300000000,55,113,"Sawyer County, WI",Sep-22,8028,7753,275,3.40000000
CN5511500000000,55,115,"Shawano County, WI",Sep-22,20006,19392,614,3.10000000
CN5511700000000,55,117,"Sheboygan County, WI",Sep-22,61763,60045,1718,2.80000000
CN5511900000000,55,119,"Taylor County, WI",Sep-22,10417,10134,283,2.70000000
CN5512100000000,55,121,"Trempealeau County, WI",Sep-22,14478,14058,420,2.90000000
CN5512300000000,55,123,"Vernon County, WI",Sep-22,14817,14386,431,2.90000000
CN5512500000000,55,125,"Vilas County, WI",Sep-22,10392,10025,367,3.50000000
CN5512700000000,55,127,"Walworth County, WI",Sep-22,57728,55959,1769,3.10000000
CN5512900000000,55,129,"Washburn County, WI",Sep-22,7648,7394,254,3.30000000
CN5513100000000,55,131,"Washington County, WI",Sep-22,76506,74412,2094,2.70000000
CN5513300000000,55,133,"Waukesha County, WI",Sep-22,224407,218031,6376,2.80000000
CN5513500000000,55,135,"Waupaca County, WI",Sep-22,25133,24344,789,3.10000000
CN5513700000000,55,137,"Waushara County, WI",Sep-22,10904,10527,377,3.50000000
CN5513900000000,55,139,"Winnebago County, WI",Sep-22,92008,89364,2644,2.90000000
CN5514100000000,55,141,"Wood County, WI",Sep-22,33615,32457,1158,3.40000000
CN5600100000000,56,001,"Albany County, WY",Sep-22,21063,20469,594,2.80000000
CN5600300000000,56,003,"Big Horn County, WY",Sep-22,5250,5083,167,3.20000000
CN5600500000000,56,005,"Campbell County, WY",Sep-22,22426,21710,716,3.20000000
CN5600700000000,56,007,"Carbon County, WY",Sep-22,7657,7410,247,3.20000000
CN5600900000000,56,009,"Converse County, WY",Sep-22,7528,7324,204,2.70000000
CN5601100000000,56,011,"Crook County, WY",Sep-22,3905,3813,92,2.40000000
CN5601300000000,56,013,"Fremont County, WY",Sep-22,19056,18419,637,3.30000000
CN5601500000000,56,015,"Goshen County, WY",Sep-22,6413,6243,170,2.70000000
CN5601700000000,56,017,"Hot Springs County, WY",Sep-22,2271,2217,54,2.40000000
CN5601900000000,56,019,"Johnson County, WY",Sep-22,4275,4153,122,2.90000000
CN5602100000000,56,021,"Laramie County, WY",Sep-22,49426,47900,1526,3.10000000
CN5602300000000,56,023,"Lincoln County, WY",Sep-22,9868,9594,274,2.80000000
CN5602500000000,56,025,"Natrona County, WY",Sep-22,38364,36928,1436,3.70000000
CN5602700000000,56,027,"Niobrara County, WY",Sep-22,1221,1191,30,2.50000000
CN5602900000000,56,029,"Park County, WY",Sep-22,16071,15634,437,2.70000000
CN5603100000000,56,031,"Platte County, WY",Sep-22,4442,4316,126,2.80000000
CN5603300000000,56,033,"Sheridan County, WY",Sep-22,15894,15442,452,2.80000000
CN5603500000000,56,035,"Sublette County, WY",Sep-22,3911,3779,132,3.40000000
CN5603700000000,56,037,"Sweetwater County, WY",Sep-22,19262,18545,717,3.70000000
CN5603900000000,56,039,"Teton County, WY",Sep-22,17257,16937,320,1.90000000
CN5604100000000,56,041,"Uinta County, WY",Sep-22,8760,8459,301,3.40000000
CN5604300000000,56,043,"Washakie County, WY",Sep-22,3828,3697,131,3.40000000
CN5604500000000,56,045,"Weston County, WY",Sep-22,3816,3736,80,2.10000000
CN7200100000000,72,001,"Adjuntas Municipio, PR",Sep-22,–,–,–,–
CN7200300000000,72,003,"Aguada Municipio, PR",Sep-22,–,–,–,–
CN7200500000000,72,005,"Aguadilla Municipio, PR",Sep-22,–,–,–,–
CN7200700000000,72,007,"Aguas Buenas Municipio, PR",Sep-22,–,–,–,–
CN7200900000000,72,009,"Aibonito Municipio, PR",Sep-22,–,–,–,–
CN7201100000000,72,011,"Anasco Municipio, PR",Sep-22,–,–,–,–
CN7201300000000,72,013,"Arecibo Municipio, PR",Sep-22,–,–,–,–
CN7201500000000,72,015,"Arroyo Municipio, PR",Sep-22,–,–,–,–
CN7201700000000,72,017,"Barceloneta Municipio, PR",Sep-22,–,–,–,–
CN7201900000000,72,019,"Barranquitas Municipio, PR",Sep-22,–,–,–,–
CN7202100000000,72,021,"Bayamon Municipio, PR",Sep-22,–,–,–,–
CN7202300000000,72,023,"Cabo Rojo Municipio, PR",Sep-22,–,–,–,–
CN7202500000000,72,025,"Caguas Municipio, PR",Sep-22,–,–,–,–
CN7202700000000,72,027,"Camuy Municipio, PR",Sep-22,–,–,–,–
CN7202900000000,72,029,"Canovanas Municipio, PR",Sep-22,–,–,–,–
CN7203100000000,72,031,"Carolina Municipio, PR",Sep-22,–,–,–,–
CN7203300000000,72,033,"Catano Municipio, PR",Sep-22,–,–,–,–
CN7203500000000,72,035,"Cayey Municipio, PR",Sep-22,–,–,–,–
CN7203700000000,72,037,"Ceiba Municipio, PR",Sep-22,–,–,–,–
CN7203900000000,72,039,"Ciales Municipio, PR",Sep-22,–,–,–,–
CN7204100000000,72,041,"Cidra Municipio, PR",Sep-22,–,–,–,–
CN7204300000000,72,043,"Coamo Municipio, PR",Sep-22,–,–,–,–
CN7204500000000,72,045,"Comerio Municipio, PR",Sep-22,–,–,–,–
CN7204700000000,72,047,"Corozal Municipio, PR",Sep-22,–,–,–,–
CN7204900000000,72,049,"Culebra Municipio, PR",Sep-22,–,–,–,–
CN7205100000000,72,051,"Dorado Municipio, PR",Sep-22,–,–,–,–
CN7205300000000,72,053,"Fajardo Municipio, PR",Sep-22,–,–,–,–
CN7205400000000,72,054,"Florida Municipio, PR",Sep-22,–,–,–,–
CN7205500000000,72,055,"Guanica Municipio, PR",Sep-22,–,–,–,–
CN7205700000000,72,057,"Guayama Municipio, PR",Sep-22,–,–,–,–
CN7205900000000,72,059,"Guayanilla Municipio, PR",Sep-22,–,–,–,–
CN7206100000000,72,061,"Guaynabo Municipio, PR",Sep-22,–,–,–,–
CN7206300000000,72,063,"Gurabo Municipio, PR",Sep-22,–,–,–,–
CN7206500000000,72,065,"Hatillo Municipio, PR",Sep-22,–,–,–,–
CN7206700000000,72,067,"Hormigueros Municipio, PR",Sep-22,–,–,–,–
CN7206900000000,72,069,"Humacao Municipio, PR",Sep-22,–,–,–,–
CN7207100000000,72,071,"Isabela Municipio, PR",Sep-22,–,–,–,–
CN7207300000000,72,073,"Jayuya Municipio, PR",Sep-22,–,–,–,–
CN7207500000000,72,075,"Juana Diaz Municipio, PR",Sep-22,–,–,–,–
CN7207700000000,72,077,"Juncos Municipio, PR",Sep-22,–,–,–,–
CN7207900000000,72,079,"Lajas Municipio, PR",Sep-22,–,–,–,–
CN7208100000000,72,081,"Lares Municipio, PR",Sep-22,–,–,–,–
CN7208300000000,72,083,"Las Marias Municipio, PR",Sep-22,–,–,–,–
CN7208500000000,72,085,"Las Piedras Municipio, PR",Sep-22,–,–,–,–
CN7208700000000,72,087,"Loiza Municipio, PR",Sep-22,–,–,–,–
CN7208900000000,72,089,"Luquillo Municipio, PR",Sep-22,–,–,–,–
CN7209100000000,72,091,"Manati Municipio, PR",Sep-22,–,–,–,–
CN7209300000000,72,093,"Maricao Municipio, PR",Sep-22,–,–,–,–
CN7209500000000,72,095,"Maunabo Municipio, PR",Sep-22,–,–,–,–
CN7209700000000,72,097,"Mayaguez Municipio, PR",Sep-22,–,–,–,–
CN7209900000000,72,099,"Moca Municipio, PR",Sep-22,–,–,–,–
CN7210100000000,72,101,"Morovis Municipio, PR",Sep-22,–,–,–,–
CN7210300000000,72,103,"Naguabo Municipio, PR",Sep-22,–,–,–,–
CN7210500000000,72,105,"Naranjito Municipio, PR",Sep-22,–,–,–,–
CN7210700000000,72,107,"Orocovis Municipio, PR",Sep-22,–,–,–,–
CN7210900000000,72,109,"Patillas Municipio, PR",Sep-22,–,–,–,–
CN7211100000000,72,111,"Penuelas Municipio, PR",Sep-22,–,–,–,–
CN7211300000000,72,113,"Ponce Municipio, PR",Sep-22,–,–,–,–
CN7211500000000,72,115,"Quebradillas Municipio, PR",Sep-22,–,–,–,–
CN7211700000000,72,117,"Rincon Municipio, PR",Sep-22,–,–,–,–
CN7211900000000,72,119,"Rio Grande Municipio, PR",Sep-22,–,–,–,–
CN7212100000000,72,121,"Sabana Grande Municipio, PR",Sep-22,–,–,–,–
CN7212300000000,72,123,"Salinas Municipio, PR",Sep-22,–,–,–,–
CN7212500000000,72,125,"San German Municipio, PR",Sep-22,–,–,–,–
CN7212700000000,72,127,"San Juan Municipio, PR",Sep-22,–,–,–,–
CN7212900000000,72,129,"San Lorenzo Municipio, PR",Sep-22,–,–,–,–
CN7213100000000,72,131,"San Sebastian Municipio, PR",Sep-22,–,–,–,–
CN7213300000000,72,133,"Santa Isabel Municipio, PR",Sep-22,–,–,–,–
CN7213500000000,72,135,"Toa Alta Municipio, PR",Sep-22,–,–,–,–
CN7213700000000,72,137,"Toa Baja Municipio, PR",Sep-22,–,–,–,–
CN7213900000000,72,139,"Trujillo Alto Municipio, PR",Sep-22,–,–,–,–
CN7214100000000,72,141,"Utuado Municipio, PR",Sep-22,–,–,–,–
CN7214300000000,72,143,"Vega Alta Municipio, PR",Sep-22,–,–,–,–
CN7214500000000,72,145,"Vega Baja Municipio, PR",Sep-22,–,–,–,–
CN7214700000000,72,147,"Vieques Municipio, PR",Sep-22,–,–,–,–
CN7214900000000,72,149,"Villalba Municipio, PR",Sep-22,–,–,–,–
CN7215100000000,72,151,"Yabucoa Municipio, PR",Sep-22,–,–,–,–
CN7215300000000,72,153,"Yauco Municipio, PR",Sep-22,–,–,–,–
CN0100100000000,01,001,"Autauga County, AL",Oct-22,26962,26341,621,2.30000000
CN0100300000000,01,003,"Baldwin County, AL",Oct-22,100496,98082,2414,2.40000000
CN0100500000000,01,005,"Barbour County, AL",Oct-22,8793,8359,434,4.90000000
CN0100700000000,01,007,"Bibb County, AL",Oct-22,8815,8585,230,2.60000000
CN0100900000000,01,009,"Blount County, AL",Oct-22,26208,25613,595,2.30000000
CN0101100000000,01,011,"Bullock County, AL",Oct-22,4783,4647,136,2.80000000
CN0101300000000,01,013,"Butler County, AL",Oct-22,9096,8751,345,3.80000000
CN0101500000000,01,015,"Calhoun County, AL",Oct-22,46537,45089,1448,3.10000000
CN0101700000000,01,017,"Chambers County, AL",Oct-22,16125,15694,431,2.70000000
CN0101900000000,01,019,"Cherokee County, AL",Oct-22,11694,11406,288,2.50000000
CN0102100000000,01,021,"Chilton County, AL",Oct-22,20608,20161,447,2.20000000
CN0102300000000,01,023,"Choctaw County, AL",Oct-22,4583,4413,170,3.70000000
CN0102500000000,01,025,"Clarke County, AL",Oct-22,7996,7554,442,5.50000000
CN0102700000000,01,027,"Clay County, AL",Oct-22,6569,6429,140,2.10000000
CN0102900000000,01,029,"Cleburne County, AL",Oct-22,6413,6277,136,2.10000000
CN0103100000000,01,031,"Coffee County, AL",Oct-22,22372,21814,558,2.50000000
CN0103300000000,01,033,"Colbert County, AL",Oct-22,23906,23188,718,3.00000000
CN0103500000000,01,035,"Conecuh County, AL",Oct-22,4319,4176,143,3.30000000
CN0103700000000,01,037,"Coosa County, AL",Oct-22,4671,4550,121,2.60000000
CN0103900000000,01,039,"Covington County, AL",Oct-22,15906,15517,389,2.40000000
CN0104100000000,01,041,"Crenshaw County, AL",Oct-22,6233,6077,156,2.50000000
CN0104300000000,01,043,"Cullman County, AL",Oct-22,41304,40508,796,1.90000000
CN0104500000000,01,045,"Dale County, AL",Oct-22,21504,20947,557,2.60000000
CN0104700000000,01,047,"Dallas County, AL",Oct-22,14097,13219,878,6.20000000
CN0104900000000,01,049,"DeKalb County, AL",Oct-22,32637,31912,725,2.20000000
CN0105100000000,01,051,"Elmore County, AL",Oct-22,38360,37497,863,2.20000000
CN0105300000000,01,053,"Escambia County, AL",Oct-22,14694,14196,498,3.40000000
CN0105500000000,01,055,"Etowah County, AL",Oct-22,39547,38319,1228,3.10000000
CN0105700000000,01,057,"Fayette County, AL",Oct-22,6677,6499,178,2.70000000
CN0105900000000,01,059,"Franklin County, AL",Oct-22,15022,14684,338,2.30000000
CN0106100000000,01,061,"Geneva County, AL",Oct-22,11542,11270,272,2.40000000
CN0106300000000,01,063,"Greene County, AL",Oct-22,2891,2733,158,5.50000000
CN0106500000000,01,065,"Hale County, AL",Oct-22,6243,5964,279,4.50000000
CN0106700000000,01,067,"Henry County, AL",Oct-22,7114,6910,204,2.90000000
CN0106900000000,01,069,"Houston County, AL",Oct-22,47789,46487,1302,2.70000000
CN0107100000000,01,071,"Jackson County, AL",Oct-22,23786,23233,553,2.30000000
CN0107300000000,01,073,"Jefferson County, AL",Oct-22,324891,316069,8822,2.70000000
CN0107500000000,01,075,"Lamar County, AL",Oct-22,5923,5790,133,2.20000000
CN0107700000000,01,077,"Lauderdale County, AL",Oct-22,42984,41903,1081,2.50000000
CN0107900000000,01,079,"Lawrence County, AL",Oct-22,14718,14361,357,2.40000000
CN0108100000000,01,081,"Lee County, AL",Oct-22,79020,77121,1899,2.40000000
CN0108300000000,01,083,"Limestone County, AL",Oct-22,47808,46809,999,2.10000000
CN0108500000000,01,085,"Lowndes County, AL",Oct-22,3623,3384,239,6.60000000
CN0108700000000,01,087,"Macon County, AL",Oct-22,8025,7699,326,4.10000000
CN0108900000000,01,089,"Madison County, AL",Oct-22,196206,191867,4339,2.20000000
CN0109100000000,01,091,"Marengo County, AL",Oct-22,8061,7755,306,3.80000000
CN0109300000000,01,093,"Marion County, AL",Oct-22,14285,13893,392,2.70000000
CN0109500000000,01,095,"Marshall County, AL",Oct-22,46372,45439,933,2.00000000
CN0109700000000,01,097,"Mobile County, AL",Oct-22,192094,185350,6744,3.50000000
CN0109900000000,01,099,"Monroe County, AL",Oct-22,7708,7387,321,4.20000000
CN0110100000000,01,101,"Montgomery County, AL",Oct-22,107889,104069,3820,3.50000000
CN0110300000000,01,103,"Morgan County, AL",Oct-22,60222,58956,1266,2.10000000
CN0110500000000,01,105,"Perry County, AL",Oct-22,3350,3133,217,6.50000000
CN0110700000000,01,107,"Pickens County, AL",Oct-22,7822,7550,272,3.50000000
CN0110900000000,01,109,"Pike County, AL",Oct-22,16791,16334,457,2.70000000
CN0111100000000,01,111,"Randolph County, AL",Oct-22,10104,9863,241,2.40000000
CN0111300000000,01,113,"Russell County, AL",Oct-22,23968,23304,664,2.80000000
CN0111500000000,01,115,"St. Clair County, AL",Oct-22,42495,41545,950,2.20000000
CN0111700000000,01,117,"Shelby County, AL",Oct-22,121792,119592,2200,1.80000000
CN0111900000000,01,119,"Sumter County, AL",Oct-22,4775,4610,165,3.50000000
CN0112100000000,01,121,"Talladega County, AL",Oct-22,37452,36254,1198,3.20000000
CN0112300000000,01,123,"Tallapoosa County, AL",Oct-22,18238,17723,515,2.80000000
CN0112500000000,01,125,"Tuscaloosa County, AL",Oct-22,102949,100283,2666,2.60000000
CN0112700000000,01,127,"Walker County, AL",Oct-22,25764,25048,716,2.80000000
CN0112900000000,01,129,"Washington County, AL",Oct-22,6751,6504,247,3.70000000
CN0113100000000,01,131,"Wilcox County, AL",Oct-22,2727,2466,261,9.60000000
CN0113300000000,01,133,"Winston County, AL",Oct-22,10602,10326,276,2.60000000
CN0201300000000,02,013,"Aleutians East Borough, AK",Oct-22,2477,2427,50,2.00000000
CN0201600000000,02,016,"Aleutians West Census Area, AK",Oct-22,2976,2864,112,3.80000000
CN0202000000000,02,020,"Anchorage Borough/municipality, AK",Oct-22,153898,149177,4721,3.10000000
CN0205000000000,02,050,"Bethel Census Area, AK",Oct-22,7189,6601,588,8.20000000
CN0206000000000,02,060,"Bristol Bay Borough, AK",Oct-22,317,306,11,3.50000000
CN0206300000000,02,063,"Chugach Census Area, AK",Oct-22,2997,2872,125,4.20000000
CN0206600000000,02,066,"Copper River Census Area, AK",Oct-22,1256,1119,137,10.90000000
CN0206800000000,02,068,"Denali Borough, AK",Oct-22,670,603,67,10.00000000
CN0207000000000,02,070,"Dillingham Census Area, AK",Oct-22,1622,1523,99,6.10000000
CN0209000000000,02,090,"Fairbanks North Star Borough, AK",Oct-22,46274,44751,1523,3.30000000
CN0210000000000,02,100,"Haines Borough, AK",Oct-22,1010,945,65,6.40000000
CN0210500000000,02,105,"Hoonah-Angoon Census Area, AK",Oct-22,1113,1060,53,4.80000000
CN0211000000000,02,110,"Juneau Borough/city, AK",Oct-22,16934,16507,427,2.50000000
CN0212200000000,02,122,"Kenai Peninsula Borough, AK",Oct-22,27687,26428,1259,4.50000000
CN0213000000000,02,130,"Ketchikan Gateway Borough, AK",Oct-22,6606,6358,248,3.80000000
CN0215000000000,02,150,"Kodiak Island Borough, AK",Oct-22,5999,5778,221,3.70000000
CN0215800000000,02,158,"Kusilvak Census Area, AK",Oct-22,2475,2193,282,11.40000000
CN0216400000000,02,164,"Lake and Peninsula Borough, AK",Oct-22,662,622,40,6.00000000
CN0217000000000,02,170,"Matanuska-Susitna Borough, AK",Oct-22,50679,48582,2097,4.10000000
CN0218000000000,02,180,"Nome Census Area, AK",Oct-22,4224,3959,265,6.30000000
CN0218500000000,02,185,"North Slope Borough, AK",Oct-22,2926,2781,145,5.00000000
CN0218800000000,02,188,"Northwest Arctic Borough, AK",Oct-22,2880,2627,253,8.80000000
CN0219500000000,02,195,"Petersburg Borough, AK",Oct-22,1547,1483,64,4.10000000
CN0219800000000,02,198,"Prince of Wales-Hyder Census Area, AK",Oct-22,2677,2541,136,5.10000000
CN0222000000000,02,220,"Sitka Borough/city, AK",Oct-22,4410,4295,115,2.60000000
CN0223000000000,02,230,"Skagway Municipality, AK",Oct-22,649,598,51,7.90000000
CN0224000000000,02,240,"Southeast Fairbanks Census Area, AK",Oct-22,3265,3123,142,4.30000000
CN0227500000000,02,275,"Wrangell Borough/city, AK",Oct-22,913,872,41,4.50000000
CN0228200000000,02,282,"Yakutat Borough/city, AK",Oct-22,284,273,11,3.90000000
CN0229000000000,02,290,"Yukon-Koyukuk Census Area, AK",Oct-22,2422,2243,179,7.40000000
CN0400100000000,04,001,"Apache County, AZ",Oct-22,18606,16902,1704,9.20000000
CN0400300000000,04,003,"Cochise County, AZ",Oct-22,49203,46983,2220,4.50000000
CN0400500000000,04,005,"Coconino County, AZ",Oct-22,77014,73342,3672,4.80000000
CN0400700000000,04,007,"Gila County, AZ",Oct-22,20516,19654,862,4.20000000
CN0400900000000,04,009,"Graham County, AZ",Oct-22,16412,15822,590,3.60000000
CN0401100000000,04,011,"Greenlee County, AZ",Oct-22,4430,4294,136,3.10000000
CN0401200000000,04,012,"La Paz County, AZ",Oct-22,9173,8735,438,4.80000000
CN0401300000000,04,013,"Maricopa County, AZ",Oct-22,2388415,2306897,81518,3.40000000
CN0401500000000,04,015,"Mohave County, AZ",Oct-22,89356,85042,4314,4.80000000
CN0401700000000,04,017,"Navajo County, AZ",Oct-22,40120,37784,2336,5.80000000
CN0401900000000,04,019,"Pima County, AZ",Oct-22,488452,469117,19335,4.00000000
CN0402100000000,04,021,"Pinal County, AZ",Oct-22,200563,192545,8018,4.00000000
CN0402300000000,04,023,"Santa Cruz County, AZ",Oct-22,19886,17846,2040,10.30000000
CN0402500000000,04,025,"Yavapai County, AZ",Oct-22,109095,105420,3675,3.40000000
CN0402700000000,04,027,"Yuma County, AZ",Oct-22,105863,86866,18997,17.90000000
CN0500100000000,05,001,"Arkansas County, AR",Oct-22,9572,9325,247,2.60000000
CN0500300000000,05,003,"Ashley County, AR",Oct-22,6786,6389,397,5.90000000
CN0500500000000,05,005,"Baxter County, AR",Oct-22,16553,16058,495,3.00000000
CN0500700000000,05,007,"Benton County, AR",Oct-22,148218,145267,2951,2.00000000
CN0500900000000,05,009,"Boone County, AR",Oct-22,15776,15396,380,2.40000000
CN0501100000000,05,011,"Bradley County, AR",Oct-22,4055,3867,188,4.60000000
CN0501300000000,05,013,"Calhoun County, AR",Oct-22,2362,2292,70,3.00000000
CN0501500000000,05,015,"Carroll County, AR",Oct-22,12801,12521,280,2.20000000
CN0501700000000,05,017,"Chicot County, AR",Oct-22,2917,2739,178,6.10000000
CN0501900000000,05,019,"Clark County, AR",Oct-22,8609,8283,326,3.80000000
CN0502100000000,05,021,"Clay County, AR",Oct-22,5407,5239,168,3.10000000
CN0502300000000,05,023,"Cleburne County, AR",Oct-22,8954,8643,311,3.50000000
CN0502500000000,05,025,"Cleveland County, AR",Oct-22,3107,2999,108,3.50000000
CN0502700000000,05,027,"Columbia County, AR",Oct-22,8765,8430,335,3.80000000
CN0502900000000,05,029,"Conway County, AR",Oct-22,8394,8142,252,3.00000000
CN0503100000000,05,031,"Craighead County, AR",Oct-22,56381,55059,1322,2.30000000
CN0503300000000,05,033,"Crawford County, AR",Oct-22,26100,25418,682,2.60000000
CN0503500000000,05,035,"Crittenden County, AR",Oct-22,20753,19971,782,3.80000000
CN0503700000000,05,037,"Cross County, AR",Oct-22,6873,6650,223,3.20000000
CN0503900000000,05,039,"Dallas County, AR",Oct-22,2682,2589,93,3.50000000
CN0504100000000,05,041,"Desha County, AR",Oct-22,4980,4737,243,4.90000000
CN0504300000000,05,043,"Drew County, AR",Oct-22,7165,6874,291,4.10000000
CN0504500000000,05,045,"Faulkner County, AR",Oct-22,62180,60625,1555,2.50000000
CN0504700000000,05,047,"Franklin County, AR",Oct-22,7506,7296,210,2.80000000
CN0504900000000,05,049,"Fulton County, AR",Oct-22,4954,4823,131,2.60000000
CN0505100000000,05,051,"Garland County, AR",Oct-22,40473,39029,1444,3.60000000
CN0505300000000,05,053,"Grant County, AR",Oct-22,8339,8110,229,2.70000000
CN0505500000000,05,055,"Greene County, AR",Oct-22,19530,19027,503,2.60000000
CN0505700000000,05,057,"Hempstead County, AR",Oct-22,9304,9038,266,2.90000000
CN0505900000000,05,059,"Hot Spring County, AR",Oct-22,13556,13137,419,3.10000000
CN0506100000000,05,061,"Howard County, AR",Oct-22,5414,5243,171,3.20000000
CN0506300000000,05,063,"Independence County, AR",Oct-22,16498,16052,446,2.70000000
CN0506500000000,05,065,"Izard County, AR",Oct-22,4607,4401,206,4.50000000
CN0506700000000,05,067,"Jackson County, AR",Oct-22,5439,5192,247,4.50000000
CN0506900000000,05,069,"Jefferson County, AR",Oct-22,25779,24444,1335,5.20000000
CN0507100000000,05,071,"Johnson County, AR",Oct-22,10081,9752,329,3.30000000
CN0507300000000,05,073,"Lafayette County, AR",Oct-22,2310,2208,102,4.40000000
CN0507500000000,05,075,"Lawrence County, AR",Oct-22,6781,6574,207,3.10000000
CN0507700000000,05,077,"Lee County, AR",Oct-22,2551,2445,106,4.20000000
CN0507900000000,05,079,"Lincoln County, AR",Oct-22,3726,3581,145,3.90000000
CN0508100000000,05,081,"Little River County, AR",Oct-22,5321,5150,171,3.20000000
CN0508300000000,05,083,"Logan County, AR",Oct-22,8198,7949,249,3.00000000
CN0508500000000,05,085,"Lonoke County, AR",Oct-22,33759,32962,797,2.40000000
CN0508700000000,05,087,"Madison County, AR",Oct-22,7663,7512,151,2.00000000
CN0508900000000,05,089,"Marion County, AR",Oct-22,6304,6106,198,3.10000000
CN0509100000000,05,091,"Miller County, AR",Oct-22,19224,18585,639,3.30000000
CN0509300000000,05,093,"Mississippi County, AR",Oct-22,16529,15698,831,5.00000000
CN0509500000000,05,095,"Monroe County, AR",Oct-22,2499,2395,104,4.20000000
CN0509700000000,05,097,"Montgomery County, AR",Oct-22,2837,2728,109,3.80000000
CN0509900000000,05,099,"Nevada County, AR",Oct-22,3415,3300,115,3.40000000
CN0510100000000,05,101,"Newton County, AR",Oct-22,3186,3113,73,2.30000000
CN0510300000000,05,103,"Ouachita County, AR",Oct-22,9562,9224,338,3.50000000
CN0510500000000,05,105,"Perry County, AR",Oct-22,4164,4043,121,2.90000000
CN0510700000000,05,107,"Phillips County, AR",Oct-22,5542,5159,383,6.90000000
CN0510900000000,05,109,"Pike County, AR",Oct-22,4104,3986,118,2.90000000
CN0511100000000,05,111,"Poinsett County, AR",Oct-22,9785,9515,270,2.80000000
CN0511300000000,05,113,"Polk County, AR",Oct-22,7742,7510,232,3.00000000
CN0511500000000,05,115,"Pope County, AR",Oct-22,27446,26626,820,3.00000000
CN0511700000000,05,117,"Prairie County, AR",Oct-22,3549,3461,88,2.50000000
CN0511900000000,05,119,"Pulaski County, AR",Oct-22,186875,180862,6013,3.20000000
CN0512100000000,05,121,"Randolph County, AR",Oct-22,7126,6930,196,2.80000000
CN0512300000000,05,123,"St. Francis County, AR",Oct-22,7599,7234,365,4.80000000
CN0512500000000,05,125,"Saline County, AR",Oct-22,59082,57701,1381,2.30000000
CN0512700000000,05,127,"Scott County, AR",Oct-22,4104,4016,88,2.10000000
CN0512900000000,05,129,"Searcy County, AR",Oct-22,2948,2839,109,3.70000000
CN0513100000000,05,131,"Sebastian County, AR",Oct-22,54886,53467,1419,2.60000000
CN0513300000000,05,133,"Sevier County, AR",Oct-22,5404,5236,168,3.10000000
CN0513500000000,05,135,"Sharp County, AR",Oct-22,5833,5643,190,3.30000000
CN0513700000000,05,137,"Stone County, AR",Oct-22,4561,4409,152,3.30000000
CN0513900000000,05,139,"Union County, AR",Oct-22,14742,14050,692,4.70000000
CN0514100000000,05,141,"Van Buren County, AR",Oct-22,5966,5759,207,3.50000000
CN0514300000000,05,143,"Washington County, AR",Oct-22,130999,128505,2494,1.90000000
CN0514500000000,05,145,"White County, AR",Oct-22,33988,33011,977,2.90000000
CN0514700000000,05,147,"Woodruff County, AR",Oct-22,2794,2715,79,2.80000000
CN0514900000000,05,149,"Yell County, AR",Oct-22,7883,7657,226,2.90000000
CN0600100000000,06,001,"Alameda County, CA",Oct-22,829907,805424,24483,3.00000000
CN0600300000000,06,003,"Alpine County, CA",Oct-22,449,425,24,5.30000000
CN0600500000000,06,005,"Amador County, CA",Oct-22,14442,13861,581,4.00000000
CN0600700000000,06,007,"Butte County, CA",Oct-22,93545,89941,3604,3.90000000
CN0600900000000,06,009,"Calaveras County, CA",Oct-22,21989,21297,692,3.10000000
CN0601100000000,06,011,"Colusa County, CA",Oct-22,11550,10713,837,7.20000000
CN0601300000000,06,013,"Contra Costa County, CA",Oct-22,554456,536903,17553,3.20000000
CN0601500000000,06,015,"Del Norte County, CA",Oct-22,9502,9080,422,4.40000000
CN0601700000000,06,017,"El Dorado County, CA",Oct-22,92769,90125,2644,2.90000000
CN0601900000000,06,019,"Fresno County, CA",Oct-22,449267,423245,26022,5.80000000
CN0602100000000,06,021,"Glenn County, CA",Oct-22,12732,12146,586,4.60000000
CN0602300000000,06,023,"Humboldt County, CA",Oct-22,60997,58953,2044,3.40000000
CN0602500000000,06,025,"Imperial County, CA",Oct-22,70788,59230,11558,16.30000000
CN0602700000000,06,027,"Inyo County, CA",Oct-22,8306,8065,241,2.90000000
CN0602900000000,06,029,"Kern County, CA",Oct-22,392343,367786,24557,6.30000000
CN0603100000000,06,031,"Kings County, CA",Oct-22,56217,52773,3444,6.10000000
CN0603300000000,06,033,"Lake County, CA",Oct-22,28726,27424,1302,4.50000000
CN0603500000000,06,035,"Lassen County, CA",Oct-22,9793,9482,311,3.20000000
CN0603700000000,06,037,"Los Angeles County, CA",Oct-22,4947566,4723562,224004,4.50000000
CN0603900000000,06,039,"Madera County, CA",Oct-22,61756,58330,3426,5.50000000
CN0604100000000,06,041,"Marin County, CA",Oct-22,129402,126486,2916,2.30000000
CN0604300000000,06,043,"Mariposa County, CA",Oct-22,7222,6946,276,3.80000000
CN0604500000000,06,045,"Mendocino County, CA",Oct-22,37945,36679,1266,3.30000000
CN0604700000000,06,047,"Merced County, CA",Oct-22,117526,110198,7328,6.20000000
CN0604900000000,06,049,"Modoc County, CA",Oct-22,3292,3172,120,3.60000000
CN0605100000000,06,051,"Mono County, CA",Oct-22,8343,8016,327,3.90000000
CN0605300000000,06,053,"Monterey County, CA",Oct-22,214761,205383,9378,4.40000000
CN0605500000000,06,055,"Napa County, CA",Oct-22,70036,68112,1924,2.70000000
CN0605700000000,06,057,"Nevada County, CA",Oct-22,48109,46707,1402,2.90000000
CN0605900000000,06,059,"Orange County, CA",Oct-22,1603753,1559399,44354,2.80000000
CN0606100000000,06,061,"Placer County, CA",Oct-22,192661,187646,5015,2.60000000
CN0606300000000,06,063,"Plumas County, CA",Oct-22,7636,7275,361,4.70000000
CN0606500000000,06,065,"Riverside County, CA",Oct-22,1169694,1122760,46934,4.00000000
CN0606700000000,06,067,"Sacramento County, CA",Oct-22,724545,697917,26628,3.70000000
CN0606900000000,06,069,"San Benito County, CA",Oct-22,33303,31913,1390,4.20000000
CN0607100000000,06,071,"San Bernardino County, CA",Oct-22,1022964,983013,39951,3.90000000
CN0607300000000,06,073,"San Diego County, CA",Oct-22,1579396,1529452,49944,3.20000000
CN0607500000000,06,075,"San Francisco County/city, CA",Oct-22,576833,564371,12462,2.20000000
CN0607700000000,06,077,"San Joaquin County, CA",Oct-22,337193,320298,16895,5.00000000
CN0607900000000,06,079,"San Luis Obispo County, CA",Oct-22,136368,132935,3433,2.50000000
CN0608100000000,06,081,"San Mateo County, CA",Oct-22,456460,447390,9070,2.00000000
CN0608300000000,06,083,"Santa Barbara County, CA",Oct-22,226888,220558,6330,2.80000000
CN0608500000000,06,085,"Santa Clara County, CA",Oct-22,1059567,1036600,22967,2.20000000
CN0608700000000,06,087,"Santa Cruz County, CA",Oct-22,136675,131713,4962,3.60000000
CN0608900000000,06,089,"Shasta County, CA",Oct-22,74606,71715,2891,3.90000000
CN0609100000000,06,091,"Sierra County, CA",Oct-22,1394,1356,38,2.70000000
CN0609300000000,06,093,"Siskiyou County, CA",Oct-22,16783,16034,749,4.50000000
CN0609500000000,06,095,"Solano County, CA",Oct-22,201537,193663,7874,3.90000000
CN0609700000000,06,097,"Sonoma County, CA",Oct-22,249050,242522,6528,2.60000000
CN0609900000000,06,099,"Stanislaus County, CA",Oct-22,239440,227555,11885,5.00000000
CN0610100000000,06,101,"Sutter County, CA",Oct-22,45533,42998,2535,5.60000000
CN0610300000000,06,103,"Tehama County, CA",Oct-22,26300,25225,1075,4.10000000
CN0610500000000,06,105,"Trinity County, CA",Oct-22,4483,4313,170,3.80000000
CN0610700000000,06,107,"Tulare County, CA",Oct-22,203575,187481,16094,7.90000000
CN0610900000000,06,109,"Tuolumne County, CA",Oct-22,19811,19036,775,3.90000000
CN0611100000000,06,111,"Ventura County, CA",Oct-22,414060,400175,13885,3.40000000
CN0611300000000,06,113,"Yolo County, CA",Oct-22,108624,105096,3528,3.20000000
CN0611500000000,06,115,"Yuba County, CA",Oct-22,30828,29272,1556,5.00000000
CN0800100000000,08,001,"Adams County, CO",Oct-22,286470,274832,11638,4.10000000
CN0800300000000,08,003,"Alamosa County, CO",Oct-22,8874,8532,342,3.90000000
CN0800500000000,08,005,"Arapahoe County, CO",Oct-22,380398,366457,13941,3.70000000
CN0800700000000,08,007,"Archuleta County, CO",Oct-22,7462,7233,229,3.10000000
CN0800900000000,08,009,"Baca County, CO",Oct-22,2208,2172,36,1.60000000
CN0801100000000,08,011,"Bent County, CO",Oct-22,2044,1971,73,3.60000000
CN0801300000000,08,013,"Boulder County, CO",Oct-22,205000,199337,5663,2.80000000
CN0801400000000,08,014,"Broomfield County/city, CO",Oct-22,42965,41669,1296,3.00000000
CN0801500000000,08,015,"Chaffee County, CO",Oct-22,10451,10147,304,2.90000000
CN0801700000000,08,017,"Cheyenne County, CO",Oct-22,1163,1142,21,1.80000000
CN0801900000000,08,019,"Clear Creek County, CO",Oct-22,6255,6030,225,3.60000000
CN0802100000000,08,021,"Conejos County, CO",Oct-22,4324,4183,141,3.30000000
CN0802300000000,08,023,"Costilla County, CO",Oct-22,1961,1877,84,4.30000000
CN0802500000000,08,025,"Crowley County, CO",Oct-22,1457,1393,64,4.40000000
CN0802700000000,08,027,"Custer County, CO",Oct-22,2534,2458,76,3.00000000
CN0802900000000,08,029,"Delta County, CO",Oct-22,14208,13695,513,3.60000000
CN0803100000000,08,031,"Denver County/city, CO",Oct-22,442539,426002,16537,3.70000000
CN0803300000000,08,033,"Dolores County, CO",Oct-22,1220,1182,38,3.10000000
CN0803500000000,08,035,"Douglas County, CO",Oct-22,209968,204039,5929,2.80000000
CN0803700000000,08,037,"Eagle County, CO",Oct-22,37018,35976,1042,2.80000000
CN0803900000000,08,039,"Elbert County, CO",Oct-22,16321,15894,427,2.60000000
CN0804100000000,08,041,"El Paso County, CO",Oct-22,360036,346244,13792,3.80000000
CN0804300000000,08,043,"Fremont County, CO",Oct-22,15591,14765,826,5.30000000
CN0804500000000,08,045,"Garfield County, CO",Oct-22,31684,30689,995,3.10000000
CN0804700000000,08,047,"Gilpin County, CO",Oct-22,3988,3856,132,3.30000000
CN0804900000000,08,049,"Grand County, CO",Oct-22,9606,9325,281,2.90000000
CN0805100000000,08,051,"Gunnison County, CO",Oct-22,11995,11694,301,2.50000000
CN0805300000000,08,053,"Hinsdale County, CO",Oct-22,495,481,14,2.80000000
CN0805500000000,08,055,"Huerfano County, CO",Oct-22,2707,2510,197,7.30000000
CN0805700000000,08,057,"Jackson County, CO",Oct-22,1036,1016,20,1.90000000
CN0805900000000,08,059,"Jefferson County, CO",Oct-22,347191,336137,11054,3.20000000
CN0806100000000,08,061,"Kiowa County, CO",Oct-22,949,932,17,1.80000000
CN0806300000000,08,063,"Kit Carson County, CO",Oct-22,4296,4208,88,2.00000000
CN0806500000000,08,065,"Lake County, CO",Oct-22,5123,4983,140,2.70000000
CN0806700000000,08,067,"La Plata County, CO",Oct-22,32120,31113,1007,3.10000000
CN0806900000000,08,069,"Larimer County, CO",Oct-22,215371,209055,6316,2.90000000
CN0807100000000,08,071,"Las Animas County, CO",Oct-22,6522,6165,357,5.50000000
CN0807300000000,08,073,"Lincoln County, CO",Oct-22,2366,2301,65,2.70000000
CN0807500000000,08,075,"Logan County, CO",Oct-22,10953,10629,324,3.00000000
CN0807700000000,08,077,"Mesa County, CO",Oct-22,78876,75894,2982,3.80000000
CN0807900000000,08,079,"Mineral County, CO",Oct-22,390,376,14,3.60000000
CN0808100000000,08,081,"Moffat County, CO",Oct-22,7010,6794,216,3.10000000
CN0808300000000,08,083,"Montezuma County, CO",Oct-22,13696,13195,501,3.70000000
CN0808500000000,08,085,"Montrose County, CO",Oct-22,23185,22433,752,3.20000000
CN0808700000000,08,087,"Morgan County, CO",Oct-22,16394,15838,556,3.40000000
CN0808900000000,08,089,"Otero County, CO",Oct-22,8401,7988,413,4.90000000
CN0809100000000,08,091,"Ouray County, CO",Oct-22,3056,2982,74,2.40000000
CN0809300000000,08,093,"Park County, CO",Oct-22,11810,11464,346,2.90000000
CN0809500000000,08,095,"Phillips County, CO",Oct-22,2665,2613,52,2.00000000
CN0809700000000,08,097,"Pitkin County, CO",Oct-22,11004,10474,530,4.80000000
CN0809900000000,08,099,"Prowers County, CO",Oct-22,6546,6364,182,2.80000000
CN0810100000000,08,101,"Pueblo County, CO",Oct-22,79428,75064,4364,5.50000000
CN0810300000000,08,103,"Rio Blanco County, CO",Oct-22,2924,2813,111,3.80000000
CN0810500000000,08,105,"Rio Grande County, CO",Oct-22,5631,5383,248,4.40000000
CN0810700000000,08,107,"Routt County, CO",Oct-22,15724,15285,439,2.80000000
CN0810900000000,08,109,"Saguache County, CO",Oct-22,3641,3524,117,3.20000000
CN0811100000000,08,111,"San Juan County, CO",Oct-22,719,705,14,1.90000000
CN0811300000000,08,113,"San Miguel County, CO",Oct-22,6532,6348,184,2.80000000
CN0811500000000,08,115,"Sedgwick County, CO",Oct-22,1230,1203,27,2.20000000
CN0811700000000,08,117,"Summit County, CO",Oct-22,21487,20914,573,2.70000000
CN0811900000000,08,119,"Teller County, CO",Oct-22,13418,12987,431,3.20000000
CN0812100000000,08,121,"Washington County, CO",Oct-22,2875,2810,65,2.30000000
CN0812300000000,08,123,"Weld County, CO",Oct-22,171311,165002,6309,3.70000000
CN0812500000000,08,125,"Yuma County, CO",Oct-22,6065,5948,117,1.90000000
CN0900100000000,09,001,"Fairfield County, CT",Oct-22,476442,457584,18858,4.00000000
CN0900300000000,09,003,"Hartford County, CT",Oct-22,475998,456709,19289,4.10000000
CN0900500000000,09,005,"Litchfield County, CT",Oct-22,103658,100130,3528,3.40000000
CN0900700000000,09,007,"Middlesex County, CT",Oct-22,93246,90207,3039,3.30000000
CN0900900000000,09,009,"New Haven County, CT",Oct-22,465347,445661,19686,4.20000000
CN0901100000000,09,011,"New London County, CT",Oct-22,131094,125509,5585,4.30000000
CN0901300000000,09,013,"Tolland County, CT",Oct-22,85697,82891,2806,3.30000000
CN0901500000000,09,015,"Windham County, CT",Oct-22,62874,60479,2395,3.80000000
CN1000100000000,10,001,"Kent County, DE",Oct-22,80853,76958,3895,4.80000000
CN1000300000000,10,003,"New Castle County, DE",Oct-22,305513,293380,12133,4.00000000
CN1000500000000,10,005,"Sussex County, DE",Oct-22,111498,107043,4455,4.00000000
CN1100100000000,11,001,District of Columbia,Oct-22,386974,370346,16628,4.30000000
CN1200100000000,12,001,"Alachua County, FL",Oct-22,145672,141960,3712,2.50000000
CN1200300000000,12,003,"Baker County, FL",Oct-22,12850,12534,316,2.50000000
CN1200500000000,12,005,"Bay County, FL",Oct-22,89859,87778,2081,2.30000000
CN1200700000000,12,007,"Bradford County, FL",Oct-22,11206,10891,315,2.80000000
CN1200900000000,12,009,"Brevard County, FL",Oct-22,301318,293497,7821,2.60000000
CN1201100000000,12,011,"Broward County, FL",Oct-22,1084077,1055706,28371,2.60000000
CN1201300000000,12,013,"Calhoun County, FL",Oct-22,5055,4914,141,2.80000000
CN1201500000000,12,015,"Charlotte County, FL",Oct-22,77600,74441,3159,4.10000000
CN1201700000000,12,017,"Citrus County, FL",Oct-22,47485,45576,1909,4.00000000
CN1201900000000,12,019,"Clay County, FL",Oct-22,114878,112142,2736,2.40000000
CN1202100000000,12,021,"Collier County, FL",Oct-22,189389,183889,5500,2.90000000
CN1202300000000,12,023,"Columbia County, FL",Oct-22,30013,29154,859,2.90000000
CN1202700000000,12,027,"DeSoto County, FL",Oct-22,15069,14598,471,3.10000000
CN1202900000000,12,029,"Dixie County, FL",Oct-22,6203,6033,170,2.70000000
CN1203100000000,12,031,"Duval County, FL",Oct-22,521577,507468,14109,2.70000000
CN1203300000000,12,033,"Escambia County, FL",Oct-22,151947,147792,4155,2.70000000
CN1203500000000,12,035,"Flagler County, FL",Oct-22,50917,49318,1599,3.10000000
CN1203700000000,12,037,"Franklin County, FL",Oct-22,4753,4632,121,2.50000000
CN1203900000000,12,039,"Gadsden County, FL",Oct-22,21402,20710,692,3.20000000
CN1204100000000,12,041,"Gilchrist County, FL",Oct-22,7556,7354,202,2.70000000
CN1204300000000,12,043,"Glades County, FL",Oct-22,5408,5258,150,2.80000000
CN1204500000000,12,045,"Gulf County, FL",Oct-22,5536,5402,134,2.40000000
CN1204700000000,12,047,"Hamilton County, FL",Oct-22,4387,4215,172,3.90000000
CN1204900000000,12,049,"Hardee County, FL",Oct-22,9095,8772,323,3.60000000
CN1205100000000,12,051,"Hendry County, FL",Oct-22,16357,15615,742,4.50000000
CN1205300000000,12,053,"Hernando County, FL",Oct-22,77729,75180,2549,3.30000000
CN1205500000000,12,055,"Highlands County, FL",Oct-22,34376,32913,1463,4.30000000
CN1205700000000,12,057,"Hillsborough County, FL",Oct-22,813731,792813,20918,2.60000000
CN1205900000000,12,059,"Holmes County, FL",Oct-22,7166,6975,191,2.70000000
CN1206100000000,12,061,"Indian River County, FL",Oct-22,67955,65852,2103,3.10000000
CN1206300000000,12,063,"Jackson County, FL",Oct-22,17406,16909,497,2.90000000
CN1206500000000,12,065,"Jefferson County, FL",Oct-22,5929,5762,167,2.80000000
CN1206700000000,12,067,"Lafayette County, FL",Oct-22,2828,2751,77,2.70000000
CN1206900000000,12,069,"Lake County, FL",Oct-22,170903,166148,4755,2.80000000
CN1207100000000,12,071,"Lee County, FL",Oct-22,378004,363004,15000,4.00000000
CN1207300000000,12,073,"Leon County, FL",Oct-22,162994,158569,4425,2.70000000
CN1207500000000,12,075,"Levy County, FL",Oct-22,17442,16937,505,2.90000000
CN1207700000000,12,077,"Liberty County, FL",Oct-22,2674,2597,77,2.90000000
CN1207900000000,12,079,"Madison County, FL",Oct-22,8095,7855,240,3.00000000
CN1208100000000,12,081,"Manatee County, FL",Oct-22,191601,186666,4935,2.60000000
CN1208300000000,12,083,"Marion County, FL",Oct-22,145457,140741,4716,3.20000000
CN1208500000000,12,085,"Martin County, FL",Oct-22,77366,75513,1853,2.40000000
CN1208600000000,12,086,"Miami-Dade County, FL",Oct-22,1386267,1353554,32713,2.40000000
CN1208700000000,12,087,"Monroe County, FL",Oct-22,51043,50199,844,1.70000000
CN1208900000000,12,089,"Nassau County, FL",Oct-22,45513,44480,1033,2.30000000
CN1209100000000,12,091,"Okaloosa County, FL",Oct-22,102803,100523,2280,2.20000000
CN1209300000000,12,093,"Okeechobee County, FL",Oct-22,17698,17223,475,2.70000000
CN1209500000000,12,095,"Orange County, FL",Oct-22,789641,767801,21840,2.80000000
CN1209700000000,12,097,"Osceola County, FL",Oct-22,196815,190166,6649,3.40000000
CN1209900000000,12,099,"Palm Beach County, FL",Oct-22,775221,754582,20639,2.70000000
CN1210100000000,12,101,"Pasco County, FL",Oct-22,261211,253843,7368,2.80000000
CN1210300000000,12,103,"Pinellas County, FL",Oct-22,515841,503352,12489,2.40000000
CN1210500000000,12,105,"Polk County, FL",Oct-22,341154,329794,11360,3.30000000
CN1210700000000,12,107,"Putnam County, FL",Oct-22,27723,26672,1051,3.80000000
CN1210900000000,12,109,"St. Johns County, FL",Oct-22,151608,148377,3231,2.10000000
CN1211100000000,12,111,"St. Lucie County, FL",Oct-22,157498,152571,4927,3.10000000
CN1211300000000,12,113,"Santa Rosa County, FL",Oct-22,89086,86930,2156,2.40000000
CN1211500000000,12,115,"Sarasota County, FL",Oct-22,201509,195995,5514,2.70000000
CN1211700000000,12,117,"Seminole County, FL",Oct-22,262817,256248,6569,2.50000000
CN1211900000000,12,119,"Sumter County, FL",Oct-22,36418,35047,1371,3.80000000
CN1212100000000,12,121,"Suwannee County, FL",Oct-22,17739,17217,522,2.90000000
CN1212300000000,12,123,"Taylor County, FL",Oct-22,7948,7723,225,2.80000000
CN1212500000000,12,125,"Union County, FL",Oct-22,4792,4652,140,2.90000000
CN1212700000000,12,127,"Volusia County, FL",Oct-22,268703,260737,7966,3.00000000
CN1212900000000,12,129,"Wakulla County, FL",Oct-22,16433,16055,378,2.30000000
CN1213100000000,12,131,"Walton County, FL",Oct-22,34994,34176,818,2.30000000
CN1213300000000,12,133,"Washington County, FL",Oct-22,9792,9510,282,2.90000000
CN1300100000000,13,001,"Appling County, GA",Oct-22,8909,8597,312,3.50000000
CN1300300000000,13,003,"Atkinson County, GA",Oct-22,4567,4442,125,2.70000000
CN1300500000000,13,005,"Bacon County, GA",Oct-22,4731,4583,148,3.10000000
CN1300700000000,13,007,"Baker County, GA",Oct-22,1140,1098,42,3.70000000
CN1300900000000,13,009,"Baldwin County, GA",Oct-22,17778,17035,743,4.20000000
CN1301100000000,13,011,"Banks County, GA",Oct-22,10312,10067,245,2.40000000
CN1301300000000,13,013,"Barrow County, GA",Oct-22,43491,42395,1096,2.50000000
CN1301500000000,13,015,"Bartow County, GA",Oct-22,52812,51294,1518,2.90000000
CN1301700000000,13,017,"Ben Hill County, GA",Oct-22,5516,5254,262,4.70000000
CN1301900000000,13,019,"Berrien County, GA",Oct-22,7705,7464,241,3.10000000
CN1302100000000,13,021,"Bibb County, GA",Oct-22,67054,64555,2499,3.70000000
CN1302300000000,13,023,"Bleckley County, GA",Oct-22,4613,4415,198,4.30000000
CN1302500000000,13,025,"Brantley County, GA",Oct-22,7409,7166,243,3.30000000
CN1302700000000,13,027,"Brooks County, GA",Oct-22,6795,6586,209,3.10000000
CN1302900000000,13,029,"Bryan County, GA",Oct-22,20431,19895,536,2.60000000
CN1303100000000,13,031,"Bulloch County, GA",Oct-22,37664,36356,1308,3.50000000
CN1303300000000,13,033,"Burke County, GA",Oct-22,9019,8562,457,5.10000000
CN1303500000000,13,035,"Butts County, GA",Oct-22,11441,11124,317,2.80000000
CN1303700000000,13,037,"Calhoun County, GA",Oct-22,2243,2175,68,3.00000000
CN1303900000000,13,039,"Camden County, GA",Oct-22,21700,21042,658,3.00000000
CN1304300000000,13,043,"Candler County, GA",Oct-22,6132,5989,143,2.30000000
CN1304500000000,13,045,"Carroll County, GA",Oct-22,57864,56121,1743,3.00000000
CN1304700000000,13,047,"Catoosa County, GA",Oct-22,33541,32661,880,2.60000000
CN1304900000000,13,049,"Charlton County, GA",Oct-22,4979,4825,154,3.10000000
CN1305100000000,13,051,"Chatham County, GA",Oct-22,145972,141652,4320,3.00000000
CN1305300000000,13,053,"Chattahoochee County, GA",Oct-22,1919,1836,83,4.30000000
CN1305500000000,13,055,"Chattooga County, GA",Oct-22,9152,8792,360,3.90000000
CN1305700000000,13,057,"Cherokee County, GA",Oct-22,144318,140882,3436,2.40000000
CN1305900000000,13,059,"Clarke County, GA",Oct-22,61608,59671,1937,3.10000000
CN1306100000000,13,061,"Clay County, GA",Oct-22,868,803,65,7.50000000
CN1306300000000,13,063,"Clayton County, GA",Oct-22,141880,135941,5939,4.20000000
CN1306500000000,13,065,"Clinch County, GA",Oct-22,3091,3006,85,2.70000000
CN1306700000000,13,067,"Cobb County, GA",Oct-22,435776,424670,11106,2.50000000
CN1306900000000,13,069,"Coffee County, GA",Oct-22,18215,17546,669,3.70000000
CN1307100000000,13,071,"Colquitt County, GA",Oct-22,22281,21664,617,2.80000000
CN1307300000000,13,073,"Columbia County, GA",Oct-22,76051,73877,2174,2.90000000
CN1307500000000,13,075,"Cook County, GA",Oct-22,8253,7981,272,3.30000000
CN1307700000000,13,077,"Coweta County, GA",Oct-22,78449,76394,2055,2.60000000
CN1307900000000,13,079,"Crawford County, GA",Oct-22,5502,5338,164,3.00000000
CN1308100000000,13,081,"Crisp County, GA",Oct-22,9329,8876,453,4.90000000
CN1308300000000,13,083,"Dade County, GA",Oct-22,8139,7923,216,2.70000000
CN1308500000000,13,085,"Dawson County, GA",Oct-22,13593,13265,328,2.40000000
CN1308700000000,13,087,"Decatur County, GA",Oct-22,11250,10879,371,3.30000000
CN1308900000000,13,089,"DeKalb County, GA",Oct-22,408915,396342,12573,3.10000000
CN1309100000000,13,091,"Dodge County, GA",Oct-22,6991,6743,248,3.50000000
CN1309300000000,13,093,"Dooly County, GA",Oct-22,4676,4486,190,4.10000000
CN1309500000000,13,095,"Dougherty County, GA",Oct-22,36858,35227,1631,4.40000000
CN1309700000000,13,097,"Douglas County, GA",Oct-22,75841,73410,2431,3.20000000
CN1309900000000,13,099,"Early County, GA",Oct-22,4216,4061,155,3.70000000
CN1310100000000,13,101,"Echols County, GA",Oct-22,1898,1852,46,2.40000000
CN1310300000000,13,103,"Effingham County, GA",Oct-22,34083,33217,866,2.50000000
CN1310500000000,13,105,"Elbert County, GA",Oct-22,7624,7339,285,3.70000000
CN1310700000000,13,107,"Emanuel County, GA",Oct-22,8681,8323,358,4.10000000
CN1310900000000,13,109,"Evans County, GA",Oct-22,5227,5088,139,2.70000000
CN1311100000000,13,111,"Fannin County, GA",Oct-22,12070,11751,319,2.60000000
CN1311300000000,13,113,"Fayette County, GA",Oct-22,60116,58562,1554,2.60000000
CN1311500000000,13,115,"Floyd County, GA",Oct-22,43882,42496,1386,3.20000000
CN1311700000000,13,117,"Forsyth County, GA",Oct-22,131593,128507,3086,2.30000000
CN1311900000000,13,119,"Franklin County, GA",Oct-22,10132,9820,312,3.10000000
CN1312100000000,13,121,"Fulton County, GA",Oct-22,581270,562882,18388,3.20000000
CN1312300000000,13,123,"Gilmer County, GA",Oct-22,12491,12106,385,3.10000000
CN1312500000000,13,125,"Glascock County, GA",Oct-22,1272,1232,40,3.10000000
CN1312700000000,13,127,"Glynn County, GA",Oct-22,39369,38162,1207,3.10000000
CN1312900000000,13,129,"Gordon County, GA",Oct-22,29111,28295,816,2.80000000
CN1313100000000,13,131,"Grady County, GA",Oct-22,11143,10826,317,2.80000000
CN1313300000000,13,133,"Greene County, GA",Oct-22,7234,7001,233,3.20000000
CN1313500000000,13,135,"Gwinnett County, GA",Oct-22,506477,492930,13547,2.70000000
CN1313700000000,13,137,"Habersham County, GA",Oct-22,18567,17981,586,3.20000000
CN1313900000000,13,139,"Hall County, GA",Oct-22,106155,103532,2623,2.50000000
CN1314100000000,13,141,"Hancock County, GA",Oct-22,2539,2402,137,5.40000000
CN1314300000000,13,143,"Haralson County, GA",Oct-22,13173,12772,401,3.00000000
CN1314500000000,13,145,"Harris County, GA",Oct-22,16976,16505,471,2.80000000
CN1314700000000,13,147,"Hart County, GA",Oct-22,11752,11390,362,3.10000000
CN1314900000000,13,149,"Heard County, GA",Oct-22,5377,5226,151,2.80000000
CN1315100000000,13,151,"Henry County, GA",Oct-22,121601,117812,3789,3.10000000
CN1315300000000,13,153,"Houston County, GA",Oct-22,71034,68824,2210,3.10000000
CN1315500000000,13,155,"Irwin County, GA",Oct-22,3551,3412,139,3.90000000
CN1315700000000,13,157,"Jackson County, GA",Oct-22,44998,44049,949,2.10000000
CN1315900000000,13,159,"Jasper County, GA",Oct-22,7281,7101,180,2.50000000
CN1316100000000,13,161,"Jeff Davis County, GA",Oct-22,6139,5920,219,3.60000000
CN1316300000000,13,163,"Jefferson County, GA",Oct-22,7000,6739,261,3.70000000
CN1316500000000,13,165,"Jenkins County, GA",Oct-22,3189,3046,143,4.50000000
CN1316700000000,13,167,"Johnson County, GA",Oct-22,4020,3905,115,2.90000000
CN1316900000000,13,169,"Jones County, GA",Oct-22,13671,13265,406,3.00000000
CN1317100000000,13,171,"Lamar County, GA",Oct-22,8484,8208,276,3.30000000
CN1317300000000,13,173,"Lanier County, GA",Oct-22,3813,3681,132,3.50000000
CN1317500000000,13,175,"Laurens County, GA",Oct-22,19203,18471,732,3.80000000
CN1317700000000,13,177,"Lee County, GA",Oct-22,15175,14763,412,2.70000000
CN1317900000000,13,179,"Liberty County, GA",Oct-22,25954,25092,862,3.30000000
CN1318100000000,13,181,"Lincoln County, GA",Oct-22,3524,3406,118,3.30000000
CN1318300000000,13,183,"Long County, GA",Oct-22,8439,8185,254,3.00000000
CN1318500000000,13,185,"Lowndes County, GA",Oct-22,50761,49087,1674,3.30000000
CN1318700000000,13,187,"Lumpkin County, GA",Oct-22,17908,17441,467,2.60000000
CN1318900000000,13,189,"McDuffie County, GA",Oct-22,8409,8036,373,4.40000000
CN1319100000000,13,191,"McIntosh County, GA",Oct-22,6184,5987,197,3.20000000
CN1319300000000,13,193,"Macon County, GA",Oct-22,4567,4370,197,4.30000000
CN1319500000000,13,195,"Madison County, GA",Oct-22,14232,13834,398,2.80000000
CN1319700000000,13,197,"Marion County, GA",Oct-22,3285,3167,118,3.60000000
CN1319900000000,13,199,"Meriwether County, GA",Oct-22,9099,8755,344,3.80000000
CN1320100000000,13,201,"Miller County, GA",Oct-22,2735,2663,72,2.60000000
CN1320500000000,13,205,"Mitchell County, GA",Oct-22,8001,7693,308,3.80000000
CN1320700000000,13,207,"Monroe County, GA",Oct-22,13134,12770,364,2.80000000
CN1320900000000,13,209,"Montgomery County, GA",Oct-22,3729,3595,134,3.60000000
CN1321100000000,13,211,"Morgan County, GA",Oct-22,9839,9581,258,2.60000000
CN1321300000000,13,213,"Murray County, GA",Oct-22,15258,14609,649,4.30000000
CN1321500000000,13,215,"Muscogee County, GA",Oct-22,76105,72905,3200,4.20000000
CN1321700000000,13,217,"Newton County, GA",Oct-22,54800,52961,1839,3.40000000
CN1321900000000,13,219,"Oconee County, GA",Oct-22,21287,20820,467,2.20000000
CN1322100000000,13,221,"Oglethorpe County, GA",Oct-22,7348,7158,190,2.60000000
CN1322300000000,13,223,"Paulding County, GA",Oct-22,92289,89865,2424,2.60000000
CN1322500000000,13,225,"Peach County, GA",Oct-22,11973,11502,471,3.90000000
CN1322700000000,13,227,"Pickens County, GA",Oct-22,16062,15660,402,2.50000000
CN1322900000000,13,229,"Pierce County, GA",Oct-22,8558,8310,248,2.90000000
CN1323100000000,13,231,"Pike County, GA",Oct-22,9316,9064,252,2.70000000
CN1323300000000,13,233,"Polk County, GA",Oct-22,18514,17942,572,3.10000000
CN1323500000000,13,235,"Pulaski County, GA",Oct-22,4037,3908,129,3.20000000
CN1323700000000,13,237,"Putnam County, GA",Oct-22,8827,8532,295,3.30000000
CN1323900000000,13,239,"Quitman County, GA",Oct-22,769,727,42,5.50000000
CN1324100000000,13,241,"Rabun County, GA",Oct-22,7676,7451,225,2.90000000
CN1324300000000,13,243,"Randolph County, GA",Oct-22,2410,2312,98,4.10000000
CN1324500000000,13,245,"Richmond County, GA",Oct-22,82719,79125,3594,4.30000000
CN1324700000000,13,247,"Rockdale County, GA",Oct-22,45653,44115,1538,3.40000000
CN1324900000000,13,249,"Schley County, GA",Oct-22,2102,2027,75,3.60000000
CN1325100000000,13,251,"Screven County, GA",Oct-22,4982,4780,202,4.10000000
CN1325300000000,13,253,"Seminole County, GA",Oct-22,2964,2859,105,3.50000000
CN1325500000000,13,255,"Spalding County, GA",Oct-22,29629,28660,969,3.30000000
CN1325700000000,13,257,"Stephens County, GA",Oct-22,10475,10047,428,4.10000000
CN1325900000000,13,259,"Stewart County, GA",Oct-22,2591,2495,96,3.70000000
CN1326100000000,13,261,"Sumter County, GA",Oct-22,11967,11454,513,4.30000000
CN1326300000000,13,263,"Talbot County, GA",Oct-22,2801,2703,98,3.50000000
CN1326500000000,13,265,"Taliaferro County, GA",Oct-22,538,512,26,4.80000000
CN1326700000000,13,267,"Tattnall County, GA",Oct-22,9822,9555,267,2.70000000
CN1326900000000,13,269,"Taylor County, GA",Oct-22,2845,2713,132,4.60000000
CN1327100000000,13,271,"Telfair County, GA",Oct-22,3580,3357,223,6.20000000
CN1327300000000,13,273,"Terrell County, GA",Oct-22,3523,3364,159,4.50000000
CN1327500000000,13,275,"Thomas County, GA",Oct-22,17475,16880,595,3.40000000
CN1327700000000,13,277,"Tift County, GA",Oct-22,21695,21118,577,2.70000000
CN1327900000000,13,279,"Toombs County, GA",Oct-22,11758,11328,430,3.70000000
CN1328100000000,13,281,"Towns County, GA",Oct-22,4303,4133,170,4.00000000
CN1328300000000,13,283,"Treutlen County, GA",Oct-22,2549,2451,98,3.80000000
CN1328500000000,13,285,"Troup County, GA",Oct-22,37501,36445,1056,2.80000000
CN1328700000000,13,287,"Turner County, GA",Oct-22,3231,3099,132,4.10000000
CN1328900000000,13,289,"Twiggs County, GA",Oct-22,2781,2658,123,4.40000000
CN1329100000000,13,291,"Union County, GA",Oct-22,11332,11030,302,2.70000000
CN1329300000000,13,293,"Upson County, GA",Oct-22,11752,11404,348,3.00000000
CN1329500000000,13,295,"Walker County, GA",Oct-22,31364,30442,922,2.90000000
CN1329700000000,13,297,"Walton County, GA",Oct-22,48479,47131,1348,2.80000000
CN1329900000000,13,299,"Ware County, GA",Oct-22,15231,14727,504,3.30000000
CN1330100000000,13,301,"Warren County, GA",Oct-22,2646,2534,112,4.20000000
CN1330300000000,13,303,"Washington County, GA",Oct-22,6559,6294,265,4.00000000
CN1330500000000,13,305,"Wayne County, GA",Oct-22,11746,11384,362,3.10000000
CN1330700000000,13,307,"Webster County, GA",Oct-22,989,954,35,3.50000000
CN1330900000000,13,309,"Wheeler County, GA",Oct-22,1635,1552,83,5.10000000
CN1331100000000,13,311,"White County, GA",Oct-22,16916,16509,407,2.40000000
CN1331300000000,13,313,"Whitfield County, GA",Oct-22,42948,41040,1908,4.40000000
CN1331500000000,13,315,"Wilcox County, GA",Oct-22,2749,2648,101,3.70000000
CN1331700000000,13,317,"Wilkes County, GA",Oct-22,3664,3517,147,4.00000000
CN1331900000000,13,319,"Wilkinson County, GA",Oct-22,3621,3487,134,3.70000000
CN1332100000000,13,321,"Worth County, GA",Oct-22,8852,8587,265,3.00000000
CN1500100000000,15,001,"Hawaii County, HI",Oct-22,94415,90993,3422,3.60000000
CN1500300000000,15,003,"Honolulu County/city, HI",Oct-22,457878,442277,15601,3.40000000
CN1500700000000,15,007,"Kauai County, HI",Oct-22,37137,35664,1473,4.00000000
CN1500900000000,15,009,"Maui County, HI",Oct-22,87369,83962,3407,3.90000000
CN1600100000000,16,001,"Ada County, ID",Oct-22,277700,270926,6774,2.40000000
CN1600300000000,16,003,"Adams County, ID",Oct-22,1826,1741,85,4.70000000
CN1600500000000,16,005,"Bannock County, ID",Oct-22,45280,44077,1203,2.70000000
CN1600700000000,16,007,"Bear Lake County, ID",Oct-22,3505,3430,75,2.10000000
CN1600900000000,16,009,"Benewah County, ID",Oct-22,4192,4036,156,3.70000000
CN1601100000000,16,011,"Bingham County, ID",Oct-22,26911,26305,606,2.30000000
CN1601300000000,16,013,"Blaine County, ID",Oct-22,13095,12785,310,2.40000000
CN1601500000000,16,015,"Boise County, ID",Oct-22,3832,3698,134,3.50000000
CN1601700000000,16,017,"Bonner County, ID",Oct-22,22310,21547,763,3.40000000
CN1601900000000,16,019,"Bonneville County, ID",Oct-22,63450,61985,1465,2.30000000
CN1602100000000,16,021,"Boundary County, ID",Oct-22,5864,5681,183,3.10000000
CN1602300000000,16,023,"Butte County, ID",Oct-22,1575,1527,48,3.00000000
CN1602500000000,16,025,"Camas County, ID",Oct-22,765,747,18,2.40000000
CN1602700000000,16,027,"Canyon County, ID",Oct-22,114907,111570,3337,2.90000000
CN1602900000000,16,029,"Caribou County, ID",Oct-22,4419,4316,103,2.30000000
CN1603100000000,16,031,"Cassia County, ID",Oct-22,14046,13734,312,2.20000000
CN1603300000000,16,033,"Clark County, ID",Oct-22,435,422,13,3.00000000
CN1603500000000,16,035,"Clearwater County, ID",Oct-22,3166,3020,146,4.60000000
CN1603700000000,16,037,"Custer County, ID",Oct-22,2351,2278,73,3.10000000
CN1603900000000,16,039,"Elmore County, ID",Oct-22,12540,12180,360,2.90000000
CN1604100000000,16,041,"Franklin County, ID",Oct-22,8075,7909,166,2.10000000
CN1604300000000,16,043,"Fremont County, ID",Oct-22,9520,9336,184,1.90000000
CN1604500000000,16,045,"Gem County, ID",Oct-22,9073,8832,241,2.70000000
CN1604700000000,16,047,"Gooding County, ID",Oct-22,8707,8505,202,2.30000000
CN1604900000000,16,049,"Idaho County, ID",Oct-22,7208,6992,216,3.00000000
CN1605100000000,16,051,"Jefferson County, ID",Oct-22,15649,15322,327,2.10000000
CN1605300000000,16,053,"Jerome County, ID",Oct-22,13193,12868,325,2.50000000
CN1605500000000,16,055,"Kootenai County, ID",Oct-22,85329,82720,2609,3.10000000
CN1605700000000,16,057,"Latah County, ID",Oct-22,21037,20572,465,2.20000000
CN1605900000000,16,059,"Lemhi County, ID",Oct-22,3920,3801,119,3.00000000
CN1606100000000,16,061,"Lewis County, ID",Oct-22,1757,1699,58,3.30000000
CN1606300000000,16,063,"Lincoln County, ID",Oct-22,2890,2802,88,3.00000000
CN1606500000000,16,065,"Madison County, ID",Oct-22,26127,25692,435,1.70000000
CN1606700000000,16,067,"Minidoka County, ID",Oct-22,13064,12790,274,2.10000000
CN1606900000000,16,069,"Nez Perce County, ID",Oct-22,21543,21002,541,2.50000000
CN1607100000000,16,071,"Oneida County, ID",Oct-22,2866,2786,80,2.80000000
CN1607300000000,16,073,"Owyhee County, ID",Oct-22,5833,5670,163,2.80000000
CN1607500000000,16,075,"Payette County, ID",Oct-22,12574,12224,350,2.80000000
CN1607700000000,16,077,"Power County, ID",Oct-22,5041,4931,110,2.20000000
CN1607900000000,16,079,"Shoshone County, ID",Oct-22,5451,5197,254,4.70000000
CN1608100000000,16,081,"Teton County, ID",Oct-22,8136,7968,168,2.10000000
CN1608300000000,16,083,"Twin Falls County, ID",Oct-22,44709,43569,1140,2.50000000
CN1608500000000,16,085,"Valley County, ID",Oct-22,5775,5576,199,3.40000000
CN1608700000000,16,087,"Washington County, ID",Oct-22,5058,4912,146,2.90000000
CN1700100000000,17,001,"Adams County, IL",Oct-22,30003,29045,958,3.20000000
CN1700300000000,17,003,"Alexander County, IL",Oct-22,1802,1678,124,6.90000000
CN1700500000000,17,005,"Bond County, IL",Oct-22,7499,7228,271,3.60000000
CN1700700000000,17,007,"Boone County, IL",Oct-22,24964,23544,1420,5.70000000
CN1700900000000,17,009,"Brown County, IL",Oct-22,3200,3140,60,1.90000000
CN1701100000000,17,011,"Bureau County, IL",Oct-22,16112,15472,640,4.00000000
CN1701300000000,17,013,"Calhoun County, IL",Oct-22,2184,2101,83,3.80000000
CN1701500000000,17,015,"Carroll County, IL",Oct-22,7673,7409,264,3.40000000
CN1701700000000,17,017,"Cass County, IL",Oct-22,5600,5374,226,4.00000000
CN1701900000000,17,019,"Champaign County, IL",Oct-22,109949,105866,4083,3.70000000
CN1702100000000,17,021,"Christian County, IL",Oct-22,13234,12653,581,4.40000000
CN1702300000000,17,023,"Clark County, IL",Oct-22,7267,6994,273,3.80000000
CN1702500000000,17,025,"Clay County, IL",Oct-22,5808,5564,244,4.20000000
CN1702700000000,17,027,"Clinton County, IL",Oct-22,19906,19339,567,2.80000000
CN1702900000000,17,029,"Coles County, IL",Oct-22,22723,21797,926,4.10000000
CN1703100000000,17,031,"Cook County, IL",Oct-22,2640891,2512742,128149,4.90000000
CN1703300000000,17,033,"Crawford County, IL",Oct-22,8514,8197,317,3.70000000
CN1703500000000,17,035,"Cumberland County, IL",Oct-22,6038,5857,181,3.00000000
CN1703700000000,17,037,"DeKalb County, IL",Oct-22,53808,51606,2202,4.10000000
CN1703900000000,17,039,"De Witt County, IL",Oct-22,7383,7115,268,3.60000000
CN1704100000000,17,041,"Douglas County, IL",Oct-22,10177,9869,308,3.00000000
CN1704300000000,17,043,"DuPage County, IL",Oct-22,513097,497116,15981,3.10000000
CN1704500000000,17,045,"Edgar County, IL",Oct-22,8897,8596,301,3.40000000
CN1704700000000,17,047,"Edwards County, IL",Oct-22,2475,2373,102,4.10000000
CN1704900000000,17,049,"Effingham County, IL",Oct-22,19284,18744,540,2.80000000
CN1705100000000,17,051,"Fayette County, IL",Oct-22,9745,9361,384,3.90000000
CN1705300000000,17,053,"Ford County, IL",Oct-22,6458,6238,220,3.40000000
CN1705500000000,17,055,"Franklin County, IL",Oct-22,15601,14739,862,5.50000000
CN1705700000000,17,057,"Fulton County, IL",Oct-22,14348,13672,676,4.70000000
CN1705900000000,17,059,"Gallatin County, IL",Oct-22,2005,1899,106,5.30000000
CN1706100000000,17,061,"Greene County, IL",Oct-22,5940,5719,221,3.70000000
CN1706300000000,17,063,"Grundy County, IL",Oct-22,25879,24867,1012,3.90000000
CN1706500000000,17,065,"Hamilton County, IL",Oct-22,4277,4143,134,3.10000000
CN1706700000000,17,067,"Hancock County, IL",Oct-22,8297,8011,286,3.40000000
CN1706900000000,17,069,"Hardin County, IL",Oct-22,1308,1238,70,5.40000000
CN1707100000000,17,071,"Henderson County, IL",Oct-22,3579,3465,114,3.20000000
CN1707300000000,17,073,"Henry County, IL",Oct-22,24568,23647,921,3.70000000
CN1707500000000,17,075,"Iroquois County, IL",Oct-22,12987,12497,490,3.80000000
CN1707700000000,17,077,"Jackson County, IL",Oct-22,27484,26392,1092,4.00000000
CN1707900000000,17,079,"Jasper County, IL",Oct-22,4841,4685,156,3.20000000
CN1708100000000,17,081,"Jefferson County, IL",Oct-22,16087,15323,764,4.70000000
CN1708300000000,17,083,"Jersey County, IL",Oct-22,10528,10188,340,3.20000000
CN1708500000000,17,085,"Jo Daviess County, IL",Oct-22,10578,10220,358,3.40000000
CN1708700000000,17,087,"Johnson County, IL",Oct-22,4121,3917,204,5.00000000
CN1708900000000,17,089,"Kane County, IL",Oct-22,262688,251548,11140,4.20000000
CN1709100000000,17,091,"Kankakee County, IL",Oct-22,52420,49646,2774,5.30000000
CN1709300000000,17,093,"Kendall County, IL",Oct-22,71522,69102,2420,3.40000000
CN1709500000000,17,095,"Knox County, IL",Oct-22,19907,18872,1035,5.20000000
CN1709700000000,17,097,"Lake County, IL",Oct-22,366928,353008,13920,3.80000000
CN1709900000000,17,099,"LaSalle County, IL",Oct-22,51737,49354,2383,4.60000000
CN1710100000000,17,101,"Lawrence County, IL",Oct-22,5408,5160,248,4.60000000
CN1710300000000,17,103,"Lee County, IL",Oct-22,16596,15992,604,3.60000000
CN1710500000000,17,105,"Livingston County, IL",Oct-22,15544,14964,580,3.70000000
CN1710700000000,17,107,"Logan County, IL",Oct-22,11626,11156,470,4.00000000
CN1710900000000,17,109,"McDonough County, IL",Oct-22,13168,12661,507,3.90000000
CN1711100000000,17,111,"McHenry County, IL",Oct-22,167702,162169,5533,3.30000000
CN1711300000000,17,113,"McLean County, IL",Oct-22,88282,85241,3041,3.40000000
CN1711500000000,17,115,"Macon County, IL",Oct-22,46348,43691,2657,5.70000000
CN1711700000000,17,117,"Macoupin County, IL",Oct-22,22093,21296,797,3.60000000
CN1711900000000,17,119,"Madison County, IL",Oct-22,129947,125051,4896,3.80000000
CN1712100000000,17,121,"Marion County, IL",Oct-22,16457,15641,816,5.00000000
CN1712300000000,17,123,"Marshall County, IL",Oct-22,5166,4945,221,4.30000000
CN1712500000000,17,125,"Mason County, IL",Oct-22,5829,5575,254,4.40000000
CN1712700000000,17,127,"Massac County, IL",Oct-22,5269,5002,267,5.10000000
CN1712900000000,17,129,"Menard County, IL",Oct-22,6263,6061,202,3.20000000
CN1713100000000,17,131,"Mercer County, IL",Oct-22,7853,7599,254,3.20000000
CN1713300000000,17,133,"Monroe County, IL",Oct-22,18520,18009,511,2.80000000
CN1713500000000,17,135,"Montgomery County, IL",Oct-22,11157,10645,512,4.60000000
CN1713700000000,17,137,"Morgan County, IL",Oct-22,15694,15114,580,3.70000000
CN1713900000000,17,139,"Moultrie County, IL",Oct-22,7389,7167,222,3.00000000
CN1714100000000,17,141,"Ogle County, IL",Oct-22,23230,22199,1031,4.40000000
CN1714300000000,17,143,"Peoria County, IL",Oct-22,81931,77555,4376,5.30000000
CN1714500000000,17,145,"Perry County, IL",Oct-22,7966,7594,372,4.70000000
CN1714700000000,17,147,"Piatt County, IL",Oct-22,8731,8464,267,3.10000000
CN1714900000000,17,149,"Pike County, IL",Oct-22,6812,6562,250,3.70000000
CN1715100000000,17,151,"Pope County, IL",Oct-22,1692,1615,77,4.60000000
CN1715300000000,17,153,"Pulaski County, IL",Oct-22,1700,1577,123,7.20000000
CN1715500000000,17,155,"Putnam County, IL",Oct-22,2891,2767,124,4.30000000
CN1715700000000,17,157,"Randolph County, IL",Oct-22,13624,13172,452,3.30000000
CN1715900000000,17,159,"Richland County, IL",Oct-22,7061,6802,259,3.70000000
CN1716100000000,17,161,"Rock Island County, IL",Oct-22,69408,66606,2802,4.00000000
CN1716300000000,17,163,"St. Clair County, IL",Oct-22,122264,116731,5533,4.50000000
CN1716500000000,17,165,"Saline County, IL",Oct-22,9149,8666,483,5.30000000
CN1716700000000,17,167,"Sangamon County, IL",Oct-22,98280,94360,3920,4.00000000
CN1716900000000,17,169,"Schuyler County, IL",Oct-22,3247,3138,109,3.40000000
CN1717100000000,17,171,"Scott County, IL",Oct-22,2324,2227,97,4.20000000
CN1717300000000,17,173,"Shelby County, IL",Oct-22,10321,9970,351,3.40000000
CN1717500000000,17,175,"Stark County, IL",Oct-22,2422,2321,101,4.20000000
CN1717700000000,17,177,"Stephenson County, IL",Oct-22,20694,19817,877,4.20000000
CN1717900000000,17,179,"Tazewell County, IL",Oct-22,61455,59091,2364,3.80000000
CN1718100000000,17,181,"Union County, IL",Oct-22,7302,6974,328,4.50000000
CN1718300000000,17,183,"Vermilion County, IL",Oct-22,31513,29896,1617,5.10000000
CN1718500000000,17,185,"Wabash County, IL",Oct-22,5559,5378,181,3.30000000
CN1718700000000,17,187,"Warren County, IL",Oct-22,7471,7196,275,3.70000000
CN1718900000000,17,189,"Washington County, IL",Oct-22,9745,9528,217,2.20000000
CN1719100000000,17,191,"Wayne County, IL",Oct-22,7030,6772,258,3.70000000
CN1719300000000,17,193,"White County, IL",Oct-22,6052,5812,240,4.00000000
CN1719500000000,17,195,"Whiteside County, IL",Oct-22,27342,26213,1129,4.10000000
CN1719700000000,17,197,"Will County, IL",Oct-22,363066,348491,14575,4.00000000
CN1719900000000,17,199,"Williamson County, IL",Oct-22,31404,30110,1294,4.10000000
CN1720100000000,17,201,"Winnebago County, IL",Oct-22,133502,125466,8036,6.00000000
CN1720300000000,17,203,"Woodford County, IL",Oct-22,18192,17589,603,3.30000000
CN1800100000000,18,001,"Adams County, IN",Oct-22,17186,16809,377,2.20000000
CN1800300000000,18,003,"Allen County, IN",Oct-22,187960,182799,5161,2.70000000
CN1800500000000,18,005,"Bartholomew County, IN",Oct-22,43340,42298,1042,2.40000000
CN1800700000000,18,007,"Benton County, IN",Oct-22,4435,4332,103,2.30000000
CN1800900000000,18,009,"Blackford County, IN",Oct-22,4891,4739,152,3.10000000
CN1801100000000,18,011,"Boone County, IN",Oct-22,38352,37533,819,2.10000000
CN1801300000000,18,013,"Brown County, IN",Oct-22,7896,7671,225,2.80000000
CN1801500000000,18,015,"Carroll County, IN",Oct-22,9995,9733,262,2.60000000
CN1801700000000,18,017,"Cass County, IN",Oct-22,17262,16733,529,3.10000000
CN1801900000000,18,019,"Clark County, IN",Oct-22,63490,61874,1616,2.50000000
CN1802100000000,18,021,"Clay County, IN",Oct-22,11664,11295,369,3.20000000
CN1802300000000,18,023,"Clinton County, IN",Oct-22,17111,16701,410,2.40000000
CN1802500000000,18,025,"Crawford County, IN",Oct-22,4803,4663,140,2.90000000
CN1802700000000,18,027,"Daviess County, IN",Oct-22,16463,16102,361,2.20000000
CN1802900000000,18,029,"Dearborn County, IN",Oct-22,25456,24809,647,2.50000000
CN1803100000000,18,031,"Decatur County, IN",Oct-22,14371,14032,339,2.40000000
CN1803300000000,18,033,"DeKalb County, IN",Oct-22,22386,21813,573,2.60000000
CN1803500000000,18,035,"Delaware County, IN",Oct-22,53937,52236,1701,3.20000000
CN1803700000000,18,037,"Dubois County, IN",Oct-22,21691,21196,495,2.30000000
CN1803900000000,18,039,"Elkhart County, IN",Oct-22,118967,115826,3141,2.60000000
CN1804100000000,18,041,"Fayette County, IN",Oct-22,8285,7938,347,4.20000000
CN1804300000000,18,043,"Floyd County, IN",Oct-22,42824,41781,1043,2.40000000
CN1804500000000,18,045,"Fountain County, IN",Oct-22,8014,7809,205,2.60000000
CN1804700000000,18,047,"Franklin County, IN",Oct-22,11307,11033,274,2.40000000
CN1804900000000,18,049,"Fulton County, IN",Oct-22,9432,9166,266,2.80000000
CN1805100000000,18,051,"Gibson County, IN",Oct-22,20011,19591,420,2.10000000
CN1805300000000,18,053,"Grant County, IN",Oct-22,31705,30747,958,3.00000000
CN1805500000000,18,055,"Greene County, IN",Oct-22,13652,13222,430,3.10000000
CN1805700000000,18,057,"Hamilton County, IN",Oct-22,195229,190970,4259,2.20000000
CN1805900000000,18,059,"Hancock County, IN",Oct-22,42734,41703,1031,2.40000000
CN1806100000000,18,061,"Harrison County, IN",Oct-22,20781,20257,524,2.50000000
CN1806300000000,18,063,"Hendricks County, IN",Oct-22,94937,92715,2222,2.30000000
CN1806500000000,18,065,"Henry County, IN",Oct-22,22056,21418,638,2.90000000
CN1806700000000,18,067,"Howard County, IN",Oct-22,33888,32265,1623,4.80000000
CN1806900000000,18,069,"Huntington County, IN",Oct-22,18435,17955,480,2.60000000
CN1807100000000,18,071,"Jackson County, IN",Oct-22,23393,22812,581,2.50000000
CN1807300000000,18,073,"Jasper County, IN",Oct-22,15833,15365,468,3.00000000
CN1807500000000,18,075,"Jay County, IN",Oct-22,8870,8625,245,2.80000000
CN1807700000000,18,077,"Jefferson County, IN",Oct-22,15093,14685,408,2.70000000
CN1807900000000,18,079,"Jennings County, IN",Oct-22,13396,13035,361,2.70000000
CN1808100000000,18,081,"Johnson County, IN",Oct-22,86846,84804,2042,2.40000000
CN1808300000000,18,083,"Knox County, IN",Oct-22,18071,17577,494,2.70000000
CN1808500000000,18,085,"Kosciusko County, IN",Oct-22,40347,39275,1072,2.70000000
CN1808700000000,18,087,"LaGrange County, IN",Oct-22,21243,20626,617,2.90000000
CN1808900000000,18,089,"Lake County, IN",Oct-22,225072,215748,9324,4.10000000
CN1809100000000,18,091,"LaPorte County, IN",Oct-22,46251,44650,1601,3.50000000
CN1809300000000,18,093,"Lawrence County, IN",Oct-22,21024,20344,680,3.20000000
CN1809500000000,18,095,"Madison County, IN",Oct-22,60071,58266,1805,3.00000000
CN1809700000000,18,097,"Marion County, IN",Oct-22,505964,491130,14834,2.90000000
CN1809900000000,18,099,"Marshall County, IN",Oct-22,23385,22772,613,2.60000000
CN1810100000000,18,101,"Martin County, IN",Oct-22,5485,5350,135,2.50000000
CN1810300000000,18,103,"Miami County, IN",Oct-22,14078,13575,503,3.60000000
CN1810500000000,18,105,"Monroe County, IN",Oct-22,74095,71991,2104,2.80000000
CN1810700000000,18,107,"Montgomery County, IN",Oct-22,18864,18393,471,2.50000000
CN1810900000000,18,109,"Morgan County, IN",Oct-22,37382,36425,957,2.60000000
CN1811100000000,18,111,"Newton County, IN",Oct-22,6739,6530,209,3.10000000
CN1811300000000,18,113,"Noble County, IN",Oct-22,21955,21214,741,3.40000000
CN1811500000000,18,115,"Ohio County, IN",Oct-22,3144,3077,67,2.10000000
CN1811700000000,18,117,"Orange County, IN",Oct-22,8210,7948,262,3.20000000
CN1811900000000,18,119,"Owen County, IN",Oct-22,9777,9485,292,3.00000000
CN1812100000000,18,121,"Parke County, IN",Oct-22,7151,6951,200,2.80000000
CN1812300000000,18,123,"Perry County, IN",Oct-22,8735,8474,261,3.00000000
CN1812500000000,18,125,"Pike County, IN",Oct-22,5866,5712,154,2.60000000
CN1812700000000,18,127,"Porter County, IN",Oct-22,84982,82469,2513,3.00000000
CN1812900000000,18,129,"Posey County, IN",Oct-22,13122,12819,303,2.30000000
CN1813100000000,18,131,"Pulaski County, IN",Oct-22,6626,6461,165,2.50000000
CN1813300000000,18,133,"Putnam County, IN",Oct-22,16939,16448,491,2.90000000
CN1813500000000,18,135,"Randolph County, IN",Oct-22,11782,11459,323,2.70000000
CN1813700000000,18,137,"Ripley County, IN",Oct-22,12589,12226,363,2.90000000
CN1813900000000,18,139,"Rush County, IN",Oct-22,9010,8796,214,2.40000000
CN1814100000000,18,141,"St. Joseph County, IN",Oct-22,134601,130293,4308,3.20000000
CN1814300000000,18,143,"Scott County, IN",Oct-22,10663,10348,315,3.00000000
CN1814500000000,18,145,"Shelby County, IN",Oct-22,23734,23148,586,2.50000000
CN1814700000000,18,147,"Spencer County, IN",Oct-22,10526,10273,253,2.40000000
CN1814900000000,18,149,"Starke County, IN",Oct-22,9507,9173,334,3.50000000
CN1815100000000,18,151,"Steuben County, IN",Oct-22,20717,20255,462,2.20000000
CN1815300000000,18,153,"Sullivan County, IN",Oct-22,7974,7709,265,3.30000000
CN1815500000000,18,155,"Switzerland County, IN",Oct-22,4672,4542,130,2.80000000
CN1815700000000,18,157,"Tippecanoe County, IN",Oct-22,97135,94380,2755,2.80000000
CN1815900000000,18,159,"Tipton County, IN",Oct-22,8931,8694,237,2.70000000
CN1816100000000,18,161,"Union County, IN",Oct-22,3535,3446,89,2.50000000
CN1816300000000,18,163,"Vanderburgh County, IN",Oct-22,92614,89995,2619,2.80000000
CN1816500000000,18,165,"Vermillion County, IN",Oct-22,6581,6368,213,3.20000000
CN1816700000000,18,167,"Vigo County, IN",Oct-22,45859,44304,1555,3.40000000
CN1816900000000,18,169,"Wabash County, IN",Oct-22,14720,14332,388,2.60000000
CN1817100000000,18,171,"Warren County, IN",Oct-22,4111,4004,107,2.60000000
CN1817300000000,18,173,"Warrick County, IN",Oct-22,32558,31733,825,2.50000000
CN1817500000000,18,175,"Washington County, IN",Oct-22,14048,13693,355,2.50000000
CN1817700000000,18,177,"Wayne County, IN",Oct-22,29337,28471,866,3.00000000
CN1817900000000,18,179,"Wells County, IN",Oct-22,14308,13980,328,2.30000000
CN1818100000000,18,181,"White County, IN",Oct-22,13015,12711,304,2.30000000
CN1818300000000,18,183,"Whitley County, IN",Oct-22,17752,17339,413,2.30000000
CN1900100000000,19,001,"Adair County, IA",Oct-22,4559,4477,82,1.80000000
CN1900300000000,19,003,"Adams County, IA",Oct-22,2028,1984,44,2.20000000
CN1900500000000,19,005,"Allamakee County, IA",Oct-22,7084,6884,200,2.80000000
CN1900700000000,19,007,"Appanoose County, IA",Oct-22,6028,5857,171,2.80000000
CN1900900000000,19,009,"Audubon County, IA",Oct-22,3079,3013,66,2.10000000
CN1901100000000,19,011,"Benton County, IA",Oct-22,13086,12713,373,2.90000000
CN1901300000000,19,013,"Black Hawk County, IA",Oct-22,69402,67474,1928,2.80000000
CN1901500000000,19,015,"Boone County, IA",Oct-22,15070,14742,328,2.20000000
CN1901700000000,19,017,"Bremer County, IA",Oct-22,14279,13976,303,2.10000000
CN1901900000000,19,019,"Buchanan County, IA",Oct-22,11295,11013,282,2.50000000
CN1902100000000,19,021,"Buena Vista County, IA",Oct-22,12498,12211,287,2.30000000
CN1902300000000,19,023,"Butler County, IA",Oct-22,8155,7961,194,2.40000000
CN1902500000000,19,025,"Calhoun County, IA",Oct-22,4118,4005,113,2.70000000
CN1902700000000,19,027,"Carroll County, IA",Oct-22,10877,10662,215,2.00000000
CN1902900000000,19,029,"Cass County, IA",Oct-22,6803,6647,156,2.30000000
CN1903100000000,19,031,"Cedar County, IA",Oct-22,10733,10485,248,2.30000000
CN1903300000000,19,033,"Cerro Gordo County, IA",Oct-22,22522,21932,590,2.60000000
CN1903500000000,19,035,"Cherokee County, IA",Oct-22,6138,6004,134,2.20000000
CN1903700000000,19,037,"Chickasaw County, IA",Oct-22,6501,6360,141,2.20000000
CN1903900000000,19,039,"Clarke County, IA",Oct-22,4896,4768,128,2.60000000
CN1904100000000,19,041,"Clay County, IA",Oct-22,8615,8400,215,2.50000000
CN1904300000000,19,043,"Clayton County, IA",Oct-22,9612,9359,253,2.60000000
CN1904500000000,19,045,"Clinton County, IA",Oct-22,22244,21478,766,3.40000000
CN1904700000000,19,047,"Crawford County, IA",Oct-22,7947,7697,250,3.10000000
CN1904900000000,19,049,"Dallas County, IA",Oct-22,54039,52908,1131,2.10000000
CN1905100000000,19,051,"Davis County, IA",Oct-22,4312,4213,99,2.30000000
CN1905300000000,19,053,"Decatur County, IA",Oct-22,4381,4282,99,2.30000000
CN1905500000000,19,055,"Delaware County, IA",Oct-22,10607,10398,209,2.00000000
CN1905700000000,19,057,"Des Moines County, IA",Oct-22,18147,17391,756,4.20000000
CN1905900000000,19,059,"Dickinson County, IA",Oct-22,10238,9978,260,2.50000000
CN1906100000000,19,061,"Dubuque County, IA",Oct-22,56337,54645,1692,3.00000000
CN1906300000000,19,063,"Emmet County, IA",Oct-22,4926,4798,128,2.60000000
CN1906500000000,19,065,"Fayette County, IA",Oct-22,10269,10006,263,2.60000000
CN1906700000000,19,067,"Floyd County, IA",Oct-22,8226,8005,221,2.70000000
CN1906900000000,19,069,"Franklin County, IA",Oct-22,5619,5487,132,2.30000000
CN1907100000000,19,071,"Fremont County, IA",Oct-22,3766,3666,100,2.70000000
CN1907300000000,19,073,"Greene County, IA",Oct-22,5438,5332,106,1.90000000
CN1907500000000,19,075,"Grundy County, IA",Oct-22,6497,6343,154,2.40000000
CN1907700000000,19,077,"Guthrie County, IA",Oct-22,5599,5452,147,2.60000000
CN1907900000000,19,079,"Hamilton County, IA",Oct-22,7028,6843,185,2.60000000
CN1908100000000,19,081,"Hancock County, IA",Oct-22,5778,5643,135,2.30000000
CN1908300000000,19,083,"Hardin County, IA",Oct-22,7919,7706,213,2.70000000
CN1908500000000,19,085,"Harrison County, IA",Oct-22,7234,7055,179,2.50000000
CN1908700000000,19,087,"Henry County, IA",Oct-22,9869,9582,287,2.90000000
CN1908900000000,19,089,"Howard County, IA",Oct-22,5260,5132,128,2.40000000
CN1909100000000,19,091,"Humboldt County, IA",Oct-22,5010,4897,113,2.30000000
CN1909300000000,19,093,"Ida County, IA",Oct-22,3982,3903,79,2.00000000
CN1909500000000,19,095,"Iowa County, IA",Oct-22,10191,9985,206,2.00000000
CN1909700000000,19,097,"Jackson County, IA",Oct-22,10790,10472,318,2.90000000
CN1909900000000,19,099,"Jasper County, IA",Oct-22,18776,18264,512,2.70000000
CN1910100000000,19,101,"Jefferson County, IA",Oct-22,10209,9946,263,2.60000000
CN1910300000000,19,103,"Johnson County, IA",Oct-22,89768,87749,2019,2.20000000
CN1910500000000,19,105,"Jones County, IA",Oct-22,10312,10034,278,2.70000000
CN1910700000000,19,107,"Keokuk County, IA",Oct-22,5208,5064,144,2.80000000
CN1910900000000,19,109,"Kossuth County, IA",Oct-22,8200,8016,184,2.20000000
CN1911100000000,19,111,"Lee County, IA",Oct-22,15314,14655,659,4.30000000
CN1911300000000,19,113,"Linn County, IA",Oct-22,120964,117263,3701,3.10000000
CN1911500000000,19,115,"Louisa County, IA",Oct-22,5908,5751,157,2.70000000
CN1911700000000,19,117,"Lucas County, IA",Oct-22,4762,4659,103,2.20000000
CN1911900000000,19,119,"Lyon County, IA",Oct-22,7124,6999,125,1.80000000
CN1912100000000,19,121,"Madison County, IA",Oct-22,8723,8483,240,2.80000000
CN1912300000000,19,123,"Mahaska County, IA",Oct-22,12421,12133,288,2.30000000
CN1912500000000,19,125,"Marion County, IA",Oct-22,19797,19413,384,1.90000000
CN1912700000000,19,127,"Marshall County, IA",Oct-22,16963,16335,628,3.70000000
CN1912900000000,19,129,"Mills County, IA",Oct-22,7251,7077,174,2.40000000
CN1913100000000,19,131,"Mitchell County, IA",Oct-22,5855,5739,116,2.00000000
CN1913300000000,19,133,"Monona County, IA",Oct-22,4415,4302,113,2.60000000
CN1913500000000,19,135,"Monroe County, IA",Oct-22,3966,3863,103,2.60000000
CN1913700000000,19,137,"Montgomery County, IA",Oct-22,4908,4783,125,2.50000000
CN1913900000000,19,139,"Muscatine County, IA",Oct-22,20879,20256,623,3.00000000
CN1914100000000,19,141,"O'Brien County, IA",Oct-22,8198,8022,176,2.10000000
CN1914300000000,19,143,"Osceola County, IA",Oct-22,3651,3585,66,1.80000000
CN1914500000000,19,145,"Page County, IA",Oct-22,6367,6196,171,2.70000000
CN1914700000000,19,147,"Palo Alto County, IA",Oct-22,4540,4436,104,2.30000000
CN1914900000000,19,149,"Plymouth County, IA",Oct-22,14844,14523,321,2.20000000
CN1915100000000,19,151,"Pocahontas County, IA",Oct-22,4702,4609,93,2.00000000
CN1915300000000,19,153,"Polk County, IA",Oct-22,276490,269271,7219,2.60000000
CN1915500000000,19,155,"Pottawattamie County, IA",Oct-22,48669,47384,1285,2.60000000
CN1915700000000,19,157,"Poweshiek County, IA",Oct-22,11081,10830,251,2.30000000
CN1915900000000,19,159,"Ringgold County, IA",Oct-22,2420,2370,50,2.10000000
CN1916100000000,19,161,"Sac County, IA",Oct-22,5319,5201,118,2.20000000
CN1916300000000,19,163,"Scott County, IA",Oct-22,92898,90048,2850,3.10000000
CN1916500000000,19,165,"Shelby County, IA",Oct-22,6309,6162,147,2.30000000
CN1916700000000,19,167,"Sioux County, IA",Oct-22,22522,22150,372,1.70000000
CN1916900000000,19,169,"Story County, IA",Oct-22,61300,60074,1226,2.00000000
CN1917100000000,19,171,"Tama County, IA",Oct-22,9229,8995,234,2.50000000
CN1917300000000,19,173,"Taylor County, IA",Oct-22,3119,3054,65,2.10000000
CN1917500000000,19,175,"Union County, IA",Oct-22,6184,6022,162,2.60000000
CN1917700000000,19,177,"Van Buren County, IA",Oct-22,3694,3597,97,2.60000000
CN1917900000000,19,179,"Wapello County, IA",Oct-22,17120,16582,538,3.10000000
CN1918100000000,19,181,"Warren County, IA",Oct-22,29285,28606,679,2.30000000
CN1918300000000,19,183,"Washington County, IA",Oct-22,12050,11760,290,2.40000000
CN1918500000000,19,185,"Wayne County, IA",Oct-22,2864,2792,72,2.50000000
CN1918700000000,19,187,"Webster County, IA",Oct-22,18494,17978,516,2.80000000
CN1918900000000,19,189,"Winnebago County, IA",Oct-22,4926,4791,135,2.70000000
CN1919100000000,19,191,"Winneshiek County, IA",Oct-22,11970,11705,265,2.20000000
CN1919300000000,19,193,"Woodbury County, IA",Oct-22,56300,54875,1425,2.50000000
CN1919500000000,19,195,"Worth County, IA",Oct-22,4007,3914,93,2.30000000
CN1919700000000,19,197,"Wright County, IA",Oct-22,6785,6626,159,2.30000000
CN2000100000000,20,001,"Allen County, KS",Oct-22,6406,6241,165,2.60000000
CN2000300000000,20,003,"Anderson County, KS",Oct-22,4434,4342,92,2.10000000
CN2000500000000,20,005,"Atchison County, KS",Oct-22,6811,6590,221,3.20000000
CN2000700000000,20,007,"Barber County, KS",Oct-22,2254,2206,48,2.10000000
CN2000900000000,20,009,"Barton County, KS",Oct-22,13110,12778,332,2.50000000
CN2001100000000,20,011,"Bourbon County, KS",Oct-22,6151,5949,202,3.30000000
CN2001300000000,20,013,"Brown County, KS",Oct-22,5026,4905,121,2.40000000
CN2001500000000,20,015,"Butler County, KS",Oct-22,32974,32089,885,2.70000000
CN2001700000000,20,017,"Chase County, KS",Oct-22,1414,1384,30,2.10000000
CN2001900000000,20,019,"Chautauqua County, KS",Oct-22,1477,1437,40,2.70000000
CN2002100000000,20,021,"Cherokee County, KS",Oct-22,10017,9775,242,2.40000000
CN2002300000000,20,023,"Cheyenne County, KS",Oct-22,1285,1256,29,2.30000000
CN2002500000000,20,025,"Clark County, KS",Oct-22,1097,1076,21,1.90000000
CN2002700000000,20,027,"Clay County, KS",Oct-22,3784,3687,97,2.60000000
CN2002900000000,20,029,"Cloud County, KS",Oct-22,3853,3754,99,2.60000000
CN2003100000000,20,031,"Coffey County, KS",Oct-22,3958,3834,124,3.10000000
CN2003300000000,20,033,"Comanche County, KS",Oct-22,918,899,19,2.10000000
CN2003500000000,20,035,"Cowley County, KS",Oct-22,16812,16311,501,3.00000000
CN2003700000000,20,037,"Crawford County, KS",Oct-22,19371,18827,544,2.80000000
CN2003900000000,20,039,"Decatur County, KS",Oct-22,1180,1145,35,3.00000000
CN2004100000000,20,041,"Dickinson County, KS",Oct-22,9004,8774,230,2.60000000
CN2004300000000,20,043,"Doniphan County, KS",Oct-22,4121,4019,102,2.50000000
CN2004500000000,20,045,"Douglas County, KS",Oct-22,66015,64319,1696,2.60000000
CN2004700000000,20,047,"Edwards County, KS",Oct-22,1369,1337,32,2.30000000
CN2004900000000,20,049,"Elk County, KS",Oct-22,1227,1195,32,2.60000000
CN2005100000000,20,051,"Ellis County, KS",Oct-22,17324,16982,342,2.00000000
CN2005300000000,20,053,"Ellsworth County, KS",Oct-22,2540,2483,57,2.20000000
CN2005500000000,20,055,"Finney County, KS",Oct-22,20768,20325,443,2.10000000
CN2005700000000,20,057,"Ford County, KS",Oct-22,18274,17893,381,2.10000000
CN2005900000000,20,059,"Franklin County, KS",Oct-22,14891,14545,346,2.30000000
CN2006100000000,20,061,"Geary County, KS",Oct-22,11359,10922,437,3.80000000
CN2006300000000,20,063,"Gove County, KS",Oct-22,1399,1367,32,2.30000000
CN2006500000000,20,065,"Graham County, KS",Oct-22,1224,1195,29,2.40000000
CN2006700000000,20,067,"Grant County, KS",Oct-22,2849,2773,76,2.70000000
CN2006900000000,20,069,"Gray County, KS",Oct-22,3327,3267,60,1.80000000
CN2007100000000,20,071,"Greeley County, KS",Oct-22,820,806,14,1.70000000
CN2007300000000,20,073,"Greenwood County, KS",Oct-22,3121,3053,68,2.20000000
CN2007500000000,20,075,"Hamilton County, KS",Oct-22,1644,1617,27,1.60000000
CN2007700000000,20,077,"Harper County, KS",Oct-22,2787,2728,59,2.10000000
CN2007900000000,20,079,"Harvey County, KS",Oct-22,17222,16809,413,2.40000000
CN2008100000000,20,081,"Haskell County, KS",Oct-22,2160,2114,46,2.10000000
CN2008300000000,20,083,"Hodgeman County, KS",Oct-22,1010,989,21,2.10000000
CN2008500000000,20,085,"Jackson County, KS",Oct-22,7212,7053,159,2.20000000
CN2008700000000,20,087,"Jefferson County, KS",Oct-22,10273,10017,256,2.50000000
CN2008900000000,20,089,"Jewell County, KS",Oct-22,1197,1164,33,2.80000000
CN2009100000000,20,091,"Johnson County, KS",Oct-22,348110,339906,8204,2.40000000
CN2009300000000,20,093,"Kearny County, KS",Oct-22,2025,1987,38,1.90000000
CN2009500000000,20,095,"Kingman County, KS",Oct-22,3303,3222,81,2.50000000
CN2009700000000,20,097,"Kiowa County, KS",Oct-22,1279,1254,25,2.00000000
CN2009900000000,20,099,"Labette County, KS",Oct-22,9464,9176,288,3.00000000
CN2010100000000,20,101,"Lane County, KS",Oct-22,773,751,22,2.80000000
CN2010300000000,20,103,"Leavenworth County, KS",Oct-22,37255,36200,1055,2.80000000
CN2010500000000,20,105,"Lincoln County, KS",Oct-22,1792,1752,40,2.20000000
CN2010700000000,20,107,"Linn County, KS",Oct-22,4341,4187,154,3.50000000
CN2010900000000,20,109,"Logan County, KS",Oct-22,1649,1617,32,1.90000000
CN2011100000000,20,111,"Lyon County, KS",Oct-22,17229,16819,410,2.40000000
CN2011300000000,20,113,"McPherson County, KS",Oct-22,17637,17300,337,1.90000000
CN2011500000000,20,115,"Marion County, KS",Oct-22,6133,5985,148,2.40000000
CN2011700000000,20,117,"Marshall County, KS",Oct-22,5417,5307,110,2.00000000
CN2011900000000,20,119,"Meade County, KS",Oct-22,2169,2129,40,1.80000000
CN2012100000000,20,121,"Miami County, KS",Oct-22,17937,17497,440,2.50000000
CN2012300000000,20,123,"Mitchell County, KS",Oct-22,3373,3308,65,1.90000000
CN2012500000000,20,125,"Montgomery County, KS",Oct-22,14472,14009,463,3.20000000
CN2012700000000,20,127,"Morris County, KS",Oct-22,3150,3078,72,2.30000000
CN2012900000000,20,129,"Morton County, KS",Oct-22,1207,1178,29,2.40000000
CN2013100000000,20,131,"Nemaha County, KS",Oct-22,5685,5582,103,1.80000000
CN2013300000000,20,133,"Neosho County, KS",Oct-22,6132,5909,223,3.60000000
CN2013500000000,20,135,"Ness County, KS",Oct-22,1365,1332,33,2.40000000
CN2013700000000,20,137,"Norton County, KS",Oct-22,2615,2566,49,1.90000000
CN2013900000000,20,139,"Osage County, KS",Oct-22,7968,7745,223,2.80000000
CN2014100000000,20,141,"Osborne County, KS",Oct-22,1918,1880,38,2.00000000
CN2014300000000,20,143,"Ottawa County, KS",Oct-22,3067,2989,78,2.50000000
CN2014500000000,20,145,"Pawnee County, KS",Oct-22,2716,2651,65,2.40000000
CN2014700000000,20,147,"Phillips County, KS",Oct-22,2687,2625,62,2.30000000
CN2014900000000,20,149,"Pottawatomie County, KS",Oct-22,12551,12265,286,2.30000000
CN2015100000000,20,151,"Pratt County, KS",Oct-22,4896,4786,110,2.20000000
CN2015300000000,20,153,"Rawlins County, KS",Oct-22,1502,1477,25,1.70000000
CN2015500000000,20,155,"Reno County, KS",Oct-22,29038,28188,850,2.90000000
CN2015700000000,20,157,"Republic County, KS",Oct-22,2398,2350,48,2.00000000
CN2015900000000,20,159,"Rice County, KS",Oct-22,5401,5285,116,2.10000000
CN2016100000000,20,161,"Riley County, KS",Oct-22,34749,33821,928,2.70000000
CN2016300000000,20,163,"Rooks County, KS",Oct-22,2406,2341,65,2.70000000
CN2016500000000,20,165,"Rush County, KS",Oct-22,1655,1618,37,2.20000000
CN2016700000000,20,167,"Russell County, KS",Oct-22,3413,3332,81,2.40000000
CN2016900000000,20,169,"Saline County, KS",Oct-22,30356,29601,755,2.50000000
CN2017100000000,20,171,"Scott County, KS",Oct-22,2746,2692,54,2.00000000
CN2017300000000,20,173,"Sedgwick County, KS",Oct-22,257542,249608,7934,3.10000000
CN2017500000000,20,175,"Seward County, KS",Oct-22,9908,9666,242,2.40000000
CN2017700000000,20,177,"Shawnee County, KS",Oct-22,91059,88540,2519,2.80000000
CN2017900000000,20,179,"Sheridan County, KS",Oct-22,1467,1440,27,1.80000000
CN2018100000000,20,181,"Sherman County, KS",Oct-22,2811,2749,62,2.20000000
CN2018300000000,20,183,"Smith County, KS",Oct-22,2086,2045,41,2.00000000
CN2018500000000,20,185,"Stafford County, KS",Oct-22,1948,1902,46,2.40000000
CN2018700000000,20,187,"Stanton County, KS",Oct-22,1129,1105,24,2.10000000
CN2018900000000,20,189,"Stevens County, KS",Oct-22,2956,2899,57,1.90000000
CN2019100000000,20,191,"Sumner County, KS",Oct-22,10862,10533,329,3.00000000
CN2019300000000,20,193,"Thomas County, KS",Oct-22,4284,4203,81,1.90000000
CN2019500000000,20,195,"Trego County, KS",Oct-22,1340,1305,35,2.60000000
CN2019700000000,20,197,"Wabaunsee County, KS",Oct-22,3702,3618,84,2.30000000
CN2019900000000,20,199,"Wallace County, KS",Oct-22,833,816,17,2.00000000
CN2020100000000,20,201,"Washington County, KS",Oct-22,3064,3007,57,1.90000000
CN2020300000000,20,203,"Wichita County, KS",Oct-22,1108,1083,25,2.30000000
CN2020500000000,20,205,"Wilson County, KS",Oct-22,3804,3688,116,3.00000000
CN2020700000000,20,207,"Woodson County, KS",Oct-22,1510,1465,45,3.00000000
CN2020900000000,20,209,"Wyandotte County, KS",Oct-22,77874,75135,2739,3.50000000
CN2100100000000,21,001,"Adair County, KY",Oct-22,7338,6981,357,4.90000000
CN2100300000000,21,003,"Allen County, KY",Oct-22,9047,8694,353,3.90000000
CN2100500000000,21,005,"Anderson County, KY",Oct-22,11764,11369,395,3.40000000
CN2100700000000,21,007,"Ballard County, KY",Oct-22,3427,3267,160,4.70000000
CN2100900000000,21,009,"Barren County, KY",Oct-22,17621,16872,749,4.30000000
CN2101100000000,21,011,"Bath County, KY",Oct-22,4671,4428,243,5.20000000
CN2101300000000,21,013,"Bell County, KY",Oct-22,8122,7690,432,5.30000000
CN2101500000000,21,015,"Boone County, KY",Oct-22,71580,69210,2370,3.30000000
CN2101700000000,21,017,"Bourbon County, KY",Oct-22,9829,9488,341,3.50000000
CN2101900000000,21,019,"Boyd County, KY",Oct-22,17132,16246,886,5.20000000
CN2102100000000,21,021,"Boyle County, KY",Oct-22,12503,11974,529,4.20000000
CN2102300000000,21,023,"Bracken County, KY",Oct-22,3757,3610,147,3.90000000
CN2102500000000,21,025,"Breathitt County, KY",Oct-22,3193,2952,241,7.50000000
CN2102700000000,21,027,"Breckinridge County, KY",Oct-22,8019,7632,387,4.80000000
CN2102900000000,21,029,"Bullitt County, KY",Oct-22,43671,42206,1465,3.40000000
CN2103100000000,21,031,"Butler County, KY",Oct-22,5009,4794,215,4.30000000
CN2103300000000,21,033,"Caldwell County, KY",Oct-22,5972,5749,223,3.70000000
CN2103500000000,21,035,"Calloway County, KY",Oct-22,16923,16206,717,4.20000000
CN2103700000000,21,037,"Campbell County, KY",Oct-22,50219,48516,1703,3.40000000
CN2103900000000,21,039,"Carlisle County, KY",Oct-22,2251,2173,78,3.50000000
CN2104100000000,21,041,"Carroll County, KY",Oct-22,5515,5331,184,3.30000000
CN2104300000000,21,043,"Carter County, KY",Oct-22,9652,9055,597,6.20000000
CN2104500000000,21,045,"Casey County, KY",Oct-22,6757,6498,259,3.80000000
CN2104700000000,21,047,"Christian County, KY",Oct-22,25148,23929,1219,4.80000000
CN2104900000000,21,049,"Clark County, KY",Oct-22,17351,16715,636,3.70000000
CN2105100000000,21,051,"Clay County, KY",Oct-22,5122,4807,315,6.10000000
CN2105300000000,21,053,"Clinton County, KY",Oct-22,3945,3770,175,4.40000000
CN2105500000000,21,055,"Crittenden County, KY",Oct-22,3762,3604,158,4.20000000
CN2105700000000,21,057,"Cumberland County, KY",Oct-22,3399,3295,104,3.10000000
CN2105900000000,21,059,"Daviess County, KY",Oct-22,46692,44756,1936,4.10000000
CN2106100000000,21,061,"Edmonson County, KY",Oct-22,4747,4511,236,5.00000000
CN2106300000000,21,063,"Elliott County, KY",Oct-22,1840,1703,137,7.40000000
CN2106500000000,21,065,"Estill County, KY",Oct-22,5202,4955,247,4.70000000
CN2106700000000,21,067,"Fayette County, KY",Oct-22,176595,170822,5773,3.30000000
CN2106900000000,21,069,"Fleming County, KY",Oct-22,6039,5770,269,4.50000000
CN2107100000000,21,071,"Floyd County, KY",Oct-22,10925,10237,688,6.30000000
CN2107300000000,21,073,"Franklin County, KY",Oct-22,24664,23785,879,3.60000000
CN2107500000000,21,075,"Fulton County, KY",Oct-22,2055,1961,94,4.60000000
CN2107700000000,21,077,"Gallatin County, KY",Oct-22,4000,3848,152,3.80000000
CN2107900000000,21,079,"Garrard County, KY",Oct-22,7723,7414,309,4.00000000
CN2108100000000,21,081,"Grant County, KY",Oct-22,11634,11171,463,4.00000000
CN2108300000000,21,083,"Graves County, KY",Oct-22,15629,14977,652,4.20000000
CN2108500000000,21,085,"Grayson County, KY",Oct-22,10587,10107,480,4.50000000
CN2108700000000,21,087,"Green County, KY",Oct-22,5361,5177,184,3.40000000
CN2108900000000,21,089,"Greenup County, KY",Oct-22,12881,12161,720,5.60000000
CN2109100000000,21,091,"Hancock County, KY",Oct-22,3925,3721,204,5.20000000
CN2109300000000,21,093,"Hardin County, KY",Oct-22,47431,45488,1943,4.10000000
CN2109500000000,21,095,"Harlan County, KY",Oct-22,6702,6257,445,6.60000000
CN2109700000000,21,097,"Harrison County, KY",Oct-22,8898,8576,322,3.60000000
CN2109900000000,21,099,"Hart County, KY",Oct-22,7519,7204,315,4.20000000
CN2110100000000,21,101,"Henderson County, KY",Oct-22,20944,20152,792,3.80000000
CN2110300000000,21,103,"Henry County, KY",Oct-22,8335,8063,272,3.30000000
CN2110500000000,21,105,"Hickman County, KY",Oct-22,1703,1631,72,4.20000000
CN2110700000000,21,107,"Hopkins County, KY",Oct-22,17575,16780,795,4.50000000
CN2110900000000,21,109,"Jackson County, KY",Oct-22,4194,3953,241,5.70000000
CN2111100000000,21,111,"Jefferson County, KY",Oct-22,402075,387900,14175,3.50000000
CN2111300000000,21,113,"Jessamine County, KY",Oct-22,26723,25798,925,3.50000000
CN2111500000000,21,115,"Johnson County, KY",Oct-22,6582,6170,412,6.30000000
CN2111700000000,21,117,"Kenton County, KY",Oct-22,86998,83998,3000,3.40000000
CN2111900000000,21,119,"Knott County, KY",Oct-22,4277,3988,289,6.80000000
CN2112100000000,21,121,"Knox County, KY",Oct-22,10250,9677,573,5.60000000
CN2112300000000,21,123,"Larue County, KY",Oct-22,5822,5568,254,4.40000000
CN2112500000000,21,125,"Laurel County, KY",Oct-22,25867,24752,1115,4.30000000
CN2112700000000,21,127,"Lawrence County, KY",Oct-22,5571,5293,278,5.00000000
CN2112900000000,21,129,"Lee County, KY",Oct-22,2006,1895,111,5.50000000
CN2113100000000,21,131,"Leslie County, KY",Oct-22,2516,2338,178,7.10000000
CN2113300000000,21,133,"Letcher County, KY",Oct-22,6120,5717,403,6.60000000
CN2113500000000,21,135,"Lewis County, KY",Oct-22,4690,4376,314,6.70000000
CN2113700000000,21,137,"Lincoln County, KY",Oct-22,9179,8724,455,5.00000000
CN2113900000000,21,139,"Livingston County, KY",Oct-22,3575,3406,169,4.70000000
CN2114100000000,21,141,"Logan County, KY",Oct-22,12510,12049,461,3.70000000
CN2114300000000,21,143,"Lyon County, KY",Oct-22,2975,2842,133,4.50000000
CN2114500000000,21,145,"McCracken County, KY",Oct-22,29326,28103,1223,4.20000000
CN2114700000000,21,147,"McCreary County, KY",Oct-22,4972,4715,257,5.20000000
CN2114900000000,21,149,"McLean County, KY",Oct-22,4065,3887,178,4.40000000
CN2115100000000,21,151,"Madison County, KY",Oct-22,47769,46009,1760,3.70000000
CN2115300000000,21,153,"Magoffin County, KY",Oct-22,3273,2982,291,8.90000000
CN2115500000000,21,155,"Marion County, KY",Oct-22,9232,8927,305,3.30000000
CN2115700000000,21,157,"Marshall County, KY",Oct-22,14199,13612,587,4.10000000
CN2115900000000,21,159,"Martin County, KY",Oct-22,2189,2016,173,7.90000000
CN2116100000000,21,161,"Mason County, KY",Oct-22,6523,6188,335,5.10000000
CN2116300000000,21,163,"Meade County, KY",Oct-22,11739,11219,520,4.40000000
CN2116500000000,21,165,"Menifee County, KY",Oct-22,2318,2191,127,5.50000000
CN2116700000000,21,167,"Mercer County, KY",Oct-22,9934,9547,387,3.90000000
CN2116900000000,21,169,"Metcalfe County, KY",Oct-22,3894,3718,176,4.50000000
CN2117100000000,21,171,"Monroe County, KY",Oct-22,4603,4441,162,3.50000000
CN2117300000000,21,173,"Montgomery County, KY",Oct-22,11661,11125,536,4.60000000
CN2117500000000,21,175,"Morgan County, KY",Oct-22,4322,4122,200,4.60000000
CN2117700000000,21,177,"Muhlenberg County, KY",Oct-22,9536,8936,600,6.30000000
CN2117900000000,21,179,"Nelson County, KY",Oct-22,23822,23007,815,3.40000000
CN2118100000000,21,181,"Nicholas County, KY",Oct-22,3356,3220,136,4.10000000
CN2118300000000,21,183,"Ohio County, KY",Oct-22,8986,8519,467,5.20000000
CN2118500000000,21,185,"Oldham County, KY",Oct-22,34013,32965,1048,3.10000000
CN2118700000000,21,187,"Owen County, KY",Oct-22,5107,4920,187,3.70000000
CN2118900000000,21,189,"Owsley County, KY",Oct-22,1059,979,80,7.60000000
CN2119100000000,21,191,"Pendleton County, KY",Oct-22,6889,6637,252,3.70000000
CN2119300000000,21,193,"Perry County, KY",Oct-22,7958,7527,431,5.40000000
CN2119500000000,21,195,"Pike County, KY",Oct-22,18864,17833,1031,5.50000000
CN2119700000000,21,197,"Powell County, KY",Oct-22,5203,4976,227,4.40000000
CN2119900000000,21,199,"Pulaski County, KY",Oct-22,25960,24777,1183,4.60000000
CN2120100000000,21,201,"Robertson County, KY",Oct-22,815,776,39,4.80000000
CN2120300000000,21,203,"Rockcastle County, KY",Oct-22,6612,6308,304,4.60000000
CN2120500000000,21,205,"Rowan County, KY",Oct-22,9922,9433,489,4.90000000
CN2120700000000,21,207,"Russell County, KY",Oct-22,6049,5725,324,5.40000000
CN2120900000000,21,209,"Scott County, KY",Oct-22,30534,29552,982,3.20000000
CN2121100000000,21,211,"Shelby County, KY",Oct-22,26490,25647,843,3.20000000
CN2121300000000,21,213,"Simpson County, KY",Oct-22,8861,8539,322,3.60000000
CN2121500000000,21,215,"Spencer County, KY",Oct-22,10769,10412,357,3.30000000
CN2121700000000,21,217,"Taylor County, KY",Oct-22,12672,12209,463,3.70000000
CN2121900000000,21,219,"Todd County, KY",Oct-22,5575,5377,198,3.60000000
CN2122100000000,21,221,"Trigg County, KY",Oct-22,6173,5895,278,4.50000000
CN2122300000000,21,223,"Trimble County, KY",Oct-22,3905,3763,142,3.60000000
CN2122500000000,21,225,"Union County, KY",Oct-22,6054,5782,272,4.50000000
CN2122700000000,21,227,"Warren County, KY",Oct-22,65634,63172,2462,3.80000000
CN2122900000000,21,229,"Washington County, KY",Oct-22,6194,5983,211,3.40000000
CN2123100000000,21,231,"Wayne County, KY",Oct-22,7105,6723,382,5.40000000
CN2123300000000,21,233,"Webster County, KY",Oct-22,5290,5079,211,4.00000000
CN2123500000000,21,235,"Whitley County, KY",Oct-22,14333,13687,646,4.50000000
CN2123700000000,21,237,"Wolfe County, KY",Oct-22,2243,2123,120,5.30000000
CN2123900000000,21,239,"Woodford County, KY",Oct-22,15316,14850,466,3.00000000
CN2200100000000,22,001,"Acadia Parish, LA",Oct-22,24075,23372,703,2.90000000
CN2200300000000,22,003,"Allen Parish, LA",Oct-22,8091,7835,256,3.20000000
CN2200500000000,22,005,"Ascension Parish, LA",Oct-22,66057,64481,1576,2.40000000
CN2200700000000,22,007,"Assumption Parish, LA",Oct-22,8804,8445,359,4.10000000
CN2200900000000,22,009,"Avoyelles Parish, LA",Oct-22,13172,12722,450,3.40000000
CN2201100000000,22,011,"Beauregard Parish, LA",Oct-22,14750,14352,398,2.70000000
CN2201300000000,22,013,"Bienville Parish, LA",Oct-22,4786,4609,177,3.70000000
CN2201500000000,22,015,"Bossier Parish, LA",Oct-22,58405,56996,1409,2.40000000
CN2201700000000,22,017,"Caddo Parish, LA",Oct-22,102430,98834,3596,3.50000000
CN2201900000000,22,019,"Calcasieu Parish, LA",Oct-22,98333,95577,2756,2.80000000
CN2202100000000,22,021,"Caldwell Parish, LA",Oct-22,3639,3535,104,2.90000000
CN2202300000000,22,023,"Cameron Parish, LA",Oct-22,3650,3572,78,2.10000000
CN2202500000000,22,025,"Catahoula Parish, LA",Oct-22,3390,3280,110,3.20000000
CN2202700000000,22,027,"Claiborne Parish, LA",Oct-22,5315,5153,162,3.00000000
CN2202900000000,22,029,"Concordia Parish, LA",Oct-22,6977,6715,262,3.80000000
CN2203100000000,22,031,"De Soto Parish, LA",Oct-22,10956,10624,332,3.00000000
CN2203300000000,22,033,"East Baton Rouge Parish, LA",Oct-22,230420,223879,6541,2.80000000
CN2203500000000,22,035,"East Carroll Parish, LA",Oct-22,1616,1508,108,6.70000000
CN2203700000000,22,037,"East Feliciana Parish, LA",Oct-22,7773,7587,186,2.40000000
CN2203900000000,22,039,"Evangeline Parish, LA",Oct-22,11958,11565,393,3.30000000
CN2204100000000,22,041,"Franklin Parish, LA",Oct-22,7449,7153,296,4.00000000
CN2204300000000,22,043,"Grant Parish, LA",Oct-22,8396,8178,218,2.60000000
CN2204500000000,22,045,"Iberia Parish, LA",Oct-22,27930,26875,1055,3.80000000
CN2204700000000,22,047,"Iberville Parish, LA",Oct-22,13747,13195,552,4.00000000
CN2204900000000,22,049,"Jackson Parish, LA",Oct-22,6840,6665,175,2.60000000
CN2205100000000,22,051,"Jefferson Parish, LA",Oct-22,213588,207128,6460,3.00000000
CN2205300000000,22,053,"Jefferson Davis Parish, LA",Oct-22,12544,12198,346,2.80000000
CN2205500000000,22,055,"Lafayette Parish, LA",Oct-22,117651,114707,2944,2.50000000
CN2205700000000,22,057,"Lafourche Parish, LA",Oct-22,40146,39078,1068,2.70000000
CN2205900000000,22,059,"LaSalle Parish, LA",Oct-22,6661,6517,144,2.20000000
CN2206100000000,22,061,"Lincoln Parish, LA",Oct-22,21315,20727,588,2.80000000
CN2206300000000,22,063,"Livingston Parish, LA",Oct-22,70826,69194,1632,2.30000000
CN2206500000000,22,065,"Madison Parish, LA",Oct-22,3437,3294,143,4.20000000
CN2206700000000,22,067,"Morehouse Parish, LA",Oct-22,9846,9399,447,4.50000000
CN2206900000000,22,069,"Natchitoches Parish, LA",Oct-22,16533,16017,516,3.10000000
CN2207100000000,22,071,"Orleans Parish, LA",Oct-22,179492,172117,7375,4.10000000
CN2207300000000,22,073,"Ouachita Parish, LA",Oct-22,69444,67383,2061,3.00000000
CN2207500000000,22,075,"Plaquemines Parish, LA",Oct-22,9910,9658,252,2.50000000
CN2207700000000,22,077,"Pointe Coupee Parish, LA",Oct-22,9659,9354,305,3.20000000
CN2207900000000,22,079,"Rapides Parish, LA",Oct-22,56722,55283,1439,2.50000000
CN2208100000000,22,081,"Red River Parish, LA",Oct-22,3775,3668,107,2.80000000
CN2208300000000,22,083,"Richland Parish, LA",Oct-22,8089,7826,263,3.30000000
CN2208500000000,22,085,"Sabine Parish, LA",Oct-22,9181,8927,254,2.80000000
CN2208700000000,22,087,"St. Bernard Parish, LA",Oct-22,20306,19577,729,3.60000000
CN2208900000000,22,089,"St. Charles Parish, LA",Oct-22,25134,24470,664,2.60000000
CN2209100000000,22,091,"St. Helena Parish, LA",Oct-22,4224,4020,204,4.80000000
CN2209300000000,22,093,"St. James Parish, LA",Oct-22,9037,8678,359,4.00000000
CN2209500000000,22,095,"St. John the Baptist Parish, LA",Oct-22,19377,18533,844,4.40000000
CN2209700000000,22,097,"St. Landry Parish, LA",Oct-22,32091,30890,1201,3.70000000
CN2209900000000,22,099,"St. Martin Parish, LA",Oct-22,22286,21618,668,3.00000000
CN2210100000000,22,101,"St. Mary Parish, LA",Oct-22,18580,17858,722,3.90000000
CN2210300000000,22,103,"St. Tammany Parish, LA",Oct-22,121387,118561,2826,2.30000000
CN2210500000000,22,105,"Tangipahoa Parish, LA",Oct-22,56475,54383,2092,3.70000000
CN2210700000000,22,107,"Tensas Parish, LA",Oct-22,1217,1165,52,4.30000000
CN2210900000000,22,109,"Terrebonne Parish, LA",Oct-22,44161,42755,1406,3.20000000
CN2211100000000,22,111,"Union Parish, LA",Oct-22,9051,8767,284,3.10000000
CN2211300000000,22,113,"Vermilion Parish, LA",Oct-22,24278,23602,676,2.80000000
CN2211500000000,22,115,"Vernon Parish, LA",Oct-22,15791,15181,610,3.90000000
CN2211700000000,22,117,"Washington Parish, LA",Oct-22,16999,16418,581,3.40000000
CN2211900000000,22,119,"Webster Parish, LA",Oct-22,14241,13751,490,3.40000000
CN2212100000000,22,121,"West Baton Rouge Parish, LA",Oct-22,13826,13455,371,2.70000000
CN2212300000000,22,123,"West Carroll Parish, LA",Oct-22,3546,3407,139,3.90000000
CN2212500000000,22,125,"West Feliciana Parish, LA",Oct-22,5371,5261,110,2.00000000
CN2212700000000,22,127,"Winn Parish, LA",Oct-22,4542,4396,146,3.20000000
CN2300100000000,23,001,"Androscoggin County, ME",Oct-22,53483,51572,1911,3.60000000
CN2300300000000,23,003,"Aroostook County, ME",Oct-22,27381,26169,1212,4.40000000
CN2300500000000,23,005,"Cumberland County, ME",Oct-22,163804,158851,4953,3.00000000
CN2300700000000,23,007,"Franklin County, ME",Oct-22,13297,12741,556,4.20000000
CN2300900000000,23,009,"Hancock County, ME",Oct-22,28339,27390,949,3.30000000
CN2301100000000,23,011,"Kennebec County, ME",Oct-22,59924,57897,2027,3.40000000
CN2301300000000,23,013,"Knox County, ME",Oct-22,19019,18367,652,3.40000000
CN2301500000000,23,015,"Lincoln County, ME",Oct-22,16146,15595,551,3.40000000
CN2301700000000,23,017,"Oxford County, ME",Oct-22,25202,24186,1016,4.00000000
CN2301900000000,23,019,"Penobscot County, ME",Oct-22,75404,72663,2741,3.60000000
CN2302100000000,23,021,"Piscataquis County, ME",Oct-22,7089,6790,299,4.20000000
CN2302300000000,23,023,"Sagadahoc County, ME",Oct-22,18657,18117,540,2.90000000
CN2302500000000,23,025,"Somerset County, ME",Oct-22,21371,20340,1031,4.80000000
CN2302700000000,23,027,"Waldo County, ME",Oct-22,19906,19228,678,3.40000000
CN2302900000000,23,029,"Washington County, ME",Oct-22,12849,12262,587,4.60000000
CN2303100000000,23,031,"York County, ME",Oct-22,111491,108132,3359,3.00000000
CN2400100000000,24,001,"Allegany County, MD",Oct-22,30264,28756,1508,5.00000000
CN2400300000000,24,003,"Anne Arundel County, MD",Oct-22,317929,307008,10921,3.40000000
CN2400500000000,24,005,"Baltimore County, MD",Oct-22,451145,432616,18529,4.10000000
CN2400900000000,24,009,"Calvert County, MD",Oct-22,49255,47488,1767,3.60000000
CN2401100000000,24,011,"Caroline County, MD",Oct-22,18127,17485,642,3.50000000
CN2401300000000,24,013,"Carroll County, MD",Oct-22,96169,93181,2988,3.10000000
CN2401500000000,24,015,"Cecil County, MD",Oct-22,53265,51097,2168,4.10000000
CN2401700000000,24,017,"Charles County, MD",Oct-22,86436,82942,3494,4.00000000
CN2401900000000,24,019,"Dorchester County, MD",Oct-22,16486,15777,709,4.30000000
CN2402100000000,24,021,"Frederick County, MD",Oct-22,136828,131870,4958,3.60000000
CN2402300000000,24,023,"Garrett County, MD",Oct-22,15223,14675,548,3.60000000
CN2402500000000,24,025,"Harford County, MD",Oct-22,142018,136922,5096,3.60000000
CN2402700000000,24,027,"Howard County, MD",Oct-22,189936,183887,6049,3.20000000
CN2402900000000,24,029,"Kent County, MD",Oct-22,10343,9929,414,4.00000000
CN2403100000000,24,031,"Montgomery County, MD",Oct-22,548795,528873,19922,3.60000000
CN2403300000000,24,033,"Prince George's County, MD",Oct-22,498262,474987,23275,4.70000000
CN2403500000000,24,035,"Queen Anne's County, MD",Oct-22,28643,27710,933,3.30000000
CN2403700000000,24,037,"St. Mary's County, MD",Oct-22,57521,55395,2126,3.70000000
CN2403900000000,24,039,"Somerset County, MD",Oct-22,9089,8539,550,6.10000000
CN2404100000000,24,041,"Talbot County, MD",Oct-22,17961,17265,696,3.90000000
CN2404300000000,24,043,"Washington County, MD",Oct-22,72919,69973,2946,4.00000000
CN2404500000000,24,045,"Wicomico County, MD",Oct-22,50328,47893,2435,4.80000000
CN2404700000000,24,047,"Worcester County, MD",Oct-22,24819,23407,1412,5.70000000
CN2451000000000,24,510,"Baltimore city, MD",Oct-22,279702,264098,15604,5.60000000
CN2500100000000,25,001,"Barnstable County, MA",Oct-22,108299,104607,3692,3.40000000
CN2500300000000,25,003,"Berkshire County, MA",Oct-22,59859,57760,2099,3.50000000
CN2500500000000,25,005,"Bristol County, MA",Oct-22,294784,284069,10715,3.60000000
CN2500700000000,25,007,"Dukes County, MA",Oct-22,9205,8881,324,3.50000000
CN2500900000000,25,009,"Essex County, MA",Oct-22,419588,405973,13615,3.20000000
CN2501100000000,25,011,"Franklin County, MA",Oct-22,40025,38981,1044,2.60000000
CN2501300000000,25,013,"Hampden County, MA",Oct-22,223991,215106,8885,4.00000000
CN2501500000000,25,015,"Hampshire County, MA",Oct-22,89769,87313,2456,2.70000000
CN2501700000000,25,017,"Middlesex County, MA",Oct-22,915473,892268,23205,2.50000000
CN2501900000000,25,019,"Nantucket County/town, MA",Oct-22,7876,7648,228,2.90000000
CN2502100000000,25,021,"Norfolk County, MA",Oct-22,393858,382948,10910,2.80000000
CN2502300000000,25,023,"Plymouth County, MA",Oct-22,282545,273831,8714,3.10000000
CN2502500000000,25,025,"Suffolk County, MA",Oct-22,454139,440919,13220,2.90000000
CN2502700000000,25,027,"Worcester County, MA",Oct-22,436184,422386,13798,3.20000000
CN2600100000000,26,001,"Alcona County, MI",Oct-22,3886,3664,222,5.70000000
CN2600300000000,26,003,"Alger County, MI",Oct-22,3282,3052,230,7.00000000
CN2600500000000,26,005,"Allegan County, MI",Oct-22,61720,59763,1957,3.20000000
CN2600700000000,26,007,"Alpena County, MI",Oct-22,13429,12870,559,4.20000000
CN2600900000000,26,009,"Antrim County, MI",Oct-22,9890,9401,489,4.90000000
CN2601100000000,26,011,"Arenac County, MI",Oct-22,5721,5354,367,6.40000000
CN2601300000000,26,013,"Baraga County, MI",Oct-22,3071,2890,181,5.90000000
CN2601500000000,26,015,"Barry County, MI",Oct-22,31640,30606,1034,3.30000000
CN2601700000000,26,017,"Bay County, MI",Oct-22,47977,45809,2168,4.50000000
CN2601900000000,26,019,"Benzie County, MI",Oct-22,8716,8360,356,4.10000000
CN2602100000000,26,021,"Berrien County, MI",Oct-22,70078,67194,2884,4.10000000
CN2602300000000,26,023,"Branch County, MI",Oct-22,19094,18339,755,4.00000000
CN2602500000000,26,025,"Calhoun County, MI",Oct-22,59147,56478,2669,4.50000000
CN2602700000000,26,027,"Cass County, MI",Oct-22,23757,22827,930,3.90000000
CN2602900000000,26,029,"Charlevoix County, MI",Oct-22,12040,11562,478,4.00000000
CN2603100000000,26,031,"Cheboygan County, MI",Oct-22,10240,9785,455,4.40000000
CN2603300000000,26,033,"Chippewa County, MI",Oct-22,16438,15678,760,4.60000000
CN2603500000000,26,035,"Clare County, MI",Oct-22,11254,10577,677,6.00000000
CN2603700000000,26,037,"Clinton County, MI",Oct-22,40538,39242,1296,3.20000000
CN2603900000000,26,039,"Crawford County, MI",Oct-22,5309,5006,303,5.70000000
CN2604100000000,26,041,"Delta County, MI",Oct-22,16186,15484,702,4.30000000
CN2604300000000,26,043,"Dickinson County, MI",Oct-22,12074,11633,441,3.70000000
CN2604500000000,26,045,"Eaton County, MI",Oct-22,55989,54026,1963,3.50000000
CN2604700000000,26,047,"Emmet County, MI",Oct-22,16274,15572,702,4.30000000
CN2604900000000,26,049,"Genesee County, MI",Oct-22,174351,164868,9483,5.40000000
CN2605100000000,26,051,"Gladwin County, MI",Oct-22,9755,9211,544,5.60000000
CN2605300000000,26,053,"Gogebic County, MI",Oct-22,5506,5266,240,4.40000000
CN2605500000000,26,055,"Grand Traverse County, MI",Oct-22,49451,47863,1588,3.20000000
CN2605700000000,26,057,"Gratiot County, MI",Oct-22,17158,16469,689,4.00000000
CN2605900000000,26,059,"Hillsdale County, MI",Oct-22,19362,18539,823,4.30000000
CN2606100000000,26,061,"Houghton County, MI",Oct-22,16492,15867,625,3.80000000
CN2606300000000,26,063,"Huron County, MI",Oct-22,14951,14391,560,3.70000000
CN2606500000000,26,065,"Ingham County, MI",Oct-22,146726,141170,5556,3.80000000
CN2606700000000,26,067,"Ionia County, MI",Oct-22,30019,29031,988,3.30000000
CN2606900000000,26,069,"Iosco County, MI",Oct-22,10252,9722,530,5.20000000
CN2607100000000,26,071,"Iron County, MI",Oct-22,4766,4530,236,5.00000000
CN2607300000000,26,073,"Isabella County, MI",Oct-22,32915,31572,1343,4.10000000
CN2607500000000,26,075,"Jackson County, MI",Oct-22,72053,69163,2890,4.00000000
CN2607700000000,26,077,"Kalamazoo County, MI",Oct-22,130377,125632,4745,3.60000000
CN2607900000000,26,079,"Kalkaska County, MI",Oct-22,7847,7452,395,5.00000000
CN2608100000000,26,081,"Kent County, MI",Oct-22,357202,345956,11246,3.10000000
CN2608300000000,26,083,"Keweenaw County, MI",Oct-22,925,878,47,5.10000000
CN2608500000000,26,085,"Lake County, MI",Oct-22,4123,3857,266,6.50000000
CN2608700000000,26,087,"Lapeer County, MI",Oct-22,40410,39096,1314,3.30000000
CN2608900000000,26,089,"Leelanau County, MI",Oct-22,10377,10014,363,3.50000000
CN2609100000000,26,091,"Lenawee County, MI",Oct-22,43934,42168,1766,4.00000000
CN2609300000000,26,093,"Livingston County, MI",Oct-22,103465,101116,2349,2.30000000
CN2609500000000,26,095,"Luce County, MI",Oct-22,2088,1987,101,4.80000000
CN2609700000000,26,097,"Mackinac County, MI",Oct-22,5497,5308,189,3.40000000
CN2609900000000,26,099,"Macomb County, MI",Oct-22,443081,428789,14292,3.20000000
CN2610100000000,26,101,"Manistee County, MI",Oct-22,10112,9623,489,4.80000000
CN2610300000000,26,103,"Marquette County, MI",Oct-22,31264,29955,1309,4.20000000
CN2610500000000,26,105,"Mason County, MI",Oct-22,12982,12394,588,4.50000000
CN2610700000000,26,107,"Mecosta County, MI",Oct-22,18843,17965,878,4.70000000
CN2610900000000,26,109,"Menominee County, MI",Oct-22,10281,9907,374,3.60000000
CN2611100000000,26,111,"Midland County, MI",Oct-22,38177,36697,1480,3.90000000
CN2611300000000,26,113,"Missaukee County, MI",Oct-22,6846,6561,285,4.20000000
CN2611500000000,26,115,"Monroe County, MI",Oct-22,72850,69660,3190,4.40000000
CN2611700000000,26,117,"Montcalm County, MI",Oct-22,27674,26607,1067,3.90000000
CN2611900000000,26,119,"Montmorency County, MI",Oct-22,3016,2819,197,6.50000000
CN2612100000000,26,121,"Muskegon County, MI",Oct-22,75926,72010,3916,5.20000000
CN2612300000000,26,123,"Newaygo County, MI",Oct-22,23383,22449,934,4.00000000
CN2612500000000,26,125,"Oakland County, MI",Oct-22,668749,651862,16887,2.50000000
CN2612700000000,26,127,"Oceana County, MI",Oct-22,12046,11397,649,5.40000000
CN2612900000000,26,129,"Ogemaw County, MI",Oct-22,8099,7614,485,6.00000000
CN2613100000000,26,131,"Ontonagon County, MI",Oct-22,2103,1973,130,6.20000000
CN2613300000000,26,133,"Osceola County, MI",Oct-22,11640,11197,443,3.80000000
CN2613500000000,26,135,"Oscoda County, MI",Oct-22,2578,2383,195,7.60000000
CN2613700000000,26,137,"Otsego County, MI",Oct-22,11300,10764,536,4.70000000
CN2613900000000,26,139,"Ottawa County, MI",Oct-22,161247,156494,4753,2.90000000
CN2614100000000,26,141,"Presque Isle County, MI",Oct-22,4903,4633,270,5.50000000
CN2614300000000,26,143,"Roscommon County, MI",Oct-22,7315,6720,595,8.10000000
CN2614500000000,26,145,"Saginaw County, MI",Oct-22,81367,77121,4246,5.20000000
CN2614700000000,26,147,"St. Clair County, MI",Oct-22,74781,72376,2405,3.20000000
CN2614900000000,26,149,"St. Joseph County, MI",Oct-22,27597,26423,1174,4.30000000
CN2615100000000,26,151,"Sanilac County, MI",Oct-22,19268,18460,808,4.20000000
CN2615300000000,26,153,"Schoolcraft County, MI",Oct-22,3171,2993,178,5.60000000
CN2615500000000,26,155,"Shiawassee County, MI",Oct-22,32126,30837,1289,4.00000000
CN2615700000000,26,157,"Tuscola County, MI",Oct-22,22818,21770,1048,4.60000000
CN2615900000000,26,159,"Van Buren County, MI",Oct-22,34362,32860,1502,4.40000000
CN2616100000000,26,161,"Washtenaw County, MI",Oct-22,195646,189234,6412,3.30000000
CN2616300000000,26,163,"Wayne County, MI",Oct-22,794312,761412,32900,4.10000000
CN2616500000000,26,165,"Wexford County, MI",Oct-22,14526,13860,666,4.60000000
CN2700100000000,27,001,"Aitkin County, MN",Oct-22,7295,7119,176,2.40000000
CN2700300000000,27,003,"Anoka County, MN",Oct-22,199455,195983,3472,1.70000000
CN2700500000000,27,005,"Becker County, MN",Oct-22,18356,18048,308,1.70000000
CN2700700000000,27,007,"Beltrami County, MN",Oct-22,23605,23180,425,1.80000000
CN2700900000000,27,009,"Benton County, MN",Oct-22,21485,21082,403,1.90000000
CN2701100000000,27,011,"Big Stone County, MN",Oct-22,2365,2330,35,1.50000000
CN2701300000000,27,013,"Blue Earth County, MN",Oct-22,40033,39491,542,1.40000000
CN2701500000000,27,015,"Brown County, MN",Oct-22,13220,13031,189,1.40000000
CN2701700000000,27,017,"Carlton County, MN",Oct-22,17398,17038,360,2.10000000
CN2701900000000,27,019,"Carver County, MN",Oct-22,59739,58898,841,1.40000000
CN2702100000000,27,021,"Cass County, MN",Oct-22,16569,16261,308,1.90000000
CN2702300000000,27,023,"Chippewa County, MN",Oct-22,6269,6185,84,1.30000000
CN2702500000000,27,025,"Chisago County, MN",Oct-22,29991,29475,516,1.70000000
CN2702700000000,27,027,"Clay County, MN",Oct-22,36470,36002,468,1.30000000
CN2702900000000,27,029,"Clearwater County, MN",Oct-22,4450,4320,130,2.90000000
CN2703100000000,27,031,"Cook County, MN",Oct-22,2803,2748,55,2.00000000
CN2703300000000,27,033,"Cottonwood County, MN",Oct-22,6565,6454,111,1.70000000
CN2703500000000,27,035,"Crow Wing County, MN",Oct-22,31377,30770,607,1.90000000
CN2703700000000,27,037,"Dakota County, MN",Oct-22,243401,239512,3889,1.60000000
CN2703900000000,27,039,"Dodge County, MN",Oct-22,11880,11728,152,1.30000000
CN2704100000000,27,041,"Douglas County, MN",Oct-22,20710,20423,287,1.40000000
CN2704300000000,27,043,"Faribault County, MN",Oct-22,6859,6729,130,1.90000000
CN2704500000000,27,045,"Fillmore County, MN",Oct-22,11478,11319,159,1.40000000
CN2704700000000,27,047,"Freeborn County, MN",Oct-22,14984,14719,265,1.80000000
CN2704900000000,27,049,"Goodhue County, MN",Oct-22,25807,25389,418,1.60000000
CN2705100000000,27,051,"Grant County, MN",Oct-22,3177,3138,39,1.20000000
CN2705300000000,27,053,"Hennepin County, MN",Oct-22,708920,696351,12569,1.80000000
CN2705500000000,27,055,"Houston County, MN",Oct-22,10160,10030,130,1.30000000
CN2705700000000,27,057,"Hubbard County, MN",Oct-22,9964,9740,224,2.20000000
CN2705900000000,27,059,"Isanti County, MN",Oct-22,21708,21303,405,1.90000000
CN2706100000000,27,061,"Itasca County, MN",Oct-22,20364,19852,512,2.50000000
CN2706300000000,27,063,"Jackson County, MN",Oct-22,5276,5209,67,1.30000000
CN2706500000000,27,065,"Kanabec County, MN",Oct-22,8968,8768,200,2.20000000
CN2706700000000,27,067,"Kandiyohi County, MN",Oct-22,22158,21828,330,1.50000000
CN2706900000000,27,069,"Kittson County, MN",Oct-22,2208,2175,33,1.50000000
CN2707100000000,27,071,"Koochiching County, MN",Oct-22,5359,5210,149,2.80000000
CN2707300000000,27,073,"Lac qui Parle County, MN",Oct-22,3304,3256,48,1.50000000
CN2707500000000,27,075,"Lake County, MN",Oct-22,5224,5067,157,3.00000000
CN2707700000000,27,077,"Lake of the Woods County, MN",Oct-22,2265,2224,41,1.80000000
CN2707900000000,27,079,"Le Sueur County, MN",Oct-22,15861,15616,245,1.50000000
CN2708100000000,27,081,"Lincoln County, MN",Oct-22,2912,2876,36,1.20000000
CN2708300000000,27,083,"Lyon County, MN",Oct-22,13790,13598,192,1.40000000
CN2708500000000,27,085,"McLeod County, MN",Oct-22,18528,18216,312,1.70000000
CN2708700000000,27,087,"Mahnomen County, MN",Oct-22,2119,2051,68,3.20000000
CN2708900000000,27,089,"Marshall County, MN",Oct-22,5195,5106,89,1.70000000
CN2709100000000,27,091,"Martin County, MN",Oct-22,9137,8994,143,1.60000000
CN2709300000000,27,093,"Meeker County, MN",Oct-22,12965,12753,212,1.60000000
CN2709500000000,27,095,"Mille Lacs County, MN",Oct-22,12582,12299,283,2.20000000
CN2709700000000,27,097,"Morrison County, MN",Oct-22,16973,16640,333,2.00000000
CN2709900000000,27,099,"Mower County, MN",Oct-22,19988,19651,337,1.70000000
CN2710100000000,27,101,"Murray County, MN",Oct-22,4474,4404,70,1.60000000
CN2710300000000,27,103,"Nicollet County, MN",Oct-22,20598,20351,247,1.20000000
CN2710500000000,27,105,"Nobles County, MN",Oct-22,10992,10853,139,1.30000000
CN2710700000000,27,107,"Norman County, MN",Oct-22,3176,3115,61,1.90000000
CN2710900000000,27,109,"Olmsted County, MN",Oct-22,90961,89674,1287,1.40000000
CN2711100000000,27,111,"Otter Tail County, MN",Oct-22,30151,29688,463,1.50000000
CN2711300000000,27,113,"Pennington County, MN",Oct-22,8448,8295,153,1.80000000
CN2711500000000,27,115,"Pine County, MN",Oct-22,13882,13555,327,2.40000000
CN2711700000000,27,117,"Pipestone County, MN",Oct-22,4404,4346,58,1.30000000
CN2711900000000,27,119,"Polk County, MN",Oct-22,15744,15491,253,1.60000000
CN2712100000000,27,121,"Pope County, MN",Oct-22,6267,6189,78,1.20000000
CN2712300000000,27,123,"Ramsey County, MN",Oct-22,286931,281499,5432,1.90000000
CN2712500000000,27,125,"Red Lake County, MN",Oct-22,2134,2087,47,2.20000000
CN2712700000000,27,127,"Redwood County, MN",Oct-22,7214,7100,114,1.60000000
CN2712900000000,27,129,"Renville County, MN",Oct-22,8357,8210,147,1.80000000
CN2713100000000,27,131,"Rice County, MN",Oct-22,36317,35761,556,1.50000000
CN2713300000000,27,133,"Rock County, MN",Oct-22,5962,5896,66,1.10000000
CN2713500000000,27,135,"Roseau County, MN",Oct-22,7667,7547,120,1.60000000
CN2713700000000,27,137,"St. Louis County, MN",Oct-22,99345,97389,1956,2.00000000
CN2713900000000,27,139,"Scott County, MN",Oct-22,84789,83530,1259,1.50000000
CN2714100000000,27,141,"Sherburne County, MN",Oct-22,53211,52321,890,1.70000000
CN2714300000000,27,143,"Sibley County, MN",Oct-22,8153,8022,131,1.60000000
CN2714500000000,27,145,"Stearns County, MN",Oct-22,89354,87921,1433,1.60000000
CN2714700000000,27,147,"Steele County, MN",Oct-22,19146,18814,332,1.70000000
CN2714900000000,27,149,"Stevens County, MN",Oct-22,5190,5135,55,1.10000000
CN2715100000000,27,151,"Swift County, MN",Oct-22,4608,4532,76,1.60000000
CN2715300000000,27,153,"Todd County, MN",Oct-22,13042,12830,212,1.60000000
CN2715500000000,27,155,"Traverse County, MN",Oct-22,1617,1597,20,1.20000000
CN2715700000000,27,157,"Wabasha County, MN",Oct-22,12216,12041,175,1.40000000
CN2715900000000,27,159,"Wadena County, MN",Oct-22,5762,5634,128,2.20000000
CN2716100000000,27,161,"Waseca County, MN",Oct-22,8570,8402,168,2.00000000
CN2716300000000,27,163,"Washington County, MN",Oct-22,145661,143392,2269,1.60000000
CN2716500000000,27,165,"Watonwan County, MN",Oct-22,6386,6299,87,1.40000000
CN2716700000000,27,167,"Wilkin County, MN",Oct-22,3363,3323,40,1.20000000
CN2716900000000,27,169,"Winona County, MN",Oct-22,26958,26588,370,1.40000000
CN2717100000000,27,171,"Wright County, MN",Oct-22,76904,75730,1174,1.50000000
CN2717300000000,27,173,"Yellow Medicine County, MN",Oct-22,4885,4816,69,1.40000000
CN2800100000000,28,001,"Adams County, MS",Oct-22,10399,9896,503,4.80000000
CN2800300000000,28,003,"Alcorn County, MS",Oct-22,15025,14576,449,3.00000000
CN2800500000000,28,005,"Amite County, MS",Oct-22,4277,4072,205,4.80000000
CN2800700000000,28,007,"Attala County, MS",Oct-22,7007,6762,245,3.50000000
CN2800900000000,28,009,"Benton County, MS",Oct-22,3108,2969,139,4.50000000
CN2801100000000,28,011,"Bolivar County, MS",Oct-22,10926,10460,466,4.30000000
CN2801300000000,28,013,"Calhoun County, MS",Oct-22,5365,5151,214,4.00000000
CN2801500000000,28,015,"Carroll County, MS",Oct-22,3462,3330,132,3.80000000
CN2801700000000,28,017,"Chickasaw County, MS",Oct-22,6747,6437,310,4.60000000
CN2801900000000,28,019,"Choctaw County, MS",Oct-22,3561,3453,108,3.00000000
CN2802100000000,28,021,"Claiborne County, MS",Oct-22,2846,2640,206,7.20000000
CN2802300000000,28,023,"Clarke County, MS",Oct-22,5512,5281,231,4.20000000
CN2802500000000,28,025,"Clay County, MS",Oct-22,8155,7796,359,4.40000000
CN2802700000000,28,027,"Coahoma County, MS",Oct-22,7540,7154,386,5.10000000
CN2802900000000,28,029,"Copiah County, MS",Oct-22,10524,10119,405,3.80000000
CN2803100000000,28,031,"Covington County, MS",Oct-22,8153,7919,234,2.90000000
CN2803300000000,28,033,"DeSoto County, MS",Oct-22,95365,92782,2583,2.70000000
CN2803500000000,28,035,"Forrest County, MS",Oct-22,33233,32140,1093,3.30000000
CN2803700000000,28,037,"Franklin County, MS",Oct-22,2587,2461,126,4.90000000
CN2803900000000,28,039,"George County, MS",Oct-22,8403,8029,374,4.50000000
CN2804100000000,28,041,"Greene County, MS",Oct-22,4096,3882,214,5.20000000
CN2804300000000,28,043,"Grenada County, MS",Oct-22,9079,8799,280,3.10000000
CN2804500000000,28,045,"Hancock County, MS",Oct-22,19102,18431,671,3.50000000
CN2804700000000,28,047,"Harrison County, MS",Oct-22,87819,84953,2866,3.30000000
CN2804900000000,28,049,"Hinds County, MS",Oct-22,100070,96526,3544,3.50000000
CN2805100000000,28,051,"Holmes County, MS",Oct-22,4933,4627,306,6.20000000
CN2805300000000,28,053,"Humphreys County, MS",Oct-22,1881,1743,138,7.30000000
CN2805500000000,28,055,"Issaquena County, MS",Oct-22,304,285,19,6.30000000
CN2805700000000,28,057,"Itawamba County, MS",Oct-22,10181,9889,292,2.90000000
CN2805900000000,28,059,"Jackson County, MS",Oct-22,58801,56632,2169,3.70000000
CN2806100000000,28,061,"Jasper County, MS",Oct-22,5671,5397,274,4.80000000
CN2806300000000,28,063,"Jefferson County, MS",Oct-22,1824,1624,200,11.00000000
CN2806500000000,28,065,"Jefferson Davis County, MS",Oct-22,3823,3651,172,4.50000000
CN2806700000000,28,067,"Jones County, MS",Oct-22,24156,23309,847,3.50000000
CN2806900000000,28,069,"Kemper County, MS",Oct-22,3177,2992,185,5.80000000
CN2807100000000,28,071,"Lafayette County, MS",Oct-22,29925,29207,718,2.40000000
CN2807300000000,28,073,"Lamar County, MS",Oct-22,31610,30815,795,2.50000000
CN2807500000000,28,075,"Lauderdale County, MS",Oct-22,28382,27387,995,3.50000000
CN2807700000000,28,077,"Lawrence County, MS",Oct-22,4598,4410,188,4.10000000
CN2807900000000,28,079,"Leake County, MS",Oct-22,7822,7545,277,3.50000000
CN2808100000000,28,081,"Lee County, MS",Oct-22,40668,39484,1184,2.90000000
CN2808300000000,28,083,"Leflore County, MS",Oct-22,9787,9324,463,4.70000000
CN2808500000000,28,085,"Lincoln County, MS",Oct-22,14326,13872,454,3.20000000
CN2808700000000,28,087,"Lowndes County, MS",Oct-22,25370,24450,920,3.60000000
CN2808900000000,28,089,"Madison County, MS",Oct-22,52427,51046,1381,2.60000000
CN2809100000000,28,091,"Marion County, MS",Oct-22,10351,9999,352,3.40000000
CN2809300000000,28,093,"Marshall County, MS",Oct-22,14473,13963,510,3.50000000
CN2809500000000,28,095,"Monroe County, MS",Oct-22,15853,15316,537,3.40000000
CN2809700000000,28,097,"Montgomery County, MS",Oct-22,3831,3689,142,3.70000000
CN2809900000000,28,099,"Neshoba County, MS",Oct-22,9735,9377,358,3.70000000
CN2810100000000,28,101,"Newton County, MS",Oct-22,8181,7869,312,3.80000000
CN2810300000000,28,103,"Noxubee County, MS",Oct-22,3375,3175,200,5.90000000
CN2810500000000,28,105,"Oktibbeha County, MS",Oct-22,22749,22009,740,3.30000000
CN2810700000000,28,107,"Panola County, MS",Oct-22,12406,11894,512,4.10000000
CN2810900000000,28,109,"Pearl River County, MS",Oct-22,23459,22694,765,3.30000000
CN2811100000000,28,111,"Perry County, MS",Oct-22,4221,4046,175,4.10000000
CN2811300000000,28,113,"Pike County, MS",Oct-22,14054,13467,587,4.20000000
CN2811500000000,28,115,"Pontotoc County, MS",Oct-22,14971,14398,573,3.80000000
CN2811700000000,28,117,"Prentiss County, MS",Oct-22,11419,11079,340,3.00000000
CN2811900000000,28,119,"Quitman County, MS",Oct-22,2220,2106,114,5.10000000
CN2812100000000,28,121,"Rankin County, MS",Oct-22,75244,73369,1875,2.50000000
CN2812300000000,28,123,"Scott County, MS",Oct-22,12188,11842,346,2.80000000
CN2812500000000,28,125,"Sharkey County, MS",Oct-22,1302,1234,68,5.20000000
CN2812700000000,28,127,"Simpson County, MS",Oct-22,10361,10024,337,3.30000000
CN2812900000000,28,129,"Smith County, MS",Oct-22,6443,6247,196,3.00000000
CN2813100000000,28,131,"Stone County, MS",Oct-22,6937,6704,233,3.40000000
CN2813300000000,28,133,"Sunflower County, MS",Oct-22,7170,6795,375,5.20000000
CN2813500000000,28,135,"Tallahatchie County, MS",Oct-22,4484,4325,159,3.50000000
CN2813700000000,28,137,"Tate County, MS",Oct-22,12267,11874,393,3.20000000
CN2813900000000,28,139,"Tippah County, MS",Oct-22,9840,9546,294,3.00000000
CN2814100000000,28,141,"Tishomingo County, MS",Oct-22,8297,8034,263,3.20000000
CN2814300000000,28,143,"Tunica County, MS",Oct-22,4202,4021,181,4.30000000
CN2814500000000,28,145,"Union County, MS",Oct-22,14442,14036,406,2.80000000
CN2814700000000,28,147,"Walthall County, MS",Oct-22,4862,4639,223,4.60000000
CN2814900000000,28,149,"Warren County, MS",Oct-22,19009,18310,699,3.70000000
CN2815100000000,28,151,"Washington County, MS",Oct-22,15143,14388,755,5.00000000
CN2815300000000,28,153,"Wayne County, MS",Oct-22,7215,6921,294,4.10000000
CN2815500000000,28,155,"Webster County, MS",Oct-22,3899,3770,129,3.30000000
CN2815700000000,28,157,"Wilkinson County, MS",Oct-22,2526,2381,145,5.70000000
CN2815900000000,28,159,"Winston County, MS",Oct-22,6929,6658,271,3.90000000
CN2816100000000,28,161,"Yalobusha County, MS",Oct-22,4980,4814,166,3.30000000
CN2816300000000,28,163,"Yazoo County, MS",Oct-22,8655,8297,358,4.10000000
CN2900100000000,29,001,"Adair County, MO",Oct-22,10054,9785,269,2.70000000
CN2900300000000,29,003,"Andrew County, MO",Oct-22,9566,9385,181,1.90000000
CN2900500000000,29,005,"Atchison County, MO",Oct-22,2535,2480,55,2.20000000
CN2900700000000,29,007,"Audrain County, MO",Oct-22,9933,9650,283,2.80000000
CN2900900000000,29,009,"Barry County, MO",Oct-22,14160,13798,362,2.60000000
CN2901100000000,29,011,"Barton County, MO",Oct-22,5129,5010,119,2.30000000
CN2901300000000,29,013,"Bates County, MO",Oct-22,7458,7279,179,2.40000000
CN2901500000000,29,015,"Benton County, MO",Oct-22,7319,7070,249,3.40000000
CN2901700000000,29,017,"Bollinger County, MO",Oct-22,5216,5082,134,2.60000000
CN2901900000000,29,019,"Boone County, MO",Oct-22,101188,99277,1911,1.90000000
CN2902100000000,29,021,"Buchanan County, MO",Oct-22,43274,42331,943,2.20000000
CN2902300000000,29,023,"Butler County, MO",Oct-22,18181,17713,468,2.60000000
CN2902500000000,29,025,"Caldwell County, MO",Oct-22,4158,4033,125,3.00000000
CN2902700000000,29,027,"Callaway County, MO",Oct-22,21261,20813,448,2.10000000
CN2902900000000,29,029,"Camden County, MO",Oct-22,19121,18594,527,2.80000000
CN2903100000000,29,031,"Cape Girardeau County, MO",Oct-22,40423,39567,856,2.10000000
CN2903300000000,29,033,"Carroll County, MO",Oct-22,4263,4160,103,2.40000000
CN2903500000000,29,035,"Carter County, MO",Oct-22,2471,2401,70,2.80000000
CN2903700000000,29,037,"Cass County, MO",Oct-22,54643,53396,1247,2.30000000
CN2903900000000,29,039,"Cedar County, MO",Oct-22,5630,5485,145,2.60000000
CN2904100000000,29,041,"Chariton County, MO",Oct-22,3639,3571,68,1.90000000
CN2904300000000,29,043,"Christian County, MO",Oct-22,47115,46204,911,1.90000000
CN2904500000000,29,045,"Clark County, MO",Oct-22,2959,2870,89,3.00000000
CN2904700000000,29,047,"Clay County, MO",Oct-22,138783,135122,3661,2.60000000
CN2904900000000,29,049,"Clinton County, MO",Oct-22,10533,10218,315,3.00000000
CN2905100000000,29,051,"Cole County, MO",Oct-22,38759,38021,738,1.90000000
CN2905300000000,29,053,"Cooper County, MO",Oct-22,7116,6953,163,2.30000000
CN2905500000000,29,055,"Crawford County, MO",Oct-22,10849,10590,259,2.40000000
CN2905700000000,29,057,"Dade County, MO",Oct-22,3418,3349,69,2.00000000
CN2905900000000,29,059,"Dallas County, MO",Oct-22,7074,6896,178,2.50000000
CN2906100000000,29,061,"Daviess County, MO",Oct-22,3864,3773,91,2.40000000
CN2906300000000,29,063,"DeKalb County, MO",Oct-22,4065,3967,98,2.40000000
CN2906500000000,29,065,"Dent County, MO",Oct-22,6145,5966,179,2.90000000
CN2906700000000,29,067,"Douglas County, MO",Oct-22,5156,5020,136,2.60000000
CN2906900000000,29,069,"Dunklin County, MO",Oct-22,10783,10394,389,3.60000000
CN2907100000000,29,071,"Franklin County, MO",Oct-22,53178,52045,1133,2.10000000
CN2907300000000,29,073,"Gasconade County, MO",Oct-22,7653,7501,152,2.00000000
CN2907500000000,29,075,"Gentry County, MO",Oct-22,3102,3042,60,1.90000000
CN2907700000000,29,077,"Greene County, MO",Oct-22,154378,151244,3134,2.00000000
CN2907900000000,29,079,"Grundy County, MO",Oct-22,4001,3899,102,2.50000000
CN2908100000000,29,081,"Harrison County, MO",Oct-22,3640,3558,82,2.30000000
CN2908300000000,29,083,"Henry County, MO",Oct-22,10241,10000,241,2.40000000
CN2908500000000,29,085,"Hickory County, MO",Oct-22,4036,3936,100,2.50000000
CN2908700000000,29,087,"Holt County, MO",Oct-22,2401,2361,40,1.70000000
CN2908900000000,29,089,"Howard County, MO",Oct-22,4712,4608,104,2.20000000
CN2909100000000,29,091,"Howell County, MO",Oct-22,16176,15718,458,2.80000000
CN2909300000000,29,093,"Iron County, MO",Oct-22,3510,3376,134,3.80000000
CN2909500000000,29,095,"Jackson County, MO",Oct-22,359675,349470,10205,2.80000000
CN2909700000000,29,097,"Jasper County, MO",Oct-22,57412,56112,1300,2.30000000
CN2909900000000,29,099,"Jefferson County, MO",Oct-22,118942,116387,2555,2.10000000
CN2910100000000,29,101,"Johnson County, MO",Oct-22,23079,22514,565,2.40000000
CN2910300000000,29,103,"Knox County, MO",Oct-22,1650,1609,41,2.50000000
CN2910500000000,29,105,"Laclede County, MO",Oct-22,16483,16096,387,2.30000000
CN2910700000000,29,107,"Lafayette County, MO",Oct-22,16528,16118,410,2.50000000
CN2910900000000,29,109,"Lawrence County, MO",Oct-22,17030,16645,385,2.30000000
CN2911100000000,29,111,"Lewis County, MO",Oct-22,4678,4574,104,2.20000000
CN2911300000000,29,113,"Lincoln County, MO",Oct-22,29332,28658,674,2.30000000
CN2911500000000,29,115,"Linn County, MO",Oct-22,5224,5084,140,2.70000000
CN2911700000000,29,117,"Livingston County, MO",Oct-22,7120,6989,131,1.80000000
CN2911900000000,29,119,"McDonald County, MO",Oct-22,10882,10633,249,2.30000000
CN2912100000000,29,121,"Macon County, MO",Oct-22,7177,7023,154,2.10000000
CN2912300000000,29,123,"Madison County, MO",Oct-22,5390,5245,145,2.70000000
CN2912500000000,29,125,"Maries County, MO",Oct-22,3823,3731,92,2.40000000
CN2912700000000,29,127,"Marion County, MO",Oct-22,13721,13426,295,2.10000000
CN2912900000000,29,129,"Mercer County, MO",Oct-22,1620,1582,38,2.30000000
CN2913100000000,29,131,"Miller County, MO",Oct-22,12857,12576,281,2.20000000
CN2913300000000,29,133,"Mississippi County, MO",Oct-22,5099,4950,149,2.90000000
CN2913500000000,29,135,"Moniteau County, MO",Oct-22,6864,6729,135,2.00000000
CN2913700000000,29,137,"Monroe County, MO",Oct-22,3767,3677,90,2.40000000
CN2913900000000,29,139,"Montgomery County, MO",Oct-22,5786,5658,128,2.20000000
CN2914100000000,29,141,"Morgan County, MO",Oct-22,8358,8131,227,2.70000000
CN2914300000000,29,143,"New Madrid County, MO",Oct-22,8035,7812,223,2.80000000
CN2914500000000,29,145,"Newton County, MO",Oct-22,27035,26418,617,2.30000000
CN2914700000000,29,147,"Nodaway County, MO",Oct-22,11094,10870,224,2.00000000
CN2914900000000,29,149,"Oregon County, MO",Oct-22,3752,3634,118,3.10000000
CN2915100000000,29,151,"Osage County, MO",Oct-22,6886,6753,133,1.90000000
CN2915300000000,29,153,"Ozark County, MO",Oct-22,3410,3297,113,3.30000000
CN2915500000000,29,155,"Pemiscot County, MO",Oct-22,5787,5576,211,3.60000000
CN2915700000000,29,157,"Perry County, MO",Oct-22,9550,9365,185,1.90000000
CN2915900000000,29,159,"Pettis County, MO",Oct-22,20231,19756,475,2.30000000
CN2916100000000,29,161,"Phelps County, MO",Oct-22,20302,19844,458,2.30000000
CN2916300000000,29,163,"Pike County, MO",Oct-22,7267,7111,156,2.10000000
CN2916500000000,29,165,"Platte County, MO",Oct-22,59851,58567,1284,2.10000000
CN2916700000000,29,167,"Polk County, MO",Oct-22,14469,14125,344,2.40000000
CN2916900000000,29,169,"Pulaski County, MO",Oct-22,14631,14225,406,2.80000000
CN2917100000000,29,171,"Putnam County, MO",Oct-22,2079,2035,44,2.10000000
CN2917300000000,29,173,"Ralls County, MO",Oct-22,5366,5253,113,2.10000000
CN2917500000000,29,175,"Randolph County, MO",Oct-22,10264,10021,243,2.40000000
CN2917700000000,29,177,"Ray County, MO",Oct-22,10836,10474,362,3.30000000
CN2917900000000,29,179,"Reynolds County, MO",Oct-22,2842,2764,78,2.70000000
CN2918100000000,29,181,"Ripley County, MO",Oct-22,5170,5023,147,2.80000000
CN2918300000000,29,183,"St. Charles County, MO",Oct-22,230995,226547,4448,1.90000000
CN2918500000000,29,185,"St. Clair County, MO",Oct-22,3754,3648,106,2.80000000
CN2918600000000,29,186,"Ste. Genevieve County, MO",Oct-22,9405,9219,186,2.00000000
CN2918700000000,29,187,"St. Francois County, MO",Oct-22,25738,24945,793,3.10000000
CN2918900000000,29,189,"St. Louis County, MO",Oct-22,530761,518551,12210,2.30000000
CN2919500000000,29,195,"Saline County, MO",Oct-22,10203,9963,240,2.40000000
CN2919700000000,29,197,"Schuyler County, MO",Oct-22,1772,1730,42,2.40000000
CN2919900000000,29,199,"Scotland County, MO",Oct-22,2237,2191,46,2.10000000
CN2920100000000,29,201,"Scott County, MO",Oct-22,19965,19530,435,2.20000000
CN2920300000000,29,203,"Shannon County, MO",Oct-22,3257,3155,102,3.10000000
CN2920500000000,29,205,"Shelby County, MO",Oct-22,2886,2833,53,1.80000000
CN2920700000000,29,207,"Stoddard County, MO",Oct-22,13069,12710,359,2.70000000
CN2920900000000,29,209,"Stone County, MO",Oct-22,13549,13124,425,3.10000000
CN2921100000000,29,211,"Sullivan County, MO",Oct-22,2421,2360,61,2.50000000
CN2921300000000,29,213,"Taney County, MO",Oct-22,26081,25295,786,3.00000000
CN2921500000000,29,215,"Texas County, MO",Oct-22,9134,8878,256,2.80000000
CN2921700000000,29,217,"Vernon County, MO",Oct-22,8898,8682,216,2.40000000
CN2921900000000,29,219,"Warren County, MO",Oct-22,18823,18398,425,2.30000000
CN2922100000000,29,221,"Washington County, MO",Oct-22,10109,9812,297,2.90000000
CN2922300000000,29,223,"Wayne County, MO",Oct-22,4794,4642,152,3.20000000
CN2922500000000,29,225,"Webster County, MO",Oct-22,17345,16978,367,2.10000000
CN2922700000000,29,227,"Worth County, MO",Oct-22,1097,1079,18,1.60000000
CN2922900000000,29,229,"Wright County, MO",Oct-22,7516,7319,197,2.60000000
CN2951000000000,29,510,"St. Louis city, MO",Oct-22,150141,145623,4518,3.00000000
CN3000100000000,30,001,"Beaverhead County, MT",Oct-22,5253,5134,119,2.30000000
CN3000300000000,30,003,"Big Horn County, MT",Oct-22,4780,4542,238,5.00000000
CN3000500000000,30,005,"Blaine County, MT",Oct-22,2236,2170,66,3.00000000
CN3000700000000,30,007,"Broadwater County, MT",Oct-22,2761,2670,91,3.30000000
CN3000900000000,30,009,"Carbon County, MT",Oct-22,5865,5713,152,2.60000000
CN3001100000000,30,011,"Carter County, MT",Oct-22,713,697,16,2.20000000
CN3001300000000,30,013,"Cascade County, MT",Oct-22,38928,37891,1037,2.70000000
CN3001500000000,30,015,"Chouteau County, MT",Oct-22,2496,2430,66,2.60000000
CN3001700000000,30,017,"Custer County, MT",Oct-22,6499,6355,144,2.20000000
CN3001900000000,30,019,"Daniels County, MT",Oct-22,888,869,19,2.10000000
CN3002100000000,30,021,"Dawson County, MT",Oct-22,4656,4554,102,2.20000000
CN3002300000000,30,023,"Deer Lodge County, MT",Oct-22,5294,5169,125,2.40000000
CN3002500000000,30,025,"Fallon County, MT",Oct-22,1694,1667,27,1.60000000
CN3002700000000,30,027,"Fergus County, MT",Oct-22,5931,5795,136,2.30000000
CN3002900000000,30,029,"Flathead County, MT",Oct-22,51316,49825,1491,2.90000000
CN3003100000000,30,031,"Gallatin County, MT",Oct-22,78431,76778,1653,2.10000000
CN3003300000000,30,033,"Garfield County, MT",Oct-22,752,736,16,2.10000000
CN3003500000000,30,035,"Glacier County, MT",Oct-22,5942,5652,290,4.90000000
CN3003700000000,30,037,"Golden Valley County, MT",Oct-22,383,371,12,3.10000000
CN3003900000000,30,039,"Granite County, MT",Oct-22,1679,1624,55,3.30000000
CN3004100000000,30,041,"Hill County, MT",Oct-22,7580,7389,191,2.50000000
CN3004300000000,30,043,"Jefferson County, MT",Oct-22,6073,5919,154,2.50000000
CN3004500000000,30,045,"Judith Basin County, MT",Oct-22,1039,1013,26,2.50000000
CN3004700000000,30,047,"Lake County, MT",Oct-22,14278,13852,426,3.00000000
CN3004900000000,30,049,"Lewis and Clark County, MT",Oct-22,38368,37468,900,2.30000000
CN3005100000000,30,051,"Liberty County, MT",Oct-22,1008,982,26,2.60000000
CN3005300000000,30,053,"Lincoln County, MT",Oct-22,8542,8173,369,4.30000000
CN3005500000000,30,055,"McCone County, MT",Oct-22,991,972,19,1.90000000
CN3005700000000,30,057,"Madison County, MT",Oct-22,4786,4667,119,2.50000000
CN3005900000000,30,059,"Meagher County, MT",Oct-22,1000,979,21,2.10000000
CN3006100000000,30,061,"Mineral County, MT",Oct-22,1812,1727,85,4.70000000
CN3006300000000,30,063,"Missoula County, MT",Oct-22,67308,65606,1702,2.50000000
CN3006500000000,30,065,"Musselshell County, MT",Oct-22,2370,2305,65,2.70000000
CN3006700000000,30,067,"Park County, MT",Oct-22,10468,10197,271,2.60000000
CN3006900000000,30,069,"Petroleum County, MT",Oct-22,277,269,8,2.90000000
CN3007100000000,30,071,"Phillips County, MT",Oct-22,1881,1810,71,3.80000000
CN3007300000000,30,073,"Pondera County, MT",Oct-22,2632,2566,66,2.50000000
CN3007500000000,30,075,"Powder River County, MT",Oct-22,1037,1015,22,2.10000000
CN3007700000000,30,077,"Powell County, MT",Oct-22,2977,2900,77,2.60000000
CN3007900000000,30,079,"Prairie County, MT",Oct-22,497,483,14,2.80000000
CN3008100000000,30,081,"Ravalli County, MT",Oct-22,21837,21242,595,2.70000000
CN3008300000000,30,083,"Richland County, MT",Oct-22,5768,5606,162,2.80000000
CN3008500000000,30,085,"Roosevelt County, MT",Oct-22,4297,4160,137,3.20000000
CN3008700000000,30,087,"Rosebud County, MT",Oct-22,3597,3475,122,3.40000000
CN3008900000000,30,089,"Sanders County, MT",Oct-22,5421,5226,195,3.60000000
CN3009100000000,30,091,"Sheridan County, MT",Oct-22,1756,1724,32,1.80000000
CN3009300000000,30,093,"Silver Bow County, MT",Oct-22,17828,17331,497,2.80000000
CN3009500000000,30,095,"Stillwater County, MT",Oct-22,5538,5408,130,2.30000000
CN3009700000000,30,097,"Sweet Grass County, MT",Oct-22,1946,1908,38,2.00000000
CN3009900000000,30,099,"Teton County, MT",Oct-22,2816,2739,77,2.70000000
CN3010100000000,30,101,"Toole County, MT",Oct-22,2075,2028,47,2.30000000
CN3010300000000,30,103,"Treasure County, MT",Oct-22,368,360,8,2.20000000
CN3010500000000,30,105,"Valley County, MT",Oct-22,3969,3878,91,2.30000000
CN3010700000000,30,107,"Wheatland County, MT",Oct-22,756,731,25,3.30000000
CN3010900000000,30,109,"Wibaux County, MT",Oct-22,459,448,11,2.40000000
CN3011100000000,30,111,"Yellowstone County, MT",Oct-22,87608,85474,2134,2.40000000
CN3100100000000,31,001,"Adams County, NE",Oct-22,17114,16795,319,1.90000000
CN3100300000000,31,003,"Antelope County, NE",Oct-22,3605,3543,62,1.70000000
CN3100500000000,31,005,"Arthur County, NE",Oct-22,223,217,6,2.70000000
CN3100700000000,31,007,"Banner County, NE",Oct-22,388,375,13,3.40000000
CN3100900000000,31,009,"Blaine County, NE",Oct-22,245,236,9,3.70000000
CN3101100000000,31,011,"Boone County, NE",Oct-22,2925,2875,50,1.70000000
CN3101300000000,31,013,"Box Butte County, NE",Oct-22,5271,5161,110,2.10000000
CN3101500000000,31,015,"Boyd County, NE",Oct-22,1014,994,20,2.00000000
CN3101700000000,31,017,"Brown County, NE",Oct-22,1375,1346,29,2.10000000
CN3101900000000,31,019,"Buffalo County, NE",Oct-22,28359,27823,536,1.90000000
CN3102100000000,31,021,"Burt County, NE",Oct-22,3590,3515,75,2.10000000
CN3102300000000,31,023,"Butler County, NE",Oct-22,4606,4522,84,1.80000000
CN3102500000000,31,025,"Cass County, NE",Oct-22,13859,13540,319,2.30000000
CN3102700000000,31,027,"Cedar County, NE",Oct-22,4620,4534,86,1.90000000
CN3102900000000,31,029,"Chase County, NE",Oct-22,2241,2204,37,1.70000000
CN3103100000000,31,031,"Cherry County, NE",Oct-22,3342,3287,55,1.60000000
CN3103300000000,31,033,"Cheyenne County, NE",Oct-22,4192,4087,105,2.50000000
CN3103500000000,31,035,"Clay County, NE",Oct-22,3043,2988,55,1.80000000
CN3103700000000,31,037,"Colfax County, NE",Oct-22,5739,5627,112,2.00000000
CN3103900000000,31,039,"Cuming County, NE",Oct-22,4905,4819,86,1.80000000
CN3104100000000,31,041,"Custer County, NE",Oct-22,6283,6188,95,1.50000000
CN3104300000000,31,043,"Dakota County, NE",Oct-22,11004,10753,251,2.30000000
CN3104500000000,31,045,"Dawes County, NE",Oct-22,5161,5066,95,1.80000000
CN3104700000000,31,047,"Dawson County, NE",Oct-22,13493,13190,303,2.20000000
CN3104900000000,31,049,"Deuel County, NE",Oct-22,984,960,24,2.40000000
CN3105100000000,31,051,"Dixon County, NE",Oct-22,2997,2949,48,1.60000000
CN3105300000000,31,053,"Dodge County, NE",Oct-22,20657,20259,398,1.90000000
CN3105500000000,31,055,"Douglas County, NE",Oct-22,311156,303507,7649,2.50000000
CN3105700000000,31,057,"Dundy County, NE",Oct-22,1131,1113,18,1.60000000
CN3105900000000,31,059,"Fillmore County, NE",Oct-22,3294,3235,59,1.80000000
CN3106100000000,31,061,"Franklin County, NE",Oct-22,1489,1456,33,2.20000000
CN3106300000000,31,063,"Frontier County, NE",Oct-22,1491,1463,28,1.90000000
CN3106500000000,31,065,"Furnas County, NE",Oct-22,2532,2482,50,2.00000000
CN3106700000000,31,067,"Gage County, NE",Oct-22,11105,10874,231,2.10000000
CN3106900000000,31,069,"Garden County, NE",Oct-22,1043,1019,24,2.30000000
CN3107100000000,31,071,"Garfield County, NE",Oct-22,1105,1085,20,1.80000000
CN3107300000000,31,073,"Gosper County, NE",Oct-22,1159,1135,24,2.10000000
CN3107500000000,31,075,"Grant County, NE",Oct-22,414,407,7,1.70000000
CN3107700000000,31,077,"Greeley County, NE",Oct-22,1188,1166,22,1.90000000
CN3107900000000,31,079,"Hall County, NE",Oct-22,32110,31411,699,2.20000000
CN3108100000000,31,081,"Hamilton County, NE",Oct-22,4788,4693,95,2.00000000
CN3108300000000,31,083,"Harlan County, NE",Oct-22,1752,1719,33,1.90000000
CN3108500000000,31,085,"Hayes County, NE",Oct-22,608,599,9,1.50000000
CN3108700000000,31,087,"Hitchcock County, NE",Oct-22,1302,1274,28,2.20000000
CN3108900000000,31,089,"Holt County, NE",Oct-22,5564,5467,97,1.70000000
CN3109100000000,31,091,"Hooker County, NE",Oct-22,433,422,11,2.50000000
CN3109300000000,31,093,"Howard County, NE",Oct-22,3392,3331,61,1.80000000
CN3109500000000,31,095,"Jefferson County, NE",Oct-22,4134,4062,72,1.70000000
CN3109700000000,31,097,"Johnson County, NE",Oct-22,2017,1962,55,2.70000000
CN3109900000000,31,099,"Kearney County, NE",Oct-22,3766,3702,64,1.70000000
CN3110100000000,31,101,"Keith County, NE",Oct-22,4660,4577,83,1.80000000
CN3110300000000,31,103,"Keya Paha County, NE",Oct-22,569,558,11,1.90000000
CN3110500000000,31,105,"Kimball County, NE",Oct-22,1947,1907,40,2.10000000
CN3110700000000,31,107,"Knox County, NE",Oct-22,4591,4507,84,1.80000000
CN3110900000000,31,109,"Lancaster County, NE",Oct-22,183198,179510,3688,2.00000000
CN3111100000000,31,111,"Lincoln County, NE",Oct-22,18430,18046,384,2.10000000
CN3111300000000,31,113,"Logan County, NE",Oct-22,476,465,11,2.30000000
CN3111500000000,31,115,"Loup County, NE",Oct-22,407,396,11,2.70000000
CN3111700000000,31,117,"McPherson County, NE",Oct-22,427,420,7,1.60000000
CN3111900000000,31,119,"Madison County, NE",Oct-22,20023,19641,382,1.90000000
CN3112100000000,31,121,"Merrick County, NE",Oct-22,4080,4005,75,1.80000000
CN3112300000000,31,123,"Morrill County, NE",Oct-22,2620,2572,48,1.80000000
CN3112500000000,31,125,"Nance County, NE",Oct-22,1921,1884,37,1.90000000
CN3112700000000,31,127,"Nemaha County, NE",Oct-22,3685,3604,81,2.20000000
CN3112900000000,31,129,"Nuckolls County, NE",Oct-22,2460,2409,51,2.10000000
CN3113100000000,31,131,"Otoe County, NE",Oct-22,8584,8411,173,2.00000000
CN3113300000000,31,133,"Pawnee County, NE",Oct-22,1499,1468,31,2.10000000
CN3113500000000,31,135,"Perkins County, NE",Oct-22,1849,1821,28,1.50000000
CN3113700000000,31,137,"Phelps County, NE",Oct-22,4896,4806,90,1.80000000
CN3113900000000,31,139,"Pierce County, NE",Oct-22,4155,4089,66,1.60000000
CN3114100000000,31,141,"Platte County, NE",Oct-22,18422,18077,345,1.90000000
CN3114300000000,31,143,"Polk County, NE",Oct-22,2893,2832,61,2.10000000
CN3114500000000,31,145,"Red Willow County, NE",Oct-22,5945,5835,110,1.90000000
CN3114700000000,31,147,"Richardson County, NE",Oct-22,4149,4074,75,1.80000000
CN3114900000000,31,149,"Rock County, NE",Oct-22,884,871,13,1.50000000
CN3115100000000,31,151,"Saline County, NE",Oct-22,7190,7039,151,2.10000000
CN3115300000000,31,153,"Sarpy County, NE",Oct-22,101423,99350,2073,2.00000000
CN3115500000000,31,155,"Saunders County, NE",Oct-22,11669,11436,233,2.00000000
CN3115700000000,31,157,"Scotts Bluff County, NE",Oct-22,18096,17665,431,2.40000000
CN3115900000000,31,159,"Seward County, NE",Oct-22,8955,8775,180,2.00000000
CN3116100000000,31,161,"Sheridan County, NE",Oct-22,2734,2684,50,1.80000000
CN3116300000000,31,163,"Sherman County, NE",Oct-22,1643,1614,29,1.80000000
CN3116500000000,31,165,"Sioux County, NE",Oct-22,749,736,13,1.70000000
CN3116700000000,31,167,"Stanton County, NE",Oct-22,3560,3498,62,1.70000000
CN3116900000000,31,169,"Thayer County, NE",Oct-22,2692,2644,48,1.80000000
CN3117100000000,31,171,"Thomas County, NE",Oct-22,408,399,9,2.20000000
CN3117300000000,31,173,"Thurston County, NE",Oct-22,3223,3126,97,3.00000000
CN3117500000000,31,175,"Valley County, NE",Oct-22,2081,2037,44,2.10000000
CN3117700000000,31,177,"Washington County, NE",Oct-22,11631,11413,218,1.90000000
CN3117900000000,31,179,"Wayne County, NE",Oct-22,5822,5725,97,1.70000000
CN3118100000000,31,181,"Webster County, NE",Oct-22,1669,1625,44,2.60000000
CN3118300000000,31,183,"Wheeler County, NE",Oct-22,552,545,7,1.30000000
CN3118500000000,31,185,"York County, NE",Oct-22,7445,7296,149,2.00000000
CN3200100000000,32,001,"Churchill County, NV",Oct-22,10999,10559,440,4.00000000
CN3200300000000,32,003,"Clark County, NV",Oct-22,1150753,1085770,64983,5.60000000
CN3200500000000,32,005,"Douglas County, NV",Oct-22,21769,20839,930,4.30000000
CN3200700000000,32,007,"Elko County, NV",Oct-22,25662,24791,871,3.40000000
CN3200900000000,32,009,"Esmeralda County, NV",Oct-22,408,390,18,4.40000000
CN3201100000000,32,011,"Eureka County, NV",Oct-22,944,912,32,3.40000000
CN3201300000000,32,013,"Humboldt County, NV",Oct-22,7908,7628,280,3.50000000
CN3201500000000,32,015,"Lander County, NV",Oct-22,3009,2920,89,3.00000000
CN3201700000000,32,017,"Lincoln County, NV",Oct-22,2124,2029,95,4.50000000
CN3201900000000,32,019,"Lyon County, NV",Oct-22,23957,22745,1212,5.10000000
CN3202100000000,32,021,"Mineral County, NV",Oct-22,2061,1980,81,3.90000000
CN3202300000000,32,023,"Nye County, NV",Oct-22,17569,16498,1071,6.10000000
CN3202700000000,32,027,"Pershing County, NV",Oct-22,2424,2337,87,3.60000000
CN3202900000000,32,029,"Storey County, NV",Oct-22,2117,2028,89,4.20000000
CN3203100000000,32,031,"Washoe County, NV",Oct-22,258467,249341,9126,3.50000000
CN3203300000000,32,033,"White Pine County, NV",Oct-22,4549,4407,142,3.10000000
CN3251000000000,32,510,"Carson City, NV",Oct-22,25782,24790,992,3.80000000
CN3300100000000,33,001,"Belknap County, NH",Oct-22,30699,29875,824,2.70000000
CN3300300000000,33,003,"Carroll County, NH",Oct-22,23459,22811,648,2.80000000
CN3300500000000,33,005,"Cheshire County, NH",Oct-22,39181,38096,1085,2.80000000
CN3300700000000,33,007,"Coos County, NH",Oct-22,14192,13738,454,3.20000000
CN3300900000000,33,009,"Grafton County, NH",Oct-22,48659,47441,1218,2.50000000
CN3301100000000,33,011,"Hillsborough County, NH",Oct-22,245813,239358,6455,2.60000000
CN3301300000000,33,013,"Merrimack County, NH",Oct-22,82691,80705,1986,2.40000000
CN3301500000000,33,015,"Rockingham County, NH",Oct-22,190311,185190,5121,2.70000000
CN3301700000000,33,017,"Strafford County, NH",Oct-22,73983,72159,1824,2.50000000
CN3301900000000,33,019,"Sullivan County, NH",Oct-22,22578,21997,581,2.60000000
CN3400100000000,34,001,"Atlantic County, NJ",Oct-22,130028,124896,5132,3.90000000
CN3400300000000,34,003,"Bergen County, NJ",Oct-22,503013,489653,13360,2.70000000
CN3400500000000,34,005,"Burlington County, NJ",Oct-22,252629,246237,6392,2.50000000
CN3400700000000,34,007,"Camden County, NJ",Oct-22,275294,266415,8879,3.20000000
CN3400900000000,34,009,"Cape May County, NJ",Oct-22,46294,44228,2066,4.50000000
CN3401100000000,34,011,"Cumberland County, NJ",Oct-22,70076,67322,2754,3.90000000
CN3401300000000,34,013,"Essex County, NJ",Oct-22,388359,373565,14794,3.80000000
CN3401500000000,34,015,"Gloucester County, NJ",Oct-22,164070,159402,4668,2.80000000
CN3401700000000,34,017,"Hudson County, NJ",Oct-22,375881,364453,11428,3.00000000
CN3401900000000,34,019,"Hunterdon County, NJ",Oct-22,68625,67201,1424,2.10000000
CN3402100000000,34,021,"Mercer County, NJ",Oct-22,215761,210439,5322,2.50000000
CN3402300000000,34,023,"Middlesex County, NJ",Oct-22,461020,448991,12029,2.60000000
CN3402500000000,34,025,"Monmouth County, NJ",Oct-22,348647,340082,8565,2.50000000
CN3402700000000,34,027,"Morris County, NJ",Oct-22,268924,262858,6066,2.30000000
CN3402900000000,34,029,"Ocean County, NJ",Oct-22,298635,290236,8399,2.80000000
CN3403100000000,34,031,"Passaic County, NJ",Oct-22,251444,241977,9467,3.80000000
CN3403300000000,34,033,"Salem County, NJ",Oct-22,30722,29594,1128,3.70000000
CN3403500000000,34,035,"Somerset County, NJ",Oct-22,179167,175024,4143,2.30000000
CN3403700000000,34,037,"Sussex County, NJ",Oct-22,77934,75797,2137,2.70000000
CN3403900000000,34,039,"Union County, NJ",Oct-22,288914,279861,9053,3.10000000
CN3404100000000,34,041,"Warren County, NJ",Oct-22,60589,59133,1456,2.40000000
CN3500100000000,35,001,"Bernalillo County, NM",Oct-22,333558,321497,12061,3.60000000
CN3500300000000,35,003,"Catron County, NM",Oct-22,1140,1082,58,5.10000000
CN3500500000000,35,005,"Chaves County, NM",Oct-22,27657,26501,1156,4.20000000
CN3500600000000,35,006,"Cibola County, NM",Oct-22,8346,7884,462,5.50000000
CN3500700000000,35,007,"Colfax County, NM",Oct-22,4452,4251,201,4.50000000
CN3500900000000,35,009,"Curry County, NM",Oct-22,21999,21330,669,3.00000000
CN3501100000000,35,011,"De Baca County, NM",Oct-22,692,671,21,3.00000000
CN3501300000000,35,013,"Dona Ana County, NM",Oct-22,99522,95323,4199,4.20000000
CN3501500000000,35,015,"Eddy County, NM",Oct-22,31523,30500,1023,3.20000000
CN3501700000000,35,017,"Grant County, NM",Oct-22,11452,10963,489,4.30000000
CN3501900000000,35,019,"Guadalupe County, NM",Oct-22,1797,1717,80,4.50000000
CN3502100000000,35,021,"Harding County, NM",Oct-22,285,277,8,2.80000000
CN3502300000000,35,023,"Hidalgo County, NM",Oct-22,1827,1769,58,3.20000000
CN3502500000000,35,025,"Lea County, NM",Oct-22,28048,26736,1312,4.70000000
CN3502700000000,35,027,"Lincoln County, NM",Oct-22,8842,8481,361,4.10000000
CN3502800000000,35,028,"Los Alamos County, NM",Oct-22,10259,10048,211,2.10000000
CN3502900000000,35,029,"Luna County, NM",Oct-22,9774,8827,947,9.70000000
CN3503100000000,35,031,"McKinley County, NM",Oct-22,23249,21960,1289,5.50000000
CN3503300000000,35,033,"Mora County, NM",Oct-22,1953,1849,104,5.30000000
CN3503500000000,35,035,"Otero County, NM",Oct-22,25649,24597,1052,4.10000000
CN3503700000000,35,037,"Quay County, NM",Oct-22,2869,2747,122,4.30000000
CN3503900000000,35,039,"Rio Arriba County, NM",Oct-22,16318,15617,701,4.30000000
CN3504100000000,35,041,"Roosevelt County, NM",Oct-22,8102,7813,289,3.60000000
CN3504300000000,35,043,"Sandoval County, NM",Oct-22,67608,65002,2606,3.90000000
CN3504500000000,35,045,"San Juan County, NM",Oct-22,48808,46502,2306,4.70000000
CN3504700000000,35,047,"San Miguel County, NM",Oct-22,10559,10035,524,5.00000000
CN3504900000000,35,049,"Santa Fe County, NM",Oct-22,72143,69607,2536,3.50000000
CN3505100000000,35,051,"Sierra County, NM",Oct-22,4097,3871,226,5.50000000
CN3505300000000,35,053,"Socorro County, NM",Oct-22,6138,5886,252,4.10000000
CN3505500000000,35,055,"Taos County, NM",Oct-22,14903,14150,753,5.10000000
CN3505700000000,35,057,"Torrance County, NM",Oct-22,5775,5475,300,5.20000000
CN3505900000000,35,059,"Union County, NM",Oct-22,1582,1541,41,2.60000000
CN3506100000000,35,061,"Valencia County, NM",Oct-22,30794,29439,1355,4.40000000
CN3600100000000,36,001,"Albany County, NY",Oct-22,160402,156792,3610,2.30000000
CN3600300000000,36,003,"Allegany County, NY",Oct-22,19684,19155,529,2.70000000
CN3600500000000,36,005,"Bronx County, NY",Oct-22,586842,543500,43342,7.40000000
CN3600700000000,36,007,"Broome County, NY",Oct-22,83933,81685,2248,2.70000000
CN3600900000000,36,009,"Cattaraugus County, NY",Oct-22,32718,31786,932,2.80000000
CN3601100000000,36,011,"Cayuga County, NY",Oct-22,35329,34504,825,2.30000000
CN3601300000000,36,013,"Chautauqua County, NY",Oct-22,52301,50796,1505,2.90000000
CN3601500000000,36,015,"Chemung County, NY",Oct-22,34871,33917,954,2.70000000
CN3601700000000,36,017,"Chenango County, NY",Oct-22,21795,21322,473,2.20000000
CN3601900000000,36,019,"Clinton County, NY",Oct-22,34954,34141,813,2.30000000
CN3602100000000,36,021,"Columbia County, NY",Oct-22,30405,29824,581,1.90000000
CN3602300000000,36,023,"Cortland County, NY",Oct-22,22775,22196,579,2.50000000
CN3602500000000,36,025,"Delaware County, NY",Oct-22,18870,18401,469,2.50000000
CN3602700000000,36,027,"Dutchess County, NY",Oct-22,145846,142592,3254,2.20000000
CN3602900000000,36,029,"Erie County, NY",Oct-22,447169,435125,12044,2.70000000
CN3603100000000,36,031,"Essex County, NY",Oct-22,16345,15970,375,2.30000000
CN3603300000000,36,033,"Franklin County, NY",Oct-22,18691,18218,473,2.50000000
CN3603500000000,36,035,"Fulton County, NY",Oct-22,22644,21994,650,2.90000000
CN3603700000000,36,037,"Genesee County, NY",Oct-22,29749,29130,619,2.10000000
CN3603900000000,36,039,"Greene County, NY",Oct-22,20355,19857,498,2.40000000
CN3604100000000,36,041,"Hamilton County, NY",Oct-22,2213,2160,53,2.40000000
CN3604300000000,36,043,"Herkimer County, NY",Oct-22,27653,26909,744,2.70000000
CN3604500000000,36,045,"Jefferson County, NY",Oct-22,44331,43150,1181,2.70000000
CN3604700000000,36,047,"Kings County, NY",Oct-22,1176379,1111473,64906,5.50000000
CN3604900000000,36,049,"Lewis County, NY",Oct-22,11605,11338,267,2.30000000
CN3605100000000,36,051,"Livingston County, NY",Oct-22,30291,29616,675,2.20000000
CN3605300000000,36,053,"Madison County, NY",Oct-22,32985,32241,744,2.30000000
CN3605500000000,36,055,"Monroe County, NY",Oct-22,367276,357762,9514,2.60000000
CN3605700000000,36,057,"Montgomery County, NY",Oct-22,22177,21502,675,3.00000000
CN3605900000000,36,059,"Nassau County, NY",Oct-22,734546,718918,15628,2.10000000
CN3606100000000,36,061,"New York County, NY",Oct-22,894198,856700,37498,4.20000000
CN3606300000000,36,063,"Niagara County, NY",Oct-22,98442,95739,2703,2.70000000
CN3606500000000,36,065,"Oneida County, NY",Oct-22,101627,99035,2592,2.60000000
CN3606700000000,36,067,"Onondaga County, NY",Oct-22,226247,220806,5441,2.40000000
CN3606900000000,36,069,"Ontario County, NY",Oct-22,56063,54868,1195,2.10000000
CN3607100000000,36,071,"Orange County, NY",Oct-22,190656,186147,4509,2.40000000
CN3607300000000,36,073,"Orleans County, NY",Oct-22,17074,16644,430,2.50000000
CN3607500000000,36,075,"Oswego County, NY",Oct-22,53153,51644,1509,2.80000000
CN3607700000000,36,077,"Otsego County, NY",Oct-22,27878,27257,621,2.20000000
CN3607900000000,36,079,"Putnam County, NY",Oct-22,51839,50724,1115,2.20000000
CN3608100000000,36,081,"Queens County, NY",Oct-22,1109964,1056221,53743,4.80000000
CN3608300000000,36,083,"Rensselaer County, NY",Oct-22,82667,80840,1827,2.20000000
CN3608500000000,36,085,"Richmond County, NY",Oct-22,220498,209538,10960,5.00000000
CN3608700000000,36,087,"Rockland County, NY",Oct-22,159979,156585,3394,2.10000000
CN3608900000000,36,089,"St. Lawrence County, NY",Oct-22,43000,41782,1218,2.80000000
CN3609100000000,36,091,"Saratoga County, NY",Oct-22,122395,120091,2304,1.90000000
CN3609300000000,36,093,"Schenectady County, NY",Oct-22,78391,76433,1958,2.50000000
CN3609500000000,36,095,"Schoharie County, NY",Oct-22,14721,14384,337,2.30000000
CN3609700000000,36,097,"Schuyler County, NY",Oct-22,8115,7928,187,2.30000000
CN3609900000000,36,099,"Seneca County, NY",Oct-22,15327,14997,330,2.20000000
CN3610100000000,36,101,"Steuben County, NY",Oct-22,41131,40098,1033,2.50000000
CN3610300000000,36,103,"Suffolk County, NY",Oct-22,804946,786849,18097,2.20000000
CN3610500000000,36,105,"Sullivan County, NY",Oct-22,37641,36753,888,2.40000000
CN3610700000000,36,107,"Tioga County, NY",Oct-22,22679,22191,488,2.20000000
CN3610900000000,36,109,"Tompkins County, NY",Oct-22,50239,49189,1050,2.10000000
CN3611100000000,36,111,"Ulster County, NY",Oct-22,89259,87295,1964,2.20000000
CN3611300000000,36,113,"Warren County, NY",Oct-22,31222,30525,697,2.20000000
CN3611500000000,36,115,"Washington County, NY",Oct-22,27419,26809,610,2.20000000
CN3611700000000,36,117,"Wayne County, NY",Oct-22,43447,42491,956,2.20000000
CN3611900000000,36,119,"Westchester County, NY",Oct-22,498074,486551,11523,2.30000000
CN3612100000000,36,121,"Wyoming County, NY",Oct-22,17994,17624,370,2.10000000
CN3612300000000,36,123,"Yates County, NY",Oct-22,11594,11355,239,2.10000000
CN3700100000000,37,001,"Alamance County, NC",Oct-22,83422,80169,3253,3.90000000
CN3700300000000,37,003,"Alexander County, NC",Oct-22,17807,17181,626,3.50000000
CN3700500000000,37,005,"Alleghany County, NC",Oct-22,4453,4275,178,4.00000000
CN3700700000000,37,007,"Anson County, NC",Oct-22,10327,9821,506,4.90000000
CN3700900000000,37,009,"Ashe County, NC",Oct-22,13322,12852,470,3.50000000
CN3701100000000,37,011,"Avery County, NC",Oct-22,7859,7593,266,3.40000000
CN3701300000000,37,013,"Beaufort County, NC",Oct-22,20002,19165,837,4.20000000
CN3701500000000,37,015,"Bertie County, NC",Oct-22,7418,7045,373,5.00000000
CN3701700000000,37,017,"Bladen County, NC",Oct-22,13994,13299,695,5.00000000
CN3701900000000,37,019,"Brunswick County, NC",Oct-22,56201,53318,2883,5.10000000
CN3702100000000,37,021,"Buncombe County, NC",Oct-22,141342,136832,4510,3.20000000
CN3702300000000,37,023,"Burke County, NC",Oct-22,40388,38853,1535,3.80000000
CN3702500000000,37,025,"Cabarrus County, NC",Oct-22,115969,111756,4213,3.60000000
CN3702700000000,37,027,"Caldwell County, NC",Oct-22,35946,34543,1403,3.90000000
CN3702900000000,37,029,"Camden County, NC",Oct-22,4654,4476,178,3.80000000
CN3703100000000,37,031,"Carteret County, NC",Oct-22,31874,30701,1173,3.70000000
CN3703300000000,37,033,"Caswell County, NC",Oct-22,9831,9418,413,4.20000000
CN3703500000000,37,035,"Catawba County, NC",Oct-22,78382,75429,2953,3.80000000
CN3703700000000,37,037,"Chatham County, NC",Oct-22,38231,36960,1271,3.30000000
CN3703900000000,37,039,"Cherokee County, NC",Oct-22,10861,10386,475,4.40000000
CN3704100000000,37,041,"Chowan County, NC",Oct-22,5764,5513,251,4.40000000
CN3704300000000,37,043,"Clay County, NC",Oct-22,4064,3880,184,4.50000000
CN3704500000000,37,045,"Cleveland County, NC",Oct-22,48815,46755,2060,4.20000000
CN3704700000000,37,047,"Columbus County, NC",Oct-22,23202,22110,1092,4.70000000
CN3704900000000,37,049,"Craven County, NC",Oct-22,41150,39472,1678,4.10000000
CN3705100000000,37,051,"Cumberland County, NC",Oct-22,128538,121235,7303,5.70000000
CN3705300000000,37,053,"Currituck County, NC",Oct-22,14521,14020,501,3.50000000
CN3705500000000,37,055,"Dare County, NC",Oct-22,20334,19572,762,3.70000000
CN3705700000000,37,057,"Davidson County, NC",Oct-22,81401,78342,3059,3.80000000
CN3705900000000,37,059,"Davie County, NC",Oct-22,20773,20013,760,3.70000000
CN3706100000000,37,061,"Duplin County, NC",Oct-22,24665,23712,953,3.90000000
CN3706300000000,37,063,"Durham County, NC",Oct-22,182243,176153,6090,3.30000000
CN3706500000000,37,065,"Edgecombe County, NC",Oct-22,20111,18601,1510,7.50000000
CN3706700000000,37,067,"Forsyth County, NC",Oct-22,188404,180943,7461,4.00000000
CN3706900000000,37,069,"Franklin County, NC",Oct-22,33848,32543,1305,3.90000000
CN3707100000000,37,071,"Gaston County, NC",Oct-22,114617,110036,4581,4.00000000
CN3707300000000,37,073,"Gates County, NC",Oct-22,5102,4900,202,4.00000000
CN3707500000000,37,075,"Graham County, NC",Oct-22,3049,2888,161,5.30000000
CN3707700000000,37,077,"Granville County, NC",Oct-22,30492,29465,1027,3.40000000
CN3707900000000,37,079,"Greene County, NC",Oct-22,9572,9247,325,3.40000000
CN3708100000000,37,081,"Guilford County, NC",Oct-22,262534,251018,11516,4.40000000
CN3708300000000,37,083,"Halifax County, NC",Oct-22,19029,17821,1208,6.30000000
CN3708500000000,37,085,"Harnett County, NC",Oct-22,55299,52862,2437,4.40000000
CN3708700000000,37,087,"Haywood County, NC",Oct-22,30060,29031,1029,3.40000000
CN3708900000000,37,089,"Henderson County, NC",Oct-22,55345,53443,1902,3.40000000
CN3709100000000,37,091,"Hertford County, NC",Oct-22,8601,8123,478,5.60000000
CN3709300000000,37,093,"Hoke County, NC",Oct-22,20450,19325,1125,5.50000000
CN3709500000000,37,095,"Hyde County, NC",Oct-22,1836,1750,86,4.70000000
CN3709700000000,37,097,"Iredell County, NC",Oct-22,94587,91121,3466,3.70000000
CN3709900000000,37,099,"Jackson County, NC",Oct-22,20276,19506,770,3.80000000
CN3710100000000,37,101,"Johnston County, NC",Oct-22,107682,103886,3796,3.50000000
CN3710300000000,37,103,"Jones County, NC",Oct-22,4258,4099,159,3.70000000
CN3710500000000,37,105,"Lee County, NC",Oct-22,26473,25263,1210,4.60000000
CN3710700000000,37,107,"Lenoir County, NC",Oct-22,27177,26108,1069,3.90000000
CN3710900000000,37,109,"Lincoln County, NC",Oct-22,46371,44816,1555,3.40000000
CN3711100000000,37,111,"McDowell County, NC",Oct-22,19577,18815,762,3.90000000
CN3711300000000,37,113,"Macon County, NC",Oct-22,15873,15279,594,3.70000000
CN3711500000000,37,115,"Madison County, NC",Oct-22,10036,9673,363,3.60000000
CN3711700000000,37,117,"Martin County, NC",Oct-22,8696,8281,415,4.80000000
CN3711900000000,37,119,"Mecklenburg County, NC",Oct-22,651642,626977,24665,3.80000000
CN3712100000000,37,121,"Mitchell County, NC",Oct-22,6006,5732,274,4.60000000
CN3712300000000,37,123,"Montgomery County, NC",Oct-22,11435,10997,438,3.80000000
CN3712500000000,37,125,"Moore County, NC",Oct-22,41300,39657,1643,4.00000000
CN3712700000000,37,127,"Nash County, NC",Oct-22,41795,39473,2322,5.60000000
CN3712900000000,37,129,"New Hanover County, NC",Oct-22,127999,123506,4493,3.50000000
CN3713100000000,37,131,"Northampton County, NC",Oct-22,7152,6787,365,5.10000000
CN3713300000000,37,133,"Onslow County, NC",Oct-22,67180,64070,3110,4.60000000
CN3713500000000,37,135,"Orange County, NC",Oct-22,82975,80391,2584,3.10000000
CN3713700000000,37,137,"Pamlico County, NC",Oct-22,5387,5176,211,3.90000000
CN3713900000000,37,139,"Pasquotank County, NC",Oct-22,16599,15829,770,4.60000000
CN3714100000000,37,141,"Pender County, NC",Oct-22,30493,29341,1152,3.80000000
CN3714300000000,37,143,"Perquimans County, NC",Oct-22,4961,4735,226,4.60000000
CN3714500000000,37,145,"Person County, NC",Oct-22,19202,18429,773,4.00000000
CN3714700000000,37,147,"Pitt County, NC",Oct-22,89089,85348,3741,4.20000000
CN3714900000000,37,149,"Polk County, NC",Oct-22,9508,9123,385,4.00000000
CN3715100000000,37,151,"Randolph County, NC",Oct-22,66002,63413,2589,3.90000000
CN3715300000000,37,153,"Richmond County, NC",Oct-22,16401,15425,976,6.00000000
CN3715500000000,37,155,"Robeson County, NC",Oct-22,47982,44969,3013,6.30000000
CN3715700000000,37,157,"Rockingham County, NC",Oct-22,39903,38104,1799,4.50000000
CN3715900000000,37,159,"Rowan County, NC",Oct-22,67717,65109,2608,3.90000000
CN3716100000000,37,161,"Rutherford County, NC",Oct-22,24308,22993,1315,5.40000000
CN3716300000000,37,163,"Sampson County, NC",Oct-22,28650,27553,1097,3.80000000
CN3716500000000,37,165,"Scotland County, NC",Oct-22,11179,10357,822,7.40000000
CN3716700000000,37,167,"Stanly County, NC",Oct-22,30508,29406,1102,3.60000000
CN3716900000000,37,169,"Stokes County, NC",Oct-22,21662,20882,780,3.60000000
CN3717100000000,37,171,"Surry County, NC",Oct-22,31831,30631,1200,3.80000000
CN3717300000000,37,173,"Swain County, NC",Oct-22,7356,7117,239,3.20000000
CN3717500000000,37,175,"Transylvania County, NC",Oct-22,14920,14361,559,3.70000000
CN3717700000000,37,177,"Tyrrell County, NC",Oct-22,1354,1281,73,5.40000000
CN3717900000000,37,179,"Union County, NC",Oct-22,130232,125915,4317,3.30000000
CN3718100000000,37,181,"Vance County, NC",Oct-22,16632,15523,1109,6.70000000
CN3718300000000,37,183,"Wake County, NC",Oct-22,627838,607315,20523,3.30000000
CN3718500000000,37,185,"Warren County, NC",Oct-22,6558,6100,458,7.00000000
CN3718700000000,37,187,"Washington County, NC",Oct-22,4356,4107,249,5.70000000
CN3718900000000,37,189,"Watauga County, NC",Oct-22,29340,28346,994,3.40000000
CN3719100000000,37,191,"Wayne County, NC",Oct-22,51443,49287,2156,4.20000000
CN3719300000000,37,193,"Wilkes County, NC",Oct-22,26799,25695,1104,4.10000000
CN3719500000000,37,195,"Wilson County, NC",Oct-22,32846,30964,1882,5.70000000
CN3719700000000,37,197,"Yadkin County, NC",Oct-22,17652,17026,626,3.50000000
CN3719900000000,37,199,"Yancey County, NC",Oct-22,8380,8065,315,3.80000000
CN3800100000000,38,001,"Adams County, ND",Oct-22,917,902,15,1.60000000
CN3800300000000,38,003,"Barnes County, ND",Oct-22,5349,5266,83,1.60000000
CN3800500000000,38,005,"Benson County, ND",Oct-22,2404,2345,59,2.50000000
CN3800700000000,38,007,"Billings County, ND",Oct-22,420,414,6,1.40000000
CN3800900000000,38,009,"Bottineau County, ND",Oct-22,3018,2951,67,2.20000000
CN3801100000000,38,011,"Bowman County, ND",Oct-22,1539,1519,20,1.30000000
CN3801300000000,38,013,"Burke County, ND",Oct-22,1058,1041,17,1.60000000
CN3801500000000,38,015,"Burleigh County, ND",Oct-22,51233,50475,758,1.50000000
CN3801700000000,38,017,"Cass County, ND",Oct-22,107371,105877,1494,1.40000000
CN3801900000000,38,019,"Cavalier County, ND",Oct-22,1879,1847,32,1.70000000
CN3802100000000,38,021,"Dickey County, ND",Oct-22,2204,2174,30,1.40000000
CN3802300000000,38,023,"Divide County, ND",Oct-22,1391,1379,12,0.90000000
CN3802500000000,38,025,"Dunn County, ND",Oct-22,3403,3373,30,0.90000000
CN3802700000000,38,027,"Eddy County, ND",Oct-22,1196,1170,26,2.20000000
CN3802900000000,38,029,"Emmons County, ND",Oct-22,1454,1404,50,3.40000000
CN3803100000000,38,031,"Foster County, ND",Oct-22,1475,1455,20,1.40000000
CN3803300000000,38,033,"Golden Valley County, ND",Oct-22,860,845,15,1.70000000
CN3803500000000,38,035,"Grand Forks County, ND",Oct-22,37048,36505,543,1.50000000
CN3803700000000,38,037,"Grant County, ND",Oct-22,1242,1227,15,1.20000000
CN3803900000000,38,039,"Griggs County, ND",Oct-22,1041,1026,15,1.40000000
CN3804100000000,38,041,"Hettinger County, ND",Oct-22,1461,1446,15,1.00000000
CN3804300000000,38,043,"Kidder County, ND",Oct-22,1341,1306,35,2.60000000
CN3804500000000,38,045,"LaMoure County, ND",Oct-22,2132,2108,24,1.10000000
CN3804700000000,38,047,"Logan County, ND",Oct-22,879,862,17,1.90000000
CN3804900000000,38,049,"McHenry County, ND",Oct-22,3146,3076,70,2.20000000
CN3805100000000,38,051,"McIntosh County, ND",Oct-22,1049,1032,17,1.60000000
CN3805300000000,38,053,"McKenzie County, ND",Oct-22,9461,9295,166,1.80000000
CN3805500000000,38,055,"McLean County, ND",Oct-22,4732,4626,106,2.20000000
CN3805700000000,38,057,"Mercer County, ND",Oct-22,3565,3479,86,2.40000000
CN3805900000000,38,059,"Morton County, ND",Oct-22,16872,16568,304,1.80000000
CN3806100000000,38,061,"Mountrail County, ND",Oct-22,6318,6232,86,1.40000000
CN3806300000000,38,063,"Nelson County, ND",Oct-22,1485,1453,32,2.20000000
CN3806500000000,38,065,"Oliver County, ND",Oct-22,886,866,20,2.30000000
CN3806700000000,38,067,"Pembina County, ND",Oct-22,3218,3135,83,2.60000000
CN3806900000000,38,069,"Pierce County, ND",Oct-22,1676,1643,33,2.00000000
CN3807100000000,38,071,"Ramsey County, ND",Oct-22,5535,5434,101,1.80000000
CN3807300000000,38,073,"Ransom County, ND",Oct-22,2667,2632,35,1.30000000
CN3807500000000,38,075,"Renville County, ND",Oct-22,1239,1222,17,1.40000000
CN3807700000000,38,077,"Richland County, ND",Oct-22,8742,8621,121,1.40000000
CN3807900000000,38,079,"Rolette County, ND",Oct-22,4667,4410,257,5.50000000
CN3808100000000,38,081,"Sargent County, ND",Oct-22,2308,2281,27,1.20000000
CN3808300000000,38,083,"Sheridan County, ND",Oct-22,672,660,12,1.80000000
CN3808500000000,38,085,"Sioux County, ND",Oct-22,1230,1201,29,2.40000000
CN3808700000000,38,087,"Slope County, ND",Oct-22,357,349,8,2.20000000
CN3808900000000,38,089,"Stark County, ND",Oct-22,17850,17552,298,1.70000000
CN3809100000000,38,091,"Steele County, ND",Oct-22,969,955,14,1.40000000
CN3809300000000,38,093,"Stutsman County, ND",Oct-22,10380,10217,163,1.60000000
CN3809500000000,38,095,"Towner County, ND",Oct-22,1156,1138,18,1.60000000
CN3809700000000,38,097,"Traill County, ND",Oct-22,4457,4395,62,1.40000000
CN3809900000000,38,099,"Walsh County, ND",Oct-22,5235,5119,116,2.20000000
CN3810100000000,38,101,"Ward County, ND",Oct-22,31529,30968,561,1.80000000
CN3810300000000,38,103,"Wells County, ND",Oct-22,1899,1858,41,2.20000000
CN3810500000000,38,105,"Williams County, ND",Oct-22,21779,21256,523,2.40000000
CN3900100000000,39,001,"Adams County, OH",Oct-22,10828,10288,540,5.00000000
CN3900300000000,39,003,"Allen County, OH",Oct-22,46553,44481,2072,4.50000000
CN3900500000000,39,005,"Ashland County, OH",Oct-22,26513,25542,971,3.70000000
CN3900700000000,39,007,"Ashtabula County, OH",Oct-22,43009,41201,1808,4.20000000
CN3900900000000,39,009,"Athens County, OH",Oct-22,27020,25746,1274,4.70000000
CN3901100000000,39,011,"Auglaize County, OH",Oct-22,23963,23157,806,3.40000000
CN3901300000000,39,013,"Belmont County, OH",Oct-22,27857,26520,1337,4.80000000
CN3901500000000,39,015,"Brown County, OH",Oct-22,19177,18333,844,4.40000000
CN3901700000000,39,017,"Butler County, OH",Oct-22,193605,186459,7146,3.70000000
CN3901900000000,39,019,"Carroll County, OH",Oct-22,12582,12030,552,4.40000000
CN3902100000000,39,021,"Champaign County, OH",Oct-22,19129,18435,694,3.60000000
CN3902300000000,39,023,"Clark County, OH",Oct-22,61737,59234,2503,4.10000000
CN3902500000000,39,025,"Clermont County, OH",Oct-22,106184,102356,3828,3.60000000
CN3902700000000,39,027,"Clinton County, OH",Oct-22,17918,17133,785,4.40000000
CN3902900000000,39,029,"Columbiana County, OH",Oct-22,44605,42607,1998,4.50000000
CN3903100000000,39,031,"Coshocton County, OH",Oct-22,13764,13117,647,4.70000000
CN3903300000000,39,033,"Crawford County, OH",Oct-22,17716,16861,855,4.80000000
CN3903500000000,39,035,"Cuyahoga County, OH",Oct-22,605781,574323,31458,5.20000000
CN3903700000000,39,037,"Darke County, OH",Oct-22,25678,24794,884,3.40000000
CN3903900000000,39,039,"Defiance County, OH",Oct-22,17437,16729,708,4.10000000
CN3904100000000,39,041,"Delaware County, OH",Oct-22,115473,111852,3621,3.10000000
CN3904300000000,39,043,"Erie County, OH",Oct-22,37555,35971,1584,4.20000000
CN3904500000000,39,045,"Fairfield County, OH",Oct-22,80122,77329,2793,3.50000000
CN3904700000000,39,047,"Fayette County, OH",Oct-22,13753,13235,518,3.80000000
CN3904900000000,39,049,"Franklin County, OH",Oct-22,707639,682393,25246,3.60000000
CN3905100000000,39,051,"Fulton County, OH",Oct-22,22037,21233,804,3.60000000
CN3905300000000,39,053,"Gallia County, OH",Oct-22,12277,11761,516,4.20000000
CN3905500000000,39,055,"Geauga County, OH",Oct-22,48702,46830,1872,3.80000000
CN3905700000000,39,057,"Greene County, OH",Oct-22,82129,79143,2986,3.60000000
CN3905900000000,39,059,"Guernsey County, OH",Oct-22,17721,16927,794,4.50000000
CN3906100000000,39,061,"Hamilton County, OH",Oct-22,410533,394990,15543,3.80000000
CN3906300000000,39,063,"Hancock County, OH",Oct-22,40383,39091,1292,3.20000000
CN3906500000000,39,065,"Hardin County, OH",Oct-22,13705,13156,549,4.00000000
CN3906700000000,39,067,"Harrison County, OH",Oct-22,6450,6129,321,5.00000000
CN3906900000000,39,069,"Henry County, OH",Oct-22,12737,12233,504,4.00000000
CN3907100000000,39,071,"Highland County, OH",Oct-22,17507,16690,817,4.70000000
CN3907300000000,39,073,"Hocking County, OH",Oct-22,12912,12401,511,4.00000000
CN3907500000000,39,075,"Holmes County, OH",Oct-22,21599,21001,598,2.80000000
CN3907700000000,39,077,"Huron County, OH",Oct-22,27772,26624,1148,4.10000000
CN3907900000000,39,079,"Jackson County, OH",Oct-22,12265,11682,583,4.80000000
CN3908100000000,39,081,"Jefferson County, OH",Oct-22,26862,25394,1468,5.50000000
CN3908300000000,39,083,"Knox County, OH",Oct-22,31089,30057,1032,3.30000000
CN3908500000000,39,085,"Lake County, OH",Oct-22,125329,120126,5203,4.20000000
CN3908700000000,39,087,"Lawrence County, OH",Oct-22,23067,21999,1068,4.60000000
CN3908900000000,39,089,"Licking County, OH",Oct-22,91860,88719,3141,3.40000000
CN3909100000000,39,091,"Logan County, OH",Oct-22,22322,21560,762,3.40000000
CN3909300000000,39,093,"Lorain County, OH",Oct-22,154580,147185,7395,4.80000000
CN3909500000000,39,095,"Lucas County, OH",Oct-22,207374,197981,9393,4.50000000
CN3909700000000,39,097,"Madison County, OH",Oct-22,20950,20290,660,3.20000000
CN3909900000000,39,099,"Mahoning County, OH",Oct-22,97171,92546,4625,4.80000000
CN3910100000000,39,101,"Marion County, OH",Oct-22,27186,26105,1081,4.00000000
CN3910300000000,39,103,"Medina County, OH",Oct-22,98318,94416,3902,4.00000000
CN3910500000000,39,105,"Meigs County, OH",Oct-22,8634,8161,473,5.50000000
CN3910700000000,39,107,"Mercer County, OH",Oct-22,22796,22128,668,2.90000000
CN3910900000000,39,109,"Miami County, OH",Oct-22,53285,51433,1852,3.50000000
CN3911100000000,39,111,"Monroe County, OH",Oct-22,5016,4713,303,6.00000000
CN3911300000000,39,113,"Montgomery County, OH",Oct-22,245764,235345,10419,4.20000000
CN3911500000000,39,115,"Morgan County, OH",Oct-22,6756,6445,311,4.60000000
CN3911700000000,39,117,"Morrow County, OH",Oct-22,16980,16346,634,3.70000000
CN3911900000000,39,119,"Muskingum County, OH",Oct-22,40893,39237,1656,4.00000000
CN3912100000000,39,121,"Noble County, OH",Oct-22,4577,4320,257,5.60000000
CN3912300000000,39,123,"Ottawa County, OH",Oct-22,20502,19559,943,4.60000000
CN3912500000000,39,125,"Paulding County, OH",Oct-22,8637,8337,300,3.50000000
CN3912700000000,39,127,"Perry County, OH",Oct-22,15912,15231,681,4.30000000
CN3912900000000,39,129,"Pickaway County, OH",Oct-22,26790,25789,1001,3.70000000
CN3913100000000,39,131,"Pike County, OH",Oct-22,11024,10485,539,4.90000000
CN3913300000000,39,133,"Portage County, OH",Oct-22,84033,80882,3151,3.70000000
CN3913500000000,39,135,"Preble County, OH",Oct-22,21950,21220,730,3.30000000
CN3913700000000,39,137,"Putnam County, OH",Oct-22,18899,18347,552,2.90000000
CN3913900000000,39,139,"Richland County, OH",Oct-22,51066,48802,2264,4.40000000
CN3914100000000,39,141,"Ross County, OH",Oct-22,34984,33693,1291,3.70000000
CN3914300000000,39,143,"Sandusky County, OH",Oct-22,30156,28729,1427,4.70000000
CN3914500000000,39,145,"Scioto County, OH",Oct-22,29265,27819,1446,4.90000000
CN3914700000000,39,147,"Seneca County, OH",Oct-22,26246,25180,1066,4.10000000
CN3914900000000,39,149,"Shelby County, OH",Oct-22,23346,22532,814,3.50000000
CN3915100000000,39,151,"Stark County, OH",Oct-22,180118,172964,7154,4.00000000
CN3915300000000,39,153,"Summit County, OH",Oct-22,261691,251024,10667,4.10000000
CN3915500000000,39,155,"Trumbull County, OH",Oct-22,82085,78085,4000,4.90000000
CN3915700000000,39,157,"Tuscarawas County, OH",Oct-22,44335,42671,1664,3.80000000
CN3915900000000,39,159,"Union County, OH",Oct-22,30227,29303,924,3.10000000
CN3916100000000,39,161,"Van Wert County, OH",Oct-22,14361,13876,485,3.40000000
CN3916300000000,39,163,"Vinton County, OH",Oct-22,5407,5147,260,4.80000000
CN3916500000000,39,165,"Warren County, OH",Oct-22,120509,116360,4149,3.40000000
CN3916700000000,39,167,"Washington County, OH",Oct-22,26852,25674,1178,4.40000000
CN3916900000000,39,169,"Wayne County, OH",Oct-22,60452,58577,1875,3.10000000
CN3917100000000,39,171,"Williams County, OH",Oct-22,17946,17338,608,3.40000000
CN3917300000000,39,173,"Wood County, OH",Oct-22,70716,68235,2481,3.50000000
CN3917500000000,39,175,"Wyandot County, OH",Oct-22,13200,12836,364,2.80000000
CN4000100000000,40,001,"Adair County, OK",Oct-22,8659,8320,339,3.90000000
CN4000300000000,40,003,"Alfalfa County, OK",Oct-22,2766,2696,70,2.50000000
CN4000500000000,40,005,"Atoka County, OK",Oct-22,5127,4893,234,4.60000000
CN4000700000000,40,007,"Beaver County, OK",Oct-22,2692,2634,58,2.20000000
CN4000900000000,40,009,"Beckham County, OK",Oct-22,10559,10247,312,3.00000000
CN4001100000000,40,011,"Blaine County, OK",Oct-22,4392,4283,109,2.50000000
CN4001300000000,40,013,"Bryan County, OK",Oct-22,23389,22661,728,3.10000000
CN4001500000000,40,015,"Caddo County, OK",Oct-22,12049,11586,463,3.80000000
CN4001700000000,40,017,"Canadian County, OK",Oct-22,80305,77935,2370,3.00000000
CN4001900000000,40,019,"Carter County, OK",Oct-22,21485,20639,846,3.90000000
CN4002100000000,40,021,"Cherokee County, OK",Oct-22,20178,19415,763,3.80000000
CN4002300000000,40,023,"Choctaw County, OK",Oct-22,5951,5671,280,4.70000000
CN4002500000000,40,025,"Cimarron County, OK",Oct-22,1662,1637,25,1.50000000
CN4002700000000,40,027,"Cleveland County, OK",Oct-22,147668,143242,4426,3.00000000
CN4002900000000,40,029,"Coal County, OK",Oct-22,2342,2264,78,3.30000000
CN4003100000000,40,031,"Comanche County, OK",Oct-22,47672,45665,2007,4.20000000
CN4003300000000,40,033,"Cotton County, OK",Oct-22,2713,2612,101,3.70000000
CN4003500000000,40,035,"Craig County, OK",Oct-22,5846,5635,211,3.60000000
CN4003700000000,40,037,"Creek County, OK",Oct-22,31762,30494,1268,4.00000000
CN4003900000000,40,039,"Custer County, OK",Oct-22,14818,14388,430,2.90000000
CN4004100000000,40,041,"Delaware County, OK",Oct-22,19707,19031,676,3.40000000
CN4004300000000,40,043,"Dewey County, OK",Oct-22,3117,3048,69,2.20000000
CN4004500000000,40,045,"Ellis County, OK",Oct-22,2053,1996,57,2.80000000
CN4004700000000,40,047,"Garfield County, OK",Oct-22,26850,25925,925,3.40000000
CN4004900000000,40,049,"Garvin County, OK",Oct-22,12924,12498,426,3.30000000
CN4005100000000,40,051,"Grady County, OK",Oct-22,27343,26441,902,3.30000000
CN4005300000000,40,053,"Grant County, OK",Oct-22,2831,2767,64,2.30000000
CN4005500000000,40,055,"Greer County, OK",Oct-22,1852,1772,80,4.30000000
CN4005700000000,40,057,"Harmon County, OK",Oct-22,1188,1150,38,3.20000000
CN4005900000000,40,059,"Harper County, OK",Oct-22,1837,1800,37,2.00000000
CN4006100000000,40,061,"Haskell County, OK",Oct-22,4244,4042,202,4.80000000
CN4006300000000,40,063,"Hughes County, OK",Oct-22,5217,4992,225,4.30000000
CN4006500000000,40,065,"Jackson County, OK",Oct-22,10732,10384,348,3.20000000
CN4006700000000,40,067,"Jefferson County, OK",Oct-22,2516,2433,83,3.30000000
CN4006900000000,40,069,"Johnston County, OK",Oct-22,3723,3559,164,4.40000000
CN4007100000000,40,071,"Kay County, OK",Oct-22,18353,17609,744,4.10000000
CN4007300000000,40,073,"Kingfisher County, OK",Oct-22,8983,8778,205,2.30000000
CN4007500000000,40,075,"Kiowa County, OK",Oct-22,3677,3544,133,3.60000000
CN4007700000000,40,077,"Latimer County, OK",Oct-22,3155,2927,228,7.20000000
CN4007900000000,40,079,"Le Flore County, OK",Oct-22,19556,18718,838,4.30000000
CN4008100000000,40,081,"Lincoln County, OK",Oct-22,16161,15579,582,3.60000000
CN4008300000000,40,083,"Logan County, OK",Oct-22,23307,22589,718,3.10000000
CN4008500000000,40,085,"Love County, OK",Oct-22,5788,5633,155,2.70000000
CN4008700000000,40,087,"McClain County, OK",Oct-22,20903,20252,651,3.10000000
CN4008900000000,40,089,"McCurtain County, OK",Oct-22,16002,15333,669,4.20000000
CN4009100000000,40,091,"McIntosh County, OK",Oct-22,7223,6826,397,5.50000000
CN4009300000000,40,093,"Major County, OK",Oct-22,3844,3732,112,2.90000000
CN4009500000000,40,095,"Marshall County, OK",Oct-22,7455,7192,263,3.50000000
CN4009700000000,40,097,"Mayes County, OK",Oct-22,19827,19141,686,3.50000000
CN4009900000000,40,099,"Murray County, OK",Oct-22,6118,5894,224,3.70000000
CN4010100000000,40,101,"Muskogee County, OK",Oct-22,28562,27435,1127,3.90000000
CN4010300000000,40,103,"Noble County, OK",Oct-22,5843,5691,152,2.60000000
CN4010500000000,40,105,"Nowata County, OK",Oct-22,4690,4534,156,3.30000000
CN4010700000000,40,107,"Okfuskee County, OK",Oct-22,4462,4261,201,4.50000000
CN4010900000000,40,109,"Oklahoma County, OK",Oct-22,396497,382799,13698,3.50000000
CN4011100000000,40,111,"Okmulgee County, OK",Oct-22,15788,15060,728,4.60000000
CN4011300000000,40,113,"Osage County, OK",Oct-22,20794,19978,816,3.90000000
CN4011500000000,40,115,"Ottawa County, OK",Oct-22,15207,14728,479,3.10000000
CN4011700000000,40,117,"Pawnee County, OK",Oct-22,7448,7143,305,4.10000000
CN4011900000000,40,119,"Payne County, OK",Oct-22,39328,38109,1219,3.10000000
CN4012100000000,40,121,"Pittsburg County, OK",Oct-22,16364,15541,823,5.00000000
CN4012300000000,40,123,"Pontotoc County, OK",Oct-22,19605,19024,581,3.00000000
CN4012500000000,40,125,"Pottawatomie County, OK",Oct-22,33203,31896,1307,3.90000000
CN4012700000000,40,127,"Pushmataha County, OK",Oct-22,4565,4367,198,4.30000000
CN4012900000000,40,129,"Roger Mills County, OK",Oct-22,1850,1803,47,2.50000000
CN4013100000000,40,131,"Rogers County, OK",Oct-22,46061,44541,1520,3.30000000
CN4013300000000,40,133,"Seminole County, OK",Oct-22,9011,8570,441,4.90000000
CN4013500000000,40,135,"Sequoyah County, OK",Oct-22,16755,16102,653,3.90000000
CN4013700000000,40,137,"Stephens County, OK",Oct-22,19046,18312,734,3.90000000
CN4013900000000,40,139,"Texas County, OK",Oct-22,12065,11849,216,1.80000000
CN4014100000000,40,141,"Tillman County, OK",Oct-22,2895,2785,110,3.80000000
CN4014300000000,40,143,"Tulsa County, OK",Oct-22,329310,317918,11392,3.50000000
CN4014500000000,40,145,"Wagoner County, OK",Oct-22,39585,38214,1371,3.50000000
CN4014700000000,40,147,"Washington County, OK",Oct-22,21937,21110,827,3.80000000
CN4014900000000,40,149,"Washita County, OK",Oct-22,5304,5128,176,3.30000000
CN4015100000000,40,151,"Woods County, OK",Oct-22,4849,4752,97,2.00000000
CN4015300000000,40,153,"Woodward County, OK",Oct-22,8409,8100,309,3.70000000
CN4100100000000,41,001,"Baker County, OR",Oct-22,7633,7324,309,4.00000000
CN4100300000000,41,003,"Benton County, OR",Oct-22,49410,47664,1746,3.50000000
CN4100500000000,41,005,"Clackamas County, OR",Oct-22,231568,223257,8311,3.60000000
CN4100700000000,41,007,"Clatsop County, OR",Oct-22,19465,18633,832,4.30000000
CN4100900000000,41,009,"Columbia County, OR",Oct-22,25678,24468,1210,4.70000000
CN4101100000000,41,011,"Coos County, OR",Oct-22,26505,25098,1407,5.30000000
CN4101300000000,41,013,"Crook County, OR",Oct-22,11329,10729,600,5.30000000
CN4101500000000,41,015,"Curry County, OR",Oct-22,9158,8667,491,5.40000000
CN4101700000000,41,017,"Deschutes County, OR",Oct-22,104312,100247,4065,3.90000000
CN4101900000000,41,019,"Douglas County, OR",Oct-22,47515,45090,2425,5.10000000
CN4102100000000,41,021,"Gilliam County, OR",Oct-22,866,835,31,3.60000000
CN4102300000000,41,023,"Grant County, OR",Oct-22,3147,2999,148,4.70000000
CN4102500000000,41,025,"Harney County, OR",Oct-22,3770,3610,160,4.20000000
CN4102700000000,41,027,"Hood River County, OR",Oct-22,14262,13809,453,3.20000000
CN4102900000000,41,029,"Jackson County, OR",Oct-22,108285,103503,4782,4.40000000
CN4103100000000,41,031,"Jefferson County, OR",Oct-22,10565,10023,542,5.10000000
CN4103300000000,41,033,"Josephine County, OR",Oct-22,37445,35476,1969,5.30000000
CN4103500000000,41,035,"Klamath County, OR",Oct-22,30433,28716,1717,5.60000000
CN4103700000000,41,037,"Lake County, OR",Oct-22,3652,3474,178,4.90000000
CN4103900000000,41,039,"Lane County, OR",Oct-22,185843,177449,8394,4.50000000
CN4104100000000,41,041,"Lincoln County, OR",Oct-22,20907,19794,1113,5.30000000
CN4104300000000,41,043,"Linn County, OR",Oct-22,61418,58680,2738,4.50000000
CN4104500000000,41,045,"Malheur County, OR",Oct-22,12749,12262,487,3.80000000
CN4104700000000,41,047,"Marion County, OR",Oct-22,168962,161910,7052,4.20000000
CN4104900000000,41,049,"Morrow County, OR",Oct-22,6126,5894,232,3.80000000
CN4105100000000,41,051,"Multnomah County, OR",Oct-22,478653,460161,18492,3.90000000
CN4105300000000,41,053,"Polk County, OR",Oct-22,42801,41061,1740,4.10000000
CN4105500000000,41,055,"Sherman County, OR",Oct-22,944,917,27,2.90000000
CN4105700000000,41,057,"Tillamook County, OR",Oct-22,12337,11815,522,4.20000000
CN4105900000000,41,059,"Umatilla County, OR",Oct-22,38246,36653,1593,4.20000000
CN4106100000000,41,061,"Union County, OR",Oct-22,12199,11656,543,4.50000000
CN4106300000000,41,063,"Wallowa County, OR",Oct-22,3633,3481,152,4.20000000
CN4106500000000,41,065,"Wasco County, OR",Oct-22,12982,12429,553,4.30000000
CN4106700000000,41,067,"Washington County, OR",Oct-22,342100,330767,11333,3.30000000
CN4106900000000,41,069,"Wheeler County, OR",Oct-22,730,711,19,2.60000000
CN4107100000000,41,071,"Yamhill County, OR",Oct-22,57495,55414,2081,3.60000000
CN4200100000000,42,001,"Adams County, PA",Oct-22,55916,54652,1264,2.30000000
CN4200300000000,42,003,"Allegheny County, PA",Oct-22,638913,618385,20528,3.20000000
CN4200500000000,42,005,"Armstrong County, PA",Oct-22,31364,30222,1142,3.60000000
CN4200700000000,42,007,"Beaver County, PA",Oct-22,82735,79243,3492,4.20000000
CN4200900000000,42,009,"Bedford County, PA",Oct-22,23890,23145,745,3.10000000
CN4201100000000,42,011,"Berks County, PA",Oct-22,212309,205177,7132,3.40000000
CN4201300000000,42,013,"Blair County, PA",Oct-22,59827,57942,1885,3.20000000
CN4201500000000,42,015,"Bradford County, PA",Oct-22,27888,27041,847,3.00000000
CN4201700000000,42,017,"Bucks County, PA",Oct-22,349068,338863,10205,2.90000000
CN4201900000000,42,019,"Butler County, PA",Oct-22,99659,96772,2887,2.90000000
CN4202100000000,42,021,"Cambria County, PA",Oct-22,55758,53654,2104,3.80000000
CN4202300000000,42,023,"Cameron County, PA",Oct-22,1967,1890,77,3.90000000
CN4202500000000,42,025,"Carbon County, PA",Oct-22,33092,31839,1253,3.80000000
CN4202700000000,42,027,"Centre County, PA",Oct-22,78870,76913,1957,2.50000000
CN4202900000000,42,029,"Chester County, PA",Oct-22,294657,287774,6883,2.30000000
CN4203100000000,42,031,"Clarion County, PA",Oct-22,16876,16299,577,3.40000000
CN4203300000000,42,033,"Clearfield County, PA",Oct-22,35023,33673,1350,3.90000000
CN4203500000000,42,035,"Clinton County, PA",Oct-22,17368,16742,626,3.60000000
CN4203700000000,42,037,"Columbia County, PA",Oct-22,33385,32260,1125,3.40000000
CN4203900000000,42,039,"Crawford County, PA",Oct-22,37857,36558,1299,3.40000000
CN4204100000000,42,041,"Cumberland County, PA",Oct-22,137876,134533,3343,2.40000000
CN4204300000000,42,043,"Dauphin County, PA",Oct-22,149153,144581,4572,3.10000000
CN4204500000000,42,045,"Delaware County, PA",Oct-22,300915,290902,10013,3.30000000
CN4204700000000,42,047,"Elk County, PA",Oct-22,14463,13971,492,3.40000000
CN4204900000000,42,049,"Erie County, PA",Oct-22,127898,123152,4746,3.70000000
CN4205100000000,42,051,"Fayette County, PA",Oct-22,55445,52938,2507,4.50000000
CN4205300000000,42,053,"Forest County, PA",Oct-22,1713,1627,86,5.00000000
CN4205500000000,42,055,"Franklin County, PA",Oct-22,78264,76138,2126,2.70000000
CN4205700000000,42,057,"Fulton County, PA",Oct-22,7143,6918,225,3.10000000
CN4205900000000,42,059,"Greene County, PA",Oct-22,15521,14918,603,3.90000000
CN4206100000000,42,061,"Huntingdon County, PA",Oct-22,19316,18579,737,3.80000000
CN4206300000000,42,063,"Indiana County, PA",Oct-22,36735,35375,1360,3.70000000
CN4206500000000,42,065,"Jefferson County, PA",Oct-22,19512,18852,660,3.40000000
CN4206700000000,42,067,"Juniata County, PA",Oct-22,12731,12390,341,2.70000000
CN4206900000000,42,069,"Lackawanna County, PA",Oct-22,105054,101168,3886,3.70000000
CN4207100000000,42,071,"Lancaster County, PA",Oct-22,287537,280212,7325,2.50000000
CN4207300000000,42,073,"Lawrence County, PA",Oct-22,39296,37736,1560,4.00000000
CN4207500000000,42,075,"Lebanon County, PA",Oct-22,75093,73126,1967,2.60000000
CN4207700000000,42,077,"Lehigh County, PA",Oct-22,201170,194317,6853,3.40000000
CN4207900000000,42,079,"Luzerne County, PA",Oct-22,158216,151371,6845,4.30000000
CN4208100000000,42,081,"Lycoming County, PA",Oct-22,54999,53072,1927,3.50000000
CN4208300000000,42,083,"McKean County, PA",Oct-22,16682,16024,658,3.90000000
CN4208500000000,42,085,"Mercer County, PA",Oct-22,47315,45514,1801,3.80000000
CN4208700000000,42,087,"Mifflin County, PA",Oct-22,20815,20104,711,3.40000000
CN4208900000000,42,089,"Monroe County, PA",Oct-22,82516,78638,3878,4.70000000
CN4209100000000,42,091,"Montgomery County, PA",Oct-22,464378,452162,12216,2.60000000
CN4209300000000,42,093,"Montour County, PA",Oct-22,9098,8868,230,2.50000000
CN4209500000000,42,095,"Northampton County, PA",Oct-22,167435,162124,5311,3.20000000
CN4209700000000,42,097,"Northumberland County, PA",Oct-22,41734,40177,1557,3.70000000
CN4209900000000,42,099,"Perry County, PA",Oct-22,25215,24599,616,2.40000000
CN4210100000000,42,101,"Philadelphia County/city, PA",Oct-22,731005,696889,34116,4.70000000
CN4210300000000,42,103,"Pike County, PA",Oct-22,25751,24587,1164,4.50000000
CN4210500000000,42,105,"Potter County, PA",Oct-22,7158,6886,272,3.80000000
CN4210700000000,42,107,"Schuylkill County, PA",Oct-22,64562,62025,2537,3.90000000
CN4210900000000,42,109,"Snyder County, PA",Oct-22,19795,19252,543,2.70000000
CN4211100000000,42,111,"Somerset County, PA",Oct-22,32052,30859,1193,3.70000000
CN4211300000000,42,113,"Sullivan County, PA",Oct-22,2503,2414,89,3.60000000
CN4211500000000,42,115,"Susquehanna County, PA",Oct-22,20488,19890,598,2.90000000
CN4211700000000,42,117,"Tioga County, PA",Oct-22,19088,18414,674,3.50000000
CN4211900000000,42,119,"Union County, PA",Oct-22,19818,19308,510,2.60000000
CN4212100000000,42,121,"Venango County, PA",Oct-22,20937,20150,787,3.80000000
CN4212300000000,42,123,"Warren County, PA",Oct-22,17437,16831,606,3.50000000
CN4212500000000,42,125,"Washington County, PA",Oct-22,105736,102180,3556,3.40000000
CN4212700000000,42,127,"Wayne County, PA",Oct-22,22255,21437,818,3.70000000
CN4212900000000,42,129,"Westmoreland County, PA",Oct-22,177277,171523,5754,3.20000000
CN4213100000000,42,131,"Wyoming County, PA",Oct-22,13521,13039,482,3.60000000
CN4213300000000,42,133,"York County, PA",Oct-22,239904,233285,6619,2.80000000
CN4400100000000,44,001,"Bristol County, RI",Oct-22,26862,26167,695,2.60000000
CN4400300000000,44,003,"Kent County, RI",Oct-22,94918,92096,2822,3.00000000
CN4400500000000,44,005,"Newport County, RI",Oct-22,45629,44402,1227,2.70000000
CN4400700000000,44,007,"Providence County, RI",Oct-22,339279,326927,12352,3.60000000
CN4400900000000,44,009,"Washington County, RI",Oct-22,70953,69037,1916,2.70000000
CN4500100000000,45,001,"Abbeville County, SC",Oct-22,9542,9147,395,4.10000000
CN4500300000000,45,003,"Aiken County, SC",Oct-22,73381,70862,2519,3.40000000
CN4500500000000,45,005,"Allendale County, SC",Oct-22,2220,2074,146,6.60000000
CN4500700000000,45,007,"Anderson County, SC",Oct-22,92047,89068,2979,3.20000000
CN4500900000000,45,009,"Bamberg County, SC",Oct-22,4586,4286,300,6.50000000
CN4501100000000,45,011,"Barnwell County, SC",Oct-22,7484,7095,389,5.20000000
CN4501300000000,45,013,"Beaufort County, SC",Oct-22,75816,73297,2519,3.30000000
CN4501500000000,45,015,"Berkeley County, SC",Oct-22,111539,107694,3845,3.40000000
CN4501700000000,45,017,"Calhoun County, SC",Oct-22,6339,6090,249,3.90000000
CN4501900000000,45,019,"Charleston County, SC",Oct-22,218568,212282,6286,2.90000000
CN4502100000000,45,021,"Cherokee County, SC",Oct-22,24671,23429,1242,5.00000000
CN4502300000000,45,023,"Chester County, SC",Oct-22,13586,12927,659,4.90000000
CN4502500000000,45,025,"Chesterfield County, SC",Oct-22,21199,20344,855,4.00000000
CN4502700000000,45,027,"Clarendon County, SC",Oct-22,11808,11267,541,4.60000000
CN4502900000000,45,029,"Colleton County, SC",Oct-22,15872,15281,591,3.70000000
CN4503100000000,45,031,"Darlington County, SC",Oct-22,28914,27797,1117,3.90000000
CN4503300000000,45,033,"Dillon County, SC",Oct-22,12893,12242,651,5.00000000
CN4503500000000,45,035,"Dorchester County, SC",Oct-22,80843,78226,2617,3.20000000
CN4503700000000,45,037,"Edgefield County, SC",Oct-22,10346,9939,407,3.90000000
CN4503900000000,45,039,"Fairfield County, SC",Oct-22,9108,8642,466,5.10000000
CN4504100000000,45,041,"Florence County, SC",Oct-22,64225,61910,2315,3.60000000
CN4504300000000,45,043,"Georgetown County, SC",Oct-22,25922,24921,1001,3.90000000
CN4504500000000,45,045,"Greenville County, SC",Oct-22,261614,253653,7961,3.00000000
CN4504700000000,45,047,"Greenwood County, SC",Oct-22,30002,28755,1247,4.20000000
CN4504900000000,45,049,"Hampton County, SC",Oct-22,7811,7580,231,3.00000000
CN4505100000000,45,051,"Horry County, SC",Oct-22,150157,144000,6157,4.10000000
CN4505300000000,45,053,"Jasper County, SC",Oct-22,13139,12723,416,3.20000000
CN4505500000000,45,055,"Kershaw County, SC",Oct-22,28967,27931,1036,3.60000000
CN4505700000000,45,057,"Lancaster County, SC",Oct-22,44240,42545,1695,3.80000000
CN4505900000000,45,059,"Laurens County, SC",Oct-22,30301,29205,1096,3.60000000
CN4506100000000,45,061,"Lee County, SC",Oct-22,6347,6005,342,5.40000000
CN4506300000000,45,063,"Lexington County, SC",Oct-22,149094,144692,4402,3.00000000
CN4506500000000,45,065,"McCormick County, SC",Oct-22,3441,3309,132,3.80000000
CN4506700000000,45,067,"Marion County, SC",Oct-22,12598,11888,710,5.60000000
CN4506900000000,45,069,"Marlboro County, SC",Oct-22,8409,7761,648,7.70000000
CN4507100000000,45,071,"Newberry County, SC",Oct-22,18924,18344,580,3.10000000
CN4507300000000,45,073,"Oconee County, SC",Oct-22,33952,32866,1086,3.20000000
CN4507500000000,45,075,"Orangeburg County, SC",Oct-22,32950,30982,1968,6.00000000
CN4507700000000,45,077,"Pickens County, SC",Oct-22,58430,56422,2008,3.40000000
CN4507900000000,45,079,"Richland County, SC",Oct-22,194363,187311,7052,3.60000000
CN4508100000000,45,081,"Saluda County, SC",Oct-22,8313,8051,262,3.20000000
CN4508300000000,45,083,"Spartanburg County, SC",Oct-22,156843,151497,5346,3.40000000
CN4508500000000,45,085,"Sumter County, SC",Oct-22,40899,39132,1767,4.30000000
CN4508700000000,45,087,"Union County, SC",Oct-22,11474,10830,644,5.60000000
CN4508900000000,45,089,"Williamsburg County, SC",Oct-22,10711,10142,569,5.30000000
CN4509100000000,45,091,"York County, SC",Oct-22,150375,145320,5055,3.40000000
CN4600300000000,46,003,"Aurora County, SD",Oct-22,1470,1442,28,1.90000000
CN4600500000000,46,005,"Beadle County, SD",Oct-22,9253,9075,178,1.90000000
CN4600700000000,46,007,"Bennett County, SD",Oct-22,1076,1042,34,3.20000000
CN4600900000000,46,009,"Bon Homme County, SD",Oct-22,2819,2766,53,1.90000000
CN4601100000000,46,011,"Brookings County, SD",Oct-22,19537,19108,429,2.20000000
CN4601300000000,46,013,"Brown County, SD",Oct-22,20129,19677,452,2.20000000
CN4601500000000,46,015,"Brule County, SD",Oct-22,2665,2610,55,2.10000000
CN4601700000000,46,017,"Buffalo County, SD",Oct-22,725,681,44,6.10000000
CN4601900000000,46,019,"Butte County, SD",Oct-22,5021,4915,106,2.10000000
CN4602100000000,46,021,"Campbell County, SD",Oct-22,779,756,23,3.00000000
CN4602300000000,46,023,"Charles Mix County, SD",Oct-22,3820,3725,95,2.50000000
CN4602500000000,46,025,"Clark County, SD",Oct-22,1932,1893,39,2.00000000
CN4602700000000,46,027,"Clay County, SD",Oct-22,7738,7553,185,2.40000000
CN4602900000000,46,029,"Codington County, SD",Oct-22,15952,15634,318,2.00000000
CN4603100000000,46,031,"Corson County, SD",Oct-22,1274,1235,39,3.10000000
CN4603300000000,46,033,"Custer County, SD",Oct-22,4237,4124,113,2.70000000
CN4603500000000,46,035,"Davison County, SD",Oct-22,11092,10884,208,1.90000000
CN4603700000000,46,037,"Day County, SD",Oct-22,2668,2599,69,2.60000000
CN4603900000000,46,039,"Deuel County, SD",Oct-22,2307,2250,57,2.50000000
CN4604100000000,46,041,"Dewey County, SD",Oct-22,2311,2170,141,6.10000000
CN4604300000000,46,043,"Douglas County, SD",Oct-22,1511,1483,28,1.90000000
CN4604500000000,46,045,"Edmunds County, SD",Oct-22,1997,1960,37,1.90000000
CN4604700000000,46,047,"Fall River County, SD",Oct-22,3128,3054,74,2.40000000
CN4604900000000,46,049,"Faulk County, SD",Oct-22,1092,1067,25,2.30000000
CN4605100000000,46,051,"Grant County, SD",Oct-22,4420,4335,85,1.90000000
CN4605300000000,46,053,"Gregory County, SD",Oct-22,2231,2189,42,1.90000000
CN4605500000000,46,055,"Haakon County, SD",Oct-22,1087,1062,25,2.30000000
CN4605700000000,46,057,"Hamlin County, SD",Oct-22,3591,3524,67,1.90000000
CN4605900000000,46,059,"Hand County, SD",Oct-22,1810,1780,30,1.70000000
CN4606100000000,46,061,"Hanson County, SD",Oct-22,1779,1737,42,2.40000000
CN4606300000000,46,063,"Harding County, SD",Oct-22,746,730,16,2.10000000
CN4606500000000,46,065,"Hughes County, SD",Oct-22,9914,9744,170,1.70000000
CN4606700000000,46,067,"Hutchinson County, SD",Oct-22,3608,3536,72,2.00000000
CN4606900000000,46,069,"Hyde County, SD",Oct-22,653,639,14,2.10000000
CN4607100000000,46,071,"Jackson County, SD",Oct-22,1217,1182,35,2.90000000
CN4607300000000,46,073,"Jerauld County, SD",Oct-22,1330,1309,21,1.60000000
CN4607500000000,46,075,"Jones County, SD",Oct-22,531,519,12,2.30000000
CN4607700000000,46,077,"Kingsbury County, SD",Oct-22,2903,2846,57,2.00000000
CN4607900000000,46,079,"Lake County, SD",Oct-22,6802,6654,148,2.20000000
CN4608100000000,46,081,"Lawrence County, SD",Oct-22,14264,13948,316,2.20000000
CN4608300000000,46,083,"Lincoln County, SD",Oct-22,38089,37451,638,1.70000000
CN4608500000000,46,085,"Lyman County, SD",Oct-22,1721,1673,48,2.80000000
CN4608700000000,46,087,"McCook County, SD",Oct-22,3153,3100,53,1.70000000
CN4608900000000,46,089,"McPherson County, SD",Oct-22,980,950,30,3.10000000
CN4609100000000,46,091,"Marshall County, SD",Oct-22,2476,2414,62,2.50000000
CN4609300000000,46,093,"Meade County, SD",Oct-22,14586,14259,327,2.20000000
CN4609500000000,46,095,"Mellette County, SD",Oct-22,747,724,23,3.10000000
CN4609700000000,46,097,"Miner County, SD",Oct-22,1225,1202,23,1.90000000
CN4609900000000,46,099,"Minnehaha County, SD",Oct-22,118266,116081,2185,1.80000000
CN4610100000000,46,101,"Moody County, SD",Oct-22,4031,3941,90,2.20000000
CN4610200000000,46,102,"Oglala Lakota County, SD",Oct-22,3859,3612,247,6.40000000
CN4610300000000,46,103,"Pennington County, SD",Oct-22,60033,58731,1302,2.20000000
CN4610500000000,46,105,"Perkins County, SD",Oct-22,1425,1393,32,2.20000000
CN4610700000000,46,107,"Potter County, SD",Oct-22,1040,1017,23,2.20000000
CN4610900000000,46,109,"Roberts County, SD",Oct-22,4728,4604,124,2.60000000
CN4611100000000,46,111,"Sanborn County, SD",Oct-22,1207,1179,28,2.30000000
CN4611500000000,46,115,"Spink County, SD",Oct-22,3002,2937,65,2.20000000
CN4611700000000,46,117,"Stanley County, SD",Oct-22,1925,1891,34,1.80000000
CN4611900000000,46,119,"Sully County, SD",Oct-22,816,800,16,2.00000000
CN4612100000000,46,121,"Todd County, SD",Oct-22,3021,2908,113,3.70000000
CN4612300000000,46,123,"Tripp County, SD",Oct-22,3127,3072,55,1.80000000
CN4612500000000,46,125,"Turner County, SD",Oct-22,4830,4738,92,1.90000000
CN4612700000000,46,127,"Union County, SD",Oct-22,8676,8457,219,2.50000000
CN4612900000000,46,129,"Walworth County, SD",Oct-22,2109,2038,71,3.40000000
CN4613500000000,46,135,"Yankton County, SD",Oct-22,11681,11448,233,2.00000000
CN4613700000000,46,137,"Ziebach County, SD",Oct-22,956,917,39,4.10000000
CN4700100000000,47,001,"Anderson County, TN",Oct-22,35284,34103,1181,3.30000000
CN4700300000000,47,003,"Bedford County, TN",Oct-22,20972,20236,736,3.50000000
CN4700500000000,47,005,"Benton County, TN",Oct-22,6605,6319,286,4.30000000
CN4700700000000,47,007,"Bledsoe County, TN",Oct-22,4289,4060,229,5.30000000
CN4700900000000,47,009,"Blount County, TN",Oct-22,65534,63542,1992,3.00000000
CN4701100000000,47,011,"Bradley County, TN",Oct-22,49653,47893,1760,3.50000000
CN4701300000000,47,013,"Campbell County, TN",Oct-22,14962,14358,604,4.00000000
CN4701500000000,47,015,"Cannon County, TN",Oct-22,6868,6662,206,3.00000000
CN4701700000000,47,017,"Carroll County, TN",Oct-22,11107,10657,450,4.10000000
CN4701900000000,47,019,"Carter County, TN",Oct-22,24025,23153,872,3.60000000
CN4702100000000,47,021,"Cheatham County, TN",Oct-22,22640,22056,584,2.60000000
CN4702300000000,47,023,"Chester County, TN",Oct-22,8405,8143,262,3.10000000
CN4702500000000,47,025,"Claiborne County, TN",Oct-22,12764,12282,482,3.80000000
CN4702700000000,47,027,"Clay County, TN",Oct-22,2705,2585,120,4.40000000
CN4702900000000,47,029,"Cocke County, TN",Oct-22,14204,13544,660,4.60000000
CN4703100000000,47,031,"Coffee County, TN",Oct-22,24582,23745,837,3.40000000
CN4703300000000,47,033,"Crockett County, TN",Oct-22,6762,6551,211,3.10000000
CN4703500000000,47,035,"Cumberland County, TN",Oct-22,21972,21023,949,4.30000000
CN4703700000000,47,037,"Davidson County, TN",Oct-22,412821,401187,11634,2.80000000
CN4703900000000,47,039,"Decatur County, TN",Oct-22,4123,3921,202,4.90000000
CN4704100000000,47,041,"DeKalb County, TN",Oct-22,7672,7381,291,3.80000000
CN4704300000000,47,043,"Dickson County, TN",Oct-22,27917,27095,822,2.90000000
CN4704500000000,47,045,"Dyer County, TN",Oct-22,15574,14965,609,3.90000000
CN4704700000000,47,047,"Fayette County, TN",Oct-22,19260,18595,665,3.50000000
CN4704900000000,47,049,"Fentress County, TN",Oct-22,7396,7117,279,3.80000000
CN4705100000000,47,051,"Franklin County, TN",Oct-22,19164,18503,661,3.40000000
CN4705300000000,47,053,"Gibson County, TN",Oct-22,20820,20052,768,3.70000000
CN4705500000000,47,055,"Giles County, TN",Oct-22,14438,13951,487,3.40000000
CN4705700000000,47,057,"Grainger County, TN",Oct-22,9763,9383,380,3.90000000
CN4705900000000,47,059,"Greene County, TN",Oct-22,27711,26603,1108,4.00000000
CN4706100000000,47,061,"Grundy County, TN",Oct-22,5066,4846,220,4.30000000
CN4706300000000,47,063,"Hamblen County, TN",Oct-22,27948,26941,1007,3.60000000
CN4706500000000,47,065,"Hamilton County, TN",Oct-22,181909,175607,6302,3.50000000
CN4706700000000,47,067,"Hancock County, TN",Oct-22,2246,2155,91,4.10000000
CN4706900000000,47,069,"Hardeman County, TN",Oct-22,8634,8245,389,4.50000000
CN4707100000000,47,071,"Hardin County, TN",Oct-22,9680,9279,401,4.10000000
CN4707300000000,47,073,"Hawkins County, TN",Oct-22,22864,21953,911,4.00000000
CN4707500000000,47,075,"Haywood County, TN",Oct-22,7431,7063,368,5.00000000
CN4707700000000,47,077,"Henderson County, TN",Oct-22,11533,11113,420,3.60000000
CN4707900000000,47,079,"Henry County, TN",Oct-22,13959,13448,511,3.70000000
CN4708100000000,47,081,"Hickman County, TN",Oct-22,11764,11431,333,2.80000000
CN4708300000000,47,083,"Houston County, TN",Oct-22,3191,3055,136,4.30000000
CN4708500000000,47,085,"Humphreys County, TN",Oct-22,8525,8221,304,3.60000000
CN4708700000000,47,087,"Jackson County, TN",Oct-22,4724,4541,183,3.90000000
CN4708900000000,47,089,"Jefferson County, TN",Oct-22,24835,23947,888,3.60000000
CN4709100000000,47,091,"Johnson County, TN",Oct-22,7580,7303,277,3.70000000
CN4709300000000,47,093,"Knox County, TN",Oct-22,250904,243737,7167,2.90000000
CN4709500000000,47,095,"Lake County, TN",Oct-22,1577,1500,77,4.90000000
CN4709700000000,47,097,"Lauderdale County, TN",Oct-22,9427,8952,475,5.00000000
CN4709900000000,47,099,"Lawrence County, TN",Oct-22,19073,18400,673,3.50000000
CN4710100000000,47,101,"Lewis County, TN",Oct-22,5636,5434,202,3.60000000
CN4710300000000,47,103,"Lincoln County, TN",Oct-22,15683,15165,518,3.30000000
CN4710500000000,47,105,"Loudon County, TN",Oct-22,24410,23628,782,3.20000000
CN4710700000000,47,107,"McMinn County, TN",Oct-22,20979,20086,893,4.30000000
CN4710900000000,47,109,"McNairy County, TN",Oct-22,8039,7653,386,4.80000000
CN4711100000000,47,111,"Macon County, TN",Oct-22,11698,11351,347,3.00000000
CN4711300000000,47,113,"Madison County, TN",Oct-22,48284,46543,1741,3.60000000
CN4711500000000,47,115,"Marion County, TN",Oct-22,12182,11723,459,3.80000000
CN4711700000000,47,117,"Marshall County, TN",Oct-22,15311,14784,527,3.40000000
CN4711900000000,47,119,"Maury County, TN",Oct-22,52954,51359,1595,3.00000000
CN4712100000000,47,121,"Meigs County, TN",Oct-22,5058,4835,223,4.40000000
CN4712300000000,47,123,"Monroe County, TN",Oct-22,20720,19945,775,3.70000000
CN4712500000000,47,125,"Montgomery County, TN",Oct-22,87257,83961,3296,3.80000000
CN4712700000000,47,127,"Moore County, TN",Oct-22,3612,3518,94,2.60000000
CN4712900000000,47,129,"Morgan County, TN",Oct-22,7849,7545,304,3.90000000
CN4713100000000,47,131,"Obion County, TN",Oct-22,11889,11432,457,3.80000000
CN4713300000000,47,133,"Overton County, TN",Oct-22,9942,9614,328,3.30000000
CN4713500000000,47,135,"Perry County, TN",Oct-22,2736,2596,140,5.10000000
CN4713700000000,47,137,"Pickett County, TN",Oct-22,2080,2001,79,3.80000000
CN4713900000000,47,139,"Polk County, TN",Oct-22,6965,6716,249,3.60000000
CN4714100000000,47,141,"Putnam County, TN",Oct-22,35055,33879,1176,3.40000000
CN4714300000000,47,143,"Rhea County, TN",Oct-22,13762,13162,600,4.40000000
CN4714500000000,47,145,"Roane County, TN",Oct-22,23760,22884,876,3.70000000
CN4714700000000,47,147,"Robertson County, TN",Oct-22,39231,38141,1090,2.80000000
CN4714900000000,47,149,"Rutherford County, TN",Oct-22,195355,190119,5236,2.70000000
CN4715100000000,47,151,"Scott County, TN",Oct-22,7898,7488,410,5.20000000
CN4715300000000,47,153,"Sequatchie County, TN",Oct-22,6134,5886,248,4.00000000
CN4715500000000,47,155,"Sevier County, TN",Oct-22,54638,53139,1499,2.70000000
CN4715700000000,47,157,"Shelby County, TN",Oct-22,440122,418039,22083,5.00000000
CN4715900000000,47,159,"Smith County, TN",Oct-22,9766,9482,284,2.90000000
CN4716100000000,47,161,"Stewart County, TN",Oct-22,5299,5098,201,3.80000000
CN4716300000000,47,163,"Sullivan County, TN",Oct-22,67907,65480,2427,3.60000000
CN4716500000000,47,165,"Sumner County, TN",Oct-22,108847,105830,3017,2.80000000
CN4716700000000,47,167,"Tipton County, TN",Oct-22,27635,26618,1017,3.70000000
CN4716900000000,47,169,"Trousdale County, TN",Oct-22,5721,5559,162,2.80000000
CN4717100000000,47,171,"Unicoi County, TN",Oct-22,7068,6759,309,4.40000000
CN4717300000000,47,173,"Union County, TN",Oct-22,7869,7579,290,3.70000000
CN4717500000000,47,175,"Van Buren County, TN",Oct-22,2003,1918,85,4.20000000
CN4717700000000,47,177,"Warren County, TN",Oct-22,16286,15635,651,4.00000000
CN4717900000000,47,179,"Washington County, TN",Oct-22,61183,59180,2003,3.30000000
CN4718100000000,47,181,"Wayne County, TN",Oct-22,6278,5987,291,4.60000000
CN4718300000000,47,183,"Weakley County, TN",Oct-22,15333,14827,506,3.30000000
CN4718500000000,47,185,"White County, TN",Oct-22,11409,10985,424,3.70000000
CN4718700000000,47,187,"Williamson County, TN",Oct-22,138288,134942,3346,2.40000000
CN4718900000000,47,189,"Wilson County, TN",Oct-22,81945,79778,2167,2.60000000
CN4800100000000,48,001,"Anderson County, TX",Oct-22,23361,22626,735,3.10000000
CN4800300000000,48,003,"Andrews County, TX",Oct-22,8460,8170,290,3.40000000
CN4800500000000,48,005,"Angelina County, TX",Oct-22,35751,34182,1569,4.40000000
CN4800700000000,48,007,"Aransas County, TX",Oct-22,9275,8787,488,5.30000000
CN4800900000000,48,009,"Archer County, TX",Oct-22,3951,3833,118,3.00000000
CN4801100000000,48,011,"Armstrong County, TX",Oct-22,902,880,22,2.40000000
CN4801300000000,48,013,"Atascosa County, TX",Oct-22,22241,21368,873,3.90000000
CN4801500000000,48,015,"Austin County, TX",Oct-22,14124,13603,521,3.70000000
CN4801700000000,48,017,"Bailey County, TX",Oct-22,2201,2108,93,4.20000000
CN4801900000000,48,019,"Bandera County, TX",Oct-22,10515,10134,381,3.60000000
CN4802100000000,48,021,"Bastrop County, TX",Oct-22,47040,45544,1496,3.20000000
CN4802300000000,48,023,"Baylor County, TX",Oct-22,1810,1765,45,2.50000000
CN4802500000000,48,025,"Bee County, TX",Oct-22,8527,7999,528,6.20000000
CN4802700000000,48,027,"Bell County, TX",Oct-22,148597,142239,6358,4.30000000
CN4802900000000,48,029,"Bexar County, TX",Oct-22,971884,937032,34852,3.60000000
CN4803100000000,48,031,"Blanco County, TX",Oct-22,7125,6937,188,2.60000000
CN4803300000000,48,033,"Borden County, TX",Oct-22,699,688,11,1.60000000
CN4803500000000,48,035,"Bosque County, TX",Oct-22,8521,8227,294,3.50000000
CN4803700000000,48,037,"Bowie County, TX",Oct-22,39229,37524,1705,4.30000000
CN4803900000000,48,039,"Brazoria County, TX",Oct-22,185867,177744,8123,4.40000000
CN4804100000000,48,041,"Brazos County, TX",Oct-22,124495,120788,3707,3.00000000
CN4804300000000,48,043,"Brewster County, TX",Oct-22,4024,3895,129,3.20000000
CN4804500000000,48,045,"Briscoe County, TX",Oct-22,544,525,19,3.50000000
CN4804700000000,48,047,"Brooks County, TX",Oct-22,2410,2271,139,5.80000000
CN4804900000000,48,049,"Brown County, TX",Oct-22,14963,14369,594,4.00000000
CN4805100000000,48,051,"Burleson County, TX",Oct-22,8573,8256,317,3.70000000
CN4805300000000,48,053,"Burnet County, TX",Oct-22,24788,24054,734,3.00000000
CN4805500000000,48,055,"Caldwell County, TX",Oct-22,20779,20106,673,3.20000000
CN4805700000000,48,057,"Calhoun County, TX",Oct-22,11951,11558,393,3.30000000
CN4805900000000,48,059,"Callahan County, TX",Oct-22,6119,5910,209,3.40000000
CN4806100000000,48,061,"Cameron County, TX",Oct-22,174043,164379,9664,5.60000000
CN4806300000000,48,063,"Camp County, TX",Oct-22,5270,5046,224,4.30000000
CN4806500000000,48,065,"Carson County, TX",Oct-22,2909,2824,85,2.90000000
CN4806700000000,48,067,"Cass County, TX",Oct-22,12150,11605,545,4.50000000
CN4806900000000,48,069,"Castro County, TX",Oct-22,3190,3090,100,3.10000000
CN4807100000000,48,071,"Chambers County, TX",Oct-22,21191,20103,1088,5.10000000
CN4807300000000,48,073,"Cherokee County, TX",Oct-22,20031,19167,864,4.30000000
CN4807500000000,48,075,"Childress County, TX",Oct-22,2891,2811,80,2.80000000
CN4807700000000,48,077,"Clay County, TX",Oct-22,4781,4606,175,3.70000000
CN4807900000000,48,079,"Cochran County, TX",Oct-22,976,927,49,5.00000000
CN4808100000000,48,081,"Coke County, TX",Oct-22,1327,1282,45,3.40000000
CN4808300000000,48,083,"Coleman County, TX",Oct-22,2871,2745,126,4.40000000
CN4808500000000,48,085,"Collin County, TX",Oct-22,633760,614956,18804,3.00000000
CN4808700000000,48,087,"Collingsworth County, TX",Oct-22,1048,1014,34,3.20000000
CN4808900000000,48,089,"Colorado County, TX",Oct-22,10093,9752,341,3.40000000
CN4809100000000,48,091,"Comal County, TX",Oct-22,81665,78998,2667,3.30000000
CN4809300000000,48,093,"Comanche County, TX",Oct-22,6216,6006,210,3.40000000
CN4809500000000,48,095,"Concho County, TX",Oct-22,1274,1236,38,3.00000000
CN4809700000000,48,097,"Cooke County, TX",Oct-22,19130,18512,618,3.20000000
CN4809900000000,48,099,"Coryell County, TX",Oct-22,24532,23481,1051,4.30000000
CN4810100000000,48,101,"Cottle County, TX",Oct-22,591,568,23,3.90000000
CN4810300000000,48,103,"Crane County, TX",Oct-22,1544,1463,81,5.20000000
CN4810500000000,48,105,"Crockett County, TX",Oct-22,1324,1273,51,3.90000000
CN4810700000000,48,107,"Crosby County, TX",Oct-22,2314,2219,95,4.10000000
CN4810900000000,48,109,"Culberson County, TX",Oct-22,1038,1009,29,2.80000000
CN4811100000000,48,111,"Dallam County, TX",Oct-22,3623,3535,88,2.40000000
CN4811300000000,48,113,"Dallas County, TX",Oct-22,1441353,1389835,51518,3.60000000
CN4811500000000,48,115,"Dawson County, TX",Oct-22,4311,4108,203,4.70000000
CN4811700000000,48,117,"Deaf Smith County, TX",Oct-22,8585,8345,240,2.80000000
CN4811900000000,48,119,"Delta County, TX",Oct-22,2442,2344,98,4.00000000
CN4812100000000,48,121,"Denton County, TX",Oct-22,558963,542100,16863,3.00000000
CN4812300000000,48,123,"DeWitt County, TX",Oct-22,9410,9127,283,3.00000000
CN4812500000000,48,125,"Dickens County, TX",Oct-22,711,679,32,4.50000000
CN4812700000000,48,127,"Dimmit County, TX",Oct-22,5619,5390,229,4.10000000
CN4812900000000,48,129,"Donley County, TX",Oct-22,1485,1436,49,3.30000000
CN4813100000000,48,131,"Duval County, TX",Oct-22,5391,5157,234,4.30000000
CN4813300000000,48,133,"Eastland County, TX",Oct-22,6953,6664,289,4.20000000
CN4813500000000,48,135,"Ector County, TX",Oct-22,81068,77681,3387,4.20000000
CN4813700000000,48,137,"Edwards County, TX",Oct-22,1242,1212,30,2.40000000
CN4813900000000,48,139,"Ellis County, TX",Oct-22,104586,101199,3387,3.20000000
CN4814100000000,48,141,"El Paso County, TX",Oct-22,361777,346156,15621,4.30000000
CN4814300000000,48,143,"Erath County, TX",Oct-22,20917,20237,680,3.30000000
CN4814500000000,48,145,"Falls County, TX",Oct-22,6662,6380,282,4.20000000
CN4814700000000,48,147,"Fannin County, TX",Oct-22,17474,16819,655,3.70000000
CN4814900000000,48,149,"Fayette County, TX",Oct-22,11412,11015,397,3.50000000
CN4815100000000,48,151,"Fisher County, TX",Oct-22,1529,1477,52,3.40000000
CN4815300000000,48,153,"Floyd County, TX",Oct-22,2354,2251,103,4.40000000
CN4815500000000,48,155,"Foard County, TX",Oct-22,599,583,16,2.70000000
CN4815700000000,48,157,"Fort Bend County, TX",Oct-22,422403,406224,16179,3.80000000
CN4815900000000,48,159,"Franklin County, TX",Oct-22,5140,4964,176,3.40000000
CN4816100000000,48,161,"Freestone County, TX",Oct-22,6035,5713,322,5.30000000
CN4816300000000,48,163,"Frio County, TX",Oct-22,9029,8745,284,3.10000000
CN4816500000000,48,165,"Gaines County, TX",Oct-22,9533,9253,280,2.90000000
CN4816700000000,48,167,"Galveston County, TX",Oct-22,170348,163114,7234,4.20000000
CN4816900000000,48,169,"Garza County, TX",Oct-22,1935,1857,78,4.00000000
CN4817100000000,48,171,"Gillespie County, TX",Oct-22,14881,14533,348,2.30000000
CN4817300000000,48,173,"Glasscock County, TX",Oct-22,769,748,21,2.70000000
CN4817500000000,48,175,"Goliad County, TX",Oct-22,3137,2997,140,4.50000000
CN4817700000000,48,177,"Gonzales County, TX",Oct-22,9359,9068,291,3.10000000
CN4817900000000,48,179,"Gray County, TX",Oct-22,7554,7223,331,4.40000000
CN4818100000000,48,181,"Grayson County, TX",Oct-22,67356,65067,2289,3.40000000
CN4818300000000,48,183,"Gregg County, TX",Oct-22,56585,54174,2411,4.30000000
CN4818500000000,48,185,"Grimes County, TX",Oct-22,11038,10517,521,4.70000000
CN4818700000000,48,187,"Guadalupe County, TX",Oct-22,84865,82146,2719,3.20000000
CN4818900000000,48,189,"Hale County, TX",Oct-22,11735,11173,562,4.80000000
CN4819100000000,48,191,"Hall County, TX",Oct-22,1042,1001,41,3.90000000
CN4819300000000,48,193,"Hamilton County, TX",Oct-22,3665,3543,122,3.30000000
CN4819500000000,48,195,"Hansford County, TX",Oct-22,2487,2418,69,2.80000000
CN4819700000000,48,197,"Hardeman County, TX",Oct-22,1653,1595,58,3.50000000
CN4819900000000,48,199,"Hardin County, TX",Oct-22,24848,23580,1268,5.10000000
CN4820100000000,48,201,"Harris County, TX",Oct-22,2360435,2263558,96877,4.10000000
CN4820300000000,48,203,"Harrison County, TX",Oct-22,27965,26694,1271,4.50000000
CN4820500000000,48,205,"Hartley County, TX",Oct-22,2660,2611,49,1.80000000
CN4820700000000,48,207,"Haskell County, TX",Oct-22,2671,2591,80,3.00000000
CN4820900000000,48,209,"Hays County, TX",Oct-22,135673,131738,3935,2.90000000
CN4821100000000,48,211,"Hemphill County, TX",Oct-22,1436,1388,48,3.30000000
CN4821300000000,48,213,"Henderson County, TX",Oct-22,39285,37875,1410,3.60000000
CN4821500000000,48,215,"Hidalgo County, TX",Oct-22,368367,345851,22516,6.10000000
CN4821700000000,48,217,"Hill County, TX",Oct-22,17277,16524,753,4.40000000
CN4821900000000,48,219,"Hockley County, TX",Oct-22,11011,10628,383,3.50000000
CN4822100000000,48,221,"Hood County, TX",Oct-22,29878,28793,1085,3.60000000
CN4822300000000,48,223,"Hopkins County, TX",Oct-22,18232,17516,716,3.90000000
CN4822500000000,48,225,"Houston County, TX",Oct-22,10757,10390,367,3.40000000
CN4822700000000,48,227,"Howard County, TX",Oct-22,13327,12749,578,4.30000000
CN4822900000000,48,229,"Hudspeth County, TX",Oct-22,1792,1714,78,4.40000000
CN4823100000000,48,231,"Hunt County, TX",Oct-22,47391,45605,1786,3.80000000
CN4823300000000,48,233,"Hutchinson County, TX",Oct-22,8056,7704,352,4.40000000
CN4823500000000,48,235,"Irion County, TX",Oct-22,753,732,21,2.80000000
CN4823700000000,48,237,"Jack County, TX",Oct-22,3448,3324,124,3.60000000
CN4823900000000,48,239,"Jackson County, TX",Oct-22,6835,6606,229,3.40000000
CN4824100000000,48,241,"Jasper County, TX",Oct-22,12674,11885,789,6.20000000
CN4824300000000,48,243,"Jeff Davis County, TX",Oct-22,983,950,33,3.40000000
CN4824500000000,48,245,"Jefferson County, TX",Oct-22,100790,94677,6113,6.10000000
CN4824700000000,48,247,"Jim Hogg County, TX",Oct-22,1781,1685,96,5.40000000
CN4824900000000,48,249,"Jim Wells County, TX",Oct-22,15160,14255,905,6.00000000
CN4825100000000,48,251,"Johnson County, TX",Oct-22,88941,86056,2885,3.20000000
CN4825300000000,48,253,"Jones County, TX",Oct-22,5613,5370,243,4.30000000
CN4825500000000,48,255,"Karnes County, TX",Oct-22,6871,6673,198,2.90000000
CN4825700000000,48,257,"Kaufman County, TX",Oct-22,76141,73379,2762,3.60000000
CN4825900000000,48,259,"Kendall County, TX",Oct-22,23459,22754,705,3.00000000
CN4826100000000,48,261,"Kenedy County, TX",Oct-22,173,162,11,6.40000000
CN4826300000000,48,263,"Kent County, TX",Oct-22,421,409,12,2.90000000
CN4826500000000,48,265,"Kerr County, TX",Oct-22,21770,21018,752,3.50000000
CN4826700000000,48,267,"Kimble County, TX",Oct-22,1880,1821,59,3.10000000
CN4826900000000,48,269,"King County, TX",Oct-22,616,612,4,0.60000000
CN4827100000000,48,271,"Kinney County, TX",Oct-22,1163,1107,56,4.80000000
CN4827300000000,48,273,"Kleberg County, TX",Oct-22,12897,12281,616,4.80000000
CN4827500000000,48,275,"Knox County, TX",Oct-22,1359,1305,54,4.00000000
CN4827700000000,48,277,"Lamar County, TX",Oct-22,24196,23192,1004,4.10000000
CN4827900000000,48,279,"Lamb County, TX",Oct-22,5010,4822,188,3.80000000
CN4828100000000,48,281,"Lampasas County, TX",Oct-22,9342,9012,330,3.50000000
CN4828300000000,48,283,"La Salle County, TX",Oct-22,3829,3723,106,2.80000000
CN4828500000000,48,285,"Lavaca County, TX",Oct-22,8509,8230,279,3.30000000
CN4828700000000,48,287,"Lee County, TX",Oct-22,8830,8550,280,3.20000000
CN4828900000000,48,289,"Leon County, TX",Oct-22,5947,5649,298,5.00000000
CN4829100000000,48,291,"Liberty County, TX",Oct-22,35450,33459,1991,5.60000000
CN4829300000000,48,293,"Limestone County, TX",Oct-22,8461,8085,376,4.40000000
CN4829500000000,48,295,"Lipscomb County, TX",Oct-22,1435,1394,41,2.90000000
CN4829700000000,48,297,"Live Oak County, TX",Oct-22,4665,4458,207,4.40000000
CN4829900000000,48,299,"Llano County, TX",Oct-22,9043,8705,338,3.70000000
CN4830100000000,48,301,"Loving County, TX",Oct-22,571,567,4,0.70000000
CN4830300000000,48,303,"Lubbock County, TX",Oct-22,162936,157836,5100,3.10000000
CN4830500000000,48,305,"Lynn County, TX",Oct-22,2759,2668,91,3.30000000
CN4830700000000,48,307,"McCulloch County, TX",Oct-22,3003,2871,132,4.40000000
CN4830900000000,48,309,"McLennan County, TX",Oct-22,124810,120605,4205,3.40000000
CN4831100000000,48,311,"McMullen County, TX",Oct-22,790,776,14,1.80000000
CN4831300000000,48,313,"Madison County, TX",Oct-22,4673,4481,192,4.10000000
CN4831500000000,48,315,"Marion County, TX",Oct-22,4236,4031,205,4.80000000
CN4831700000000,48,317,"Martin County, TX",Oct-22,2619,2545,74,2.80000000
CN4831900000000,48,319,"Mason County, TX",Oct-22,1775,1719,56,3.20000000
CN4832100000000,48,321,"Matagorda County, TX",Oct-22,16182,15208,974,6.00000000
CN4832300000000,48,323,"Maverick County, TX",Oct-22,22194,20573,1621,7.30000000
CN4832500000000,48,325,"Medina County, TX",Oct-22,22362,21550,812,3.60000000
CN4832700000000,48,327,"Menard County, TX",Oct-22,772,745,27,3.50000000
CN4832900000000,48,329,"Midland County, TX",Oct-22,101383,98392,2991,3.00000000
CN4833100000000,48,331,"Milam County, TX",Oct-22,10149,9723,426,4.20000000
CN4833300000000,48,333,"Mills County, TX",Oct-22,1806,1730,76,4.20000000
CN4833500000000,48,335,"Mitchell County, TX",Oct-22,2277,2178,99,4.30000000
CN4833700000000,48,337,"Montague County, TX",Oct-22,9266,8946,320,3.50000000
CN4833900000000,48,339,"Montgomery County, TX",Oct-22,304317,292866,11451,3.80000000
CN4834100000000,48,341,"Moore County, TX",Oct-22,10871,10596,275,2.50000000
CN4834300000000,48,343,"Morris County, TX",Oct-22,4367,4074,293,6.70000000
CN4834500000000,48,345,"Motley County, TX",Oct-22,429,411,18,4.20000000
CN4834700000000,48,347,"Nacogdoches County, TX",Oct-22,27925,26780,1145,4.10000000
CN4834900000000,48,349,"Navarro County, TX",Oct-22,24124,23280,844,3.50000000
CN4835100000000,48,351,"Newton County, TX",Oct-22,4846,4520,326,6.70000000
CN4835300000000,48,353,"Nolan County, TX",Oct-22,6878,6644,234,3.40000000
CN4835500000000,48,355,"Nueces County, TX",Oct-22,164079,156608,7471,4.60000000
CN4835700000000,48,357,"Ochiltree County, TX",Oct-22,3859,3733,126,3.30000000
CN4835900000000,48,359,"Oldham County, TX",Oct-22,897,872,25,2.80000000
CN4836100000000,48,361,"Orange County, TX",Oct-22,34830,32845,1985,5.70000000
CN4836300000000,48,363,"Palo Pinto County, TX",Oct-22,12675,12189,486,3.80000000
CN4836500000000,48,365,"Panola County, TX",Oct-22,9436,9021,415,4.40000000
CN4836700000000,48,367,"Parker County, TX",Oct-22,74515,72204,2311,3.10000000
CN4836900000000,48,369,"Parmer County, TX",Oct-22,4778,4661,117,2.40000000
CN4837100000000,48,371,"Pecos County, TX",Oct-22,5607,5362,245,4.40000000
CN4837300000000,48,373,"Polk County, TX",Oct-22,18267,17264,1003,5.50000000
CN4837500000000,48,375,"Potter County, TX",Oct-22,54094,52489,1605,3.00000000
CN4837700000000,48,377,"Presidio County, TX",Oct-22,3087,2882,205,6.60000000
CN4837900000000,48,379,"Rains County, TX",Oct-22,6658,6441,217,3.30000000
CN4838100000000,48,381,"Randall County, TX",Oct-22,74595,72553,2042,2.70000000
CN4838300000000,48,383,"Reagan County, TX",Oct-22,1543,1485,58,3.80000000
CN4838500000000,48,385,"Real County, TX",Oct-22,1060,1006,54,5.10000000
CN4838700000000,48,387,"Red River County, TX",Oct-22,5326,5079,247,4.60000000
CN4838900000000,48,389,"Reeves County, TX",Oct-22,9224,8890,334,3.60000000
CN4839100000000,48,391,"Refugio County, TX",Oct-22,2944,2816,128,4.30000000
CN4839300000000,48,393,"Roberts County, TX",Oct-22,379,367,12,3.20000000
CN4839500000000,48,395,"Robertson County, TX",Oct-22,7659,7376,283,3.70000000
CN4839700000000,48,397,"Rockwall County, TX",Oct-22,60053,58155,1898,3.20000000
CN4839900000000,48,399,"Runnels County, TX",Oct-22,4483,4339,144,3.20000000
CN4840100000000,48,401,"Rusk County, TX",Oct-22,22214,21292,922,4.20000000
CN4840300000000,48,403,"Sabine County, TX",Oct-22,3912,3656,256,6.50000000
CN4840500000000,48,405,"San Augustine County, TX",Oct-22,2947,2768,179,6.10000000
CN4840700000000,48,407,"San Jacinto County, TX",Oct-22,11916,11333,583,4.90000000
CN4840900000000,48,409,"San Patricio County, TX",Oct-22,29134,27463,1671,5.70000000
CN4841100000000,48,411,"San Saba County, TX",Oct-22,2074,2004,70,3.40000000
CN4841300000000,48,413,"Schleicher County, TX",Oct-22,1136,1096,40,3.50000000
CN4841500000000,48,415,"Scurry County, TX",Oct-22,5722,5472,250,4.40000000
CN4841700000000,48,417,"Shackelford County, TX",Oct-22,1790,1745,45,2.50000000
CN4841900000000,48,419,"Shelby County, TX",Oct-22,11561,11130,431,3.70000000
CN4842100000000,48,421,"Sherman County, TX",Oct-22,1424,1387,37,2.60000000
CN4842300000000,48,423,"Smith County, TX",Oct-22,111862,107895,3967,3.50000000
CN4842500000000,48,425,"Somervell County, TX",Oct-22,4577,4408,169,3.70000000
CN4842700000000,48,427,"Starr County, TX",Oct-22,23058,20589,2469,10.70000000
CN4842900000000,48,429,"Stephens County, TX",Oct-22,4226,4086,140,3.30000000
CN4843100000000,48,431,"Sterling County, TX",Oct-22,490,474,16,3.30000000
CN4843300000000,48,433,"Stonewall County, TX",Oct-22,562,543,19,3.40000000
CN4843500000000,48,435,"Sutton County, TX",Oct-22,1057,999,58,5.50000000
CN4843700000000,48,437,"Swisher County, TX",Oct-22,2541,2430,111,4.40000000
CN4843900000000,48,439,"Tarrant County, TX",Oct-22,1142443,1102771,39672,3.50000000
CN4844100000000,48,441,"Taylor County, TX",Oct-22,67065,64956,2109,3.10000000
CN4844300000000,48,443,"Terrell County, TX",Oct-22,424,412,12,2.80000000
CN4844500000000,48,445,"Terry County, TX",Oct-22,4447,4263,184,4.10000000
CN4844700000000,48,447,"Throckmorton County, TX",Oct-22,1452,1431,21,1.40000000
CN4844900000000,48,449,"Titus County, TX",Oct-22,13672,13099,573,4.20000000
CN4845100000000,48,451,"Tom Green County, TX",Oct-22,53735,51961,1774,3.30000000
CN4845300000000,48,453,"Travis County, TX",Oct-22,806765,784520,22245,2.80000000
CN4845500000000,48,455,"Trinity County, TX",Oct-22,5135,4864,271,5.30000000
CN4845700000000,48,457,"Tyler County, TX",Oct-22,7364,6944,420,5.70000000
CN4845900000000,48,459,"Upshur County, TX",Oct-22,17632,16908,724,4.10000000
CN4846100000000,48,461,"Upton County, TX",Oct-22,1644,1588,56,3.40000000
CN4846300000000,48,463,"Uvalde County, TX",Oct-22,10893,10416,477,4.40000000
CN4846500000000,48,465,"Val Verde County, TX",Oct-22,21950,20996,954,4.30000000
CN4846700000000,48,467,"Van Zandt County, TX",Oct-22,27286,26370,916,3.40000000
CN4846900000000,48,469,"Victoria County, TX",Oct-22,40706,39020,1686,4.10000000
CN4847100000000,48,471,"Walker County, TX",Oct-22,23315,22246,1069,4.60000000
CN4847300000000,48,473,"Waller County, TX",Oct-22,25534,24457,1077,4.20000000
CN4847500000000,48,475,"Ward County, TX",Oct-22,6387,6163,224,3.50000000
CN4847700000000,48,477,"Washington County, TX",Oct-22,14623,14060,563,3.90000000
CN4847900000000,48,479,"Webb County, TX",Oct-22,117749,113307,4442,3.80000000
CN4848100000000,48,481,"Wharton County, TX",Oct-22,20731,19955,776,3.70000000
CN4848300000000,48,483,"Wheeler County, TX",Oct-22,1810,1737,73,4.00000000
CN4848500000000,48,485,"Wichita County, TX",Oct-22,55294,53287,2007,3.60000000
CN4848700000000,48,487,"Wilbarger County, TX",Oct-22,4609,4388,221,4.80000000
CN4848900000000,48,489,"Willacy County, TX",Oct-22,6985,6445,540,7.70000000
CN4849100000000,48,491,"Williamson County, TX",Oct-22,357179,346915,10264,2.90000000
CN4849300000000,48,493,"Wilson County, TX",Oct-22,25714,24932,782,3.00000000
CN4849500000000,48,495,"Winkler County, TX",Oct-22,3603,3453,150,4.20000000
CN4849700000000,48,497,"Wise County, TX",Oct-22,34181,33056,1125,3.30000000
CN4849900000000,48,499,"Wood County, TX",Oct-22,17792,17018,774,4.40000000
CN4850100000000,48,501,"Yoakum County, TX",Oct-22,2994,2861,133,4.40000000
CN4850300000000,48,503,"Young County, TX",Oct-22,7999,7749,250,3.10000000
CN4850500000000,48,505,"Zapata County, TX",Oct-22,4427,4123,304,6.90000000
CN4850700000000,48,507,"Zavala County, TX",Oct-22,3187,2909,278,8.70000000
CN4900100000000,49,001,"Beaver County, UT",Oct-22,2749,2678,71,2.60000000
CN4900300000000,49,003,"Box Elder County, UT",Oct-22,27779,27238,541,1.90000000
CN4900500000000,49,005,"Cache County, UT",Oct-22,72495,71248,1247,1.70000000
CN4900700000000,49,007,"Carbon County, UT",Oct-22,8555,8306,249,2.90000000
CN4900900000000,49,009,"Daggett County, UT",Oct-22,403,388,15,3.70000000
CN4901100000000,49,011,"Davis County, UT",Oct-22,186372,182749,3623,1.90000000
CN4901300000000,49,013,"Duchesne County, UT",Oct-22,8153,7947,206,2.50000000
CN4901500000000,49,015,"Emery County, UT",Oct-22,4527,4423,104,2.30000000
CN4901700000000,49,017,"Garfield County, UT",Oct-22,2989,2894,95,3.20000000
CN4901900000000,49,019,"Grand County, UT",Oct-22,7281,7141,140,1.90000000
CN4902100000000,49,021,"Iron County, UT",Oct-22,28490,27919,571,2.00000000
CN4902300000000,49,023,"Juab County, UT",Oct-22,6561,6444,117,1.80000000
CN4902500000000,49,025,"Kane County, UT",Oct-22,4132,4056,76,1.80000000
CN4902700000000,49,027,"Millard County, UT",Oct-22,6078,5958,120,2.00000000
CN4902900000000,49,029,"Morgan County, UT",Oct-22,6010,5902,108,1.80000000
CN4903100000000,49,031,"Piute County, UT",Oct-22,524,505,19,3.60000000
CN4903300000000,49,033,"Rich County, UT",Oct-22,1113,1087,26,2.30000000
CN4903500000000,49,035,"Salt Lake County, UT",Oct-22,675273,661370,13903,2.10000000
CN4903700000000,49,037,"San Juan County, UT",Oct-22,5678,5486,192,3.40000000
CN4903900000000,49,039,"Sanpete County, UT",Oct-22,13465,13140,325,2.40000000
CN4904100000000,49,041,"Sevier County, UT",Oct-22,10341,10099,242,2.30000000
CN4904300000000,49,043,"Summit County, UT",Oct-22,25394,24856,538,2.10000000
CN4904500000000,49,045,"Tooele County, UT",Oct-22,38065,37181,884,2.30000000
CN4904700000000,49,047,"Uintah County, UT",Oct-22,14158,13723,435,3.10000000
CN4904900000000,49,049,"Utah County, UT",Oct-22,352956,346267,6689,1.90000000
CN4905100000000,49,051,"Wasatch County, UT",Oct-22,17769,17403,366,2.10000000
CN4905300000000,49,053,"Washington County, UT",Oct-22,88153,86295,1858,2.10000000
CN4905500000000,49,055,"Wayne County, UT",Oct-22,1483,1441,42,2.80000000
CN4905700000000,49,057,"Weber County, UT",Oct-22,136442,133579,2863,2.10000000
CN5000100000000,50,001,"Addison County, VT",Oct-22,20632,20304,328,1.60000000
CN5000300000000,50,003,"Bennington County, VT",Oct-22,17396,17032,364,2.10000000
CN5000500000000,50,005,"Caledonia County, VT",Oct-22,14162,13873,289,2.00000000
CN5000700000000,50,007,"Chittenden County, VT",Oct-22,96839,95346,1493,1.50000000
CN5000900000000,50,009,"Essex County, VT",Oct-22,2593,2518,75,2.90000000
CN5001100000000,50,011,"Franklin County, VT",Oct-22,27675,27206,469,1.70000000
CN5001300000000,50,013,"Grand Isle County, VT",Oct-22,4072,4000,72,1.80000000
CN5001500000000,50,015,"Lamoille County, VT",Oct-22,13598,13304,294,2.20000000
CN5001700000000,50,017,"Orange County, VT",Oct-22,15310,15055,255,1.70000000
CN5001900000000,50,019,"Orleans County, VT",Oct-22,12579,12239,340,2.70000000
CN5002100000000,50,021,"Rutland County, VT",Oct-22,28832,28173,659,2.30000000
CN5002300000000,50,023,"Washington County, VT",Oct-22,33044,32479,565,1.70000000
CN5002500000000,50,025,"Windham County, VT",Oct-22,20320,19907,413,2.00000000
CN5002700000000,50,027,"Windsor County, VT",Oct-22,27763,27312,451,1.60000000
CN5100100000000,51,001,"Accomack County, VA",Oct-22,15942,15503,439,2.80000000
CN5100300000000,51,003,"Albemarle County, VA",Oct-22,56906,55433,1473,2.60000000
CN5100500000000,51,005,"Alleghany County, VA",Oct-22,6996,6809,187,2.70000000
CN5100700000000,51,007,"Amelia County, VA",Oct-22,6083,5918,165,2.70000000
CN5100900000000,51,009,"Amherst County, VA",Oct-22,14682,14246,436,3.00000000
CN5101100000000,51,011,"Appomattox County, VA",Oct-22,7068,6860,208,2.90000000
CN5101300000000,51,013,"Arlington County, VA",Oct-22,153564,150553,3011,2.00000000
CN5101500000000,51,015,"Augusta County, VA",Oct-22,37297,36401,896,2.40000000
CN5101700000000,51,017,"Bath County, VA",Oct-22,2428,2371,57,2.30000000
CN5101900000000,51,019,"Bedford County, VA",Oct-22,38068,37062,1006,2.60000000
CN5102100000000,51,021,"Bland County, VA",Oct-22,2883,2814,69,2.40000000
CN5102300000000,51,023,"Botetourt County, VA",Oct-22,17101,16680,421,2.50000000
CN5102500000000,51,025,"Brunswick County, VA",Oct-22,6047,5778,269,4.40000000
CN5102700000000,51,027,"Buchanan County, VA",Oct-22,6662,6363,299,4.50000000
CN5102900000000,51,029,"Buckingham County, VA",Oct-22,6311,6078,233,3.70000000
CN5103100000000,51,031,"Campbell County, VA",Oct-22,25507,24781,726,2.80000000
CN5103300000000,51,033,"Caroline County, VA",Oct-22,14822,14360,462,3.10000000
CN5103500000000,51,035,"Carroll County, VA",Oct-22,13918,13511,407,2.90000000
CN5103600000000,51,036,"Charles City County, VA",Oct-22,3489,3381,108,3.10000000
CN5103700000000,51,037,"Charlotte County, VA",Oct-22,5947,5793,154,2.60000000
CN5104100000000,51,041,"Chesterfield County, VA",Oct-22,186802,181622,5180,2.80000000
CN5104300000000,51,043,"Clarke County, VA",Oct-22,7544,7371,173,2.30000000
CN5104500000000,51,045,"Craig County, VA",Oct-22,2240,2175,65,2.90000000
CN5104700000000,51,047,"Culpeper County, VA",Oct-22,25070,24419,651,2.60000000
CN5104900000000,51,049,"Cumberland County, VA",Oct-22,4821,4684,137,2.80000000
CN5105100000000,51,051,"Dickenson County, VA",Oct-22,5289,5102,187,3.50000000
CN5105300000000,51,053,"Dinwiddie County, VA",Oct-22,13341,12920,421,3.20000000
CN5105700000000,51,057,"Essex County, VA",Oct-22,5382,5200,182,3.40000000
CN5105900000000,51,059,"Fairfax County, VA",Oct-22,625648,610800,14848,2.40000000
CN5106100000000,51,061,"Fauquier County, VA",Oct-22,37109,36206,903,2.40000000
CN5106300000000,51,063,"Floyd County, VA",Oct-22,8560,8371,189,2.20000000
CN5106500000000,51,065,"Fluvanna County, VA",Oct-22,13891,13563,328,2.40000000
CN5106700000000,51,067,"Franklin County, VA",Oct-22,25681,24951,730,2.80000000
CN5106900000000,51,069,"Frederick County, VA",Oct-22,50236,49069,1167,2.30000000
CN5107100000000,51,071,"Giles County, VA",Oct-22,8163,7935,228,2.80000000
CN5107300000000,51,073,"Gloucester County, VA",Oct-22,19131,18637,494,2.60000000
CN5107500000000,51,075,"Goochland County, VA",Oct-22,11440,11140,300,2.60000000
CN5107700000000,51,077,"Grayson County, VA",Oct-22,9230,9039,191,2.10000000
CN5107900000000,51,079,"Greene County, VA",Oct-22,10422,10183,239,2.30000000
CN5108100000000,51,081,"Greensville County, VA",Oct-22,4641,4487,154,3.30000000
CN5108300000000,51,083,"Halifax County, VA",Oct-22,16268,15690,578,3.60000000
CN5108500000000,51,085,"Hanover County, VA",Oct-22,57985,56586,1399,2.40000000
CN5108700000000,51,087,"Henrico County, VA",Oct-22,178688,173746,4942,2.80000000
CN5108900000000,51,089,"Henry County, VA",Oct-22,26120,25356,764,2.90000000
CN5109100000000,51,091,"Highland County, VA",Oct-22,1324,1297,27,2.00000000
CN5109300000000,51,093,"Isle of Wight County, VA",Oct-22,19314,18801,513,2.70000000
CN5109500000000,51,095,"James City County, VA",Oct-22,36211,35217,994,2.70000000
CN5109700000000,51,097,"King and Queen County, VA",Oct-22,4040,3949,91,2.30000000
CN5109900000000,51,099,"King George County, VA",Oct-22,14704,14361,343,2.30000000
CN5110100000000,51,101,"King William County, VA",Oct-22,9253,9016,237,2.60000000
CN5110300000000,51,103,"Lancaster County, VA",Oct-22,5771,5610,161,2.80000000
CN5110500000000,51,105,"Lee County, VA",Oct-22,8858,8558,300,3.40000000
CN5110700000000,51,107,"Loudoun County, VA",Oct-22,227500,222284,5216,2.30000000
CN5110900000000,51,109,"Louisa County, VA",Oct-22,21690,21189,501,2.30000000
CN5111100000000,51,111,"Lunenburg County, VA",Oct-22,5398,5218,180,3.30000000
CN5111300000000,51,113,"Madison County, VA",Oct-22,7797,7643,154,2.00000000
CN5111500000000,51,115,"Mathews County, VA",Oct-22,4010,3900,110,2.70000000
CN5111700000000,51,117,"Mecklenburg County, VA",Oct-22,13724,13303,421,3.10000000
CN5111900000000,51,119,"Middlesex County, VA",Oct-22,5469,5335,134,2.50000000
CN5112100000000,51,121,"Montgomery County, VA",Oct-22,52300,50913,1387,2.70000000
CN5112500000000,51,125,"Nelson County, VA",Oct-22,7250,7066,184,2.50000000
CN5112700000000,51,127,"New Kent County, VA",Oct-22,12784,12482,302,2.40000000
CN5113100000000,51,131,"Northampton County, VA",Oct-22,5784,5593,191,3.30000000
CN5113300000000,51,133,"Northumberland County, VA",Oct-22,5945,5763,182,3.10000000
CN5113500000000,51,135,"Nottoway County, VA",Oct-22,7490,7279,211,2.80000000
CN5113700000000,51,137,"Orange County, VA",Oct-22,17922,17447,475,2.70000000
CN5113900000000,51,139,"Page County, VA",Oct-22,12914,12554,360,2.80000000
CN5114100000000,51,141,"Patrick County, VA",Oct-22,7542,7312,230,3.00000000
CN5114300000000,51,143,"Pittsylvania County, VA",Oct-22,32467,31602,865,2.70000000
CN5114500000000,51,145,"Powhatan County, VA",Oct-22,14163,13813,350,2.50000000
CN5114700000000,51,147,"Prince Edward County, VA",Oct-22,11313,10939,374,3.30000000
CN5114900000000,51,149,"Prince George County, VA",Oct-22,14845,14352,493,3.30000000
CN5115300000000,51,153,"Prince William County, VA",Oct-22,245682,239202,6480,2.60000000
CN5115500000000,51,155,"Pulaski County, VA",Oct-22,16703,16252,451,2.70000000
CN5115700000000,51,157,"Rappahannock County, VA",Oct-22,3654,3570,84,2.30000000
CN5115900000000,51,159,"Richmond County, VA",Oct-22,4183,4085,98,2.30000000
CN5116100000000,51,161,"Roanoke County, VA",Oct-22,48151,46963,1188,2.50000000
CN5116300000000,51,163,"Rockbridge County, VA",Oct-22,11654,11376,278,2.40000000
CN5116500000000,51,165,"Rockingham County, VA",Oct-22,42657,41644,1013,2.40000000
CN5116700000000,51,167,"Russell County, VA",Oct-22,11548,11206,342,3.00000000
CN5116900000000,51,169,"Scott County, VA",Oct-22,8969,8693,276,3.10000000
CN5117100000000,51,171,"Shenandoah County, VA",Oct-22,23243,22649,594,2.60000000
CN5117300000000,51,173,"Smyth County, VA",Oct-22,15873,15485,388,2.40000000
CN5117500000000,51,175,"Southampton County, VA",Oct-22,9267,9037,230,2.50000000
CN5117700000000,51,177,"Spotsylvania County, VA",Oct-22,68017,66074,1943,2.90000000
CN5117900000000,51,179,"Stafford County, VA",Oct-22,74049,72008,2041,2.80000000
CN5118100000000,51,181,"Surry County, VA",Oct-22,3638,3545,93,2.60000000
CN5118300000000,51,183,"Sussex County, VA",Oct-22,3615,3461,154,4.30000000
CN5118500000000,51,185,"Tazewell County, VA",Oct-22,16385,15817,568,3.50000000
CN5118700000000,51,187,"Warren County, VA",Oct-22,20318,19786,532,2.60000000
CN5119100000000,51,191,"Washington County, VA",Oct-22,25659,24960,699,2.70000000
CN5119300000000,51,193,"Westmoreland County, VA",Oct-22,10246,9964,282,2.80000000
CN5119500000000,51,195,"Wise County, VA",Oct-22,14816,14311,505,3.40000000
CN5119700000000,51,197,"Wythe County, VA",Oct-22,15034,14650,384,2.60000000
CN5119900000000,51,199,"York County, VA",Oct-22,32486,31623,863,2.70000000
CN5151000000000,51,510,"Alexandria city, VA",Oct-22,98675,96466,2209,2.20000000
CN5152000000000,51,520,"Bristol city, VA",Oct-22,7377,7125,252,3.40000000
CN5153000000000,51,530,"Buena Vista city, VA",Oct-22,3287,3198,89,2.70000000
CN5154000000000,51,540,"Charlottesville city, VA",Oct-22,25136,24516,620,2.50000000
CN5155000000000,51,550,"Chesapeake city, VA",Oct-22,121362,117908,3454,2.80000000
CN5157000000000,51,570,"Colonial Heights city, VA",Oct-22,8229,7968,261,3.20000000
CN5158000000000,51,580,"Covington city, VA",Oct-22,2454,2361,93,3.80000000
CN5159000000000,51,590,"Danville city, VA",Oct-22,20024,19155,869,4.30000000
CN5159500000000,51,595,"Emporia city, VA",Oct-22,2554,2437,117,4.60000000
CN5160000000000,51,600,"Fairfax city, VA",Oct-22,12661,12350,311,2.50000000
CN5161000000000,51,610,"Falls Church city, VA",Oct-22,8391,8207,184,2.20000000
CN5162000000000,51,620,"Franklin city, VA",Oct-22,3578,3425,153,4.30000000
CN5163000000000,51,630,"Fredericksburg city, VA",Oct-22,14071,13606,465,3.30000000
CN5164000000000,51,640,"Galax city, VA",Oct-22,3085,3006,79,2.60000000
CN5165000000000,51,650,"Hampton city, VA",Oct-22,63216,60708,2508,4.00000000
CN5166000000000,51,660,"Harrisonburg city, VA",Oct-22,24721,23876,845,3.40000000
CN5167000000000,51,670,"Hopewell city, VA",Oct-22,9340,8883,457,4.90000000
CN5167800000000,51,678,"Lexington city, VA",Oct-22,2321,2227,94,4.00000000
CN5168000000000,51,680,"Lynchburg city, VA",Oct-22,35339,33974,1365,3.90000000
CN5168300000000,51,683,"Manassas city, VA",Oct-22,21292,20755,537,2.50000000
CN5168500000000,51,685,"Manassas Park city, VA",Oct-22,9596,9363,233,2.40000000
CN5169000000000,51,690,"Martinsville city, VA",Oct-22,6031,5736,295,4.90000000
CN5170000000000,51,700,"Newport News city, VA",Oct-22,86690,83499,3191,3.70000000
CN5171000000000,51,710,"Norfolk city, VA",Oct-22,108091,104150,3941,3.60000000
CN5172000000000,51,720,"Norton city, VA",Oct-22,1823,1768,55,3.00000000
CN5173000000000,51,730,"Petersburg city, VA",Oct-22,12274,11490,784,6.40000000
CN5173500000000,51,735,"Poquoson city, VA",Oct-22,6254,6106,148,2.40000000
CN5174000000000,51,740,"Portsmouth city, VA",Oct-22,43326,41544,1782,4.10000000
CN5175000000000,51,750,"Radford city, VA",Oct-22,9046,8732,314,3.50000000
CN5176000000000,51,760,"Richmond city, VA",Oct-22,116702,112572,4130,3.50000000
CN5177000000000,51,770,"Roanoke city, VA",Oct-22,47375,45907,1468,3.10000000
CN5177500000000,51,775,"Salem city, VA",Oct-22,12455,12101,354,2.80000000
CN5179000000000,51,790,"Staunton city, VA",Oct-22,12096,11780,316,2.60000000
CN5180000000000,51,800,"Suffolk city, VA",Oct-22,44622,43319,1303,2.90000000
CN5181000000000,51,810,"Virginia Beach city, VA",Oct-22,227101,220961,6140,2.70000000
CN5182000000000,51,820,"Waynesboro city, VA",Oct-22,10500,10205,295,2.80000000
CN5183000000000,51,830,"Williamsburg city, VA",Oct-22,6689,6404,285,4.30000000
CN5184000000000,51,840,"Winchester city, VA",Oct-22,14749,14368,381,2.60000000
CN5300100000000,53,001,"Adams County, WA",Oct-22,10488,10143,345,3.30000000
CN5300300000000,53,003,"Asotin County, WA",Oct-22,10741,10405,336,3.10000000
CN5300500000000,53,005,"Benton County, WA",Oct-22,108706,104421,4285,3.90000000
CN5300700000000,53,007,"Chelan County, WA",Oct-22,45310,43731,1579,3.50000000
CN5300900000000,53,009,"Clallam County, WA",Oct-22,30086,28621,1465,4.90000000
CN5301100000000,53,011,"Clark County, WA",Oct-22,257124,247215,9909,3.90000000
CN5301300000000,53,013,"Columbia County, WA",Oct-22,1832,1758,74,4.00000000
CN5301500000000,53,015,"Cowlitz County, WA",Oct-22,49329,46898,2431,4.90000000
CN5301700000000,53,017,"Douglas County, WA",Oct-22,22270,21414,856,3.80000000
CN5301900000000,53,019,"Ferry County, WA",Oct-22,2281,2113,168,7.40000000
CN5302100000000,53,021,"Franklin County, WA",Oct-22,44915,42860,2055,4.60000000
CN5302300000000,53,023,"Garfield County, WA",Oct-22,797,756,41,5.10000000
CN5302500000000,53,025,"Grant County, WA",Oct-22,48872,46655,2217,4.50000000
CN5302700000000,53,027,"Grays Harbor County, WA",Oct-22,29004,27225,1779,6.10000000
CN5302900000000,53,029,"Island County, WA",Oct-22,37102,35533,1569,4.20000000
CN5303100000000,53,031,"Jefferson County, WA",Oct-22,13013,12416,597,4.60000000
CN5303300000000,53,033,"King County, WA",Oct-22,1321206,1284025,37181,2.80000000
CN5303500000000,53,035,"Kitsap County, WA",Oct-22,130749,125843,4906,3.80000000
CN5303700000000,53,037,"Kittitas County, WA",Oct-22,22320,21296,1024,4.60000000
CN5303900000000,53,039,"Klickitat County, WA",Oct-22,9932,9485,447,4.50000000
CN5304100000000,53,041,"Lewis County, WA",Oct-22,35292,33529,1763,5.00000000
CN5304300000000,53,043,"Lincoln County, WA",Oct-22,4710,4518,192,4.10000000
CN5304500000000,53,045,"Mason County, WA",Oct-22,26128,24738,1390,5.30000000
CN5304700000000,53,047,"Okanogan County, WA",Oct-22,19924,19023,901,4.50000000
CN5304900000000,53,049,"Pacific County, WA",Oct-22,8930,8303,627,7.00000000
CN5305100000000,53,051,"Pend Oreille County, WA",Oct-22,5226,4940,286,5.50000000
CN5305300000000,53,053,"Pierce County, WA",Oct-22,454628,434667,19961,4.40000000
CN5305500000000,53,055,"San Juan County, WA",Oct-22,8416,8141,275,3.30000000
CN5305700000000,53,057,"Skagit County, WA",Oct-22,62827,60134,2693,4.30000000
CN5305900000000,53,059,"Skamania County, WA",Oct-22,5736,5495,241,4.20000000
CN5306100000000,53,061,"Snohomish County, WA",Oct-22,450293,436136,14157,3.10000000
CN5306300000000,53,063,"Spokane County, WA",Oct-22,267049,256903,10146,3.80000000
CN5306500000000,53,065,"Stevens County, WA",Oct-22,19422,18439,983,5.10000000
CN5306700000000,53,067,"Thurston County, WA",Oct-22,147039,141212,5827,4.00000000
CN5306900000000,53,069,"Wahkiakum County, WA",Oct-22,1357,1273,84,6.20000000
CN5307100000000,53,071,"Walla Walla County, WA",Oct-22,32516,31429,1087,3.30000000
CN5307300000000,53,073,"Whatcom County, WA",Oct-22,116944,112145,4799,4.10000000
CN5307500000000,53,075,"Whitman County, WA",Oct-22,23873,23024,849,3.60000000
CN5307700000000,53,077,"Yakima County, WA",Oct-22,137004,130497,6507,4.70000000
CN5400100000000,54,001,"Barbour County, WV",Oct-22,7319,7020,299,4.10000000
CN5400300000000,54,003,"Berkeley County, WV",Oct-22,60974,59357,1617,2.70000000
CN5400500000000,54,005,"Boone County, WV",Oct-22,7162,6873,289,4.00000000
CN5400700000000,54,007,"Braxton County, WV",Oct-22,4956,4719,237,4.80000000
CN5400900000000,54,009,"Brooke County, WV",Oct-22,9882,9478,404,4.10000000
CN5401100000000,54,011,"Cabell County, WV",Oct-22,41350,40055,1295,3.10000000
CN5401300000000,54,013,"Calhoun County, WV",Oct-22,2589,2418,171,6.60000000
CN5401500000000,54,015,"Clay County, WV",Oct-22,2994,2848,146,4.90000000
CN5401700000000,54,017,"Doddridge County, WV",Oct-22,3802,3701,101,2.70000000
CN5401900000000,54,019,"Fayette County, WV",Oct-22,16280,15657,623,3.80000000
CN5402100000000,54,021,"Gilmer County, WV",Oct-22,2419,2318,101,4.20000000
CN5402300000000,54,023,"Grant County, WV",Oct-22,5986,5815,171,2.90000000
CN5402500000000,54,025,"Greenbrier County, WV",Oct-22,15682,15173,509,3.20000000
CN5402700000000,54,027,"Hampshire County, WV",Oct-22,11423,11157,266,2.30000000
CN5402900000000,54,029,"Hancock County, WV",Oct-22,13027,12433,594,4.60000000
CN5403100000000,54,031,"Hardy County, WV",Oct-22,5930,5737,193,3.30000000
CN5403300000000,54,033,"Harrison County, WV",Oct-22,33210,32205,1005,3.00000000
CN5403500000000,54,035,"Jackson County, WV",Oct-22,11900,11482,418,3.50000000
CN5403700000000,54,037,"Jefferson County, WV",Oct-22,31048,30348,700,2.30000000
CN5403900000000,54,039,"Kanawha County, WV",Oct-22,80793,78181,2612,3.20000000
CN5404100000000,54,041,"Lewis County, WV",Oct-22,6046,5772,274,4.50000000
CN5404300000000,54,043,"Lincoln County, WV",Oct-22,7016,6707,309,4.40000000
CN5404500000000,54,045,"Logan County, WV",Oct-22,10973,10510,463,4.20000000
CN5404700000000,54,047,"McDowell County, WV",Oct-22,4288,4046,242,5.60000000
CN5404900000000,54,049,"Marion County, WV",Oct-22,25238,24302,936,3.70000000
CN5405100000000,54,051,"Marshall County, WV",Oct-22,13422,12889,533,4.00000000
CN5405300000000,54,053,"Mason County, WV",Oct-22,10070,9690,380,3.80000000
CN5405500000000,54,055,"Mercer County, WV",Oct-22,20954,20126,828,4.00000000
CN5405700000000,54,057,"Mineral County, WV",Oct-22,12305,11909,396,3.20000000
CN5405900000000,54,059,"Mingo County, WV",Oct-22,6075,5730,345,5.70000000
CN5406100000000,54,061,"Monongalia County, WV",Oct-22,58490,56933,1557,2.70000000
CN5406300000000,54,063,"Monroe County, WV",Oct-22,6278,6124,154,2.50000000
CN5406500000000,54,065,"Morgan County, WV",Oct-22,8739,8531,208,2.40000000
CN5406700000000,54,067,"Nicholas County, WV",Oct-22,9147,8783,364,4.00000000
CN5406900000000,54,069,"Ohio County, WV",Oct-22,20505,19838,667,3.30000000
CN5407100000000,54,071,"Pendleton County, WV",Oct-22,3884,3805,79,2.00000000
CN5407300000000,54,073,"Pleasants County, WV",Oct-22,2708,2583,125,4.60000000
CN5407500000000,54,075,"Pocahontas County, WV",Oct-22,4297,4173,124,2.90000000
CN5407700000000,54,077,"Preston County, WV",Oct-22,16445,15918,527,3.20000000
CN5407900000000,54,079,"Putnam County, WV",Oct-22,26878,26156,722,2.70000000
CN5408100000000,54,081,"Raleigh County, WV",Oct-22,30771,29778,993,3.20000000
CN5408300000000,54,083,"Randolph County, WV",Oct-22,11826,11350,476,4.00000000
CN5408500000000,54,085,"Ritchie County, WV",Oct-22,4318,4162,156,3.60000000
CN5408700000000,54,087,"Roane County, WV",Oct-22,4960,4715,245,4.90000000
CN5408900000000,54,089,"Summers County, WV",Oct-22,4578,4448,130,2.80000000
CN5409100000000,54,091,"Taylor County, WV",Oct-22,7844,7611,233,3.00000000
CN5409300000000,54,093,"Tucker County, WV",Oct-22,3328,3211,117,3.50000000
CN5409500000000,54,095,"Tyler County, WV",Oct-22,2951,2806,145,4.90000000
CN5409700000000,54,097,"Upshur County, WV",Oct-22,9685,9280,405,4.20000000
CN5409900000000,54,099,"Wayne County, WV",Oct-22,15498,14983,515,3.30000000
CN5410100000000,54,101,"Webster County, WV",Oct-22,3322,3197,125,3.80000000
CN5410300000000,54,103,"Wetzel County, WV",Oct-22,6766,6469,297,4.40000000
CN5410500000000,54,105,"Wirt County, WV",Oct-22,2314,2201,113,4.90000000
CN5410700000000,54,107,"Wood County, WV",Oct-22,37297,36020,1277,3.40000000
CN5410900000000,54,109,"Wyoming County, WV",Oct-22,7358,7082,276,3.80000000
CN5500100000000,55,001,"Adams County, WI",Oct-22,7514,7182,332,4.40000000
CN5500300000000,55,003,"Ashland County, WI",Oct-22,7376,7138,238,3.20000000
CN5500500000000,55,005,"Barron County, WI",Oct-22,23096,22465,631,2.70000000
CN5500700000000,55,007,"Bayfield County, WI",Oct-22,7187,6914,273,3.80000000
CN5500900000000,55,009,"Brown County, WI",Oct-22,141209,137591,3618,2.60000000
CN5501100000000,55,011,"Buffalo County, WI",Oct-22,5908,5725,183,3.10000000
CN5501300000000,55,013,"Burnett County, WI",Oct-22,7002,6743,259,3.70000000
CN5501500000000,55,015,"Calumet County, WI",Oct-22,27262,26660,602,2.20000000
CN5501700000000,55,017,"Chippewa County, WI",Oct-22,32742,31854,888,2.70000000
CN5501900000000,55,019,"Clark County, WI",Oct-22,16789,16408,381,2.30000000
CN5502100000000,55,021,"Columbia County, WI",Oct-22,31543,30767,776,2.50000000
CN5502300000000,55,023,"Crawford County, WI",Oct-22,6830,6613,217,3.20000000
CN5502500000000,55,025,"Dane County, WI",Oct-22,330478,323250,7228,2.20000000
CN5502700000000,55,027,"Dodge County, WI",Oct-22,46925,45783,1142,2.40000000
CN5502900000000,55,029,"Door County, WI",Oct-22,15224,14843,381,2.50000000
CN5503100000000,55,031,"Douglas County, WI",Oct-22,23246,22463,783,3.40000000
CN5503300000000,55,033,"Dunn County, WI",Oct-22,24312,23675,637,2.60000000
CN5503500000000,55,035,"Eau Claire County, WI",Oct-22,58881,57514,1367,2.30000000
CN5503700000000,55,037,"Florence County, WI",Oct-22,1990,1918,72,3.60000000
CN5503900000000,55,039,"Fond du Lac County, WI",Oct-22,56138,54798,1340,2.40000000
CN5504100000000,55,041,"Forest County, WI",Oct-22,3713,3538,175,4.70000000
CN5504300000000,55,043,"Grant County, WI",Oct-22,26885,26126,759,2.80000000
CN5504500000000,55,045,"Green County, WI",Oct-22,20461,19983,478,2.30000000
CN5504700000000,55,047,"Green Lake County, WI",Oct-22,8836,8556,280,3.20000000
CN5504900000000,55,049,"Iowa County, WI",Oct-22,13201,12909,292,2.20000000
CN5505100000000,55,051,"Iron County, WI",Oct-22,2419,2301,118,4.90000000
CN5505300000000,55,053,"Jackson County, WI",Oct-22,9124,8813,311,3.40000000
CN5505500000000,55,055,"Jefferson County, WI",Oct-22,45481,44335,1146,2.50000000
CN5505700000000,55,057,"Juneau County, WI",Oct-22,12971,12594,377,2.90000000
CN5505900000000,55,059,"Kenosha County, WI",Oct-22,92086,89175,2911,3.20000000
CN5506100000000,55,061,"Kewaunee County, WI",Oct-22,10517,10271,246,2.30000000
CN5506300000000,55,063,"La Crosse County, WI",Oct-22,66319,64779,1540,2.30000000
CN5506500000000,55,065,"Lafayette County, WI",Oct-22,9882,9619,263,2.70000000
CN5506700000000,55,067,"Langlade County, WI",Oct-22,8852,8551,301,3.40000000
CN5506900000000,55,069,"Lincoln County, WI",Oct-22,14506,14148,358,2.50000000
CN5507100000000,55,071,"Manitowoc County, WI",Oct-22,40297,39233,1064,2.60000000
CN5507300000000,55,073,"Marathon County, WI",Oct-22,72418,70767,1651,2.30000000
CN5507500000000,55,075,"Marinette County, WI",Oct-22,18435,17783,652,3.50000000
CN5507700000000,55,077,"Marquette County, WI",Oct-22,7446,7223,223,3.00000000
CN5507800000000,55,078,"Menominee County, WI",Oct-22,1464,1378,86,5.90000000
CN5507900000000,55,079,"Milwaukee County, WI",Oct-22,460128,441912,18216,4.00000000
CN5508100000000,55,081,"Monroe County, WI",Oct-22,22449,21915,534,2.40000000
CN5508300000000,55,083,"Oconto County, WI",Oct-22,20282,19706,576,2.80000000
CN5508500000000,55,085,"Oneida County, WI",Oct-22,17319,16854,465,2.70000000
CN5508700000000,55,087,"Outagamie County, WI",Oct-22,103939,101535,2404,2.30000000
CN5508900000000,55,089,"Ozaukee County, WI",Oct-22,48508,47273,1235,2.50000000
CN5509100000000,55,091,"Pepin County, WI",Oct-22,3958,3859,99,2.50000000
CN5509300000000,55,093,"Pierce County, WI",Oct-22,25068,24382,686,2.70000000
CN5509500000000,55,095,"Polk County, WI",Oct-22,24093,23405,688,2.90000000
CN5509700000000,55,097,"Portage County, WI",Oct-22,37671,36691,980,2.60000000
CN5509900000000,55,099,"Price County, WI",Oct-22,6103,5914,189,3.10000000
CN5510100000000,55,101,"Racine County, WI",Oct-22,95756,92460,3296,3.40000000
CN5510300000000,55,103,"Richland County, WI",Oct-22,8586,8355,231,2.70000000
CN5510500000000,55,105,"Rock County, WI",Oct-22,85034,82163,2871,3.40000000
CN5510700000000,55,107,"Rusk County, WI",Oct-22,6169,5973,196,3.20000000
CN5510900000000,55,109,"St. Croix County, WI",Oct-22,51238,49902,1336,2.60000000
CN5511100000000,55,111,"Sauk County, WI",Oct-22,33670,32801,869,2.60000000
CN5511300000000,55,113,"Sawyer County, WI",Oct-22,7803,7559,244,3.10000000
CN5511500000000,55,115,"Shawano County, WI",Oct-22,19741,19211,530,2.70000000
CN5511700000000,55,117,"Sheboygan County, WI",Oct-22,61490,60001,1489,2.40000000
CN5511900000000,55,119,"Taylor County, WI",Oct-22,10151,9894,257,2.50000000
CN5512100000000,55,121,"Trempealeau County, WI",Oct-22,14310,13948,362,2.50000000
CN5512300000000,55,123,"Vernon County, WI",Oct-22,14668,14315,353,2.40000000
CN5512500000000,55,125,"Vilas County, WI",Oct-22,9776,9448,328,3.40000000
CN5512700000000,55,127,"Walworth County, WI",Oct-22,57770,56192,1578,2.70000000
CN5512900000000,55,129,"Washburn County, WI",Oct-22,7387,7168,219,3.00000000
CN5513100000000,55,131,"Washington County, WI",Oct-22,76042,74195,1847,2.40000000
CN5513300000000,55,133,"Waukesha County, WI",Oct-22,222869,217311,5558,2.50000000
CN5513500000000,55,135,"Waupaca County, WI",Oct-22,24490,23819,671,2.70000000
CN5513700000000,55,137,"Waushara County, WI",Oct-22,10694,10366,328,3.10000000
CN5513900000000,55,139,"Winnebago County, WI",Oct-22,91907,89618,2289,2.50000000
CN5514100000000,55,141,"Wood County, WI",Oct-22,32861,31828,1033,3.10000000
CN5600100000000,56,001,"Albany County, WY",Oct-22,21278,20687,591,2.80000000
CN5600300000000,56,003,"Big Horn County, WY",Oct-22,5199,5024,175,3.40000000
CN5600500000000,56,005,"Campbell County, WY",Oct-22,22455,21737,718,3.20000000
CN5600700000000,56,007,"Carbon County, WY",Oct-22,7502,7249,253,3.40000000
CN5600900000000,56,009,"Converse County, WY",Oct-22,7554,7356,198,2.60000000
CN5601100000000,56,011,"Crook County, WY",Oct-22,3904,3805,99,2.50000000
CN5601300000000,56,013,"Fremont County, WY",Oct-22,18961,18299,662,3.50000000
CN5601500000000,56,015,"Goshen County, WY",Oct-22,6450,6276,174,2.70000000
CN5601700000000,56,017,"Hot Springs County, WY",Oct-22,2272,2213,59,2.60000000
CN5601900000000,56,019,"Johnson County, WY",Oct-22,4245,4122,123,2.90000000
CN5602100000000,56,021,"Laramie County, WY",Oct-22,49486,47930,1556,3.10000000
CN5602300000000,56,023,"Lincoln County, WY",Oct-22,9682,9410,272,2.80000000
CN5602500000000,56,025,"Natrona County, WY",Oct-22,38310,36868,1442,3.80000000
CN5602700000000,56,027,"Niobrara County, WY",Oct-22,1228,1198,30,2.40000000
CN5602900000000,56,029,"Park County, WY",Oct-22,15452,14986,466,3.00000000
CN5603100000000,56,031,"Platte County, WY",Oct-22,4427,4288,139,3.10000000
CN5603300000000,56,033,"Sheridan County, WY",Oct-22,15896,15420,476,3.00000000
CN5603500000000,56,035,"Sublette County, WY",Oct-22,3888,3748,140,3.60000000
CN5603700000000,56,037,"Sweetwater County, WY",Oct-22,19228,18481,747,3.90000000
CN5603900000000,56,039,"Teton County, WY",Oct-22,16339,15923,416,2.50000000
CN5604100000000,56,041,"Uinta County, WY",Oct-22,8750,8455,295,3.40000000
CN5604300000000,56,043,"Washakie County, WY",Oct-22,3841,3710,131,3.40000000
CN5604500000000,56,045,"Weston County, WY",Oct-22,3819,3735,84,2.20000000
CN7200100000000,72,001,"Adjuntas Municipio, PR",Oct-22,4510,4130,380,8.40000000
CN7200300000000,72,003,"Aguada Municipio, PR",Oct-22,12958,11963,995,7.70000000
CN7200500000000,72,005,"Aguadilla Municipio, PR",Oct-22,15778,14420,1358,8.60000000
CN7200700000000,72,007,"Aguas Buenas Municipio, PR",Oct-22,7130,6655,475,6.70000000
CN7200900000000,72,009,"Aibonito Municipio, PR",Oct-22,6936,6427,509,7.30000000
CN7201100000000,72,011,"Anasco Municipio, PR",Oct-22,9773,9101,672,6.90000000
CN7201300000000,72,013,"Arecibo Municipio, PR",Oct-22,25728,23900,1828,7.10000000
CN7201500000000,72,015,"Arroyo Municipio, PR",Oct-22,4985,4584,401,8.00000000
CN7201700000000,72,017,"Barceloneta Municipio, PR",Oct-22,6425,5863,562,8.70000000
CN7201900000000,72,019,"Barranquitas Municipio, PR",Oct-22,7912,7346,566,7.20000000
CN7202100000000,72,021,"Bayamon Municipio, PR",Oct-22,70448,66649,3799,5.40000000
CN7202300000000,72,023,"Cabo Rojo Municipio, PR",Oct-22,15239,14074,1165,7.60000000
CN7202500000000,72,025,"Caguas Municipio, PR",Oct-22,51759,49076,2683,5.20000000
CN7202700000000,72,027,"Camuy Municipio, PR",Oct-22,10401,9667,734,7.10000000
CN7202900000000,72,029,"Canovanas Municipio, PR",Oct-22,17699,16770,929,5.20000000
CN7203100000000,72,031,"Carolina Municipio, PR",Oct-22,66465,63067,3398,5.10000000
CN7203300000000,72,033,"Catano Municipio, PR",Oct-22,8456,7938,518,6.10000000
CN7203500000000,72,035,"Cayey Municipio, PR",Oct-22,17539,16610,929,5.30000000
CN7203700000000,72,037,"Ceiba Municipio, PR",Oct-22,3892,3606,286,7.30000000
CN7203900000000,72,039,"Ciales Municipio, PR",Oct-22,3996,3640,356,8.90000000
CN7204100000000,72,041,"Cidra Municipio, PR",Oct-22,16700,15902,798,4.80000000
CN7204300000000,72,043,"Coamo Municipio, PR",Oct-22,11117,10179,938,8.40000000
CN7204500000000,72,045,"Comerio Municipio, PR",Oct-22,5352,4960,392,7.30000000
CN7204700000000,72,047,"Corozal Municipio, PR",Oct-22,9631,8863,768,8.00000000
CN7204900000000,72,049,"Culebra Municipio, PR",Oct-22,985,960,25,2.50000000
CN7205100000000,72,051,"Dorado Municipio, PR",Oct-22,14659,13995,664,4.50000000
CN7205300000000,72,053,"Fajardo Municipio, PR",Oct-22,11461,10617,844,7.40000000
CN7205400000000,72,054,"Florida Municipio, PR",Oct-22,3538,3245,293,8.30000000
CN7205500000000,72,055,"Guanica Municipio, PR",Oct-22,4190,3753,437,10.40000000
CN7205700000000,72,057,"Guayama Municipio, PR",Oct-22,11827,10966,861,7.30000000
CN7205900000000,72,059,"Guayanilla Municipio, PR",Oct-22,5285,4697,588,11.10000000
CN7206100000000,72,061,"Guaynabo Municipio, PR",Oct-22,41170,39827,1343,3.30000000
CN7206300000000,72,063,"Gurabo Municipio, PR",Oct-22,20377,19516,861,4.20000000
CN7206500000000,72,065,"Hatillo Municipio, PR",Oct-22,14730,13515,1215,8.20000000
CN7206700000000,72,067,"Hormigueros Municipio, PR",Oct-22,5928,5510,418,7.10000000
CN7206900000000,72,069,"Humacao Municipio, PR",Oct-22,19056,17800,1256,6.60000000
CN7207100000000,72,071,"Isabela Municipio, PR",Oct-22,12915,11971,944,7.30000000
CN7207300000000,72,073,"Jayuya Municipio, PR",Oct-22,4722,4249,473,10.00000000
CN7207500000000,72,075,"Juana Diaz Municipio, PR",Oct-22,17179,15874,1305,7.60000000
CN7207700000000,72,077,"Juncos Municipio, PR",Oct-22,13571,12604,967,7.10000000
CN7207900000000,72,079,"Lajas Municipio, PR",Oct-22,5808,5144,664,11.40000000
CN7208100000000,72,081,"Lares Municipio, PR",Oct-22,7998,6971,1027,12.80000000
CN7208300000000,72,083,"Las Marias Municipio, PR",Oct-22,2911,2525,386,13.30000000
CN7208500000000,72,085,"Las Piedras Municipio, PR",Oct-22,12467,11661,806,6.50000000
CN7208700000000,72,087,"Loiza Municipio, PR",Oct-22,9024,8432,592,6.60000000
CN7208900000000,72,089,"Luquillo Municipio, PR",Oct-22,6669,6215,454,6.80000000
CN7209100000000,72,091,"Manati Municipio, PR",Oct-22,12232,11441,791,6.50000000
CN7209300000000,72,093,"Maricao Municipio, PR",Oct-22,2118,1929,189,8.90000000
CN7209500000000,72,095,"Maunabo Municipio, PR",Oct-22,3046,2728,318,10.40000000
CN7209700000000,72,097,"Mayaguez Municipio, PR",Oct-22,23635,21891,1744,7.40000000
CN7209900000000,72,099,"Moca Municipio, PR",Oct-22,11532,10503,1029,8.90000000
CN7210100000000,72,101,"Morovis Municipio, PR",Oct-22,8811,8122,689,7.80000000
CN7210300000000,72,103,"Naguabo Municipio, PR",Oct-22,8946,8397,549,6.10000000
CN7210500000000,72,105,"Naranjito Municipio, PR",Oct-22,7701,7101,600,7.80000000
CN7210700000000,72,107,"Orocovis Municipio, PR",Oct-22,5270,4808,462,8.80000000
CN7210900000000,72,109,"Patillas Municipio, PR",Oct-22,4469,4060,409,9.20000000
CN7211100000000,72,111,"Penuelas Municipio, PR",Oct-22,6284,5563,721,11.50000000
CN7211300000000,72,113,"Ponce Municipio, PR",Oct-22,49344,45365,3979,8.10000000
CN7211500000000,72,115,"Quebradillas Municipio, PR",Oct-22,6559,5995,564,8.60000000
CN7211700000000,72,117,"Rincon Municipio, PR",Oct-22,5065,4624,441,8.70000000
CN7211900000000,72,119,"Rio Grande Municipio, PR",Oct-22,18471,17351,1120,6.10000000
CN7212100000000,72,121,"Sabana Grande Municipio, PR",Oct-22,6500,5902,598,9.20000000
CN7212300000000,72,123,"Salinas Municipio, PR",Oct-22,7637,6905,732,9.60000000
CN7212500000000,72,125,"San German Municipio, PR",Oct-22,10493,9611,882,8.40000000
CN7212700000000,72,127,"San Juan Municipio, PR",Oct-22,144855,138122,6733,4.60000000
CN7212900000000,72,129,"San Lorenzo Municipio, PR",Oct-22,12578,11717,861,6.80000000
CN7213100000000,72,131,"San Sebastian Municipio, PR",Oct-22,11257,10035,1222,10.90000000
CN7213300000000,72,133,"Santa Isabel Municipio, PR",Oct-22,8664,7849,815,9.40000000
CN7213500000000,72,135,"Toa Alta Municipio, PR",Oct-22,30214,28803,1411,4.70000000
CN7213700000000,72,137,"Toa Baja Municipio, PR",Oct-22,31465,29885,1580,5.00000000
CN7213900000000,72,139,"Trujillo Alto Municipio, PR",Oct-22,29379,28274,1105,3.80000000
CN7214100000000,72,141,"Utuado Municipio, PR",Oct-22,7215,6570,645,8.90000000
CN7214300000000,72,143,"Vega Alta Municipio, PR",Oct-22,10692,9884,808,7.60000000
CN7214500000000,72,145,"Vega Baja Municipio, PR",Oct-22,14308,13146,1162,8.10000000
CN7214700000000,72,147,"Vieques Municipio, PR",Oct-22,2677,2461,216,8.10000000
CN7214900000000,72,149,"Villalba Municipio, PR",Oct-22,7786,6986,800,10.30000000
CN7215100000000,72,151,"Yabucoa Municipio, PR",Oct-22,9281,8475,806,8.70000000
CN7215300000000,72,153,"Yauco Municipio, PR",Oct-22,10539,9402,1137,10.80000000
CN0100100000000,01,001,"Autauga County, AL",Nov-22,26930,26371,559,2.10000000
CN0100300000000,01,003,"Baldwin County, AL",Nov-22,99455,97260,2195,2.20000000
CN0100500000000,01,005,"Barbour County, AL",Nov-22,8710,8348,362,4.20000000
CN0100700000000,01,007,"Bibb County, AL",Nov-22,8726,8523,203,2.30000000
CN0100900000000,01,009,"Blount County, AL",Nov-22,25847,25331,516,2.00000000
CN0101100000000,01,011,"Bullock County, AL",Nov-22,4640,4525,115,2.50000000
CN0101300000000,01,013,"Butler County, AL",Nov-22,9013,8731,282,3.10000000
CN0101500000000,01,015,"Calhoun County, AL",Nov-22,46344,45122,1222,2.60000000
CN0101700000000,01,017,"Chambers County, AL",Nov-22,16045,15661,384,2.40000000
CN0101900000000,01,019,"Cherokee County, AL",Nov-22,11621,11368,253,2.20000000
CN0102100000000,01,021,"Chilton County, AL",Nov-22,20349,19935,414,2.00000000
CN0102300000000,01,023,"Choctaw County, AL",Nov-22,4572,4417,155,3.40000000
CN0102500000000,01,025,"Clarke County, AL",Nov-22,7958,7556,402,5.10000000
CN0102700000000,01,027,"Clay County, AL",Nov-22,6492,6368,124,1.90000000
CN0102900000000,01,029,"Cleburne County, AL",Nov-22,6335,6208,127,2.00000000
CN0103100000000,01,031,"Coffee County, AL",Nov-22,22224,21738,486,2.20000000
CN0103300000000,01,033,"Colbert County, AL",Nov-22,23741,23091,650,2.70000000
CN0103500000000,01,035,"Conecuh County, AL",Nov-22,4289,4150,139,3.20000000
CN0103700000000,01,037,"Coosa County, AL",Nov-22,4619,4502,117,2.50000000
CN0103900000000,01,039,"Covington County, AL",Nov-22,15725,15356,369,2.30000000
CN0104100000000,01,041,"Crenshaw County, AL",Nov-22,6086,5942,144,2.40000000
CN0104300000000,01,043,"Cullman County, AL",Nov-22,41130,40406,724,1.80000000
CN0104500000000,01,045,"Dale County, AL",Nov-22,21347,20836,511,2.40000000
CN0104700000000,01,047,"Dallas County, AL",Nov-22,13866,13156,710,5.10000000
CN0104900000000,01,049,"DeKalb County, AL",Nov-22,32404,31740,664,2.00000000
CN0105100000000,01,051,"Elmore County, AL",Nov-22,38381,37603,778,2.00000000
CN0105300000000,01,053,"Escambia County, AL",Nov-22,14603,14154,449,3.10000000
CN0105500000000,01,055,"Etowah County, AL",Nov-22,39344,38291,1053,2.70000000
CN0105700000000,01,057,"Fayette County, AL",Nov-22,6657,6500,157,2.40000000
CN0105900000000,01,059,"Franklin County, AL",Nov-22,15021,14695,326,2.20000000
CN0106100000000,01,061,"Geneva County, AL",Nov-22,11317,11081,236,2.10000000
CN0106300000000,01,063,"Greene County, AL",Nov-22,2836,2718,118,4.20000000
CN0106500000000,01,065,"Hale County, AL",Nov-22,6068,5844,224,3.70000000
CN0106700000000,01,067,"Henry County, AL",Nov-22,7029,6847,182,2.60000000
CN0106900000000,01,069,"Houston County, AL",Nov-22,47539,46409,1130,2.40000000
CN0107100000000,01,071,"Jackson County, AL",Nov-22,23647,23145,502,2.10000000
CN0107300000000,01,073,"Jefferson County, AL",Nov-22,322161,314618,7543,2.30000000
CN0107500000000,01,075,"Lamar County, AL",Nov-22,5877,5747,130,2.20000000
CN0107700000000,01,077,"Lauderdale County, AL",Nov-22,42703,41692,1011,2.40000000
CN0107900000000,01,079,"Lawrence County, AL",Nov-22,14614,14298,316,2.20000000
CN0108100000000,01,081,"Lee County, AL",Nov-22,78593,76882,1711,2.20000000
CN0108300000000,01,083,"Limestone County, AL",Nov-22,47711,46782,929,1.90000000
CN0108500000000,01,085,"Lowndes County, AL",Nov-22,3553,3372,181,5.10000000
CN0108700000000,01,087,"Macon County, AL",Nov-22,7977,7697,280,3.50000000
CN0108900000000,01,089,"Madison County, AL",Nov-22,196080,192237,3843,2.00000000
CN0109100000000,01,091,"Marengo County, AL",Nov-22,7962,7701,261,3.30000000
CN0109300000000,01,093,"Marion County, AL",Nov-22,14243,13900,343,2.40000000
CN0109500000000,01,095,"Marshall County, AL",Nov-22,46139,45311,828,1.80000000
CN0109700000000,01,097,"Mobile County, AL",Nov-22,191010,185293,5717,3.00000000
CN0109900000000,01,099,"Monroe County, AL",Nov-22,7630,7347,283,3.70000000
CN0110100000000,01,101,"Montgomery County, AL",Nov-22,107670,104501,3169,2.90000000
CN0110300000000,01,103,"Morgan County, AL",Nov-22,60109,58968,1141,1.90000000
CN0110500000000,01,105,"Perry County, AL",Nov-22,3262,3085,177,5.40000000
CN0110700000000,01,107,"Pickens County, AL",Nov-22,7713,7481,232,3.00000000
CN0110900000000,01,109,"Pike County, AL",Nov-22,16710,16304,406,2.40000000
CN0111100000000,01,111,"Randolph County, AL",Nov-22,9970,9741,229,2.30000000
CN0111300000000,01,113,"Russell County, AL",Nov-22,23853,23249,604,2.50000000
CN0111500000000,01,115,"St. Clair County, AL",Nov-22,42115,41284,831,2.00000000
CN0111700000000,01,117,"Shelby County, AL",Nov-22,121024,119005,2019,1.70000000
CN0111900000000,01,119,"Sumter County, AL",Nov-22,4688,4544,144,3.10000000
CN0112100000000,01,121,"Talladega County, AL",Nov-22,36766,35746,1020,2.80000000
CN0112300000000,01,123,"Tallapoosa County, AL",Nov-22,18160,17712,448,2.50000000
CN0112500000000,01,125,"Tuscaloosa County, AL",Nov-22,102759,100392,2367,2.30000000
CN0112700000000,01,127,"Walker County, AL",Nov-22,25490,24861,629,2.50000000
CN0112900000000,01,129,"Washington County, AL",Nov-22,6711,6486,225,3.40000000
CN0113100000000,01,131,"Wilcox County, AL",Nov-22,2655,2434,221,8.30000000
CN0113300000000,01,133,"Winston County, AL",Nov-22,10507,10267,240,2.30000000
CN0201300000000,02,013,"Aleutians East Borough, AK",Nov-22,1615,1557,58,3.60000000
CN0201600000000,02,016,"Aleutians West Census Area, AK",Nov-22,2736,2620,116,4.20000000
CN0202000000000,02,020,"Anchorage Borough/municipality, AK",Nov-22,154967,149889,5078,3.30000000
CN0205000000000,02,050,"Bethel Census Area, AK",Nov-22,7179,6541,638,8.90000000
CN0206000000000,02,060,"Bristol Bay Borough, AK",Nov-22,260,243,17,6.50000000
CN0206300000000,02,063,"Chugach Census Area, AK",Nov-22,2884,2755,129,4.50000000
CN0206600000000,02,066,"Copper River Census Area, AK",Nov-22,1247,1070,177,14.20000000
CN0206800000000,02,068,"Denali Borough, AK",Nov-22,604,522,82,13.60000000
CN0207000000000,02,070,"Dillingham Census Area, AK",Nov-22,1584,1483,101,6.40000000
CN0209000000000,02,090,"Fairbanks North Star Borough, AK",Nov-22,46368,44606,1762,3.80000000
CN0210000000000,02,100,"Haines Borough, AK",Nov-22,908,831,77,8.50000000
CN0210500000000,02,105,"Hoonah-Angoon Census Area, AK",Nov-22,984,903,81,8.20000000
CN0211000000000,02,110,"Juneau Borough/city, AK",Nov-22,16469,15995,474,2.90000000
CN0212200000000,02,122,"Kenai Peninsula Borough, AK",Nov-22,27347,25917,1430,5.20000000
CN0213000000000,02,130,"Ketchikan Gateway Borough, AK",Nov-22,6215,5925,290,4.70000000
CN0215000000000,02,150,"Kodiak Island Borough, AK",Nov-22,5725,5398,327,5.70000000
CN0215800000000,02,158,"Kusilvak Census Area, AK",Nov-22,2497,2151,346,13.90000000
CN0216400000000,02,164,"Lake and Peninsula Borough, AK",Nov-22,578,534,44,7.60000000
CN0217000000000,02,170,"Matanuska-Susitna Borough, AK",Nov-22,51064,48688,2376,4.70000000
CN0218000000000,02,180,"Nome Census Area, AK",Nov-22,4300,4001,299,7.00000000
CN0218500000000,02,185,"North Slope Borough, AK",Nov-22,3025,2876,149,4.90000000
CN0218800000000,02,188,"Northwest Arctic Borough, AK",Nov-22,2995,2686,309,10.30000000
CN0219500000000,02,195,"Petersburg Borough, AK",Nov-22,1340,1254,86,6.40000000
CN0219800000000,02,198,"Prince of Wales-Hyder Census Area, AK",Nov-22,2634,2478,156,5.90000000
CN0222000000000,02,220,"Sitka Borough/city, AK",Nov-22,4055,3938,117,2.90000000
CN0223000000000,02,230,"Skagway Municipality, AK",Nov-22,583,512,71,12.20000000
CN0224000000000,02,240,"Southeast Fairbanks Census Area, AK",Nov-22,3282,3109,173,5.30000000
CN0227500000000,02,275,"Wrangell Borough/city, AK",Nov-22,886,833,53,6.00000000
CN0228200000000,02,282,"Yakutat Borough/city, AK",Nov-22,267,249,18,6.70000000
CN0229000000000,02,290,"Yukon-Koyukuk Census Area, AK",Nov-22,2399,2189,210,8.80000000
CN0400100000000,04,001,"Apache County, AZ",Nov-22,18431,16890,1541,8.40000000
CN0400300000000,04,003,"Cochise County, AZ",Nov-22,49680,47737,1943,3.90000000
CN0400500000000,04,005,"Coconino County, AZ",Nov-22,76824,73632,3192,4.20000000
CN0400700000000,04,007,"Gila County, AZ",Nov-22,20549,19800,749,3.60000000
CN0400900000000,04,009,"Graham County, AZ",Nov-22,16443,15953,490,3.00000000
CN0401100000000,04,011,"Greenlee County, AZ",Nov-22,4423,4305,118,2.70000000
CN0401200000000,04,012,"La Paz County, AZ",Nov-22,9822,9402,420,4.30000000
CN0401300000000,04,013,"Maricopa County, AZ",Nov-22,2382710,2313130,69580,2.90000000
CN0401500000000,04,015,"Mohave County, AZ",Nov-22,89195,85227,3968,4.40000000
CN0401700000000,04,017,"Navajo County, AZ",Nov-22,39957,37807,2150,5.40000000
CN0401900000000,04,019,"Pima County, AZ",Nov-22,488679,472135,16544,3.40000000
CN0402100000000,04,021,"Pinal County, AZ",Nov-22,202234,195399,6835,3.40000000
CN0402300000000,04,023,"Santa Cruz County, AZ",Nov-22,20204,18494,1710,8.50000000
CN0402500000000,04,025,"Yavapai County, AZ",Nov-22,109317,106146,3171,2.90000000
CN0402700000000,04,027,"Yuma County, AZ",Nov-22,109722,91421,18301,16.70000000
CN0500100000000,05,001,"Arkansas County, AR",Nov-22,9452,9193,259,2.70000000
CN0500300000000,05,003,"Ashley County, AR",Nov-22,6664,6276,388,5.80000000
CN0500500000000,05,005,"Baxter County, AR",Nov-22,16546,16023,523,3.20000000
CN0500700000000,05,007,"Benton County, AR",Nov-22,147870,144694,3176,2.10000000
CN0500900000000,05,009,"Boone County, AR",Nov-22,15701,15283,418,2.70000000
CN0501100000000,05,011,"Bradley County, AR",Nov-22,3996,3815,181,4.50000000
CN0501300000000,05,013,"Calhoun County, AR",Nov-22,2336,2267,69,3.00000000
CN0501500000000,05,015,"Carroll County, AR",Nov-22,12414,12098,316,2.50000000
CN0501700000000,05,017,"Chicot County, AR",Nov-22,2843,2672,171,6.00000000
CN0501900000000,05,019,"Clark County, AR",Nov-22,8601,8246,355,4.10000000
CN0502100000000,05,021,"Clay County, AR",Nov-22,5331,5112,219,4.10000000
CN0502300000000,05,023,"Cleburne County, AR",Nov-22,8830,8500,330,3.70000000
CN0502500000000,05,025,"Cleveland County, AR",Nov-22,3066,2963,103,3.40000000
CN0502700000000,05,027,"Columbia County, AR",Nov-22,8801,8432,369,4.20000000
CN0502900000000,05,029,"Conway County, AR",Nov-22,8365,8090,275,3.30000000
CN0503100000000,05,031,"Craighead County, AR",Nov-22,56590,55190,1400,2.50000000
CN0503300000000,05,033,"Crawford County, AR",Nov-22,26118,25401,717,2.70000000
CN0503500000000,05,035,"Crittenden County, AR",Nov-22,20832,20055,777,3.70000000
CN0503700000000,05,037,"Cross County, AR",Nov-22,6780,6543,237,3.50000000
CN0503900000000,05,039,"Dallas County, AR",Nov-22,2678,2580,98,3.70000000
CN0504100000000,05,041,"Desha County, AR",Nov-22,4895,4657,238,4.90000000
CN0504300000000,05,043,"Drew County, AR",Nov-22,7045,6747,298,4.20000000
CN0504500000000,05,045,"Faulkner County, AR",Nov-22,62043,60380,1663,2.70000000
CN0504700000000,05,047,"Franklin County, AR",Nov-22,7397,7184,213,2.90000000
CN0504900000000,05,049,"Fulton County, AR",Nov-22,4863,4720,143,2.90000000
CN0505100000000,05,051,"Garland County, AR",Nov-22,40449,38998,1451,3.60000000
CN0505300000000,05,053,"Grant County, AR",Nov-22,8294,8063,231,2.80000000
CN0505500000000,05,055,"Greene County, AR",Nov-22,19791,18885,906,4.60000000
CN0505700000000,05,057,"Hempstead County, AR",Nov-22,9231,8958,273,3.00000000
CN0505900000000,05,059,"Hot Spring County, AR",Nov-22,13510,13095,415,3.10000000
CN0506100000000,05,061,"Howard County, AR",Nov-22,5335,5168,167,3.10000000
CN0506300000000,05,063,"Independence County, AR",Nov-22,16523,16051,472,2.90000000
CN0506500000000,05,065,"Izard County, AR",Nov-22,4545,4332,213,4.70000000
CN0506700000000,05,067,"Jackson County, AR",Nov-22,5352,5102,250,4.70000000
CN0506900000000,05,069,"Jefferson County, AR",Nov-22,25758,24480,1278,5.00000000
CN0507100000000,05,071,"Johnson County, AR",Nov-22,10096,9740,356,3.50000000
CN0507300000000,05,073,"Lafayette County, AR",Nov-22,2278,2166,112,4.90000000
CN0507500000000,05,075,"Lawrence County, AR",Nov-22,6708,6487,221,3.30000000
CN0507700000000,05,077,"Lee County, AR",Nov-22,2485,2378,107,4.30000000
CN0507900000000,05,079,"Lincoln County, AR",Nov-22,3671,3523,148,4.00000000
CN0508100000000,05,081,"Little River County, AR",Nov-22,5337,5157,180,3.40000000
CN0508300000000,05,083,"Logan County, AR",Nov-22,8133,7865,268,3.30000000
CN0508500000000,05,085,"Lonoke County, AR",Nov-22,33563,32715,848,2.50000000
CN0508700000000,05,087,"Madison County, AR",Nov-22,7519,7357,162,2.20000000
CN0508900000000,05,089,"Marion County, AR",Nov-22,6221,6011,210,3.40000000
CN0509100000000,05,091,"Miller County, AR",Nov-22,19175,18553,622,3.20000000
CN0509300000000,05,093,"Mississippi County, AR",Nov-22,16312,15486,826,5.10000000
CN0509500000000,05,095,"Monroe County, AR",Nov-22,2441,2338,103,4.20000000
CN0509700000000,05,097,"Montgomery County, AR",Nov-22,2707,2588,119,4.40000000
CN0509900000000,05,099,"Nevada County, AR",Nov-22,3405,3289,116,3.40000000
CN0510100000000,05,101,"Newton County, AR",Nov-22,3134,3056,78,2.50000000
CN0510300000000,05,103,"Ouachita County, AR",Nov-22,9569,9237,332,3.50000000
CN0510500000000,05,105,"Perry County, AR",Nov-22,4127,3997,130,3.10000000
CN0510700000000,05,107,"Phillips County, AR",Nov-22,5446,5062,384,7.10000000
CN0510900000000,05,109,"Pike County, AR",Nov-22,4029,3898,131,3.30000000
CN0511100000000,05,111,"Poinsett County, AR",Nov-22,9729,9438,291,3.00000000
CN0511300000000,05,113,"Polk County, AR",Nov-22,7651,7402,249,3.30000000
CN0511500000000,05,115,"Pope County, AR",Nov-22,27356,26444,912,3.30000000
CN0511700000000,05,117,"Prairie County, AR",Nov-22,3487,3389,98,2.80000000
CN0511900000000,05,119,"Pulaski County, AR",Nov-22,186354,180487,5867,3.10000000
CN0512100000000,05,121,"Randolph County, AR",Nov-22,7070,6851,219,3.10000000
CN0512300000000,05,123,"St. Francis County, AR",Nov-22,7513,7166,347,4.60000000
CN0512500000000,05,125,"Saline County, AR",Nov-22,59000,57561,1439,2.40000000
CN0512700000000,05,127,"Scott County, AR",Nov-22,4018,3921,97,2.40000000
CN0512900000000,05,129,"Searcy County, AR",Nov-22,2909,2801,108,3.70000000
CN0513100000000,05,131,"Sebastian County, AR",Nov-22,55031,53543,1488,2.70000000
CN0513300000000,05,133,"Sevier County, AR",Nov-22,5340,5158,182,3.40000000
CN0513500000000,05,135,"Sharp County, AR",Nov-22,5778,5579,199,3.40000000
CN0513700000000,05,137,"Stone County, AR",Nov-22,4426,4256,170,3.80000000
CN0513900000000,05,139,"Union County, AR",Nov-22,14684,14002,682,4.60000000
CN0514100000000,05,141,"Van Buren County, AR",Nov-22,5889,5675,214,3.60000000
CN0514300000000,05,143,"Washington County, AR",Nov-22,130692,127936,2756,2.10000000
CN0514500000000,05,145,"White County, AR",Nov-22,33974,32943,1031,3.00000000
CN0514700000000,05,147,"Woodruff County, AR",Nov-22,2735,2650,85,3.10000000
CN0514900000000,05,149,"Yell County, AR",Nov-22,7766,7512,254,3.30000000
CN0600100000000,06,001,"Alameda County, CA",Nov-22,826842,800733,26109,3.20000000
CN0600300000000,06,003,"Alpine County, CA",Nov-22,490,464,26,5.30000000
CN0600500000000,06,005,"Amador County, CA",Nov-22,14283,13643,640,4.50000000
CN0600700000000,06,007,"Butte County, CA",Nov-22,93092,89035,4057,4.40000000
CN0600900000000,06,009,"Calaveras County, CA",Nov-22,21857,21099,758,3.50000000
CN0601100000000,06,011,"Colusa County, CA",Nov-22,11061,9913,1148,10.40000000
CN0601300000000,06,013,"Contra Costa County, CA",Nov-22,552398,533623,18775,3.40000000
CN0601500000000,06,015,"Del Norte County, CA",Nov-22,9316,8834,482,5.20000000
CN0601700000000,06,017,"El Dorado County, CA",Nov-22,92408,89464,2944,3.20000000
CN0601900000000,06,019,"Fresno County, CA",Nov-22,449440,419590,29850,6.60000000
CN0602100000000,06,021,"Glenn County, CA",Nov-22,12644,11984,660,5.20000000
CN0602300000000,06,023,"Humboldt County, CA",Nov-22,60889,58632,2257,3.70000000
CN0602500000000,06,025,"Imperial County, CA",Nov-22,71445,59532,11913,16.70000000
CN0602700000000,06,027,"Inyo County, CA",Nov-22,8263,7983,280,3.40000000
CN0602900000000,06,029,"Kern County, CA",Nov-22,391538,364979,26559,6.80000000
CN0603100000000,06,031,"Kings County, CA",Nov-22,56271,52341,3930,7.00000000
CN0603300000000,06,033,"Lake County, CA",Nov-22,28360,26851,1509,5.30000000
CN0603500000000,06,035,"Lassen County, CA",Nov-22,9392,9025,367,3.90000000
CN0603700000000,06,037,"Los Angeles County, CA",Nov-22,4986416,4760132,226284,4.50000000
CN0603900000000,06,039,"Madera County, CA",Nov-22,62321,58382,3939,6.30000000
CN0604100000000,06,041,"Marin County, CA",Nov-22,128447,125277,3170,2.50000000
CN0604300000000,06,043,"Mariposa County, CA",Nov-22,6858,6541,317,4.60000000
CN0604500000000,06,045,"Mendocino County, CA",Nov-22,37583,36087,1496,4.00000000
CN0604700000000,06,047,"Merced County, CA",Nov-22,116579,108105,8474,7.30000000
CN0604900000000,06,049,"Modoc County, CA",Nov-22,3210,3057,153,4.80000000
CN0605100000000,06,051,"Mono County, CA",Nov-22,8399,8076,323,3.80000000
CN0605300000000,06,053,"Monterey County, CA",Nov-22,210333,198584,11749,5.60000000
CN0605500000000,06,055,"Napa County, CA",Nov-22,67552,65392,2160,3.20000000
CN0605700000000,06,057,"Nevada County, CA",Nov-22,47843,46327,1516,3.20000000
CN0605900000000,06,059,"Orange County, CA",Nov-22,1598060,1550752,47308,3.00000000
CN0606100000000,06,061,"Placer County, CA",Nov-22,191807,186357,5450,2.80000000
CN0606300000000,06,063,"Plumas County, CA",Nov-22,7296,6840,456,6.30000000
CN0606500000000,06,065,"Riverside County, CA",Nov-22,1170429,1120811,49618,4.20000000
CN0606700000000,06,067,"Sacramento County, CA",Nov-22,721856,693142,28714,4.00000000
CN0606900000000,06,069,"San Benito County, CA",Nov-22,33098,31512,1586,4.80000000
CN0607100000000,06,071,"San Bernardino County, CA",Nov-22,1023748,981268,42480,4.10000000
CN0607300000000,06,073,"San Diego County, CA",Nov-22,1581097,1528191,52906,3.30000000
CN0607500000000,06,075,"San Francisco County/city, CA",Nov-22,574132,560821,13311,2.30000000
CN0607700000000,06,077,"San Joaquin County, CA",Nov-22,337254,318482,18772,5.60000000
CN0607900000000,06,079,"San Luis Obispo County, CA",Nov-22,136823,133048,3775,2.80000000
CN0608100000000,06,081,"San Mateo County, CA",Nov-22,454420,444543,9877,2.20000000
CN0608300000000,06,083,"Santa Barbara County, CA",Nov-22,224909,217705,7204,3.20000000
CN0608500000000,06,085,"Santa Clara County, CA",Nov-22,1055415,1030418,24997,2.40000000
CN0608700000000,06,087,"Santa Cruz County, CA",Nov-22,134763,128760,6003,4.50000000
CN0608900000000,06,089,"Shasta County, CA",Nov-22,73867,70633,3234,4.40000000
CN0609100000000,06,091,"Sierra County, CA",Nov-22,1339,1295,44,3.30000000
CN0609300000000,06,093,"Siskiyou County, CA",Nov-22,16276,15397,879,5.40000000
CN0609500000000,06,095,"Solano County, CA",Nov-22,200011,191437,8574,4.30000000
CN0609700000000,06,097,"Sonoma County, CA",Nov-22,247475,240306,7169,2.90000000
CN0609900000000,06,099,"Stanislaus County, CA",Nov-22,238168,224826,13342,5.60000000
CN0610100000000,06,101,"Sutter County, CA",Nov-22,45030,41975,3055,6.80000000
CN0610300000000,06,103,"Tehama County, CA",Nov-22,25721,24508,1213,4.70000000
CN0610500000000,06,105,"Trinity County, CA",Nov-22,4389,4180,209,4.80000000
CN0610700000000,06,107,"Tulare County, CA",Nov-22,205531,187935,17596,8.60000000
CN0610900000000,06,109,"Tuolumne County, CA",Nov-22,19795,18941,854,4.30000000
CN0611100000000,06,111,"Ventura County, CA",Nov-22,412137,396889,15248,3.70000000
CN0611300000000,06,113,"Yolo County, CA",Nov-22,107880,103726,4154,3.90000000
CN0611500000000,06,115,"Yuba County, CA",Nov-22,30820,29041,1779,5.80000000
CN0800100000000,08,001,"Adams County, CO",Nov-22,287084,276256,10828,3.80000000
CN0800300000000,08,003,"Alamosa County, CO",Nov-22,8531,8187,344,4.00000000
CN0800500000000,08,005,"Arapahoe County, CO",Nov-22,382419,369488,12931,3.40000000
CN0800700000000,08,007,"Archuleta County, CO",Nov-22,7116,6900,216,3.00000000
CN0800900000000,08,009,"Baca County, CO",Nov-22,1993,1959,34,1.70000000
CN0801100000000,08,011,"Bent County, CO",Nov-22,1867,1795,72,3.90000000
CN0801300000000,08,013,"Boulder County, CO",Nov-22,206170,200727,5443,2.60000000
CN0801400000000,08,014,"Broomfield County/city, CO",Nov-22,43229,42000,1229,2.80000000
CN0801500000000,08,015,"Chaffee County, CO",Nov-22,10302,10032,270,2.60000000
CN0801700000000,08,017,"Cheyenne County, CO",Nov-22,1049,1029,20,1.90000000
CN0801900000000,08,019,"Clear Creek County, CO",Nov-22,6258,6067,191,3.10000000
CN0802100000000,08,021,"Conejos County, CO",Nov-22,4039,3909,130,3.20000000
CN0802300000000,08,023,"Costilla County, CO",Nov-22,1856,1773,83,4.50000000
CN0802500000000,08,025,"Crowley County, CO",Nov-22,1411,1350,61,4.30000000
CN0802700000000,08,027,"Custer County, CO",Nov-22,2476,2400,76,3.10000000
CN0802900000000,08,029,"Delta County, CO",Nov-22,13459,12948,511,3.80000000
CN0803100000000,08,031,"Denver County/city, CO",Nov-22,444702,429458,15244,3.40000000
CN0803300000000,08,033,"Dolores County, CO",Nov-22,1141,1096,45,3.90000000
CN0803500000000,08,035,"Douglas County, CO",Nov-22,211404,205628,5776,2.70000000
CN0803700000000,08,037,"Eagle County, CO",Nov-22,36096,35017,1079,3.00000000
CN0803900000000,08,039,"Elbert County, CO",Nov-22,16089,15675,414,2.60000000
CN0804100000000,08,041,"El Paso County, CO",Nov-22,361759,348810,12949,3.60000000
CN0804300000000,08,043,"Fremont County, CO",Nov-22,15387,14614,773,5.00000000
CN0804500000000,08,045,"Garfield County, CO",Nov-22,31067,30076,991,3.20000000
CN0804700000000,08,047,"Gilpin County, CO",Nov-22,4008,3884,124,3.10000000
CN0804900000000,08,049,"Grand County, CO",Nov-22,9493,9224,269,2.80000000
CN0805100000000,08,051,"Gunnison County, CO",Nov-22,11421,11084,337,3.00000000
CN0805300000000,08,053,"Hinsdale County, CO",Nov-22,447,433,14,3.10000000
CN0805500000000,08,055,"Huerfano County, CO",Nov-22,2567,2380,187,7.30000000
CN0805700000000,08,057,"Jackson County, CO",Nov-22,910,891,19,2.10000000
CN0805900000000,08,059,"Jefferson County, CO",Nov-22,349071,338715,10356,3.00000000
CN0806100000000,08,061,"Kiowa County, CO",Nov-22,816,797,19,2.30000000
CN0806300000000,08,063,"Kit Carson County, CO",Nov-22,3888,3806,82,2.10000000
CN0806500000000,08,065,"Lake County, CO",Nov-22,5101,4966,135,2.60000000
CN0806700000000,08,067,"La Plata County, CO",Nov-22,31165,30181,984,3.20000000
CN0806900000000,08,069,"Larimer County, CO",Nov-22,214298,208245,6053,2.80000000
CN0807100000000,08,071,"Las Animas County, CO",Nov-22,6272,5944,328,5.20000000
CN0807300000000,08,073,"Lincoln County, CO",Nov-22,2199,2133,66,3.00000000
CN0807500000000,08,075,"Logan County, CO",Nov-22,10478,10187,291,2.80000000
CN0807700000000,08,077,"Mesa County, CO",Nov-22,79018,76182,2836,3.60000000
CN0807900000000,08,079,"Mineral County, CO",Nov-22,388,376,12,3.10000000
CN0808100000000,08,081,"Moffat County, CO",Nov-22,6861,6634,227,3.30000000
CN0808300000000,08,083,"Montezuma County, CO",Nov-22,13401,12894,507,3.80000000
CN0808500000000,08,085,"Montrose County, CO",Nov-22,22509,21781,728,3.20000000
CN0808700000000,08,087,"Morgan County, CO",Nov-22,15405,14909,496,3.20000000
CN0808900000000,08,089,"Otero County, CO",Nov-22,7966,7590,376,4.70000000
CN0809100000000,08,091,"Ouray County, CO",Nov-22,2835,2752,83,2.90000000
CN0809300000000,08,093,"Park County, CO",Nov-22,11805,11487,318,2.70000000
CN0809500000000,08,095,"Phillips County, CO",Nov-22,2325,2276,49,2.10000000
CN0809700000000,08,097,"Pitkin County, CO",Nov-22,10893,10328,565,5.20000000
CN0809900000000,08,099,"Prowers County, CO",Nov-22,6099,5921,178,2.90000000
CN0810100000000,08,101,"Pueblo County, CO",Nov-22,79694,75639,4055,5.10000000
CN0810300000000,08,103,"Rio Blanco County, CO",Nov-22,2753,2644,109,4.00000000
CN0810500000000,08,105,"Rio Grande County, CO",Nov-22,5151,4924,227,4.40000000
CN0810700000000,08,107,"Routt County, CO",Nov-22,15493,15056,437,2.80000000
CN0810900000000,08,109,"Saguache County, CO",Nov-22,3349,3222,127,3.80000000
CN0811100000000,08,111,"San Juan County, CO",Nov-22,595,575,20,3.40000000
CN0811300000000,08,113,"San Miguel County, CO",Nov-22,6114,5810,304,5.00000000
CN0811500000000,08,115,"Sedgwick County, CO",Nov-22,1103,1073,30,2.70000000
CN0811700000000,08,117,"Summit County, CO",Nov-22,23161,22648,513,2.20000000
CN0811900000000,08,119,"Teller County, CO",Nov-22,13539,13117,422,3.10000000
CN0812100000000,08,121,"Washington County, CO",Nov-22,2552,2489,63,2.50000000
CN0812300000000,08,123,"Weld County, CO",Nov-22,169712,163785,5927,3.50000000
CN0812500000000,08,125,"Yuma County, CO",Nov-22,5257,5146,111,2.10000000
CN0900100000000,09,001,"Fairfield County, CT",Nov-22,474896,458253,16643,3.50000000
CN0900300000000,09,003,"Hartford County, CT",Nov-22,477753,460858,16895,3.50000000
CN0900500000000,09,005,"Litchfield County, CT",Nov-22,103513,100285,3228,3.10000000
CN0900700000000,09,007,"Middlesex County, CT",Nov-22,93662,90913,2749,2.90000000
CN0900900000000,09,009,"New Haven County, CT",Nov-22,465833,448785,17048,3.70000000
CN0901100000000,09,011,"New London County, CT",Nov-22,131489,126663,4826,3.70000000
CN0901300000000,09,013,"Tolland County, CT",Nov-22,86347,83654,2693,3.10000000
CN0901500000000,09,015,"Windham County, CT",Nov-22,63047,60852,2195,3.50000000
CN1000100000000,10,001,"Kent County, DE",Nov-22,80884,77118,3766,4.70000000
CN1000300000000,10,003,"New Castle County, DE",Nov-22,304182,292409,11773,3.90000000
CN1000500000000,10,005,"Sussex County, DE",Nov-22,110476,105781,4695,4.20000000
CN1100100000000,11,001,District of Columbia,Nov-22,386175,370463,15712,4.10000000
CN1200100000000,12,001,"Alachua County, FL",Nov-22,144180,140467,3713,2.60000000
CN1200300000000,12,003,"Baker County, FL",Nov-22,12807,12487,320,2.50000000
CN1200500000000,12,005,"Bay County, FL",Nov-22,89087,86939,2148,2.40000000
CN1200700000000,12,007,"Bradford County, FL",Nov-22,11072,10771,301,2.70000000
CN1200900000000,12,009,"Brevard County, FL",Nov-22,301736,293983,7753,2.60000000
CN1201100000000,12,011,"Broward County, FL",Nov-22,1072635,1045307,27328,2.50000000
CN1201300000000,12,013,"Calhoun County, FL",Nov-22,5040,4895,145,2.90000000
CN1201500000000,12,015,"Charlotte County, FL",Nov-22,77458,74690,2768,3.60000000
CN1201700000000,12,017,"Citrus County, FL",Nov-22,47144,45247,1897,4.00000000
CN1201900000000,12,019,"Clay County, FL",Nov-22,114566,111810,2756,2.40000000
CN1202100000000,12,021,"Collier County, FL",Nov-22,188970,183929,5041,2.70000000
CN1202300000000,12,023,"Columbia County, FL",Nov-22,29809,28984,825,2.80000000
CN1202700000000,12,027,"DeSoto County, FL",Nov-22,15116,14669,447,3.00000000
CN1202900000000,12,029,"Dixie County, FL",Nov-22,6019,5846,173,2.90000000
CN1203100000000,12,031,"Duval County, FL",Nov-22,519138,505444,13694,2.60000000
CN1203300000000,12,033,"Escambia County, FL",Nov-22,150801,146731,4070,2.70000000
CN1203500000000,12,035,"Flagler County, FL",Nov-22,50639,49041,1598,3.20000000
CN1203700000000,12,037,"Franklin County, FL",Nov-22,4669,4556,113,2.40000000
CN1203900000000,12,039,"Gadsden County, FL",Nov-22,21347,20668,679,3.20000000
CN1204100000000,12,041,"Gilchrist County, FL",Nov-22,7484,7279,205,2.70000000
CN1204300000000,12,043,"Glades County, FL",Nov-22,5349,5199,150,2.80000000
CN1204500000000,12,045,"Gulf County, FL",Nov-22,5481,5350,131,2.40000000
CN1204700000000,12,047,"Hamilton County, FL",Nov-22,4201,4037,164,3.90000000
CN1204900000000,12,049,"Hardee County, FL",Nov-22,9068,8761,307,3.40000000
CN1205100000000,12,051,"Hendry County, FL",Nov-22,16021,15347,674,4.20000000
CN1205300000000,12,053,"Hernando County, FL",Nov-22,77251,74748,2503,3.20000000
CN1205500000000,12,055,"Highlands County, FL",Nov-22,34225,32772,1453,4.20000000
CN1205700000000,12,057,"Hillsborough County, FL",Nov-22,812248,791754,20494,2.50000000
CN1205900000000,12,059,"Holmes County, FL",Nov-22,7092,6898,194,2.70000000
CN1206100000000,12,061,"Indian River County, FL",Nov-22,67315,65305,2010,3.00000000
CN1206300000000,12,063,"Jackson County, FL",Nov-22,17286,16801,485,2.80000000
CN1206500000000,12,065,"Jefferson County, FL",Nov-22,5848,5694,154,2.60000000
CN1206700000000,12,067,"Lafayette County, FL",Nov-22,2795,2718,77,2.80000000
CN1206900000000,12,069,"Lake County, FL",Nov-22,170102,165368,4734,2.80000000
CN1207100000000,12,071,"Lee County, FL",Nov-22,375652,362209,13443,3.60000000
CN1207300000000,12,073,"Leon County, FL",Nov-22,161369,157000,4369,2.70000000
CN1207500000000,12,075,"Levy County, FL",Nov-22,17200,16700,500,2.90000000
CN1207700000000,12,077,"Liberty County, FL",Nov-22,2646,2575,71,2.70000000
CN1207900000000,12,079,"Madison County, FL",Nov-22,8025,7787,238,3.00000000
CN1208100000000,12,081,"Manatee County, FL",Nov-22,192349,187502,4847,2.50000000
CN1208300000000,12,083,"Marion County, FL",Nov-22,145145,140474,4671,3.20000000
CN1208500000000,12,085,"Martin County, FL",Nov-22,76793,74962,1831,2.40000000
CN1208600000000,12,086,"Miami-Dade County, FL",Nov-22,1379414,1350633,28781,2.10000000
CN1208700000000,12,087,"Monroe County, FL",Nov-22,51436,50599,837,1.60000000
CN1208900000000,12,089,"Nassau County, FL",Nov-22,45337,44275,1062,2.30000000
CN1209100000000,12,091,"Okaloosa County, FL",Nov-22,101903,99617,2286,2.20000000
CN1209300000000,12,093,"Okeechobee County, FL",Nov-22,17615,17135,480,2.70000000
CN1209500000000,12,095,"Orange County, FL",Nov-22,786584,765549,21035,2.70000000
CN1209700000000,12,097,"Osceola County, FL",Nov-22,196031,189667,6364,3.20000000
CN1209900000000,12,099,"Palm Beach County, FL",Nov-22,770676,750810,19866,2.60000000
CN1210100000000,12,101,"Pasco County, FL",Nov-22,260018,252730,7288,2.80000000
CN1210300000000,12,103,"Pinellas County, FL",Nov-22,513428,501106,12322,2.40000000
CN1210500000000,12,105,"Polk County, FL",Nov-22,342135,331157,10978,3.20000000
CN1210700000000,12,107,"Putnam County, FL",Nov-22,27394,26354,1040,3.80000000
CN1210900000000,12,109,"St. Johns County, FL",Nov-22,150899,147613,3286,2.20000000
CN1211100000000,12,111,"St. Lucie County, FL",Nov-22,156534,151827,4707,3.00000000
CN1211300000000,12,113,"Santa Rosa County, FL",Nov-22,88574,86419,2155,2.40000000
CN1211500000000,12,115,"Sarasota County, FL",Nov-22,200855,195541,5314,2.60000000
CN1211700000000,12,117,"Seminole County, FL",Nov-22,261631,255149,6482,2.50000000
CN1211900000000,12,119,"Sumter County, FL",Nov-22,36230,34871,1359,3.80000000
CN1212100000000,12,121,"Suwannee County, FL",Nov-22,17597,17074,523,3.00000000
CN1212300000000,12,123,"Taylor County, FL",Nov-22,7898,7663,235,3.00000000
CN1212500000000,12,125,"Union County, FL",Nov-22,4733,4603,130,2.70000000
CN1212700000000,12,127,"Volusia County, FL",Nov-22,266713,258929,7784,2.90000000
CN1212900000000,12,129,"Wakulla County, FL",Nov-22,16309,15942,367,2.30000000
CN1213100000000,12,131,"Walton County, FL",Nov-22,34548,33736,812,2.40000000
CN1213300000000,12,133,"Washington County, FL",Nov-22,9774,9495,279,2.90000000
CN1300100000000,13,001,"Appling County, GA",Nov-22,8802,8509,293,3.30000000
CN1300300000000,13,003,"Atkinson County, GA",Nov-22,4456,4363,93,2.10000000
CN1300500000000,13,005,"Bacon County, GA",Nov-22,4640,4510,130,2.80000000
CN1300700000000,13,007,"Baker County, GA",Nov-22,1115,1076,39,3.50000000
CN1300900000000,13,009,"Baldwin County, GA",Nov-22,17721,17047,674,3.80000000
CN1301100000000,13,011,"Banks County, GA",Nov-22,10292,10075,217,2.10000000
CN1301300000000,13,013,"Barrow County, GA",Nov-22,43431,42423,1008,2.30000000
CN1301500000000,13,015,"Bartow County, GA",Nov-22,52672,51299,1373,2.60000000
CN1301700000000,13,017,"Ben Hill County, GA",Nov-22,5400,5182,218,4.00000000
CN1301900000000,13,019,"Berrien County, GA",Nov-22,7608,7391,217,2.90000000
CN1302100000000,13,021,"Bibb County, GA",Nov-22,67614,65320,2294,3.40000000
CN1302300000000,13,023,"Bleckley County, GA",Nov-22,4564,4391,173,3.80000000
CN1302500000000,13,025,"Brantley County, GA",Nov-22,7332,7099,233,3.20000000
CN1302700000000,13,027,"Brooks County, GA",Nov-22,6675,6481,194,2.90000000
CN1302900000000,13,029,"Bryan County, GA",Nov-22,20338,19848,490,2.40000000
CN1303100000000,13,031,"Bulloch County, GA",Nov-22,37429,36291,1138,3.00000000
CN1303300000000,13,033,"Burke County, GA",Nov-22,8981,8543,438,4.90000000
CN1303500000000,13,035,"Butts County, GA",Nov-22,11424,11128,296,2.60000000
CN1303700000000,13,037,"Calhoun County, GA",Nov-22,2238,2178,60,2.70000000
CN1303900000000,13,039,"Camden County, GA",Nov-22,21729,21128,601,2.80000000
CN1304300000000,13,043,"Candler County, GA",Nov-22,6094,5949,145,2.40000000
CN1304500000000,13,045,"Carroll County, GA",Nov-22,57628,56055,1573,2.70000000
CN1304700000000,13,047,"Catoosa County, GA",Nov-22,33319,32522,797,2.40000000
CN1304900000000,13,049,"Charlton County, GA",Nov-22,4965,4820,145,2.90000000
CN1305100000000,13,051,"Chatham County, GA",Nov-22,145402,141471,3931,2.70000000
CN1305300000000,13,053,"Chattahoochee County, GA",Nov-22,1907,1831,76,4.00000000
CN1305500000000,13,055,"Chattooga County, GA",Nov-22,9085,8749,336,3.70000000
CN1305700000000,13,057,"Cherokee County, GA",Nov-22,143923,140820,3103,2.20000000
CN1305900000000,13,059,"Clarke County, GA",Nov-22,61795,60105,1690,2.70000000
CN1306100000000,13,061,"Clay County, GA",Nov-22,845,779,66,7.80000000
CN1306300000000,13,063,"Clayton County, GA",Nov-22,141783,136101,5682,4.00000000
CN1306500000000,13,065,"Clinch County, GA",Nov-22,3063,2987,76,2.50000000
CN1306700000000,13,067,"Cobb County, GA",Nov-22,434941,424667,10274,2.40000000
CN1306900000000,13,069,"Coffee County, GA",Nov-22,17969,17389,580,3.20000000
CN1307100000000,13,071,"Colquitt County, GA",Nov-22,21830,21274,556,2.50000000
CN1307300000000,13,073,"Columbia County, GA",Nov-22,75795,73812,1983,2.60000000
CN1307500000000,13,075,"Cook County, GA",Nov-22,8186,7951,235,2.90000000
CN1307700000000,13,077,"Coweta County, GA",Nov-22,78316,76432,1884,2.40000000
CN1307900000000,13,079,"Crawford County, GA",Nov-22,5525,5381,144,2.60000000
CN1308100000000,13,081,"Crisp County, GA",Nov-22,9312,8904,408,4.40000000
CN1308300000000,13,083,"Dade County, GA",Nov-22,8028,7829,199,2.50000000
CN1308500000000,13,085,"Dawson County, GA",Nov-22,13517,13215,302,2.20000000
CN1308700000000,13,087,"Decatur County, GA",Nov-22,11112,10770,342,3.10000000
CN1308900000000,13,089,"DeKalb County, GA",Nov-22,408514,396611,11903,2.90000000
CN1309100000000,13,091,"Dodge County, GA",Nov-22,6923,6697,226,3.30000000
CN1309300000000,13,093,"Dooly County, GA",Nov-22,4653,4469,184,4.00000000
CN1309500000000,13,095,"Dougherty County, GA",Nov-22,36816,35261,1555,4.20000000
CN1309700000000,13,097,"Douglas County, GA",Nov-22,75696,73441,2255,3.00000000
CN1309900000000,13,099,"Early County, GA",Nov-22,4145,3995,150,3.60000000
CN1310100000000,13,101,"Echols County, GA",Nov-22,1859,1819,40,2.20000000
CN1310300000000,13,103,"Effingham County, GA",Nov-22,33986,33195,791,2.30000000
CN1310500000000,13,105,"Elbert County, GA",Nov-22,7600,7335,265,3.50000000
CN1310700000000,13,107,"Emanuel County, GA",Nov-22,8689,8351,338,3.90000000
CN1310900000000,13,109,"Evans County, GA",Nov-22,5168,5035,133,2.60000000
CN1311100000000,13,111,"Fannin County, GA",Nov-22,11984,11695,289,2.40000000
CN1311300000000,13,113,"Fayette County, GA",Nov-22,60011,58617,1394,2.30000000
CN1311500000000,13,115,"Floyd County, GA",Nov-22,43918,42693,1225,2.80000000
CN1311700000000,13,117,"Forsyth County, GA",Nov-22,131249,128504,2745,2.10000000
CN1311900000000,13,119,"Franklin County, GA",Nov-22,10067,9796,271,2.70000000
CN1312100000000,13,121,"Fulton County, GA",Nov-22,580285,563084,17201,3.00000000
CN1312300000000,13,123,"Gilmer County, GA",Nov-22,12317,11967,350,2.80000000
CN1312500000000,13,125,"Glascock County, GA",Nov-22,1251,1217,34,2.70000000
CN1312700000000,13,127,"Glynn County, GA",Nov-22,39277,38217,1060,2.70000000
CN1312900000000,13,129,"Gordon County, GA",Nov-22,28904,28179,725,2.50000000
CN1313100000000,13,131,"Grady County, GA",Nov-22,11043,10765,278,2.50000000
CN1313300000000,13,133,"Greene County, GA",Nov-22,7183,6959,224,3.10000000
CN1313500000000,13,135,"Gwinnett County, GA",Nov-22,505029,492703,12326,2.40000000
CN1313700000000,13,137,"Habersham County, GA",Nov-22,18391,17869,522,2.80000000
CN1313900000000,13,139,"Hall County, GA",Nov-22,105605,103314,2291,2.20000000
CN1314100000000,13,141,"Hancock County, GA",Nov-22,2511,2382,129,5.10000000
CN1314300000000,13,143,"Haralson County, GA",Nov-22,13114,12755,359,2.70000000
CN1314500000000,13,145,"Harris County, GA",Nov-22,16852,16438,414,2.50000000
CN1314700000000,13,147,"Hart County, GA",Nov-22,11625,11287,338,2.90000000
CN1314900000000,13,149,"Heard County, GA",Nov-22,5357,5218,139,2.60000000
CN1315100000000,13,151,"Henry County, GA",Nov-22,121615,118077,3538,2.90000000
CN1315300000000,13,153,"Houston County, GA",Nov-22,70778,68776,2002,2.80000000
CN1315500000000,13,155,"Irwin County, GA",Nov-22,3497,3364,133,3.80000000
CN1315700000000,13,157,"Jackson County, GA",Nov-22,45705,44836,869,1.90000000
CN1315900000000,13,159,"Jasper County, GA",Nov-22,7246,7080,166,2.30000000
CN1316100000000,13,161,"Jeff Davis County, GA",Nov-22,6095,5883,212,3.50000000
CN1316300000000,13,163,"Jefferson County, GA",Nov-22,6980,6754,226,3.20000000
CN1316500000000,13,165,"Jenkins County, GA",Nov-22,3139,3004,135,4.30000000
CN1316700000000,13,167,"Johnson County, GA",Nov-22,4009,3909,100,2.50000000
CN1316900000000,13,169,"Jones County, GA",Nov-22,13750,13387,363,2.60000000
CN1317100000000,13,171,"Lamar County, GA",Nov-22,8448,8194,254,3.00000000
CN1317300000000,13,173,"Lanier County, GA",Nov-22,3788,3659,129,3.40000000
CN1317500000000,13,175,"Laurens County, GA",Nov-22,19226,18529,697,3.60000000
CN1317700000000,13,177,"Lee County, GA",Nov-22,15152,14769,383,2.50000000
CN1317900000000,13,179,"Liberty County, GA",Nov-22,25955,25170,785,3.00000000
CN1318100000000,13,181,"Lincoln County, GA",Nov-22,3495,3384,111,3.20000000
CN1318300000000,13,183,"Long County, GA",Nov-22,8392,8160,232,2.80000000
CN1318500000000,13,185,"Lowndes County, GA",Nov-22,50556,49026,1530,3.00000000
CN1318700000000,13,187,"Lumpkin County, GA",Nov-22,17723,17331,392,2.20000000
CN1318900000000,13,189,"McDuffie County, GA",Nov-22,8403,8038,365,4.30000000
CN1319100000000,13,191,"McIntosh County, GA",Nov-22,6144,5966,178,2.90000000
CN1319300000000,13,193,"Macon County, GA",Nov-22,4488,4309,179,4.00000000
CN1319500000000,13,195,"Madison County, GA",Nov-22,14250,13893,357,2.50000000
CN1319700000000,13,197,"Marion County, GA",Nov-22,3255,3146,109,3.30000000
CN1319900000000,13,199,"Meriwether County, GA",Nov-22,9044,8725,319,3.50000000
CN1320100000000,13,201,"Miller County, GA",Nov-22,2724,2655,69,2.50000000
CN1320500000000,13,205,"Mitchell County, GA",Nov-22,7894,7616,278,3.50000000
CN1320700000000,13,207,"Monroe County, GA",Nov-22,13193,12866,327,2.50000000
CN1320900000000,13,209,"Montgomery County, GA",Nov-22,3731,3596,135,3.60000000
CN1321100000000,13,211,"Morgan County, GA",Nov-22,9744,9514,230,2.40000000
CN1321300000000,13,213,"Murray County, GA",Nov-22,15232,14658,574,3.80000000
CN1321500000000,13,215,"Muscogee County, GA",Nov-22,75799,72777,3022,4.00000000
CN1321700000000,13,217,"Newton County, GA",Nov-22,54667,52974,1693,3.10000000
CN1321900000000,13,219,"Oconee County, GA",Nov-22,21317,20909,408,1.90000000
CN1322100000000,13,221,"Oglethorpe County, GA",Nov-22,7353,7178,175,2.40000000
CN1322300000000,13,223,"Paulding County, GA",Nov-22,92156,89944,2212,2.40000000
CN1322500000000,13,225,"Peach County, GA",Nov-22,11841,11428,413,3.50000000
CN1322700000000,13,227,"Pickens County, GA",Nov-22,16034,15668,366,2.30000000
CN1322900000000,13,229,"Pierce County, GA",Nov-22,8494,8268,226,2.70000000
CN1323100000000,13,231,"Pike County, GA",Nov-22,9271,9041,230,2.50000000
CN1323300000000,13,233,"Polk County, GA",Nov-22,18369,17841,528,2.90000000
CN1323500000000,13,235,"Pulaski County, GA",Nov-22,3990,3878,112,2.80000000
CN1323700000000,13,237,"Putnam County, GA",Nov-22,8774,8496,278,3.20000000
CN1323900000000,13,239,"Quitman County, GA",Nov-22,766,723,43,5.60000000
CN1324100000000,13,241,"Rabun County, GA",Nov-22,7555,7349,206,2.70000000
CN1324300000000,13,243,"Randolph County, GA",Nov-22,2347,2251,96,4.10000000
CN1324500000000,13,245,"Richmond County, GA",Nov-22,82668,79244,3424,4.10000000
CN1324700000000,13,247,"Rockdale County, GA",Nov-22,45600,44130,1470,3.20000000
CN1324900000000,13,249,"Schley County, GA",Nov-22,2083,2013,70,3.40000000
CN1325100000000,13,251,"Screven County, GA",Nov-22,4928,4711,217,4.40000000
CN1325300000000,13,253,"Seminole County, GA",Nov-22,2939,2842,97,3.30000000
CN1325500000000,13,255,"Spalding County, GA",Nov-22,29605,28658,947,3.20000000
CN1325700000000,13,257,"Stephens County, GA",Nov-22,10342,10012,330,3.20000000
CN1325900000000,13,259,"Stewart County, GA",Nov-22,2586,2490,96,3.70000000
CN1326100000000,13,261,"Sumter County, GA",Nov-22,11865,11381,484,4.10000000
CN1326300000000,13,263,"Talbot County, GA",Nov-22,2784,2696,88,3.20000000
CN1326500000000,13,265,"Taliaferro County, GA",Nov-22,528,507,21,4.00000000
CN1326700000000,13,267,"Tattnall County, GA",Nov-22,9658,9416,242,2.50000000
CN1326900000000,13,269,"Taylor County, GA",Nov-22,2791,2673,118,4.20000000
CN1327100000000,13,271,"Telfair County, GA",Nov-22,3524,3312,212,6.00000000
CN1327300000000,13,273,"Terrell County, GA",Nov-22,3512,3359,153,4.40000000
CN1327500000000,13,275,"Thomas County, GA",Nov-22,17287,16746,541,3.10000000
CN1327700000000,13,277,"Tift County, GA",Nov-22,21647,21121,526,2.40000000
CN1327900000000,13,279,"Toombs County, GA",Nov-22,11749,11311,438,3.70000000
CN1328100000000,13,281,"Towns County, GA",Nov-22,4180,4035,145,3.50000000
CN1328300000000,13,283,"Treutlen County, GA",Nov-22,2539,2436,103,4.10000000
CN1328500000000,13,285,"Troup County, GA",Nov-22,37462,36492,970,2.60000000
CN1328700000000,13,287,"Turner County, GA",Nov-22,3195,3074,121,3.80000000
CN1328900000000,13,289,"Twiggs County, GA",Nov-22,2802,2697,105,3.70000000
CN1329100000000,13,291,"Union County, GA",Nov-22,11198,10930,268,2.40000000
CN1329300000000,13,293,"Upson County, GA",Nov-22,11731,11399,332,2.80000000
CN1329500000000,13,295,"Walker County, GA",Nov-22,31139,30293,846,2.70000000
CN1329700000000,13,297,"Walton County, GA",Nov-22,48386,47160,1226,2.50000000
CN1329900000000,13,299,"Ware County, GA",Nov-22,15141,14683,458,3.00000000
CN1330100000000,13,301,"Warren County, GA",Nov-22,2629,2545,84,3.20000000
CN1330300000000,13,303,"Washington County, GA",Nov-22,6534,6287,247,3.80000000
CN1330500000000,13,305,"Wayne County, GA",Nov-22,11596,11266,330,2.80000000
CN1330700000000,13,307,"Webster County, GA",Nov-22,973,943,30,3.10000000
CN1330900000000,13,309,"Wheeler County, GA",Nov-22,1612,1537,75,4.70000000
CN1331100000000,13,311,"White County, GA",Nov-22,16712,16346,366,2.20000000
CN1331300000000,13,313,"Whitfield County, GA",Nov-22,42744,41240,1504,3.50000000
CN1331500000000,13,315,"Wilcox County, GA",Nov-22,2684,2600,84,3.10000000
CN1331700000000,13,317,"Wilkes County, GA",Nov-22,3612,3480,132,3.70000000
CN1331900000000,13,319,"Wilkinson County, GA",Nov-22,3605,3478,127,3.50000000
CN1332100000000,13,321,"Worth County, GA",Nov-22,8808,8561,247,2.80000000
CN1500100000000,15,001,"Hawaii County, HI",Nov-22,94302,90447,3855,4.10000000
CN1500300000000,15,003,"Honolulu County/city, HI",Nov-22,455429,438128,17301,3.80000000
CN1500700000000,15,007,"Kauai County, HI",Nov-22,37084,35489,1595,4.30000000
CN1500900000000,15,009,"Maui County, HI",Nov-22,86928,83263,3665,4.20000000
CN1600100000000,16,001,"Ada County, ID",Nov-22,280958,274492,6466,2.30000000
CN1600300000000,16,003,"Adams County, ID",Nov-22,1799,1708,91,5.10000000
CN1600500000000,16,005,"Bannock County, ID",Nov-22,45812,44638,1174,2.60000000
CN1600700000000,16,007,"Bear Lake County, ID",Nov-22,3400,3324,76,2.20000000
CN1600900000000,16,009,"Benewah County, ID",Nov-22,4203,4024,179,4.30000000
CN1601100000000,16,011,"Bingham County, ID",Nov-22,25458,24833,625,2.50000000
CN1601300000000,16,013,"Blaine County, ID",Nov-22,13217,12870,347,2.60000000
CN1601500000000,16,015,"Boise County, ID",Nov-22,3898,3750,148,3.80000000
CN1601700000000,16,017,"Bonner County, ID",Nov-22,22893,22043,850,3.70000000
CN1601900000000,16,019,"Bonneville County, ID",Nov-22,64354,62937,1417,2.20000000
CN1602100000000,16,021,"Boundary County, ID",Nov-22,5844,5632,212,3.60000000
CN1602300000000,16,023,"Butte County, ID",Nov-22,1533,1479,54,3.50000000
CN1602500000000,16,025,"Camas County, ID",Nov-22,730,711,19,2.60000000
CN1602700000000,16,027,"Canyon County, ID",Nov-22,115123,111821,3302,2.90000000
CN1602900000000,16,029,"Caribou County, ID",Nov-22,4266,4130,136,3.20000000
CN1603100000000,16,031,"Cassia County, ID",Nov-22,13346,13033,313,2.30000000
CN1603300000000,16,033,"Clark County, ID",Nov-22,402,385,17,4.20000000
CN1603500000000,16,035,"Clearwater County, ID",Nov-22,3138,2990,148,4.70000000
CN1603700000000,16,037,"Custer County, ID",Nov-22,2161,2064,97,4.50000000
CN1603900000000,16,039,"Elmore County, ID",Nov-22,12587,12243,344,2.70000000
CN1604100000000,16,041,"Franklin County, ID",Nov-22,7868,7695,173,2.20000000
CN1604300000000,16,043,"Fremont County, ID",Nov-22,8928,8699,229,2.60000000
CN1604500000000,16,045,"Gem County, ID",Nov-22,9132,8893,239,2.60000000
CN1604700000000,16,047,"Gooding County, ID",Nov-22,8738,8515,223,2.60000000
CN1604900000000,16,049,"Idaho County, ID",Nov-22,7188,6951,237,3.30000000
CN1605100000000,16,051,"Jefferson County, ID",Nov-22,15529,15220,309,2.00000000
CN1605300000000,16,053,"Jerome County, ID",Nov-22,13084,12750,334,2.60000000
CN1605500000000,16,055,"Kootenai County, ID",Nov-22,86541,83678,2863,3.30000000
CN1605700000000,16,057,"Latah County, ID",Nov-22,21246,20829,417,2.00000000
CN1605900000000,16,059,"Lemhi County, ID",Nov-22,3845,3719,126,3.30000000
CN1606100000000,16,061,"Lewis County, ID",Nov-22,1712,1663,49,2.90000000
CN1606300000000,16,063,"Lincoln County, ID",Nov-22,2784,2683,101,3.60000000
CN1606500000000,16,065,"Madison County, ID",Nov-22,25546,25167,379,1.50000000
CN1606700000000,16,067,"Minidoka County, ID",Nov-22,12607,12318,289,2.30000000
CN1606900000000,16,069,"Nez Perce County, ID",Nov-22,21767,21214,553,2.50000000
CN1607100000000,16,071,"Oneida County, ID",Nov-22,2802,2724,78,2.80000000
CN1607300000000,16,073,"Owyhee County, ID",Nov-22,5713,5536,177,3.10000000
CN1607500000000,16,075,"Payette County, ID",Nov-22,12552,12201,351,2.80000000
CN1607700000000,16,077,"Power County, ID",Nov-22,4275,4151,124,2.90000000
CN1607900000000,16,079,"Shoshone County, ID",Nov-22,5595,5292,303,5.40000000
CN1608100000000,16,081,"Teton County, ID",Nov-22,7508,7291,217,2.90000000
CN1608300000000,16,083,"Twin Falls County, ID",Nov-22,44557,43447,1110,2.50000000
CN1608500000000,16,085,"Valley County, ID",Nov-22,5709,5494,215,3.80000000
CN1608700000000,16,087,"Washington County, ID",Nov-22,5079,4928,151,3.00000000
CN1700100000000,17,001,"Adams County, IL",Nov-22,29985,28922,1063,3.50000000
CN1700300000000,17,003,"Alexander County, IL",Nov-22,1802,1678,124,6.90000000
CN1700500000000,17,005,"Bond County, IL",Nov-22,7437,7174,263,3.50000000
CN1700700000000,17,007,"Boone County, IL",Nov-22,25042,23623,1419,5.70000000
CN1700900000000,17,009,"Brown County, IL",Nov-22,3155,3091,64,2.00000000
CN1701100000000,17,011,"Bureau County, IL",Nov-22,15735,15077,658,4.20000000
CN1701300000000,17,013,"Calhoun County, IL",Nov-22,2165,2079,86,4.00000000
CN1701500000000,17,015,"Carroll County, IL",Nov-22,7430,7154,276,3.70000000
CN1701700000000,17,017,"Cass County, IL",Nov-22,5514,5279,235,4.30000000
CN1701900000000,17,019,"Champaign County, IL",Nov-22,110441,106474,3967,3.60000000
CN1702100000000,17,021,"Christian County, IL",Nov-22,13123,12524,599,4.60000000
CN1702300000000,17,023,"Clark County, IL",Nov-22,7026,6747,279,4.00000000
CN1702500000000,17,025,"Clay County, IL",Nov-22,5655,5393,262,4.60000000
CN1702700000000,17,027,"Clinton County, IL",Nov-22,19803,19271,532,2.70000000
CN1702900000000,17,029,"Coles County, IL",Nov-22,22641,21724,917,4.10000000
CN1703100000000,17,031,"Cook County, IL",Nov-22,2652989,2521932,131057,4.90000000
CN1703300000000,17,033,"Crawford County, IL",Nov-22,8493,8178,315,3.70000000
CN1703500000000,17,035,"Cumberland County, IL",Nov-22,5951,5772,179,3.00000000
CN1703700000000,17,037,"DeKalb County, IL",Nov-22,53842,51681,2161,4.00000000
CN1703900000000,17,039,"De Witt County, IL",Nov-22,7342,7053,289,3.90000000
CN1704100000000,17,041,"Douglas County, IL",Nov-22,10089,9776,313,3.10000000
CN1704300000000,17,043,"DuPage County, IL",Nov-22,515512,499123,16389,3.20000000
CN1704500000000,17,045,"Edgar County, IL",Nov-22,8772,8481,291,3.30000000
CN1704700000000,17,047,"Edwards County, IL",Nov-22,2434,2335,99,4.10000000
CN1704900000000,17,049,"Effingham County, IL",Nov-22,19255,18704,551,2.90000000
CN1705100000000,17,051,"Fayette County, IL",Nov-22,9585,9189,396,4.10000000
CN1705300000000,17,053,"Ford County, IL",Nov-22,6330,6106,224,3.50000000
CN1705500000000,17,055,"Franklin County, IL",Nov-22,15400,14540,860,5.60000000
CN1705700000000,17,057,"Fulton County, IL",Nov-22,14252,13555,697,4.90000000
CN1705900000000,17,059,"Gallatin County, IL",Nov-22,1972,1860,112,5.70000000
CN1706100000000,17,061,"Greene County, IL",Nov-22,5820,5591,229,3.90000000
CN1706300000000,17,063,"Grundy County, IL",Nov-22,26031,24915,1116,4.30000000
CN1706500000000,17,065,"Hamilton County, IL",Nov-22,4216,4074,142,3.40000000
CN1706700000000,17,067,"Hancock County, IL",Nov-22,8081,7784,297,3.70000000
CN1706900000000,17,069,"Hardin County, IL",Nov-22,1283,1210,73,5.70000000
CN1707100000000,17,071,"Henderson County, IL",Nov-22,3522,3389,133,3.80000000
CN1707300000000,17,073,"Henry County, IL",Nov-22,24323,23380,943,3.90000000
CN1707500000000,17,075,"Iroquois County, IL",Nov-22,12620,12110,510,4.00000000
CN1707700000000,17,077,"Jackson County, IL",Nov-22,27380,26297,1083,4.00000000
CN1707900000000,17,079,"Jasper County, IL",Nov-22,4683,4527,156,3.30000000
CN1708100000000,17,081,"Jefferson County, IL",Nov-22,15971,15194,777,4.90000000
CN1708300000000,17,083,"Jersey County, IL",Nov-22,10522,10166,356,3.40000000
CN1708500000000,17,085,"Jo Daviess County, IL",Nov-22,10130,9791,339,3.30000000
CN1708700000000,17,087,"Johnson County, IL",Nov-22,4074,3873,201,4.90000000
CN1708900000000,17,089,"Kane County, IL",Nov-22,264283,252958,11325,4.30000000
CN1709100000000,17,091,"Kankakee County, IL",Nov-22,52379,49579,2800,5.30000000
CN1709300000000,17,093,"Kendall County, IL",Nov-22,72124,69606,2518,3.50000000
CN1709500000000,17,095,"Knox County, IL",Nov-22,19717,18659,1058,5.40000000
CN1709700000000,17,097,"Lake County, IL",Nov-22,367225,352577,14648,4.00000000
CN1709900000000,17,099,"LaSalle County, IL",Nov-22,51454,49013,2441,4.70000000
CN1710100000000,17,101,"Lawrence County, IL",Nov-22,5412,5151,261,4.80000000
CN1710300000000,17,103,"Lee County, IL",Nov-22,16319,15700,619,3.80000000
CN1710500000000,17,105,"Livingston County, IL",Nov-22,15241,14659,582,3.80000000
CN1710700000000,17,107,"Logan County, IL",Nov-22,11518,11011,507,4.40000000
CN1710900000000,17,109,"McDonough County, IL",Nov-22,13022,12537,485,3.70000000
CN1711100000000,17,111,"McHenry County, IL",Nov-22,168263,162541,5722,3.40000000
CN1711300000000,17,113,"McLean County, IL",Nov-22,88652,85699,2953,3.30000000
CN1711500000000,17,115,"Macon County, IL",Nov-22,46171,43552,2619,5.70000000
CN1711700000000,17,117,"Macoupin County, IL",Nov-22,21985,21193,792,3.60000000
CN1711900000000,17,119,"Madison County, IL",Nov-22,130525,125700,4825,3.70000000
CN1712100000000,17,121,"Marion County, IL",Nov-22,16326,15548,778,4.80000000
CN1712300000000,17,123,"Marshall County, IL",Nov-22,5104,4866,238,4.70000000
CN1712500000000,17,125,"Mason County, IL",Nov-22,5716,5448,268,4.70000000
CN1712700000000,17,127,"Massac County, IL",Nov-22,5278,5016,262,5.00000000
CN1712900000000,17,129,"Menard County, IL",Nov-22,6258,6048,210,3.40000000
CN1713100000000,17,131,"Mercer County, IL",Nov-22,7740,7462,278,3.60000000
CN1713300000000,17,133,"Monroe County, IL",Nov-22,18594,18082,512,2.80000000
CN1713500000000,17,135,"Montgomery County, IL",Nov-22,10963,10448,515,4.70000000
CN1713700000000,17,137,"Morgan County, IL",Nov-22,15532,14952,580,3.70000000
CN1713900000000,17,139,"Moultrie County, IL",Nov-22,7293,7079,214,2.90000000
CN1714100000000,17,141,"Ogle County, IL",Nov-22,23077,22015,1062,4.60000000
CN1714300000000,17,143,"Peoria County, IL",Nov-22,82271,77968,4303,5.20000000
CN1714500000000,17,145,"Perry County, IL",Nov-22,7852,7481,371,4.70000000
CN1714700000000,17,147,"Piatt County, IL",Nov-22,8668,8402,266,3.10000000
CN1714900000000,17,149,"Pike County, IL",Nov-22,6553,6290,263,4.00000000
CN1715100000000,17,151,"Pope County, IL",Nov-22,1652,1579,73,4.40000000
CN1715300000000,17,153,"Pulaski County, IL",Nov-22,1685,1553,132,7.80000000
CN1715500000000,17,155,"Putnam County, IL",Nov-22,2836,2710,126,4.40000000
CN1715700000000,17,157,"Randolph County, IL",Nov-22,13503,13051,452,3.30000000
CN1715900000000,17,159,"Richland County, IL",Nov-22,7043,6777,266,3.80000000
CN1716100000000,17,161,"Rock Island County, IL",Nov-22,69208,66428,2780,4.00000000
CN1716300000000,17,163,"St. Clair County, IL",Nov-22,122816,117353,5463,4.40000000
CN1716500000000,17,165,"Saline County, IL",Nov-22,9021,8532,489,5.40000000
CN1716700000000,17,167,"Sangamon County, IL",Nov-22,98792,94874,3918,4.00000000
CN1716900000000,17,169,"Schuyler County, IL",Nov-22,3162,3041,121,3.80000000
CN1717100000000,17,171,"Scott County, IL",Nov-22,2285,2185,100,4.40000000
CN1717300000000,17,173,"Shelby County, IL",Nov-22,10198,9824,374,3.70000000
CN1717500000000,17,175,"Stark County, IL",Nov-22,2386,2269,117,4.90000000
CN1717700000000,17,177,"Stephenson County, IL",Nov-22,20358,19422,936,4.60000000
CN1717900000000,17,179,"Tazewell County, IL",Nov-22,61630,59247,2383,3.90000000
CN1718100000000,17,181,"Union County, IL",Nov-22,7231,6877,354,4.90000000
CN1718300000000,17,183,"Vermilion County, IL",Nov-22,31371,29740,1631,5.20000000
CN1718500000000,17,185,"Wabash County, IL",Nov-22,5517,5337,180,3.30000000
CN1718700000000,17,187,"Warren County, IL",Nov-22,7303,7016,287,3.90000000
CN1718900000000,17,189,"Washington County, IL",Nov-22,9667,9442,225,2.30000000
CN1719100000000,17,191,"Wayne County, IL",Nov-22,6873,6606,267,3.90000000
CN1719300000000,17,193,"White County, IL",Nov-22,5912,5661,251,4.20000000
CN1719500000000,17,195,"Whiteside County, IL",Nov-22,26962,25879,1083,4.00000000
CN1719700000000,17,197,"Will County, IL",Nov-22,366118,350967,15151,4.10000000
CN1719900000000,17,199,"Williamson County, IL",Nov-22,31384,30078,1306,4.20000000
CN1720100000000,17,201,"Winnebago County, IL",Nov-22,134101,126239,7862,5.90000000
CN1720300000000,17,203,"Woodford County, IL",Nov-22,18165,17558,607,3.30000000
CN1800100000000,18,001,"Adams County, IN",Nov-22,16939,16594,345,2.00000000
CN1800300000000,18,003,"Allen County, IN",Nov-22,188427,183338,5089,2.70000000
CN1800500000000,18,005,"Bartholomew County, IN",Nov-22,43560,42548,1012,2.30000000
CN1800700000000,18,007,"Benton County, IN",Nov-22,4374,4260,114,2.60000000
CN1800900000000,18,009,"Blackford County, IN",Nov-22,4851,4689,162,3.30000000
CN1801100000000,18,011,"Boone County, IN",Nov-22,38303,37542,761,2.00000000
CN1801300000000,18,013,"Brown County, IN",Nov-22,7882,7666,216,2.70000000
CN1801500000000,18,015,"Carroll County, IN",Nov-22,9886,9646,240,2.40000000
CN1801700000000,18,017,"Cass County, IN",Nov-22,17042,16550,492,2.90000000
CN1801900000000,18,019,"Clark County, IN",Nov-22,63992,62389,1603,2.50000000
CN1802100000000,18,021,"Clay County, IN",Nov-22,11654,11282,372,3.20000000
CN1802300000000,18,023,"Clinton County, IN",Nov-22,17016,16607,409,2.40000000
CN1802500000000,18,025,"Crawford County, IN",Nov-22,4772,4634,138,2.90000000
CN1802700000000,18,027,"Daviess County, IN",Nov-22,16227,15890,337,2.10000000
CN1802900000000,18,029,"Dearborn County, IN",Nov-22,25499,24845,654,2.60000000
CN1803100000000,18,031,"Decatur County, IN",Nov-22,14253,13925,328,2.30000000
CN1803300000000,18,033,"DeKalb County, IN",Nov-22,22323,21805,518,2.30000000
CN1803500000000,18,035,"Delaware County, IN",Nov-22,54270,52623,1647,3.00000000
CN1803700000000,18,037,"Dubois County, IN",Nov-22,21449,20979,470,2.20000000
CN1803900000000,18,039,"Elkhart County, IN",Nov-22,118895,115556,3339,2.80000000
CN1804100000000,18,041,"Fayette County, IN",Nov-22,8195,7858,337,4.10000000
CN1804300000000,18,043,"Floyd County, IN",Nov-22,43111,42110,1001,2.30000000
CN1804500000000,18,045,"Fountain County, IN",Nov-22,7910,7702,208,2.60000000
CN1804700000000,18,047,"Franklin County, IN",Nov-22,11219,10948,271,2.40000000
CN1804900000000,18,049,"Fulton County, IN",Nov-22,9231,8967,264,2.90000000
CN1805100000000,18,051,"Gibson County, IN",Nov-22,20029,19618,411,2.10000000
CN1805300000000,18,053,"Grant County, IN",Nov-22,31920,30960,960,3.00000000
CN1805500000000,18,055,"Greene County, IN",Nov-22,13544,13124,420,3.10000000
CN1805700000000,18,057,"Hamilton County, IN",Nov-22,195772,191720,4052,2.10000000
CN1805900000000,18,059,"Hancock County, IN",Nov-22,42788,41784,1004,2.30000000
CN1806100000000,18,061,"Harrison County, IN",Nov-22,20884,20392,492,2.40000000
CN1806300000000,18,063,"Hendricks County, IN",Nov-22,95280,93137,2143,2.20000000
CN1806500000000,18,065,"Henry County, IN",Nov-22,22028,21379,649,2.90000000
CN1806700000000,18,067,"Howard County, IN",Nov-22,33992,32361,1631,4.80000000
CN1806900000000,18,069,"Huntington County, IN",Nov-22,18404,17930,474,2.60000000
CN1807100000000,18,071,"Jackson County, IN",Nov-22,23416,22860,556,2.40000000
CN1807300000000,18,073,"Jasper County, IN",Nov-22,15755,15281,474,3.00000000
CN1807500000000,18,075,"Jay County, IN",Nov-22,8748,8514,234,2.70000000
CN1807700000000,18,077,"Jefferson County, IN",Nov-22,15047,14625,422,2.80000000
CN1807900000000,18,079,"Jennings County, IN",Nov-22,13386,13019,367,2.70000000
CN1808100000000,18,081,"Johnson County, IN",Nov-22,87041,85062,1979,2.30000000
CN1808300000000,18,083,"Knox County, IN",Nov-22,17857,17396,461,2.60000000
CN1808500000000,18,085,"Kosciusko County, IN",Nov-22,40114,39019,1095,2.70000000
CN1808700000000,18,087,"LaGrange County, IN",Nov-22,20753,20232,521,2.50000000
CN1808900000000,18,089,"Lake County, IN",Nov-22,226989,216639,10350,4.60000000
CN1809100000000,18,091,"LaPorte County, IN",Nov-22,46383,44715,1668,3.60000000
CN1809300000000,18,093,"Lawrence County, IN",Nov-22,21058,20387,671,3.20000000
CN1809500000000,18,095,"Madison County, IN",Nov-22,60222,58389,1833,3.00000000
CN1809700000000,18,097,"Marion County, IN",Nov-22,508562,493432,15130,3.00000000
CN1809900000000,18,099,"Marshall County, IN",Nov-22,23301,22632,669,2.90000000
CN1810100000000,18,101,"Martin County, IN",Nov-22,5419,5286,133,2.50000000
CN1810300000000,18,103,"Miami County, IN",Nov-22,13936,13455,481,3.50000000
CN1810500000000,18,105,"Monroe County, IN",Nov-22,74325,72429,1896,2.60000000
CN1810700000000,18,107,"Montgomery County, IN",Nov-22,18747,18296,451,2.40000000
CN1810900000000,18,109,"Morgan County, IN",Nov-22,37416,36484,932,2.50000000
CN1811100000000,18,111,"Newton County, IN",Nov-22,6689,6472,217,3.20000000
CN1811300000000,18,113,"Noble County, IN",Nov-22,21690,21078,612,2.80000000
CN1811500000000,18,115,"Ohio County, IN",Nov-22,3157,3087,70,2.20000000
CN1811700000000,18,117,"Orange County, IN",Nov-22,8130,7874,256,3.10000000
CN1811900000000,18,119,"Owen County, IN",Nov-22,9778,9491,287,2.90000000
CN1812100000000,18,121,"Parke County, IN",Nov-22,6947,6755,192,2.80000000
CN1812300000000,18,123,"Perry County, IN",Nov-22,8664,8419,245,2.80000000
CN1812500000000,18,125,"Pike County, IN",Nov-22,5813,5666,147,2.50000000
CN1812700000000,18,127,"Porter County, IN",Nov-22,85437,82767,2670,3.10000000
CN1812900000000,18,129,"Posey County, IN",Nov-22,13066,12767,299,2.30000000
CN1813100000000,18,131,"Pulaski County, IN",Nov-22,6533,6367,166,2.50000000
CN1813300000000,18,133,"Putnam County, IN",Nov-22,16908,16442,466,2.80000000
CN1813500000000,18,135,"Randolph County, IN",Nov-22,11549,11247,302,2.60000000
CN1813700000000,18,137,"Ripley County, IN",Nov-22,12614,12260,354,2.80000000
CN1813900000000,18,139,"Rush County, IN",Nov-22,8850,8647,203,2.30000000
CN1814100000000,18,141,"St. Joseph County, IN",Nov-22,135104,130656,4448,3.30000000
CN1814300000000,18,143,"Scott County, IN",Nov-22,10748,10427,321,3.00000000
CN1814500000000,18,145,"Shelby County, IN",Nov-22,23750,23177,573,2.40000000
CN1814700000000,18,147,"Spencer County, IN",Nov-22,10002,9761,241,2.40000000
CN1814900000000,18,149,"Starke County, IN",Nov-22,9409,9066,343,3.60000000
CN1815100000000,18,151,"Steuben County, IN",Nov-22,20609,20189,420,2.00000000
CN1815300000000,18,153,"Sullivan County, IN",Nov-22,7938,7674,264,3.30000000
CN1815500000000,18,155,"Switzerland County, IN",Nov-22,4642,4515,127,2.70000000
CN1815700000000,18,157,"Tippecanoe County, IN",Nov-22,97548,94965,2583,2.60000000
CN1815900000000,18,159,"Tipton County, IN",Nov-22,8837,8605,232,2.60000000
CN1816100000000,18,161,"Union County, IN",Nov-22,3519,3431,88,2.50000000
CN1816300000000,18,163,"Vanderburgh County, IN",Nov-22,92852,90261,2591,2.80000000
CN1816500000000,18,165,"Vermillion County, IN",Nov-22,6564,6339,225,3.40000000
CN1816700000000,18,167,"Vigo County, IN",Nov-22,45999,44436,1563,3.40000000
CN1816900000000,18,169,"Wabash County, IN",Nov-22,14603,14227,376,2.60000000
CN1817100000000,18,171,"Warren County, IN",Nov-22,4054,3949,105,2.60000000
CN1817300000000,18,173,"Warrick County, IN",Nov-22,32604,31790,814,2.50000000
CN1817500000000,18,175,"Washington County, IN",Nov-22,13984,13638,346,2.50000000
CN1817700000000,18,177,"Wayne County, IN",Nov-22,29342,28504,838,2.90000000
CN1817900000000,18,179,"Wells County, IN",Nov-22,14238,13919,319,2.20000000
CN1818100000000,18,181,"White County, IN",Nov-22,12720,12416,304,2.40000000
CN1818300000000,18,183,"Whitley County, IN",Nov-22,17738,17344,394,2.20000000
CN1900100000000,19,001,"Adair County, IA",Nov-22,4461,4369,92,2.10000000
CN1900300000000,19,003,"Adams County, IA",Nov-22,2025,1981,44,2.20000000
CN1900500000000,19,005,"Allamakee County, IA",Nov-22,7090,6859,231,3.30000000
CN1900700000000,19,007,"Appanoose County, IA",Nov-22,5975,5780,195,3.30000000
CN1900900000000,19,009,"Audubon County, IA",Nov-22,3093,3020,73,2.40000000
CN1901100000000,19,011,"Benton County, IA",Nov-22,12999,12582,417,3.20000000
CN1901300000000,19,013,"Black Hawk County, IA",Nov-22,68697,66651,2046,3.00000000
CN1901500000000,19,015,"Boone County, IA",Nov-22,14918,14573,345,2.30000000
CN1901700000000,19,017,"Bremer County, IA",Nov-22,14204,13869,335,2.40000000
CN1901900000000,19,019,"Buchanan County, IA",Nov-22,11233,10934,299,2.70000000
CN1902100000000,19,021,"Buena Vista County, IA",Nov-22,12554,12267,287,2.30000000
CN1902300000000,19,023,"Butler County, IA",Nov-22,8132,7915,217,2.70000000
CN1902500000000,19,025,"Calhoun County, IA",Nov-22,4106,3993,113,2.80000000
CN1902700000000,19,027,"Carroll County, IA",Nov-22,10771,10533,238,2.20000000
CN1902900000000,19,029,"Cass County, IA",Nov-22,6781,6610,171,2.50000000
CN1903100000000,19,031,"Cedar County, IA",Nov-22,10610,10337,273,2.60000000
CN1903300000000,19,033,"Cerro Gordo County, IA",Nov-22,22323,21689,634,2.80000000
CN1903500000000,19,035,"Cherokee County, IA",Nov-22,6110,5965,145,2.40000000
CN1903700000000,19,037,"Chickasaw County, IA",Nov-22,6469,6307,162,2.50000000
CN1903900000000,19,039,"Clarke County, IA",Nov-22,4908,4763,145,3.00000000
CN1904100000000,19,041,"Clay County, IA",Nov-22,8608,8365,243,2.80000000
CN1904300000000,19,043,"Clayton County, IA",Nov-22,9589,9287,302,3.10000000
CN1904500000000,19,045,"Clinton County, IA",Nov-22,22181,21354,827,3.70000000
CN1904700000000,19,047,"Crawford County, IA",Nov-22,8025,7762,263,3.30000000
CN1904900000000,19,049,"Dallas County, IA",Nov-22,53230,52044,1186,2.20000000
CN1905100000000,19,051,"Davis County, IA",Nov-22,4318,4207,111,2.60000000
CN1905300000000,19,053,"Decatur County, IA",Nov-22,4339,4231,108,2.50000000
CN1905500000000,19,055,"Delaware County, IA",Nov-22,10634,10395,239,2.20000000
CN1905700000000,19,057,"Des Moines County, IA",Nov-22,18047,17249,798,4.40000000
CN1905900000000,19,059,"Dickinson County, IA",Nov-22,9909,9613,296,3.00000000
CN1906100000000,19,061,"Dubuque County, IA",Nov-22,55378,53833,1545,2.80000000
CN1906300000000,19,063,"Emmet County, IA",Nov-22,4871,4738,133,2.70000000
CN1906500000000,19,065,"Fayette County, IA",Nov-22,10226,9910,316,3.10000000
CN1906700000000,19,067,"Floyd County, IA",Nov-22,8233,7980,253,3.10000000
CN1906900000000,19,069,"Franklin County, IA",Nov-22,5619,5479,140,2.50000000
CN1907100000000,19,071,"Fremont County, IA",Nov-22,3719,3615,104,2.80000000
CN1907300000000,19,073,"Greene County, IA",Nov-22,5398,5280,118,2.20000000
CN1907500000000,19,075,"Grundy County, IA",Nov-22,6500,6333,167,2.60000000
CN1907700000000,19,077,"Guthrie County, IA",Nov-22,5579,5417,162,2.90000000
CN1907900000000,19,079,"Hamilton County, IA",Nov-22,7025,6830,195,2.80000000
CN1908100000000,19,081,"Hancock County, IA",Nov-22,5754,5612,142,2.50000000
CN1908300000000,19,083,"Hardin County, IA",Nov-22,7954,7720,234,2.90000000
CN1908500000000,19,085,"Harrison County, IA",Nov-22,7238,7023,215,3.00000000
CN1908700000000,19,087,"Henry County, IA",Nov-22,9676,9392,284,2.90000000
CN1908900000000,19,089,"Howard County, IA",Nov-22,5327,5127,200,3.80000000
CN1909100000000,19,091,"Humboldt County, IA",Nov-22,4995,4880,115,2.30000000
CN1909300000000,19,093,"Ida County, IA",Nov-22,3970,3878,92,2.30000000
CN1909500000000,19,095,"Iowa County, IA",Nov-22,10179,9947,232,2.30000000
CN1909700000000,19,097,"Jackson County, IA",Nov-22,10674,10366,308,2.90000000
CN1909900000000,19,099,"Jasper County, IA",Nov-22,18570,18015,555,3.00000000
CN1910100000000,19,101,"Jefferson County, IA",Nov-22,10099,9846,253,2.50000000
CN1910300000000,19,103,"Johnson County, IA",Nov-22,88563,86446,2117,2.40000000
CN1910500000000,19,105,"Jones County, IA",Nov-22,10244,9953,291,2.80000000
CN1910700000000,19,107,"Keokuk County, IA",Nov-22,5193,5044,149,2.90000000
CN1910900000000,19,109,"Kossuth County, IA",Nov-22,8218,8021,197,2.40000000
CN1911100000000,19,111,"Lee County, IA",Nov-22,15136,14420,716,4.70000000
CN1911300000000,19,113,"Linn County, IA",Nov-22,119381,115341,4040,3.40000000
CN1911500000000,19,115,"Louisa County, IA",Nov-22,5882,5706,176,3.00000000
CN1911700000000,19,117,"Lucas County, IA",Nov-22,4712,4609,103,2.20000000
CN1911900000000,19,119,"Lyon County, IA",Nov-22,7058,6923,135,1.90000000
CN1912100000000,19,121,"Madison County, IA",Nov-22,8631,8368,263,3.00000000
CN1912300000000,19,123,"Mahaska County, IA",Nov-22,12381,12060,321,2.60000000
CN1912500000000,19,125,"Marion County, IA",Nov-22,19556,19122,434,2.20000000
CN1912700000000,19,127,"Marshall County, IA",Nov-22,16851,16120,731,4.30000000
CN1912900000000,19,129,"Mills County, IA",Nov-22,7216,7028,188,2.60000000
CN1913100000000,19,131,"Mitchell County, IA",Nov-22,5842,5710,132,2.30000000
CN1913300000000,19,133,"Monona County, IA",Nov-22,4386,4261,125,2.80000000
CN1913500000000,19,135,"Monroe County, IA",Nov-22,3935,3819,116,2.90000000
CN1913700000000,19,137,"Montgomery County, IA",Nov-22,4900,4762,138,2.80000000
CN1913900000000,19,139,"Muscatine County, IA",Nov-22,20627,19962,665,3.20000000
CN1914100000000,19,141,"O'Brien County, IA",Nov-22,8167,7967,200,2.40000000
CN1914300000000,19,143,"Osceola County, IA",Nov-22,3658,3586,72,2.00000000
CN1914500000000,19,145,"Page County, IA",Nov-22,6334,6167,167,2.60000000
CN1914700000000,19,147,"Palo Alto County, IA",Nov-22,4528,4420,108,2.40000000
CN1914900000000,19,149,"Plymouth County, IA",Nov-22,14782,14416,366,2.50000000
CN1915100000000,19,151,"Pocahontas County, IA",Nov-22,4657,4556,101,2.20000000
CN1915300000000,19,153,"Polk County, IA",Nov-22,272235,264454,7781,2.90000000
CN1915500000000,19,155,"Pottawattamie County, IA",Nov-22,48245,46854,1391,2.90000000
CN1915700000000,19,157,"Poweshiek County, IA",Nov-22,11008,10733,275,2.50000000
CN1915900000000,19,159,"Ringgold County, IA",Nov-22,2407,2352,55,2.30000000
CN1916100000000,19,161,"Sac County, IA",Nov-22,5290,5165,125,2.40000000
CN1916300000000,19,163,"Scott County, IA",Nov-22,91575,88454,3121,3.40000000
CN1916500000000,19,165,"Shelby County, IA",Nov-22,6265,6109,156,2.50000000
CN1916700000000,19,167,"Sioux County, IA",Nov-22,22363,21975,388,1.70000000
CN1916900000000,19,169,"Story County, IA",Nov-22,60811,59507,1304,2.10000000
CN1917100000000,19,171,"Tama County, IA",Nov-22,9204,8932,272,3.00000000
CN1917300000000,19,173,"Taylor County, IA",Nov-22,3105,3035,70,2.30000000
CN1917500000000,19,175,"Union County, IA",Nov-22,6175,6011,164,2.70000000
CN1917700000000,19,177,"Van Buren County, IA",Nov-22,3661,3562,99,2.70000000
CN1917900000000,19,179,"Wapello County, IA",Nov-22,17076,16519,557,3.30000000
CN1918100000000,19,181,"Warren County, IA",Nov-22,28850,28103,747,2.60000000
CN1918300000000,19,183,"Washington County, IA",Nov-22,11953,11662,291,2.40000000
CN1918500000000,19,185,"Wayne County, IA",Nov-22,2885,2806,79,2.70000000
CN1918700000000,19,187,"Webster County, IA",Nov-22,18444,17871,573,3.10000000
CN1918900000000,19,189,"Winnebago County, IA",Nov-22,4908,4761,147,3.00000000
CN1919100000000,19,191,"Winneshiek County, IA",Nov-22,11909,11591,318,2.70000000
CN1919300000000,19,193,"Woodbury County, IA",Nov-22,55727,54121,1606,2.90000000
CN1919500000000,19,195,"Worth County, IA",Nov-22,3973,3879,94,2.40000000
CN1919700000000,19,197,"Wright County, IA",Nov-22,6781,6617,164,2.40000000
CN2000100000000,20,001,"Allen County, KS",Nov-22,6421,6257,164,2.60000000
CN2000300000000,20,003,"Anderson County, KS",Nov-22,4476,4394,82,1.80000000
CN2000500000000,20,005,"Atchison County, KS",Nov-22,6828,6609,219,3.20000000
CN2000700000000,20,007,"Barber County, KS",Nov-22,2316,2276,40,1.70000000
CN2000900000000,20,009,"Barton County, KS",Nov-22,13236,12891,345,2.60000000
CN2001100000000,20,011,"Bourbon County, KS",Nov-22,6160,5964,196,3.20000000
CN2001300000000,20,013,"Brown County, KS",Nov-22,5081,4965,116,2.30000000
CN2001500000000,20,015,"Butler County, KS",Nov-22,32838,31969,869,2.60000000
CN2001700000000,20,017,"Chase County, KS",Nov-22,1403,1378,25,1.80000000
CN2001900000000,20,019,"Chautauqua County, KS",Nov-22,1498,1460,38,2.50000000
CN2002100000000,20,021,"Cherokee County, KS",Nov-22,10056,9803,253,2.50000000
CN2002300000000,20,023,"Cheyenne County, KS",Nov-22,1339,1312,27,2.00000000
CN2002500000000,20,025,"Clark County, KS",Nov-22,1134,1115,19,1.70000000
CN2002700000000,20,027,"Clay County, KS",Nov-22,3852,3759,93,2.40000000
CN2002900000000,20,029,"Cloud County, KS",Nov-22,3908,3809,99,2.50000000
CN2003100000000,20,031,"Coffey County, KS",Nov-22,3814,3698,116,3.00000000
CN2003300000000,20,033,"Comanche County, KS",Nov-22,957,936,21,2.20000000
CN2003500000000,20,035,"Cowley County, KS",Nov-22,16597,16149,448,2.70000000
CN2003700000000,20,037,"Crawford County, KS",Nov-22,19410,18903,507,2.60000000
CN2003900000000,20,039,"Decatur County, KS",Nov-22,1269,1237,32,2.50000000
CN2004100000000,20,041,"Dickinson County, KS",Nov-22,9028,8813,215,2.40000000
CN2004300000000,20,043,"Doniphan County, KS",Nov-22,4153,4052,101,2.40000000
CN2004500000000,20,045,"Douglas County, KS",Nov-22,65862,64298,1564,2.40000000
CN2004700000000,20,047,"Edwards County, KS",Nov-22,1396,1369,27,1.90000000
CN2004900000000,20,049,"Elk County, KS",Nov-22,1258,1224,34,2.70000000
CN2005100000000,20,051,"Ellis County, KS",Nov-22,17367,17070,297,1.70000000
CN2005300000000,20,053,"Ellsworth County, KS",Nov-22,2559,2513,46,1.80000000
CN2005500000000,20,055,"Finney County, KS",Nov-22,20876,20476,400,1.90000000
CN2005700000000,20,057,"Ford County, KS",Nov-22,18288,17958,330,1.80000000
CN2005900000000,20,059,"Franklin County, KS",Nov-22,14980,14662,318,2.10000000
CN2006100000000,20,061,"Geary County, KS",Nov-22,11360,10939,421,3.70000000
CN2006300000000,20,063,"Gove County, KS",Nov-22,1438,1411,27,1.90000000
CN2006500000000,20,065,"Graham County, KS",Nov-22,1247,1222,25,2.00000000
CN2006700000000,20,067,"Grant County, KS",Nov-22,2910,2838,72,2.50000000
CN2006900000000,20,069,"Gray County, KS",Nov-22,3455,3400,55,1.60000000
CN2007100000000,20,071,"Greeley County, KS",Nov-22,843,832,11,1.30000000
CN2007300000000,20,073,"Greenwood County, KS",Nov-22,3132,3073,59,1.90000000
CN2007500000000,20,075,"Hamilton County, KS",Nov-22,1719,1696,23,1.30000000
CN2007700000000,20,077,"Harper County, KS",Nov-22,2809,2758,51,1.80000000
CN2007900000000,20,079,"Harvey County, KS",Nov-22,17162,16773,389,2.30000000
CN2008100000000,20,081,"Haskell County, KS",Nov-22,2233,2193,40,1.80000000
CN2008300000000,20,083,"Hodgeman County, KS",Nov-22,1059,1038,21,2.00000000
CN2008500000000,20,085,"Jackson County, KS",Nov-22,7207,7068,139,1.90000000
CN2008700000000,20,087,"Jefferson County, KS",Nov-22,10308,10058,250,2.40000000
CN2008900000000,20,089,"Jewell County, KS",Nov-22,1224,1197,27,2.20000000
CN2009100000000,20,091,"Johnson County, KS",Nov-22,346200,338569,7631,2.20000000
CN2009300000000,20,093,"Kearny County, KS",Nov-22,2093,2059,34,1.60000000
CN2009500000000,20,095,"Kingman County, KS",Nov-22,3335,3266,69,2.10000000
CN2009700000000,20,097,"Kiowa County, KS",Nov-22,1311,1288,23,1.80000000
CN2009900000000,20,099,"Labette County, KS",Nov-22,9477,9214,263,2.80000000
CN2010100000000,20,101,"Lane County, KS",Nov-22,790,769,21,2.70000000
CN2010300000000,20,103,"Leavenworth County, KS",Nov-22,37045,36069,976,2.60000000
CN2010500000000,20,105,"Lincoln County, KS",Nov-22,1802,1768,34,1.90000000
CN2010700000000,20,107,"Linn County, KS",Nov-22,4344,4207,137,3.20000000
CN2010900000000,20,109,"Logan County, KS",Nov-22,1655,1632,23,1.40000000
CN2011100000000,20,111,"Lyon County, KS",Nov-22,17212,16823,389,2.30000000
CN2011300000000,20,113,"McPherson County, KS",Nov-22,17626,17327,299,1.70000000
CN2011500000000,20,115,"Marion County, KS",Nov-22,6201,6079,122,2.00000000
CN2011700000000,20,117,"Marshall County, KS",Nov-22,5479,5384,95,1.70000000
CN2011900000000,20,119,"Meade County, KS",Nov-22,2202,2164,38,1.70000000
CN2012100000000,20,121,"Miami County, KS",Nov-22,17845,17441,404,2.30000000
CN2012300000000,20,123,"Mitchell County, KS",Nov-22,3386,3331,55,1.60000000
CN2012500000000,20,125,"Montgomery County, KS",Nov-22,14423,13994,429,3.00000000
CN2012700000000,20,127,"Morris County, KS",Nov-22,3173,3112,61,1.90000000
CN2012900000000,20,129,"Morton County, KS",Nov-22,1212,1191,21,1.70000000
CN2013100000000,20,131,"Nemaha County, KS",Nov-22,5757,5669,88,1.50000000
CN2013300000000,20,133,"Neosho County, KS",Nov-22,6113,5905,208,3.40000000
CN2013500000000,20,135,"Ness County, KS",Nov-22,1394,1369,25,1.80000000
CN2013700000000,20,137,"Norton County, KS",Nov-22,2642,2594,48,1.80000000
CN2013900000000,20,139,"Osage County, KS",Nov-22,7995,7787,208,2.60000000
CN2014100000000,20,141,"Osborne County, KS",Nov-22,1943,1907,36,1.90000000
CN2014300000000,20,143,"Ottawa County, KS",Nov-22,3090,3016,74,2.40000000
CN2014500000000,20,145,"Pawnee County, KS",Nov-22,2777,2722,55,2.00000000
CN2014700000000,20,147,"Phillips County, KS",Nov-22,2729,2674,55,2.00000000
CN2014900000000,20,149,"Pottawatomie County, KS",Nov-22,12610,12336,274,2.20000000
CN2015100000000,20,151,"Pratt County, KS",Nov-22,4919,4818,101,2.10000000
CN2015300000000,20,153,"Rawlins County, KS",Nov-22,1564,1541,23,1.50000000
CN2015500000000,20,155,"Reno County, KS",Nov-22,28959,28168,791,2.70000000
CN2015700000000,20,157,"Republic County, KS",Nov-22,2475,2437,38,1.50000000
CN2015900000000,20,159,"Rice County, KS",Nov-22,5358,5251,107,2.00000000
CN2016100000000,20,161,"Riley County, KS",Nov-22,34686,33869,817,2.40000000
CN2016300000000,20,163,"Rooks County, KS",Nov-22,2485,2428,57,2.30000000
CN2016500000000,20,165,"Rush County, KS",Nov-22,1671,1637,34,2.00000000
CN2016700000000,20,167,"Russell County, KS",Nov-22,3423,3356,67,2.00000000
CN2016900000000,20,169,"Saline County, KS",Nov-22,30432,29746,686,2.30000000
CN2017100000000,20,171,"Scott County, KS",Nov-22,2824,2778,46,1.60000000
CN2017300000000,20,173,"Sedgwick County, KS",Nov-22,255740,248141,7599,3.00000000
CN2017500000000,20,175,"Seward County, KS",Nov-22,9964,9739,225,2.30000000
CN2017700000000,20,177,"Shawnee County, KS",Nov-22,90757,88398,2359,2.60000000
CN2017900000000,20,179,"Sheridan County, KS",Nov-22,1539,1516,23,1.50000000
CN2018100000000,20,181,"Sherman County, KS",Nov-22,2851,2796,55,1.90000000
CN2018300000000,20,183,"Smith County, KS",Nov-22,2131,2095,36,1.70000000
CN2018500000000,20,185,"Stafford County, KS",Nov-22,2005,1965,40,2.00000000
CN2018700000000,20,187,"Stanton County, KS",Nov-22,1172,1153,19,1.60000000
CN2018900000000,20,189,"Stevens County, KS",Nov-22,3026,2971,55,1.80000000
CN2019100000000,20,191,"Sumner County, KS",Nov-22,10840,10547,293,2.70000000
CN2019300000000,20,193,"Thomas County, KS",Nov-22,4340,4273,67,1.50000000
CN2019500000000,20,195,"Trego County, KS",Nov-22,1359,1325,34,2.50000000
CN2019700000000,20,197,"Wabaunsee County, KS",Nov-22,3740,3664,76,2.00000000
CN2019900000000,20,199,"Wallace County, KS",Nov-22,865,848,17,2.00000000
CN2020100000000,20,201,"Washington County, KS",Nov-22,3120,3074,46,1.50000000
CN2020300000000,20,203,"Wichita County, KS",Nov-22,1159,1138,21,1.80000000
CN2020500000000,20,205,"Wilson County, KS",Nov-22,3840,3724,116,3.00000000
CN2020700000000,20,207,"Woodson County, KS",Nov-22,1515,1464,51,3.40000000
CN2020900000000,20,209,"Wyandotte County, KS",Nov-22,77401,74813,2588,3.30000000
CN2100100000000,21,001,"Adair County, KY",Nov-22,7297,6960,337,4.60000000
CN2100300000000,21,003,"Allen County, KY",Nov-22,8915,8581,334,3.70000000
CN2100500000000,21,005,"Anderson County, KY",Nov-22,11964,11585,379,3.20000000
CN2100700000000,21,007,"Ballard County, KY",Nov-22,3405,3252,153,4.50000000
CN2100900000000,21,009,"Barren County, KY",Nov-22,17488,16781,707,4.00000000
CN2101100000000,21,011,"Bath County, KY",Nov-22,4606,4373,233,5.10000000
CN2101300000000,21,013,"Bell County, KY",Nov-22,8101,7695,406,5.00000000
CN2101500000000,21,015,"Boone County, KY",Nov-22,71165,68920,2245,3.20000000
CN2101700000000,21,017,"Bourbon County, KY",Nov-22,9547,9227,320,3.40000000
CN2101900000000,21,019,"Boyd County, KY",Nov-22,17107,16251,856,5.00000000
CN2102100000000,21,021,"Boyle County, KY",Nov-22,12430,11932,498,4.00000000
CN2102300000000,21,023,"Bracken County, KY",Nov-22,3726,3581,145,3.90000000
CN2102500000000,21,025,"Breathitt County, KY",Nov-22,3190,2957,233,7.30000000
CN2102700000000,21,027,"Breckinridge County, KY",Nov-22,7880,7515,365,4.60000000
CN2102900000000,21,029,"Bullitt County, KY",Nov-22,43587,42186,1401,3.20000000
CN2103100000000,21,031,"Butler County, KY",Nov-22,4978,4777,201,4.00000000
CN2103300000000,21,033,"Caldwell County, KY",Nov-22,5928,5718,210,3.50000000
CN2103500000000,21,035,"Calloway County, KY",Nov-22,16738,16062,676,4.00000000
CN2103700000000,21,037,"Campbell County, KY",Nov-22,49969,48346,1623,3.20000000
CN2103900000000,21,039,"Carlisle County, KY",Nov-22,2191,2117,74,3.40000000
CN2104100000000,21,041,"Carroll County, KY",Nov-22,5509,5332,177,3.20000000
CN2104300000000,21,043,"Carter County, KY",Nov-22,9597,9011,586,6.10000000
CN2104500000000,21,045,"Casey County, KY",Nov-22,6626,6375,251,3.80000000
CN2104700000000,21,047,"Christian County, KY",Nov-22,24890,23733,1157,4.60000000
CN2104900000000,21,049,"Clark County, KY",Nov-22,17176,16580,596,3.50000000
CN2105100000000,21,051,"Clay County, KY",Nov-22,5074,4778,296,5.80000000
CN2105300000000,21,053,"Clinton County, KY",Nov-22,3867,3698,169,4.40000000
CN2105500000000,21,055,"Crittenden County, KY",Nov-22,3715,3566,149,4.00000000
CN2105700000000,21,057,"Cumberland County, KY",Nov-22,3371,3270,101,3.00000000
CN2105900000000,21,059,"Daviess County, KY",Nov-22,46110,44257,1853,4.00000000
CN2106100000000,21,061,"Edmonson County, KY",Nov-22,4709,4492,217,4.60000000
CN2106300000000,21,063,"Elliott County, KY",Nov-22,1814,1676,138,7.60000000
CN2106500000000,21,065,"Estill County, KY",Nov-22,5145,4915,230,4.50000000
CN2106700000000,21,067,"Fayette County, KY",Nov-22,174882,169475,5407,3.10000000
CN2106900000000,21,069,"Fleming County, KY",Nov-22,5957,5702,255,4.30000000
CN2107100000000,21,071,"Floyd County, KY",Nov-22,10816,10156,660,6.10000000
CN2107300000000,21,073,"Franklin County, KY",Nov-22,25069,24242,827,3.30000000
CN2107500000000,21,075,"Fulton County, KY",Nov-22,2034,1944,90,4.40000000
CN2107700000000,21,077,"Gallatin County, KY",Nov-22,3955,3812,143,3.60000000
CN2107900000000,21,079,"Garrard County, KY",Nov-22,7654,7358,296,3.90000000
CN2108100000000,21,081,"Grant County, KY",Nov-22,11534,11107,427,3.70000000
CN2108300000000,21,083,"Graves County, KY",Nov-22,15444,14814,630,4.10000000
CN2108500000000,21,085,"Grayson County, KY",Nov-22,10508,10045,463,4.40000000
CN2108700000000,21,087,"Green County, KY",Nov-22,5331,5161,170,3.20000000
CN2108900000000,21,089,"Greenup County, KY",Nov-22,12870,12145,725,5.60000000
CN2109100000000,21,091,"Hancock County, KY",Nov-22,3844,3677,167,4.30000000
CN2109300000000,21,093,"Hardin County, KY",Nov-22,46893,45042,1851,3.90000000
CN2109500000000,21,095,"Harlan County, KY",Nov-22,6652,6223,429,6.40000000
CN2109700000000,21,097,"Harrison County, KY",Nov-22,8785,8494,291,3.30000000
CN2109900000000,21,099,"Hart County, KY",Nov-22,7384,7082,302,4.10000000
CN2110100000000,21,101,"Henderson County, KY",Nov-22,20751,19999,752,3.60000000
CN2110300000000,21,103,"Henry County, KY",Nov-22,8257,8003,254,3.10000000
CN2110500000000,21,105,"Hickman County, KY",Nov-22,1652,1585,67,4.10000000
CN2110700000000,21,107,"Hopkins County, KY",Nov-22,17517,16768,749,4.30000000
CN2110900000000,21,109,"Jackson County, KY",Nov-22,4182,3957,225,5.40000000
CN2111100000000,21,111,"Jefferson County, KY",Nov-22,401391,387978,13413,3.30000000
CN2111300000000,21,113,"Jessamine County, KY",Nov-22,26494,25625,869,3.30000000
CN2111500000000,21,115,"Johnson County, KY",Nov-22,6535,6130,405,6.20000000
CN2111700000000,21,117,"Kenton County, KY",Nov-22,86522,83672,2850,3.30000000
CN2111900000000,21,119,"Knott County, KY",Nov-22,4269,3991,278,6.50000000
CN2112100000000,21,121,"Knox County, KY",Nov-22,10260,9711,549,5.40000000
CN2112300000000,21,123,"Larue County, KY",Nov-22,5745,5504,241,4.20000000
CN2112500000000,21,125,"Laurel County, KY",Nov-22,25897,24846,1051,4.10000000
CN2112700000000,21,127,"Lawrence County, KY",Nov-22,5510,5242,268,4.90000000
CN2112900000000,21,129,"Lee County, KY",Nov-22,1975,1864,111,5.60000000
CN2113100000000,21,131,"Leslie County, KY",Nov-22,2516,2342,174,6.90000000
CN2113300000000,21,133,"Letcher County, KY",Nov-22,6090,5695,395,6.50000000
CN2113500000000,21,135,"Lewis County, KY",Nov-22,4656,4328,328,7.00000000
CN2113700000000,21,137,"Lincoln County, KY",Nov-22,9134,8683,451,4.90000000
CN2113900000000,21,139,"Livingston County, KY",Nov-22,3564,3400,164,4.60000000
CN2114100000000,21,141,"Logan County, KY",Nov-22,12404,11975,429,3.50000000
CN2114300000000,21,143,"Lyon County, KY",Nov-22,2945,2815,130,4.40000000
CN2114500000000,21,145,"McCracken County, KY",Nov-22,29284,28116,1168,4.00000000
CN2114700000000,21,147,"McCreary County, KY",Nov-22,4897,4658,239,4.90000000
CN2114900000000,21,149,"McLean County, KY",Nov-22,3975,3814,161,4.10000000
CN2115100000000,21,151,"Madison County, KY",Nov-22,47850,46189,1661,3.50000000
CN2115300000000,21,153,"Magoffin County, KY",Nov-22,3257,2957,300,9.20000000
CN2115500000000,21,155,"Marion County, KY",Nov-22,9138,8847,291,3.20000000
CN2115700000000,21,157,"Marshall County, KY",Nov-22,14113,13528,585,4.10000000
CN2115900000000,21,159,"Martin County, KY",Nov-22,2172,2000,172,7.90000000
CN2116100000000,21,161,"Mason County, KY",Nov-22,6493,6180,313,4.80000000
CN2116300000000,21,163,"Meade County, KY",Nov-22,11576,11086,490,4.20000000
CN2116500000000,21,165,"Menifee County, KY",Nov-22,2302,2180,122,5.30000000
CN2116700000000,21,167,"Mercer County, KY",Nov-22,9851,9480,371,3.80000000
CN2116900000000,21,169,"Metcalfe County, KY",Nov-22,3835,3671,164,4.30000000
CN2117100000000,21,171,"Monroe County, KY",Nov-22,4528,4377,151,3.30000000
CN2117300000000,21,173,"Montgomery County, KY",Nov-22,11587,11073,514,4.40000000
CN2117500000000,21,175,"Morgan County, KY",Nov-22,4275,4079,196,4.60000000
CN2117700000000,21,177,"Muhlenberg County, KY",Nov-22,9565,8993,572,6.00000000
CN2117900000000,21,179,"Nelson County, KY",Nov-22,23745,22963,782,3.30000000
CN2118100000000,21,181,"Nicholas County, KY",Nov-22,3320,3188,132,4.00000000
CN2118300000000,21,183,"Ohio County, KY",Nov-22,8841,8394,447,5.10000000
CN2118500000000,21,185,"Oldham County, KY",Nov-22,33906,32919,987,2.90000000
CN2118700000000,21,187,"Owen County, KY",Nov-22,4932,4757,175,3.50000000
CN2118900000000,21,189,"Owsley County, KY",Nov-22,1029,952,77,7.50000000
CN2119100000000,21,191,"Pendleton County, KY",Nov-22,6839,6600,239,3.50000000
CN2119300000000,21,193,"Perry County, KY",Nov-22,7966,7556,410,5.10000000
CN2119500000000,21,195,"Pike County, KY",Nov-22,18854,17884,970,5.10000000
CN2119700000000,21,197,"Powell County, KY",Nov-22,5184,4967,217,4.20000000
CN2119900000000,21,199,"Pulaski County, KY",Nov-22,25698,24577,1121,4.40000000
CN2120100000000,21,201,"Robertson County, KY",Nov-22,795,760,35,4.40000000
CN2120300000000,21,203,"Rockcastle County, KY",Nov-22,6621,6329,292,4.40000000
CN2120500000000,21,205,"Rowan County, KY",Nov-22,9852,9389,463,4.70000000
CN2120700000000,21,207,"Russell County, KY",Nov-22,5978,5653,325,5.40000000
CN2120900000000,21,209,"Scott County, KY",Nov-22,30230,29300,930,3.10000000
CN2121100000000,21,211,"Shelby County, KY",Nov-22,26298,25516,782,3.00000000
CN2121300000000,21,213,"Simpson County, KY",Nov-22,8862,8550,312,3.50000000
CN2121500000000,21,215,"Spencer County, KY",Nov-22,10731,10402,329,3.10000000
CN2121700000000,21,217,"Taylor County, KY",Nov-22,12921,12479,442,3.40000000
CN2121900000000,21,219,"Todd County, KY",Nov-22,5463,5281,182,3.30000000
CN2122100000000,21,221,"Trigg County, KY",Nov-22,6092,5812,280,4.60000000
CN2122300000000,21,223,"Trimble County, KY",Nov-22,3882,3744,138,3.60000000
CN2122500000000,21,225,"Union County, KY",Nov-22,5950,5683,267,4.50000000
CN2122700000000,21,227,"Warren County, KY",Nov-22,65359,63023,2336,3.60000000
CN2122900000000,21,229,"Washington County, KY",Nov-22,6092,5893,199,3.30000000
CN2123100000000,21,231,"Wayne County, KY",Nov-22,6985,6627,358,5.10000000
CN2123300000000,21,233,"Webster County, KY",Nov-22,5217,5018,199,3.80000000
CN2123500000000,21,235,"Whitley County, KY",Nov-22,14345,13741,604,4.20000000
CN2123700000000,21,237,"Wolfe County, KY",Nov-22,2184,2070,114,5.20000000
CN2123900000000,21,239,"Woodford County, KY",Nov-22,14928,14494,434,2.90000000
CN2200100000000,22,001,"Acadia Parish, LA",Nov-22,24154,23481,673,2.80000000
CN2200300000000,22,003,"Allen Parish, LA",Nov-22,8119,7844,275,3.40000000
CN2200500000000,22,005,"Ascension Parish, LA",Nov-22,66687,65166,1521,2.30000000
CN2200700000000,22,007,"Assumption Parish, LA",Nov-22,8817,8476,341,3.90000000
CN2200900000000,22,009,"Avoyelles Parish, LA",Nov-22,13129,12681,448,3.40000000
CN2201100000000,22,011,"Beauregard Parish, LA",Nov-22,14815,14447,368,2.50000000
CN2201300000000,22,013,"Bienville Parish, LA",Nov-22,4788,4612,176,3.70000000
CN2201500000000,22,015,"Bossier Parish, LA",Nov-22,58904,57545,1359,2.30000000
CN2201700000000,22,017,"Caddo Parish, LA",Nov-22,103314,99803,3511,3.40000000
CN2201900000000,22,019,"Calcasieu Parish, LA",Nov-22,99501,96829,2672,2.70000000
CN2202100000000,22,021,"Caldwell Parish, LA",Nov-22,3662,3557,105,2.90000000
CN2202300000000,22,023,"Cameron Parish, LA",Nov-22,3692,3615,77,2.10000000
CN2202500000000,22,025,"Catahoula Parish, LA",Nov-22,3366,3254,112,3.30000000
CN2202700000000,22,027,"Claiborne Parish, LA",Nov-22,5314,5162,152,2.90000000
CN2202900000000,22,029,"Concordia Parish, LA",Nov-22,6992,6736,256,3.70000000
CN2203100000000,22,031,"De Soto Parish, LA",Nov-22,11044,10717,327,3.00000000
CN2203300000000,22,033,"East Baton Rouge Parish, LA",Nov-22,232638,226278,6360,2.70000000
CN2203500000000,22,035,"East Carroll Parish, LA",Nov-22,1611,1500,111,6.90000000
CN2203700000000,22,037,"East Feliciana Parish, LA",Nov-22,7838,7656,182,2.30000000
CN2203900000000,22,039,"Evangeline Parish, LA",Nov-22,11994,11623,371,3.10000000
CN2204100000000,22,041,"Franklin Parish, LA",Nov-22,7434,7137,297,4.00000000
CN2204300000000,22,043,"Grant Parish, LA",Nov-22,8466,8239,227,2.70000000
CN2204500000000,22,045,"Iberia Parish, LA",Nov-22,28023,27004,1019,3.60000000
CN2204700000000,22,047,"Iberville Parish, LA",Nov-22,13872,13316,556,4.00000000
CN2204900000000,22,049,"Jackson Parish, LA",Nov-22,6869,6705,164,2.40000000
CN2205100000000,22,051,"Jefferson Parish, LA",Nov-22,215030,208846,6184,2.90000000
CN2205300000000,22,053,"Jefferson Davis Parish, LA",Nov-22,12596,12254,342,2.70000000
CN2205500000000,22,055,"Lafayette Parish, LA",Nov-22,118400,115570,2830,2.40000000
CN2205700000000,22,057,"Lafourche Parish, LA",Nov-22,40332,39313,1019,2.50000000
CN2205900000000,22,059,"LaSalle Parish, LA",Nov-22,6717,6578,139,2.10000000
CN2206100000000,22,061,"Lincoln Parish, LA",Nov-22,21485,20896,589,2.70000000
CN2206300000000,22,063,"Livingston Parish, LA",Nov-22,71441,69875,1566,2.20000000
CN2206500000000,22,065,"Madison Parish, LA",Nov-22,3414,3278,136,4.00000000
CN2206700000000,22,067,"Morehouse Parish, LA",Nov-22,9859,9416,443,4.50000000
CN2206900000000,22,069,"Natchitoches Parish, LA",Nov-22,16592,16075,517,3.10000000
CN2207100000000,22,071,"Orleans Parish, LA",Nov-22,180664,173507,7157,4.00000000
CN2207300000000,22,073,"Ouachita Parish, LA",Nov-22,69982,67971,2011,2.90000000
CN2207500000000,22,075,"Plaquemines Parish, LA",Nov-22,9946,9701,245,2.50000000
CN2207700000000,22,077,"Pointe Coupee Parish, LA",Nov-22,9707,9412,295,3.00000000
CN2207900000000,22,079,"Rapides Parish, LA",Nov-22,57141,55743,1398,2.40000000
CN2208100000000,22,081,"Red River Parish, LA",Nov-22,3757,3654,103,2.70000000
CN2208300000000,22,083,"Richland Parish, LA",Nov-22,8108,7842,266,3.30000000
CN2208500000000,22,085,"Sabine Parish, LA",Nov-22,9130,8892,238,2.60000000
CN2208700000000,22,087,"St. Bernard Parish, LA",Nov-22,20425,19705,720,3.50000000
CN2208900000000,22,089,"St. Charles Parish, LA",Nov-22,25293,24673,620,2.50000000
CN2209100000000,22,091,"St. Helena Parish, LA",Nov-22,4257,4054,203,4.80000000
CN2209300000000,22,093,"St. James Parish, LA",Nov-22,9104,8746,358,3.90000000
CN2209500000000,22,095,"St. John the Baptist Parish, LA",Nov-22,19528,18697,831,4.30000000
CN2209700000000,22,097,"St. Landry Parish, LA",Nov-22,32321,31140,1181,3.70000000
CN2209900000000,22,099,"St. Martin Parish, LA",Nov-22,22407,21769,638,2.80000000
CN2210100000000,22,101,"St. Mary Parish, LA",Nov-22,18615,17910,705,3.80000000
CN2210300000000,22,103,"St. Tammany Parish, LA",Nov-22,122164,119477,2687,2.20000000
CN2210500000000,22,105,"Tangipahoa Parish, LA",Nov-22,56807,54750,2057,3.60000000
CN2210700000000,22,107,"Tensas Parish, LA",Nov-22,1180,1129,51,4.30000000
CN2210900000000,22,109,"Terrebonne Parish, LA",Nov-22,44320,42991,1329,3.00000000
CN2211100000000,22,111,"Union Parish, LA",Nov-22,9086,8807,279,3.10000000
CN2211300000000,22,113,"Vermilion Parish, LA",Nov-22,24348,23721,627,2.60000000
CN2211500000000,22,115,"Vernon Parish, LA",Nov-22,15831,15344,487,3.10000000
CN2211700000000,22,117,"Washington Parish, LA",Nov-22,17137,16585,552,3.20000000
CN2211900000000,22,119,"Webster Parish, LA",Nov-22,14366,13882,484,3.40000000
CN2212100000000,22,121,"West Baton Rouge Parish, LA",Nov-22,13965,13605,360,2.60000000
CN2212300000000,22,123,"West Carroll Parish, LA",Nov-22,3544,3396,148,4.20000000
CN2212500000000,22,125,"West Feliciana Parish, LA",Nov-22,5414,5305,109,2.00000000
CN2212700000000,22,127,"Winn Parish, LA",Nov-22,4527,4382,145,3.20000000
CN2300100000000,23,001,"Androscoggin County, ME",Nov-22,53112,51185,1927,3.60000000
CN2300300000000,23,003,"Aroostook County, ME",Nov-22,27092,25811,1281,4.70000000
CN2300500000000,23,005,"Cumberland County, ME",Nov-22,162993,158209,4784,2.90000000
CN2300700000000,23,007,"Franklin County, ME",Nov-22,13223,12639,584,4.40000000
CN2300900000000,23,009,"Hancock County, ME",Nov-22,26357,25240,1117,4.20000000
CN2301100000000,23,011,"Kennebec County, ME",Nov-22,59749,57749,2000,3.30000000
CN2301300000000,23,013,"Knox County, ME",Nov-22,18526,17826,700,3.80000000
CN2301500000000,23,015,"Lincoln County, ME",Nov-22,15444,14879,565,3.70000000
CN2301700000000,23,017,"Oxford County, ME",Nov-22,24919,23905,1014,4.10000000
CN2301900000000,23,019,"Penobscot County, ME",Nov-22,74737,72057,2680,3.60000000
CN2302100000000,23,021,"Piscataquis County, ME",Nov-22,6968,6665,303,4.30000000
CN2302300000000,23,023,"Sagadahoc County, ME",Nov-22,18476,17967,509,2.80000000
CN2302500000000,23,025,"Somerset County, ME",Nov-22,21176,20064,1112,5.30000000
CN2302700000000,23,027,"Waldo County, ME",Nov-22,19618,18928,690,3.50000000
CN2302900000000,23,029,"Washington County, ME",Nov-22,12924,12304,620,4.80000000
CN2303100000000,23,031,"York County, ME",Nov-22,110773,107373,3400,3.10000000
CN2400100000000,24,001,"Allegany County, MD",Nov-22,29847,28539,1308,4.40000000
CN2400300000000,24,003,"Anne Arundel County, MD",Nov-22,315495,306132,9363,3.00000000
CN2400500000000,24,005,"Baltimore County, MD",Nov-22,447572,431634,15938,3.60000000
CN2400900000000,24,009,"Calvert County, MD",Nov-22,48888,47437,1451,3.00000000
CN2401100000000,24,011,"Caroline County, MD",Nov-22,17545,16996,549,3.10000000
CN2401300000000,24,013,"Carroll County, MD",Nov-22,94640,92119,2521,2.70000000
CN2401500000000,24,015,"Cecil County, MD",Nov-22,52283,50408,1875,3.60000000
CN2401700000000,24,017,"Charles County, MD",Nov-22,86050,83038,3012,3.50000000
CN2401900000000,24,019,"Dorchester County, MD",Nov-22,15875,15249,626,3.90000000
CN2402100000000,24,021,"Frederick County, MD",Nov-22,135640,131470,4170,3.10000000
CN2402300000000,24,023,"Garrett County, MD",Nov-22,14676,14173,503,3.40000000
CN2402500000000,24,025,"Harford County, MD",Nov-22,140850,136512,4338,3.10000000
CN2402700000000,24,027,"Howard County, MD",Nov-22,188490,183470,5020,2.70000000
CN2402900000000,24,029,"Kent County, MD",Nov-22,9724,9360,364,3.70000000
CN2403100000000,24,031,"Montgomery County, MD",Nov-22,545175,528462,16713,3.10000000
CN2403300000000,24,033,"Prince George's County, MD",Nov-22,495053,474891,20162,4.10000000
CN2403500000000,24,035,"Queen Anne's County, MD",Nov-22,27842,27031,811,2.90000000
CN2403700000000,24,037,"St. Mary's County, MD",Nov-22,56978,55191,1787,3.10000000
CN2403900000000,24,039,"Somerset County, MD",Nov-22,8509,8055,454,5.30000000
CN2404100000000,24,041,"Talbot County, MD",Nov-22,17356,16704,652,3.80000000
CN2404300000000,24,043,"Washington County, MD",Nov-22,72144,69583,2561,3.50000000
CN2404500000000,24,045,"Wicomico County, MD",Nov-22,48891,46725,2166,4.40000000
CN2404700000000,24,047,"Worcester County, MD",Nov-22,24386,22678,1708,7.00000000
CN2451000000000,24,510,"Baltimore city, MD",Nov-22,277767,264008,13759,5.00000000
CN2500100000000,25,001,"Barnstable County, MA",Nov-22,106452,102200,4252,4.00000000
CN2500300000000,25,003,"Berkshire County, MA",Nov-22,59126,56949,2177,3.70000000
CN2500500000000,25,005,"Bristol County, MA",Nov-22,294068,283377,10691,3.60000000
CN2500700000000,25,007,"Dukes County, MA",Nov-22,8402,7982,420,5.00000000
CN2500900000000,25,009,"Essex County, MA",Nov-22,417733,404682,13051,3.10000000
CN2501100000000,25,011,"Franklin County, MA",Nov-22,39548,38604,944,2.40000000
CN2501300000000,25,013,"Hampden County, MA",Nov-22,222804,214165,8639,3.90000000
CN2501500000000,25,015,"Hampshire County, MA",Nov-22,89260,86917,2343,2.60000000
CN2501700000000,25,017,"Middlesex County, MA",Nov-22,911808,890770,21038,2.30000000
CN2501900000000,25,019,"Nantucket County/town, MA",Nov-22,6966,6656,310,4.50000000
CN2502100000000,25,021,"Norfolk County, MA",Nov-22,392288,382270,10018,2.60000000
CN2502300000000,25,023,"Plymouth County, MA",Nov-22,281725,273328,8397,3.00000000
CN2502500000000,25,025,"Suffolk County, MA",Nov-22,452499,440144,12355,2.70000000
CN2502700000000,25,027,"Worcester County, MA",Nov-22,434129,421025,13104,3.00000000
CN2600100000000,26,001,"Alcona County, MI",Nov-22,3857,3607,250,6.50000000
CN2600300000000,26,003,"Alger County, MI",Nov-22,3087,2816,271,8.80000000
CN2600500000000,26,005,"Allegan County, MI",Nov-22,62179,60269,1910,3.10000000
CN2600700000000,26,007,"Alpena County, MI",Nov-22,13569,12996,573,4.20000000
CN2600900000000,26,009,"Antrim County, MI",Nov-22,9647,9145,502,5.20000000
CN2601100000000,26,011,"Arenac County, MI",Nov-22,5741,5357,384,6.70000000
CN2601300000000,26,013,"Baraga County, MI",Nov-22,3083,2881,202,6.60000000
CN2601500000000,26,015,"Barry County, MI",Nov-22,32190,31148,1042,3.20000000
CN2601700000000,26,017,"Bay County, MI",Nov-22,48833,46663,2170,4.40000000
CN2601900000000,26,019,"Benzie County, MI",Nov-22,8699,8309,390,4.50000000
CN2602100000000,26,021,"Berrien County, MI",Nov-22,71230,68307,2923,4.10000000
CN2602300000000,26,023,"Branch County, MI",Nov-22,19334,18618,716,3.70000000
CN2602500000000,26,025,"Calhoun County, MI",Nov-22,60280,57719,2561,4.20000000
CN2602700000000,26,027,"Cass County, MI",Nov-22,24154,23239,915,3.80000000
CN2602900000000,26,029,"Charlevoix County, MI",Nov-22,11851,11323,528,4.50000000
CN2603100000000,26,031,"Cheboygan County, MI",Nov-22,9715,8942,773,8.00000000
CN2603300000000,26,033,"Chippewa County, MI",Nov-22,16360,15479,881,5.40000000
CN2603500000000,26,035,"Clare County, MI",Nov-22,11321,10621,700,6.20000000
CN2603700000000,26,037,"Clinton County, MI",Nov-22,41258,40014,1244,3.00000000
CN2603900000000,26,039,"Crawford County, MI",Nov-22,5313,4972,341,6.40000000
CN2604100000000,26,041,"Delta County, MI",Nov-22,16170,15389,781,4.80000000
CN2604300000000,26,043,"Dickinson County, MI",Nov-22,11960,11518,442,3.70000000
CN2604500000000,26,045,"Eaton County, MI",Nov-22,57159,55280,1879,3.30000000
CN2604700000000,26,047,"Emmet County, MI",Nov-22,15994,15175,819,5.10000000
CN2604900000000,26,049,"Genesee County, MI",Nov-22,177367,168220,9147,5.20000000
CN2605100000000,26,051,"Gladwin County, MI",Nov-22,9717,9153,564,5.80000000
CN2605300000000,26,053,"Gogebic County, MI",Nov-22,5565,5314,251,4.50000000
CN2605500000000,26,055,"Grand Traverse County, MI",Nov-22,49216,47635,1581,3.20000000
CN2605700000000,26,057,"Gratiot County, MI",Nov-22,17216,16533,683,4.00000000
CN2605900000000,26,059,"Hillsdale County, MI",Nov-22,19656,18832,824,4.20000000
CN2606100000000,26,061,"Houghton County, MI",Nov-22,16512,15853,659,4.00000000
CN2606300000000,26,063,"Huron County, MI",Nov-22,14882,14302,580,3.90000000
CN2606500000000,26,065,"Ingham County, MI",Nov-22,149778,144438,5340,3.60000000
CN2606700000000,26,067,"Ionia County, MI",Nov-22,30333,29372,961,3.20000000
CN2606900000000,26,069,"Iosco County, MI",Nov-22,10211,9648,563,5.50000000
CN2607100000000,26,071,"Iron County, MI",Nov-22,4783,4543,240,5.00000000
CN2607300000000,26,073,"Isabella County, MI",Nov-22,33045,31735,1310,4.00000000
CN2607500000000,26,075,"Jackson County, MI",Nov-22,73166,70352,2814,3.80000000
CN2607700000000,26,077,"Kalamazoo County, MI",Nov-22,132941,128358,4583,3.40000000
CN2607900000000,26,079,"Kalkaska County, MI",Nov-22,7850,7410,440,5.60000000
CN2608100000000,26,081,"Kent County, MI",Nov-22,363705,352889,10816,3.00000000
CN2608300000000,26,083,"Keweenaw County, MI",Nov-22,929,874,55,5.90000000
CN2608500000000,26,085,"Lake County, MI",Nov-22,4095,3832,263,6.40000000
CN2608700000000,26,087,"Lapeer County, MI",Nov-22,40068,38799,1269,3.20000000
CN2608900000000,26,089,"Leelanau County, MI",Nov-22,10304,9932,372,3.60000000
CN2609100000000,26,091,"Lenawee County, MI",Nov-22,44908,43179,1729,3.90000000
CN2609300000000,26,093,"Livingston County, MI",Nov-22,102706,100540,2166,2.10000000
CN2609500000000,26,095,"Luce County, MI",Nov-22,2074,1934,140,6.80000000
CN2609700000000,26,097,"Mackinac County, MI",Nov-22,4369,3903,466,10.70000000
CN2609900000000,26,099,"Macomb County, MI",Nov-22,439231,426718,12513,2.80000000
CN2610100000000,26,101,"Manistee County, MI",Nov-22,9917,9382,535,5.40000000
CN2610300000000,26,103,"Marquette County, MI",Nov-22,31519,30180,1339,4.20000000
CN2610500000000,26,105,"Mason County, MI",Nov-22,12746,12084,662,5.20000000
CN2610700000000,26,107,"Mecosta County, MI",Nov-22,18936,18064,872,4.60000000
CN2610900000000,26,109,"Menominee County, MI",Nov-22,10338,9944,394,3.80000000
CN2611100000000,26,111,"Midland County, MI",Nov-22,38898,37408,1490,3.80000000
CN2611300000000,26,113,"Missaukee County, MI",Nov-22,6807,6538,269,4.00000000
CN2611500000000,26,115,"Monroe County, MI",Nov-22,73928,70979,2949,4.00000000
CN2611700000000,26,117,"Montcalm County, MI",Nov-22,28138,27044,1094,3.90000000
CN2611900000000,26,119,"Montmorency County, MI",Nov-22,3046,2804,242,7.90000000
CN2612100000000,26,121,"Muskegon County, MI",Nov-22,77128,73352,3776,4.90000000
CN2612300000000,26,123,"Newaygo County, MI",Nov-22,23635,22691,944,4.00000000
CN2612500000000,26,125,"Oakland County, MI",Nov-22,663908,648763,15145,2.30000000
CN2612700000000,26,127,"Oceana County, MI",Nov-22,11739,11063,676,5.80000000
CN2612900000000,26,129,"Ogemaw County, MI",Nov-22,8061,7541,520,6.50000000
CN2613100000000,26,131,"Ontonagon County, MI",Nov-22,2071,1930,141,6.80000000
CN2613300000000,26,133,"Osceola County, MI",Nov-22,11720,11270,450,3.80000000
CN2613500000000,26,135,"Oscoda County, MI",Nov-22,2561,2358,203,7.90000000
CN2613700000000,26,137,"Otsego County, MI",Nov-22,11296,10728,568,5.00000000
CN2613900000000,26,139,"Ottawa County, MI",Nov-22,163925,159278,4647,2.80000000
CN2614100000000,26,141,"Presque Isle County, MI",Nov-22,4926,4596,330,6.70000000
CN2614300000000,26,143,"Roscommon County, MI",Nov-22,7229,6616,613,8.50000000
CN2614500000000,26,145,"Saginaw County, MI",Nov-22,82883,78727,4156,5.00000000
CN2614700000000,26,147,"St. Clair County, MI",Nov-22,74159,71949,2210,3.00000000
CN2614900000000,26,149,"St. Joseph County, MI",Nov-22,28117,27002,1115,4.00000000
CN2615100000000,26,151,"Sanilac County, MI",Nov-22,19272,18464,808,4.20000000
CN2615300000000,26,153,"Schoolcraft County, MI",Nov-22,3205,3012,193,6.00000000
CN2615500000000,26,155,"Shiawassee County, MI",Nov-22,32664,31412,1252,3.80000000
CN2615700000000,26,157,"Tuscola County, MI",Nov-22,23108,22063,1045,4.50000000
CN2615900000000,26,159,"Van Buren County, MI",Nov-22,34811,33257,1554,4.50000000
CN2616100000000,26,161,"Washtenaw County, MI",Nov-22,199140,193020,6120,3.10000000
CN2616300000000,26,163,"Wayne County, MI",Nov-22,786102,757392,28710,3.70000000
CN2616500000000,26,165,"Wexford County, MI",Nov-22,14635,14009,626,4.30000000
CN2700100000000,27,001,"Aitkin County, MN",Nov-22,7288,7011,277,3.80000000
CN2700300000000,27,003,"Anoka County, MN",Nov-22,200233,196296,3937,2.00000000
CN2700500000000,27,005,"Becker County, MN",Nov-22,18148,17738,410,2.30000000
CN2700700000000,27,007,"Beltrami County, MN",Nov-22,23647,23035,612,2.60000000
CN2700900000000,27,009,"Benton County, MN",Nov-22,21535,20973,562,2.60000000
CN2701100000000,27,011,"Big Stone County, MN",Nov-22,2284,2239,45,2.00000000
CN2701300000000,27,013,"Blue Earth County, MN",Nov-22,40085,39407,678,1.70000000
CN2701500000000,27,015,"Brown County, MN",Nov-22,13041,12786,255,2.00000000
CN2701700000000,27,017,"Carlton County, MN",Nov-22,17384,16893,491,2.80000000
CN2701900000000,27,019,"Carver County, MN",Nov-22,59842,58861,981,1.60000000
CN2702100000000,27,021,"Cass County, MN",Nov-22,15659,15148,511,3.30000000
CN2702300000000,27,023,"Chippewa County, MN",Nov-22,6210,6103,107,1.70000000
CN2702500000000,27,025,"Chisago County, MN",Nov-22,30114,29453,661,2.20000000
CN2702700000000,27,027,"Clay County, MN",Nov-22,36361,35790,571,1.60000000
CN2702900000000,27,029,"Clearwater County, MN",Nov-22,4390,4214,176,4.00000000
CN2703100000000,27,031,"Cook County, MN",Nov-22,2680,2586,94,3.50000000
CN2703300000000,27,033,"Cottonwood County, MN",Nov-22,6592,6478,114,1.70000000
CN2703500000000,27,035,"Crow Wing County, MN",Nov-22,30949,30020,929,3.00000000
CN2703700000000,27,037,"Dakota County, MN",Nov-22,244275,239933,4342,1.80000000
CN2703900000000,27,039,"Dodge County, MN",Nov-22,11876,11672,204,1.70000000
CN2704100000000,27,041,"Douglas County, MN",Nov-22,20609,20210,399,1.90000000
CN2704300000000,27,043,"Faribault County, MN",Nov-22,6603,6438,165,2.50000000
CN2704500000000,27,045,"Fillmore County, MN",Nov-22,11387,11181,206,1.80000000
CN2704700000000,27,047,"Freeborn County, MN",Nov-22,14816,14494,322,2.20000000
CN2704900000000,27,049,"Goodhue County, MN",Nov-22,25623,25144,479,1.90000000
CN2705100000000,27,051,"Grant County, MN",Nov-22,3132,3063,69,2.20000000
CN2705300000000,27,053,"Hennepin County, MN",Nov-22,710695,697295,13400,1.90000000
CN2705500000000,27,055,"Houston County, MN",Nov-22,10147,9987,160,1.60000000
CN2705700000000,27,057,"Hubbard County, MN",Nov-22,9693,9365,328,3.40000000
CN2705900000000,27,059,"Isanti County, MN",Nov-22,21847,21307,540,2.50000000
CN2706100000000,27,061,"Itasca County, MN",Nov-22,20300,19513,787,3.90000000
CN2706300000000,27,063,"Jackson County, MN",Nov-22,5178,5098,80,1.50000000
CN2706500000000,27,065,"Kanabec County, MN",Nov-22,8994,8671,323,3.60000000
CN2706700000000,27,067,"Kandiyohi County, MN",Nov-22,21998,21565,433,2.00000000
CN2706900000000,27,069,"Kittson County, MN",Nov-22,2159,2109,50,2.30000000
CN2707100000000,27,071,"Koochiching County, MN",Nov-22,5312,5104,208,3.90000000
CN2707300000000,27,073,"Lac qui Parle County, MN",Nov-22,3231,3171,60,1.90000000
CN2707500000000,27,075,"Lake County, MN",Nov-22,5113,4870,243,4.80000000
CN2707700000000,27,077,"Lake of the Woods County, MN",Nov-22,2181,2117,64,2.90000000
CN2707900000000,27,079,"Le Sueur County, MN",Nov-22,15946,15545,401,2.50000000
CN2708100000000,27,081,"Lincoln County, MN",Nov-22,2813,2761,52,1.80000000
CN2708300000000,27,083,"Lyon County, MN",Nov-22,13609,13373,236,1.70000000
CN2708500000000,27,085,"McLeod County, MN",Nov-22,18500,18106,394,2.10000000
CN2708700000000,27,087,"Mahnomen County, MN",Nov-22,2102,2013,89,4.20000000
CN2708900000000,27,089,"Marshall County, MN",Nov-22,5128,4955,173,3.40000000
CN2709100000000,27,091,"Martin County, MN",Nov-22,9034,8861,173,1.90000000
CN2709300000000,27,093,"Meeker County, MN",Nov-22,12917,12608,309,2.40000000
CN2709500000000,27,095,"Mille Lacs County, MN",Nov-22,12710,12280,430,3.40000000
CN2709700000000,27,097,"Morrison County, MN",Nov-22,16925,16330,595,3.50000000
CN2709900000000,27,099,"Mower County, MN",Nov-22,20032,19651,381,1.90000000
CN2710100000000,27,101,"Murray County, MN",Nov-22,4390,4294,96,2.20000000
CN2710300000000,27,103,"Nicollet County, MN",Nov-22,20557,20257,300,1.50000000
CN2710500000000,27,105,"Nobles County, MN",Nov-22,10912,10725,187,1.70000000
CN2710700000000,27,107,"Norman County, MN",Nov-22,3105,3024,81,2.60000000
CN2710900000000,27,109,"Olmsted County, MN",Nov-22,91386,89925,1461,1.60000000
CN2711100000000,27,111,"Otter Tail County, MN",Nov-22,29787,29119,668,2.20000000
CN2711300000000,27,113,"Pennington County, MN",Nov-22,8458,8266,192,2.30000000
CN2711500000000,27,115,"Pine County, MN",Nov-22,13885,13405,480,3.50000000
CN2711700000000,27,117,"Pipestone County, MN",Nov-22,4373,4302,71,1.60000000
CN2711900000000,27,119,"Polk County, MN",Nov-22,15654,15325,329,2.10000000
CN2712100000000,27,121,"Pope County, MN",Nov-22,6170,6046,124,2.00000000
CN2712300000000,27,123,"Ramsey County, MN",Nov-22,287652,281888,5764,2.00000000
CN2712500000000,27,125,"Red Lake County, MN",Nov-22,2123,2060,63,3.00000000
CN2712700000000,27,127,"Redwood County, MN",Nov-22,7127,6986,141,2.00000000
CN2712900000000,27,129,"Renville County, MN",Nov-22,8069,7886,183,2.30000000
CN2713100000000,27,131,"Rice County, MN",Nov-22,36305,35595,710,2.00000000
CN2713300000000,27,133,"Rock County, MN",Nov-22,5886,5814,72,1.20000000
CN2713500000000,27,135,"Roseau County, MN",Nov-22,7640,7489,151,2.00000000
CN2713700000000,27,137,"St. Louis County, MN",Nov-22,99283,96695,2588,2.60000000
CN2713900000000,27,139,"Scott County, MN",Nov-22,85094,83650,1444,1.70000000
CN2714100000000,27,141,"Sherburne County, MN",Nov-22,53488,52370,1118,2.10000000
CN2714300000000,27,143,"Sibley County, MN",Nov-22,8066,7890,176,2.20000000
CN2714500000000,27,145,"Stearns County, MN",Nov-22,89235,87396,1839,2.10000000
CN2714700000000,27,147,"Steele County, MN",Nov-22,19058,18653,405,2.10000000
CN2714900000000,27,149,"Stevens County, MN",Nov-22,5089,5001,88,1.70000000
CN2715100000000,27,151,"Swift County, MN",Nov-22,4529,4433,96,2.10000000
CN2715300000000,27,153,"Todd County, MN",Nov-22,12978,12638,340,2.60000000
CN2715500000000,27,155,"Traverse County, MN",Nov-22,1586,1556,30,1.90000000
CN2715700000000,27,157,"Wabasha County, MN",Nov-22,12127,11914,213,1.80000000
CN2715900000000,27,159,"Wadena County, MN",Nov-22,5790,5602,188,3.20000000
CN2716100000000,27,161,"Waseca County, MN",Nov-22,8343,8116,227,2.70000000
CN2716300000000,27,163,"Washington County, MN",Nov-22,146148,143601,2547,1.70000000
CN2716500000000,27,165,"Watonwan County, MN",Nov-22,6339,6224,115,1.80000000
CN2716700000000,27,167,"Wilkin County, MN",Nov-22,3255,3207,48,1.50000000
CN2716900000000,27,169,"Winona County, MN",Nov-22,26897,26449,448,1.70000000
CN2717100000000,27,171,"Wright County, MN",Nov-22,77197,75698,1499,1.90000000
CN2717300000000,27,173,"Yellow Medicine County, MN",Nov-22,4799,4708,91,1.90000000
CN2800100000000,28,001,"Adams County, MS",Nov-22,10354,9834,520,5.00000000
CN2800300000000,28,003,"Alcorn County, MS",Nov-22,14981,14490,491,3.30000000
CN2800500000000,28,005,"Amite County, MS",Nov-22,4247,4044,203,4.80000000
CN2800700000000,28,007,"Attala County, MS",Nov-22,6962,6697,265,3.80000000
CN2800900000000,28,009,"Benton County, MS",Nov-22,3101,2955,146,4.70000000
CN2801100000000,28,011,"Bolivar County, MS",Nov-22,10847,10349,498,4.60000000
CN2801300000000,28,013,"Calhoun County, MS",Nov-22,5272,5065,207,3.90000000
CN2801500000000,28,015,"Carroll County, MS",Nov-22,3428,3283,145,4.20000000
CN2801700000000,28,017,"Chickasaw County, MS",Nov-22,6614,6354,260,3.90000000
CN2801900000000,28,019,"Choctaw County, MS",Nov-22,3526,3408,118,3.30000000
CN2802100000000,28,021,"Claiborne County, MS",Nov-22,2824,2611,213,7.50000000
CN2802300000000,28,023,"Clarke County, MS",Nov-22,5474,5230,244,4.50000000
CN2802500000000,28,025,"Clay County, MS",Nov-22,8116,7766,350,4.30000000
CN2802700000000,28,027,"Coahoma County, MS",Nov-22,7505,7087,418,5.60000000
CN2802900000000,28,029,"Copiah County, MS",Nov-22,10470,10016,454,4.30000000
CN2803100000000,28,031,"Covington County, MS",Nov-22,8094,7840,254,3.10000000
CN2803300000000,28,033,"DeSoto County, MS",Nov-22,95017,92249,2768,2.90000000
CN2803500000000,28,035,"Forrest County, MS",Nov-22,33012,31860,1152,3.50000000
CN2803700000000,28,037,"Franklin County, MS",Nov-22,2563,2426,137,5.30000000
CN2803900000000,28,039,"George County, MS",Nov-22,8353,7958,395,4.70000000
CN2804100000000,28,041,"Greene County, MS",Nov-22,4095,3866,229,5.60000000
CN2804300000000,28,043,"Grenada County, MS",Nov-22,8854,8554,300,3.40000000
CN2804500000000,28,045,"Hancock County, MS",Nov-22,18837,18133,704,3.70000000
CN2804700000000,28,047,"Harrison County, MS",Nov-22,87114,84045,3069,3.50000000
CN2804900000000,28,049,"Hinds County, MS",Nov-22,99205,95481,3724,3.80000000
CN2805100000000,28,051,"Holmes County, MS",Nov-22,4913,4597,316,6.40000000
CN2805300000000,28,053,"Humphreys County, MS",Nov-22,1840,1701,139,7.60000000
CN2805500000000,28,055,"Issaquena County, MS",Nov-22,298,277,21,7.00000000
CN2805700000000,28,057,"Itawamba County, MS",Nov-22,10169,9850,319,3.10000000
CN2805900000000,28,059,"Jackson County, MS",Nov-22,58454,56143,2311,4.00000000
CN2806100000000,28,061,"Jasper County, MS",Nov-22,5645,5358,287,5.10000000
CN2806300000000,28,063,"Jefferson County, MS",Nov-22,1813,1609,204,11.30000000
CN2806500000000,28,065,"Jefferson Davis County, MS",Nov-22,3776,3584,192,5.10000000
CN2806700000000,28,067,"Jones County, MS",Nov-22,24019,23098,921,3.80000000
CN2806900000000,28,069,"Kemper County, MS",Nov-22,3182,2978,204,6.40000000
CN2807100000000,28,071,"Lafayette County, MS",Nov-22,29648,28872,776,2.60000000
CN2807300000000,28,073,"Lamar County, MS",Nov-22,31404,30554,850,2.70000000
CN2807500000000,28,075,"Lauderdale County, MS",Nov-22,28340,27239,1101,3.90000000
CN2807700000000,28,077,"Lawrence County, MS",Nov-22,4573,4360,213,4.70000000
CN2807900000000,28,079,"Leake County, MS",Nov-22,7745,7451,294,3.80000000
CN2808100000000,28,081,"Lee County, MS",Nov-22,40535,39318,1217,3.00000000
CN2808300000000,28,083,"Leflore County, MS",Nov-22,9729,9222,507,5.20000000
CN2808500000000,28,085,"Lincoln County, MS",Nov-22,14216,13718,498,3.50000000
CN2808700000000,28,087,"Lowndes County, MS",Nov-22,25280,24328,952,3.80000000
CN2808900000000,28,089,"Madison County, MS",Nov-22,51936,50437,1499,2.90000000
CN2809100000000,28,091,"Marion County, MS",Nov-22,10244,9877,367,3.60000000
CN2809300000000,28,093,"Marshall County, MS",Nov-22,14384,13855,529,3.70000000
CN2809500000000,28,095,"Monroe County, MS",Nov-22,15668,15115,553,3.50000000
CN2809700000000,28,097,"Montgomery County, MS",Nov-22,3770,3615,155,4.10000000
CN2809900000000,28,099,"Neshoba County, MS",Nov-22,9681,9270,411,4.20000000
CN2810100000000,28,101,"Newton County, MS",Nov-22,8080,7768,312,3.90000000
CN2810300000000,28,103,"Noxubee County, MS",Nov-22,3353,3162,191,5.70000000
CN2810500000000,28,105,"Oktibbeha County, MS",Nov-22,22663,21857,806,3.60000000
CN2810700000000,28,107,"Panola County, MS",Nov-22,12467,11929,538,4.30000000
CN2810900000000,28,109,"Pearl River County, MS",Nov-22,23332,22506,826,3.50000000
CN2811100000000,28,111,"Perry County, MS",Nov-22,4199,4010,189,4.50000000
CN2811300000000,28,113,"Pike County, MS",Nov-22,13987,13357,630,4.50000000
CN2811500000000,28,115,"Pontotoc County, MS",Nov-22,14733,14285,448,3.00000000
CN2811700000000,28,117,"Prentiss County, MS",Nov-22,11365,11029,336,3.00000000
CN2811900000000,28,119,"Quitman County, MS",Nov-22,2206,2082,124,5.60000000
CN2812100000000,28,121,"Rankin County, MS",Nov-22,74628,72589,2039,2.70000000
CN2812300000000,28,123,"Scott County, MS",Nov-22,12093,11732,361,3.00000000
CN2812500000000,28,125,"Sharkey County, MS",Nov-22,1297,1228,69,5.30000000
CN2812700000000,28,127,"Simpson County, MS",Nov-22,10285,9915,370,3.60000000
CN2812900000000,28,129,"Smith County, MS",Nov-22,6339,6128,211,3.30000000
CN2813100000000,28,131,"Stone County, MS",Nov-22,6909,6650,259,3.70000000
CN2813300000000,28,133,"Sunflower County, MS",Nov-22,7182,6759,423,5.90000000
CN2813500000000,28,135,"Tallahatchie County, MS",Nov-22,4393,4223,170,3.90000000
CN2813700000000,28,137,"Tate County, MS",Nov-22,12225,11801,424,3.50000000
CN2813900000000,28,139,"Tippah County, MS",Nov-22,9777,9471,306,3.10000000
CN2814100000000,28,141,"Tishomingo County, MS",Nov-22,8270,7989,281,3.40000000
CN2814300000000,28,143,"Tunica County, MS",Nov-22,4204,4016,188,4.50000000
CN2814500000000,28,145,"Union County, MS",Nov-22,14275,13897,378,2.60000000
CN2814700000000,28,147,"Walthall County, MS",Nov-22,4805,4579,226,4.70000000
CN2814900000000,28,149,"Warren County, MS",Nov-22,18877,18147,730,3.90000000
CN2815100000000,28,151,"Washington County, MS",Nov-22,14987,14190,797,5.30000000
CN2815300000000,28,153,"Wayne County, MS",Nov-22,7189,6880,309,4.30000000
CN2815500000000,28,155,"Webster County, MS",Nov-22,3827,3691,136,3.60000000
CN2815700000000,28,157,"Wilkinson County, MS",Nov-22,2527,2378,149,5.90000000
CN2815900000000,28,159,"Winston County, MS",Nov-22,6869,6578,291,4.20000000
CN2816100000000,28,161,"Yalobusha County, MS",Nov-22,4911,4732,179,3.60000000
CN2816300000000,28,163,"Yazoo County, MS",Nov-22,8558,8190,368,4.30000000
CN2900100000000,29,001,"Adair County, MO",Nov-22,10097,9822,275,2.70000000
CN2900300000000,29,003,"Andrew County, MO",Nov-22,9582,9406,176,1.80000000
CN2900500000000,29,005,"Atchison County, MO",Nov-22,2534,2480,54,2.10000000
CN2900700000000,29,007,"Audrain County, MO",Nov-22,9957,9675,282,2.80000000
CN2900900000000,29,009,"Barry County, MO",Nov-22,14148,13772,376,2.70000000
CN2901100000000,29,011,"Barton County, MO",Nov-22,5157,5039,118,2.30000000
CN2901300000000,29,013,"Bates County, MO",Nov-22,7507,7323,184,2.50000000
CN2901500000000,29,015,"Benton County, MO",Nov-22,7293,7039,254,3.50000000
CN2901700000000,29,017,"Bollinger County, MO",Nov-22,5253,5121,132,2.50000000
CN2901900000000,29,019,"Boone County, MO",Nov-22,101060,99194,1866,1.80000000
CN2902100000000,29,021,"Buchanan County, MO",Nov-22,43182,42239,943,2.20000000
CN2902300000000,29,023,"Butler County, MO",Nov-22,18265,17770,495,2.70000000
CN2902500000000,29,025,"Caldwell County, MO",Nov-22,4165,4061,104,2.50000000
CN2902700000000,29,027,"Callaway County, MO",Nov-22,21264,20820,444,2.10000000
CN2902900000000,29,029,"Camden County, MO",Nov-22,18740,18157,583,3.10000000
CN2903100000000,29,031,"Cape Girardeau County, MO",Nov-22,40505,39657,848,2.10000000
CN2903300000000,29,033,"Carroll County, MO",Nov-22,4261,4165,96,2.30000000
CN2903500000000,29,035,"Carter County, MO",Nov-22,2492,2407,85,3.40000000
CN2903700000000,29,037,"Cass County, MO",Nov-22,54645,53414,1231,2.30000000
CN2903900000000,29,039,"Cedar County, MO",Nov-22,5622,5478,144,2.60000000
CN2904100000000,29,041,"Chariton County, MO",Nov-22,3649,3584,65,1.80000000
CN2904300000000,29,043,"Christian County, MO",Nov-22,47108,46201,907,1.90000000
CN2904500000000,29,045,"Clark County, MO",Nov-22,2962,2866,96,3.20000000
CN2904700000000,29,047,"Clay County, MO",Nov-22,137889,134908,2981,2.20000000
CN2904900000000,29,049,"Clinton County, MO",Nov-22,10459,10222,237,2.30000000
CN2905100000000,29,051,"Cole County, MO",Nov-22,38767,38025,742,1.90000000
CN2905300000000,29,053,"Cooper County, MO",Nov-22,7104,6945,159,2.20000000
CN2905500000000,29,055,"Crawford County, MO",Nov-22,10791,10528,263,2.40000000
CN2905700000000,29,057,"Dade County, MO",Nov-22,3422,3353,69,2.00000000
CN2905900000000,29,059,"Dallas County, MO",Nov-22,7094,6912,182,2.60000000
CN2906100000000,29,061,"Daviess County, MO",Nov-22,3876,3794,82,2.10000000
CN2906300000000,29,063,"DeKalb County, MO",Nov-22,4053,3972,81,2.00000000
CN2906500000000,29,065,"Dent County, MO",Nov-22,6116,5929,187,3.10000000
CN2906700000000,29,067,"Douglas County, MO",Nov-22,5141,5001,140,2.70000000
CN2906900000000,29,069,"Dunklin County, MO",Nov-22,10828,10383,445,4.10000000
CN2907100000000,29,071,"Franklin County, MO",Nov-22,53164,52031,1133,2.10000000
CN2907300000000,29,073,"Gasconade County, MO",Nov-22,7622,7458,164,2.20000000
CN2907500000000,29,075,"Gentry County, MO",Nov-22,3120,3060,60,1.90000000
CN2907700000000,29,077,"Greene County, MO",Nov-22,154002,150864,3138,2.00000000
CN2907900000000,29,079,"Grundy County, MO",Nov-22,4021,3925,96,2.40000000
CN2908100000000,29,081,"Harrison County, MO",Nov-22,3679,3605,74,2.00000000
CN2908300000000,29,083,"Henry County, MO",Nov-22,10214,9977,237,2.30000000
CN2908500000000,29,085,"Hickory County, MO",Nov-22,3953,3852,101,2.60000000
CN2908700000000,29,087,"Holt County, MO",Nov-22,2403,2363,40,1.70000000
CN2908900000000,29,089,"Howard County, MO",Nov-22,4726,4625,101,2.10000000
CN2909100000000,29,091,"Howell County, MO",Nov-22,16153,15699,454,2.80000000
CN2909300000000,29,093,"Iron County, MO",Nov-22,3496,3359,137,3.90000000
CN2909500000000,29,095,"Jackson County, MO",Nov-22,359065,349170,9895,2.80000000
CN2909700000000,29,097,"Jasper County, MO",Nov-22,57828,56531,1297,2.20000000
CN2909900000000,29,099,"Jefferson County, MO",Nov-22,118971,116372,2599,2.20000000
CN2910100000000,29,101,"Johnson County, MO",Nov-22,22974,22425,549,2.40000000
CN2910300000000,29,103,"Knox County, MO",Nov-22,1689,1651,38,2.20000000
CN2910500000000,29,105,"Laclede County, MO",Nov-22,16425,16013,412,2.50000000
CN2910700000000,29,107,"Lafayette County, MO",Nov-22,16499,16123,376,2.30000000
CN2910900000000,29,109,"Lawrence County, MO",Nov-22,17067,16678,389,2.30000000
CN2911100000000,29,111,"Lewis County, MO",Nov-22,4682,4577,105,2.20000000
CN2911300000000,29,113,"Lincoln County, MO",Nov-22,29337,28648,689,2.30000000
CN2911500000000,29,115,"Linn County, MO",Nov-22,5193,5044,149,2.90000000
CN2911700000000,29,117,"Livingston County, MO",Nov-22,7132,7008,124,1.70000000
CN2911900000000,29,119,"McDonald County, MO",Nov-22,10865,10622,243,2.20000000
CN2912100000000,29,121,"Macon County, MO",Nov-22,7207,7049,158,2.20000000
CN2912300000000,29,123,"Madison County, MO",Nov-22,5381,5231,150,2.80000000
CN2912500000000,29,125,"Maries County, MO",Nov-22,3842,3757,85,2.20000000
CN2912700000000,29,127,"Marion County, MO",Nov-22,13878,13578,300,2.20000000
CN2912900000000,29,129,"Mercer County, MO",Nov-22,1637,1600,37,2.30000000
CN2913100000000,29,131,"Miller County, MO",Nov-22,12779,12479,300,2.30000000
CN2913300000000,29,133,"Mississippi County, MO",Nov-22,5126,4973,153,3.00000000
CN2913500000000,29,135,"Moniteau County, MO",Nov-22,6877,6746,131,1.90000000
CN2913700000000,29,137,"Monroe County, MO",Nov-22,3762,3673,89,2.40000000
CN2913900000000,29,139,"Montgomery County, MO",Nov-22,5757,5630,127,2.20000000
CN2914100000000,29,141,"Morgan County, MO",Nov-22,8250,8005,245,3.00000000
CN2914300000000,29,143,"New Madrid County, MO",Nov-22,8029,7807,222,2.80000000
CN2914500000000,29,145,"Newton County, MO",Nov-22,27251,26640,611,2.20000000
CN2914700000000,29,147,"Nodaway County, MO",Nov-22,11058,10839,219,2.00000000
CN2914900000000,29,149,"Oregon County, MO",Nov-22,3767,3649,118,3.10000000
CN2915100000000,29,151,"Osage County, MO",Nov-22,6916,6785,131,1.90000000
CN2915300000000,29,153,"Ozark County, MO",Nov-22,3405,3279,126,3.70000000
CN2915500000000,29,155,"Pemiscot County, MO",Nov-22,5777,5559,218,3.80000000
CN2915700000000,29,157,"Perry County, MO",Nov-22,9531,9350,181,1.90000000
CN2915900000000,29,159,"Pettis County, MO",Nov-22,20188,19721,467,2.30000000
CN2916100000000,29,161,"Phelps County, MO",Nov-22,20360,19880,480,2.40000000
CN2916300000000,29,163,"Pike County, MO",Nov-22,7235,7085,150,2.10000000
CN2916500000000,29,165,"Platte County, MO",Nov-22,59640,58466,1174,2.00000000
CN2916700000000,29,167,"Polk County, MO",Nov-22,14561,14217,344,2.40000000
CN2916900000000,29,169,"Pulaski County, MO",Nov-22,14536,14145,391,2.70000000
CN2917100000000,29,171,"Putnam County, MO",Nov-22,2100,2058,42,2.00000000
CN2917300000000,29,173,"Ralls County, MO",Nov-22,5440,5319,121,2.20000000
CN2917500000000,29,175,"Randolph County, MO",Nov-22,10284,10041,243,2.40000000
CN2917700000000,29,177,"Ray County, MO",Nov-22,10732,10474,258,2.40000000
CN2917900000000,29,179,"Reynolds County, MO",Nov-22,2807,2725,82,2.90000000
CN2918100000000,29,181,"Ripley County, MO",Nov-22,5158,5007,151,2.90000000
CN2918300000000,29,183,"St. Charles County, MO",Nov-22,230398,226041,4357,1.90000000
CN2918500000000,29,185,"St. Clair County, MO",Nov-22,3780,3679,101,2.70000000
CN2918600000000,29,186,"Ste. Genevieve County, MO",Nov-22,9327,9137,190,2.00000000
CN2918700000000,29,187,"St. Francois County, MO",Nov-22,25663,24842,821,3.20000000
CN2918900000000,29,189,"St. Louis County, MO",Nov-22,530502,518098,12404,2.30000000
CN2919500000000,29,195,"Saline County, MO",Nov-22,10178,9935,243,2.40000000
CN2919700000000,29,197,"Schuyler County, MO",Nov-22,1799,1753,46,2.60000000
CN2919900000000,29,199,"Scotland County, MO",Nov-22,2231,2190,41,1.80000000
CN2920100000000,29,201,"Scott County, MO",Nov-22,19930,19496,434,2.20000000
CN2920300000000,29,203,"Shannon County, MO",Nov-22,3247,3117,130,4.00000000
CN2920500000000,29,205,"Shelby County, MO",Nov-22,2893,2840,53,1.80000000
CN2920700000000,29,207,"Stoddard County, MO",Nov-22,13023,12677,346,2.70000000
CN2920900000000,29,209,"Stone County, MO",Nov-22,13625,13186,439,3.20000000
CN2921100000000,29,211,"Sullivan County, MO",Nov-22,2437,2375,62,2.50000000
CN2921300000000,29,213,"Taney County, MO",Nov-22,26116,25301,815,3.10000000
CN2921500000000,29,215,"Texas County, MO",Nov-22,9214,8951,263,2.90000000
CN2921700000000,29,217,"Vernon County, MO",Nov-22,8881,8660,221,2.50000000
CN2921900000000,29,219,"Warren County, MO",Nov-22,18826,18399,427,2.30000000
CN2922100000000,29,221,"Washington County, MO",Nov-22,10032,9733,299,3.00000000
CN2922300000000,29,223,"Wayne County, MO",Nov-22,4784,4622,162,3.40000000
CN2922500000000,29,225,"Webster County, MO",Nov-22,17365,17010,355,2.00000000
CN2922700000000,29,227,"Worth County, MO",Nov-22,1111,1089,22,2.00000000
CN2922900000000,29,229,"Wright County, MO",Nov-22,7500,7305,195,2.60000000
CN2951000000000,29,510,"St. Louis city, MO",Nov-22,150162,145406,4756,3.20000000
CN3000100000000,30,001,"Beaverhead County, MT",Nov-22,5220,5131,89,1.70000000
CN3000300000000,30,003,"Big Horn County, MT",Nov-22,4804,4615,189,3.90000000
CN3000500000000,30,005,"Blaine County, MT",Nov-22,2244,2186,58,2.60000000
CN3000700000000,30,007,"Broadwater County, MT",Nov-22,2750,2667,83,3.00000000
CN3000900000000,30,009,"Carbon County, MT",Nov-22,5859,5730,129,2.20000000
CN3001100000000,30,011,"Carter County, MT",Nov-22,743,733,10,1.30000000
CN3001300000000,30,013,"Cascade County, MT",Nov-22,38880,37964,916,2.40000000
CN3001500000000,30,015,"Chouteau County, MT",Nov-22,2522,2481,41,1.60000000
CN3001700000000,30,017,"Custer County, MT",Nov-22,6510,6406,104,1.60000000
CN3001900000000,30,019,"Daniels County, MT",Nov-22,898,884,14,1.60000000
CN3002100000000,30,021,"Dawson County, MT",Nov-22,4734,4653,81,1.70000000
CN3002300000000,30,023,"Deer Lodge County, MT",Nov-22,5303,5188,115,2.20000000
CN3002500000000,30,025,"Fallon County, MT",Nov-22,1711,1691,20,1.20000000
CN3002700000000,30,027,"Fergus County, MT",Nov-22,5961,5828,133,2.20000000
CN3002900000000,30,029,"Flathead County, MT",Nov-22,50710,49297,1413,2.80000000
CN3003100000000,30,031,"Gallatin County, MT",Nov-22,78062,76723,1339,1.70000000
CN3003300000000,30,033,"Garfield County, MT",Nov-22,772,744,28,3.60000000
CN3003500000000,30,035,"Glacier County, MT",Nov-22,5756,5494,262,4.60000000
CN3003700000000,30,037,"Golden Valley County, MT",Nov-22,382,373,9,2.40000000
CN3003900000000,30,039,"Granite County, MT",Nov-22,1652,1602,50,3.00000000
CN3004100000000,30,041,"Hill County, MT",Nov-22,7607,7478,129,1.70000000
CN3004300000000,30,043,"Jefferson County, MT",Nov-22,6101,5971,130,2.10000000
CN3004500000000,30,045,"Judith Basin County, MT",Nov-22,1071,1052,19,1.80000000
CN3004700000000,30,047,"Lake County, MT",Nov-22,14158,13806,352,2.50000000
CN3004900000000,30,049,"Lewis and Clark County, MT",Nov-22,38482,37733,749,1.90000000
CN3005100000000,30,051,"Liberty County, MT",Nov-22,1028,1009,19,1.80000000
CN3005300000000,30,053,"Lincoln County, MT",Nov-22,8389,8037,352,4.20000000
CN3005500000000,30,055,"McCone County, MT",Nov-22,1003,989,14,1.40000000
CN3005700000000,30,057,"Madison County, MT",Nov-22,4943,4840,103,2.10000000
CN3005900000000,30,059,"Meagher County, MT",Nov-22,1011,992,19,1.90000000
CN3006100000000,30,061,"Mineral County, MT",Nov-22,1773,1689,84,4.70000000
CN3006300000000,30,063,"Missoula County, MT",Nov-22,67084,65682,1402,2.10000000
CN3006500000000,30,065,"Musselshell County, MT",Nov-22,2374,2316,58,2.40000000
CN3006700000000,30,067,"Park County, MT",Nov-22,10248,9977,271,2.60000000
CN3006900000000,30,069,"Petroleum County, MT",Nov-22,283,275,8,2.80000000
CN3007100000000,30,071,"Phillips County, MT",Nov-22,1880,1822,58,3.10000000
CN3007300000000,30,073,"Pondera County, MT",Nov-22,2657,2602,55,2.10000000
CN3007500000000,30,075,"Powder River County, MT",Nov-22,1063,1048,15,1.40000000
CN3007700000000,30,077,"Powell County, MT",Nov-22,2981,2913,68,2.30000000
CN3007900000000,30,079,"Prairie County, MT",Nov-22,502,489,13,2.60000000
CN3008100000000,30,081,"Ravalli County, MT",Nov-22,21617,21123,494,2.30000000
CN3008300000000,30,083,"Richland County, MT",Nov-22,5790,5673,117,2.00000000
CN3008500000000,30,085,"Roosevelt County, MT",Nov-22,4317,4216,101,2.30000000
CN3008700000000,30,087,"Rosebud County, MT",Nov-22,3575,3471,104,2.90000000
CN3008900000000,30,089,"Sanders County, MT",Nov-22,5363,5163,200,3.70000000
CN3009100000000,30,091,"Sheridan County, MT",Nov-22,1761,1740,21,1.20000000
CN3009300000000,30,093,"Silver Bow County, MT",Nov-22,17906,17501,405,2.30000000
CN3009500000000,30,095,"Stillwater County, MT",Nov-22,5559,5466,93,1.70000000
CN3009700000000,30,097,"Sweet Grass County, MT",Nov-22,1937,1909,28,1.40000000
CN3009900000000,30,099,"Teton County, MT",Nov-22,2835,2765,70,2.50000000
CN3010100000000,30,101,"Toole County, MT",Nov-22,2063,2033,30,1.50000000
CN3010300000000,30,103,"Treasure County, MT",Nov-22,374,368,6,1.60000000
CN3010500000000,30,105,"Valley County, MT",Nov-22,3993,3925,68,1.70000000
CN3010700000000,30,107,"Wheatland County, MT",Nov-22,776,750,26,3.40000000
CN3010900000000,30,109,"Wibaux County, MT",Nov-22,452,446,6,1.30000000
CN3011100000000,30,111,"Yellowstone County, MT",Nov-22,87408,85793,1615,1.80000000
CN3100100000000,31,001,"Adams County, NE",Nov-22,17049,16720,329,1.90000000
CN3100300000000,31,003,"Antelope County, NE",Nov-22,3652,3589,63,1.70000000
CN3100500000000,31,005,"Arthur County, NE",Nov-22,230,224,6,2.60000000
CN3100700000000,31,007,"Banner County, NE",Nov-22,394,381,13,3.30000000
CN3100900000000,31,009,"Blaine County, NE",Nov-22,253,245,8,3.20000000
CN3101100000000,31,011,"Boone County, NE",Nov-22,2964,2919,45,1.50000000
CN3101300000000,31,013,"Box Butte County, NE",Nov-22,5267,5155,112,2.10000000
CN3101500000000,31,015,"Boyd County, NE",Nov-22,1033,1010,23,2.20000000
CN3101700000000,31,017,"Brown County, NE",Nov-22,1393,1362,31,2.20000000
CN3101900000000,31,019,"Buffalo County, NE",Nov-22,28297,27763,534,1.90000000
CN3102100000000,31,021,"Burt County, NE",Nov-22,3614,3538,76,2.10000000
CN3102300000000,31,023,"Butler County, NE",Nov-22,4637,4554,83,1.80000000
CN3102500000000,31,025,"Cass County, NE",Nov-22,13847,13550,297,2.10000000
CN3102700000000,31,027,"Cedar County, NE",Nov-22,4658,4574,84,1.80000000
CN3102900000000,31,029,"Chase County, NE",Nov-22,2267,2228,39,1.70000000
CN3103100000000,31,031,"Cherry County, NE",Nov-22,3397,3339,58,1.70000000
CN3103300000000,31,033,"Cheyenne County, NE",Nov-22,4181,4079,102,2.40000000
CN3103500000000,31,035,"Clay County, NE",Nov-22,3080,3018,62,2.00000000
CN3103700000000,31,037,"Colfax County, NE",Nov-22,5747,5635,112,1.90000000
CN3103900000000,31,039,"Cuming County, NE",Nov-22,4946,4854,92,1.90000000
CN3104100000000,31,041,"Custer County, NE",Nov-22,6349,6245,104,1.60000000
CN3104300000000,31,043,"Dakota County, NE",Nov-22,10994,10720,274,2.50000000
CN3104500000000,31,045,"Dawes County, NE",Nov-22,5173,5064,109,2.10000000
CN3104700000000,31,047,"Dawson County, NE",Nov-22,13507,13222,285,2.10000000
CN3104900000000,31,049,"Deuel County, NE",Nov-22,995,966,29,2.90000000
CN3105100000000,31,051,"Dixon County, NE",Nov-22,3034,2974,60,2.00000000
CN3105300000000,31,053,"Dodge County, NE",Nov-22,20664,20262,402,1.90000000
CN3105500000000,31,055,"Douglas County, NE",Nov-22,310375,302974,7401,2.40000000
CN3105700000000,31,057,"Dundy County, NE",Nov-22,1147,1131,16,1.40000000
CN3105900000000,31,059,"Fillmore County, NE",Nov-22,3312,3255,57,1.70000000
CN3106100000000,31,061,"Franklin County, NE",Nov-22,1509,1473,36,2.40000000
CN3106300000000,31,063,"Frontier County, NE",Nov-22,1522,1490,32,2.10000000
CN3106500000000,31,065,"Furnas County, NE",Nov-22,2554,2500,54,2.10000000
CN3106700000000,31,067,"Gage County, NE",Nov-22,11122,10900,222,2.00000000
CN3106900000000,31,069,"Garden County, NE",Nov-22,1054,1031,23,2.20000000
CN3107100000000,31,071,"Garfield County, NE",Nov-22,1116,1097,19,1.70000000
CN3107300000000,31,073,"Gosper County, NE",Nov-22,1144,1120,24,2.10000000
CN3107500000000,31,075,"Grant County, NE",Nov-22,422,416,6,1.40000000
CN3107700000000,31,077,"Greeley County, NE",Nov-22,1204,1183,21,1.70000000
CN3107900000000,31,079,"Hall County, NE",Nov-22,32173,31458,715,2.20000000
CN3108100000000,31,081,"Hamilton County, NE",Nov-22,4834,4737,97,2.00000000
CN3108300000000,31,083,"Harlan County, NE",Nov-22,1754,1722,32,1.80000000
CN3108500000000,31,085,"Hayes County, NE",Nov-22,614,606,8,1.30000000
CN3108700000000,31,087,"Hitchcock County, NE",Nov-22,1311,1282,29,2.20000000
CN3108900000000,31,089,"Holt County, NE",Nov-22,5648,5539,109,1.90000000
CN3109100000000,31,091,"Hooker County, NE",Nov-22,404,394,10,2.50000000
CN3109300000000,31,093,"Howard County, NE",Nov-22,3430,3360,70,2.00000000
CN3109500000000,31,095,"Jefferson County, NE",Nov-22,4167,4088,79,1.90000000
CN3109700000000,31,097,"Johnson County, NE",Nov-22,2022,1968,54,2.70000000
CN3109900000000,31,099,"Kearney County, NE",Nov-22,3780,3713,67,1.80000000
CN3110100000000,31,101,"Keith County, NE",Nov-22,4653,4575,78,1.70000000
CN3110300000000,31,103,"Keya Paha County, NE",Nov-22,592,581,11,1.90000000
CN3110500000000,31,105,"Kimball County, NE",Nov-22,1951,1915,36,1.80000000
CN3110700000000,31,107,"Knox County, NE",Nov-22,4656,4562,94,2.00000000
CN3110900000000,31,109,"Lancaster County, NE",Nov-22,183088,179268,3820,2.10000000
CN3111100000000,31,111,"Lincoln County, NE",Nov-22,18369,17998,371,2.00000000
CN3111300000000,31,113,"Logan County, NE",Nov-22,488,475,13,2.70000000
CN3111500000000,31,115,"Loup County, NE",Nov-22,416,405,11,2.60000000
CN3111700000000,31,117,"McPherson County, NE",Nov-22,431,421,10,2.30000000
CN3111900000000,31,119,"Madison County, NE",Nov-22,20015,19631,384,1.90000000
CN3112100000000,31,121,"Merrick County, NE",Nov-22,4118,4042,76,1.80000000
CN3112300000000,31,123,"Morrill County, NE",Nov-22,2648,2596,52,2.00000000
CN3112500000000,31,125,"Nance County, NE",Nov-22,1939,1902,37,1.90000000
CN3112700000000,31,127,"Nemaha County, NE",Nov-22,3708,3619,89,2.40000000
CN3112900000000,31,129,"Nuckolls County, NE",Nov-22,2489,2435,54,2.20000000
CN3113100000000,31,131,"Otoe County, NE",Nov-22,8575,8403,172,2.00000000
CN3113300000000,31,133,"Pawnee County, NE",Nov-22,1512,1484,28,1.90000000
CN3113500000000,31,135,"Perkins County, NE",Nov-22,1869,1840,29,1.60000000
CN3113700000000,31,137,"Phelps County, NE",Nov-22,4920,4829,91,1.80000000
CN3113900000000,31,139,"Pierce County, NE",Nov-22,4173,4103,70,1.70000000
CN3114100000000,31,141,"Platte County, NE",Nov-22,18419,18075,344,1.90000000
CN3114300000000,31,143,"Polk County, NE",Nov-22,2925,2867,58,2.00000000
CN3114500000000,31,145,"Red Willow County, NE",Nov-22,5966,5854,112,1.90000000
CN3114700000000,31,147,"Richardson County, NE",Nov-22,4136,4063,73,1.80000000
CN3114900000000,31,149,"Rock County, NE",Nov-22,901,888,13,1.40000000
CN3115100000000,31,151,"Saline County, NE",Nov-22,7229,7054,175,2.40000000
CN3115300000000,31,153,"Sarpy County, NE",Nov-22,101271,99169,2102,2.10000000
CN3115500000000,31,155,"Saunders County, NE",Nov-22,11687,11468,219,1.90000000
CN3115700000000,31,157,"Scotts Bluff County, NE",Nov-22,17991,17545,446,2.50000000
CN3115900000000,31,159,"Seward County, NE",Nov-22,9018,8823,195,2.20000000
CN3116100000000,31,161,"Sheridan County, NE",Nov-22,2774,2720,54,1.90000000
CN3116300000000,31,163,"Sherman County, NE",Nov-22,1657,1628,29,1.80000000
CN3116500000000,31,165,"Sioux County, NE",Nov-22,767,749,18,2.30000000
CN3116700000000,31,167,"Stanton County, NE",Nov-22,3583,3513,70,2.00000000
CN3116900000000,31,169,"Thayer County, NE",Nov-22,2722,2672,50,1.80000000
CN3117100000000,31,171,"Thomas County, NE",Nov-22,417,407,10,2.40000000
CN3117300000000,31,173,"Thurston County, NE",Nov-22,3236,3137,99,3.10000000
CN3117500000000,31,175,"Valley County, NE",Nov-22,2098,2053,45,2.10000000
CN3117700000000,31,177,"Washington County, NE",Nov-22,11659,11429,230,2.00000000
CN3117900000000,31,179,"Wayne County, NE",Nov-22,5966,5843,123,2.10000000
CN3118100000000,31,181,"Webster County, NE",Nov-22,1693,1646,47,2.80000000
CN3118300000000,31,183,"Wheeler County, NE",Nov-22,583,573,10,1.70000000
CN3118500000000,31,185,"York County, NE",Nov-22,7379,7227,152,2.10000000
CN3200100000000,32,001,"Churchill County, NV",Nov-22,10803,10370,433,4.00000000
CN3200300000000,32,003,"Clark County, NV",Nov-22,1145175,1080773,64402,5.60000000
CN3200500000000,32,005,"Douglas County, NV",Nov-22,21399,20478,921,4.30000000
CN3200700000000,32,007,"Elko County, NV",Nov-22,25359,24511,848,3.30000000
CN3200900000000,32,009,"Esmeralda County, NV",Nov-22,395,380,15,3.80000000
CN3201100000000,32,011,"Eureka County, NV",Nov-22,904,868,36,4.00000000
CN3201300000000,32,013,"Humboldt County, NV",Nov-22,7706,7440,266,3.50000000
CN3201500000000,32,015,"Lander County, NV",Nov-22,2957,2870,87,2.90000000
CN3201700000000,32,017,"Lincoln County, NV",Nov-22,2077,1989,88,4.20000000
CN3201900000000,32,019,"Lyon County, NV",Nov-22,23670,22490,1180,5.00000000
CN3202100000000,32,021,"Mineral County, NV",Nov-22,2050,1972,78,3.80000000
CN3202300000000,32,023,"Nye County, NV",Nov-22,17365,16323,1042,6.00000000
CN3202700000000,32,027,"Pershing County, NV",Nov-22,2377,2286,91,3.80000000
CN3202900000000,32,029,"Storey County, NV",Nov-22,2103,2016,87,4.10000000
CN3203100000000,32,031,"Washoe County, NV",Nov-22,257331,248279,9052,3.50000000
CN3203300000000,32,033,"White Pine County, NV",Nov-22,4463,4320,143,3.20000000
CN3251000000000,32,510,"Carson City, NV",Nov-22,25595,24574,1021,4.00000000
CN3300100000000,33,001,"Belknap County, NH",Nov-22,30287,29490,797,2.60000000
CN3300300000000,33,003,"Carroll County, NH",Nov-22,22857,22191,666,2.90000000
CN3300500000000,33,005,"Cheshire County, NH",Nov-22,39129,38114,1015,2.60000000
CN3300700000000,33,007,"Coos County, NH",Nov-22,13975,13510,465,3.30000000
CN3300900000000,33,009,"Grafton County, NH",Nov-22,48123,46990,1133,2.40000000
CN3301100000000,33,011,"Hillsborough County, NH",Nov-22,246292,240049,6243,2.50000000
CN3301300000000,33,013,"Merrimack County, NH",Nov-22,82462,80600,1862,2.30000000
CN3301500000000,33,015,"Rockingham County, NH",Nov-22,190045,185088,4957,2.60000000
CN3301700000000,33,017,"Strafford County, NH",Nov-22,74026,72334,1692,2.30000000
CN3301900000000,33,019,"Sullivan County, NH",Nov-22,22514,21954,560,2.50000000
CN3400100000000,34,001,"Atlantic County, NJ",Nov-22,127939,122687,5252,4.10000000
CN3400300000000,34,003,"Bergen County, NJ",Nov-22,501965,488571,13394,2.70000000
CN3400500000000,34,005,"Burlington County, NJ",Nov-22,250648,244155,6493,2.60000000
CN3400700000000,34,007,"Camden County, NJ",Nov-22,273924,264954,8970,3.30000000
CN3400900000000,34,009,"Cape May County, NJ",Nov-22,43857,41078,2779,6.30000000
CN3401100000000,34,011,"Cumberland County, NJ",Nov-22,68514,65591,2923,4.30000000
CN3401300000000,34,013,"Essex County, NJ",Nov-22,385973,371221,14752,3.80000000
CN3401500000000,34,015,"Gloucester County, NJ",Nov-22,163176,158413,4763,2.90000000
CN3401700000000,34,017,"Hudson County, NJ",Nov-22,375700,364425,11275,3.00000000
CN3401900000000,34,019,"Hunterdon County, NJ",Nov-22,67605,66116,1489,2.20000000
CN3402100000000,34,021,"Mercer County, NJ",Nov-22,215001,209582,5419,2.50000000
CN3402300000000,34,023,"Middlesex County, NJ",Nov-22,462023,449637,12386,2.70000000
CN3402500000000,34,025,"Monmouth County, NJ",Nov-22,347453,338523,8930,2.60000000
CN3402700000000,34,027,"Morris County, NJ",Nov-22,267204,260955,6249,2.30000000
CN3402900000000,34,029,"Ocean County, NJ",Nov-22,297898,289146,8752,2.90000000
CN3403100000000,34,031,"Passaic County, NJ",Nov-22,251364,241811,9553,3.80000000
CN3403300000000,34,033,"Salem County, NJ",Nov-22,29783,28609,1174,3.90000000
CN3403500000000,34,035,"Somerset County, NJ",Nov-22,178095,173865,4230,2.40000000
CN3403700000000,34,037,"Sussex County, NJ",Nov-22,77011,74817,2194,2.80000000
CN3403900000000,34,039,"Union County, NJ",Nov-22,287647,278537,9110,3.20000000
CN3404100000000,34,041,"Warren County, NJ",Nov-22,59463,57963,1500,2.50000000
CN3500100000000,35,001,"Bernalillo County, NM",Nov-22,334255,323685,10570,3.20000000
CN3500300000000,35,003,"Catron County, NM",Nov-22,1133,1086,47,4.10000000
CN3500500000000,35,005,"Chaves County, NM",Nov-22,27711,26651,1060,3.80000000
CN3500600000000,35,006,"Cibola County, NM",Nov-22,8357,7943,414,5.00000000
CN3500700000000,35,007,"Colfax County, NM",Nov-22,4450,4276,174,3.90000000
CN3500900000000,35,009,"Curry County, NM",Nov-22,21961,21385,576,2.60000000
CN3501100000000,35,011,"De Baca County, NM",Nov-22,696,676,20,2.90000000
CN3501300000000,35,013,"Dona Ana County, NM",Nov-22,99556,95590,3966,4.00000000
CN3501500000000,35,015,"Eddy County, NM",Nov-22,31751,30858,893,2.80000000
CN3501700000000,35,017,"Grant County, NM",Nov-22,11557,11125,432,3.70000000
CN3501900000000,35,019,"Guadalupe County, NM",Nov-22,1827,1758,69,3.80000000
CN3502100000000,35,021,"Harding County, NM",Nov-22,293,285,8,2.70000000
CN3502300000000,35,023,"Hidalgo County, NM",Nov-22,1802,1750,52,2.90000000
CN3502500000000,35,025,"Lea County, NM",Nov-22,28327,27144,1183,4.20000000
CN3502700000000,35,027,"Lincoln County, NM",Nov-22,8853,8536,317,3.60000000
CN3502800000000,35,028,"Los Alamos County, NM",Nov-22,10309,10137,172,1.70000000
CN3502900000000,35,029,"Luna County, NM",Nov-22,9755,8665,1090,11.20000000
CN3503100000000,35,031,"McKinley County, NM",Nov-22,23702,22528,1174,5.00000000
CN3503300000000,35,033,"Mora County, NM",Nov-22,1966,1876,90,4.60000000
CN3503500000000,35,035,"Otero County, NM",Nov-22,25829,24878,951,3.70000000
CN3503700000000,35,037,"Quay County, NM",Nov-22,2860,2753,107,3.70000000
CN3503900000000,35,039,"Rio Arriba County, NM",Nov-22,16361,15755,606,3.70000000
CN3504100000000,35,041,"Roosevelt County, NM",Nov-22,8281,8020,261,3.20000000
CN3504300000000,35,043,"Sandoval County, NM",Nov-22,67588,65276,2312,3.40000000
CN3504500000000,35,045,"San Juan County, NM",Nov-22,48632,46552,2080,4.30000000
CN3504700000000,35,047,"San Miguel County, NM",Nov-22,10763,10290,473,4.40000000
CN3504900000000,35,049,"Santa Fe County, NM",Nov-22,73352,71163,2189,3.00000000
CN3505100000000,35,051,"Sierra County, NM",Nov-22,4078,3873,205,5.00000000
CN3505300000000,35,053,"Socorro County, NM",Nov-22,6151,5920,231,3.80000000
CN3505500000000,35,055,"Taos County, NM",Nov-22,14948,14253,695,4.60000000
CN3505700000000,35,057,"Torrance County, NM",Nov-22,5467,5199,268,4.90000000
CN3505900000000,35,059,"Union County, NM",Nov-22,1573,1537,36,2.30000000
CN3506100000000,35,061,"Valencia County, NM",Nov-22,30865,29671,1194,3.90000000
CN3600100000000,36,001,"Albany County, NY",Nov-22,158424,154464,3960,2.50000000
CN3600300000000,36,003,"Allegany County, NY",Nov-22,19373,18756,617,3.20000000
CN3600500000000,36,005,"Bronx County, NY",Nov-22,586345,543312,43033,7.30000000
CN3600700000000,36,007,"Broome County, NY",Nov-22,83066,80584,2482,3.00000000
CN3600900000000,36,009,"Cattaraugus County, NY",Nov-22,32260,31137,1123,3.50000000
CN3601100000000,36,011,"Cayuga County, NY",Nov-22,34632,33697,935,2.70000000
CN3601300000000,36,013,"Chautauqua County, NY",Nov-22,51072,49298,1774,3.50000000
CN3601500000000,36,015,"Chemung County, NY",Nov-22,34553,33480,1073,3.10000000
CN3601700000000,36,017,"Chenango County, NY",Nov-22,21402,20835,567,2.60000000
CN3601900000000,36,019,"Clinton County, NY",Nov-22,34559,33615,944,2.70000000
CN3602100000000,36,021,"Columbia County, NY",Nov-22,29766,29122,644,2.20000000
CN3602300000000,36,023,"Cortland County, NY",Nov-22,22506,21787,719,3.20000000
CN3602500000000,36,025,"Delaware County, NY",Nov-22,18290,17753,537,2.90000000
CN3602700000000,36,027,"Dutchess County, NY",Nov-22,143306,139742,3564,2.50000000
CN3602900000000,36,029,"Erie County, NY",Nov-22,440216,426748,13468,3.10000000
CN3603100000000,36,031,"Essex County, NY",Nov-22,15707,15207,500,3.20000000
CN3603300000000,36,033,"Franklin County, NY",Nov-22,18323,17745,578,3.20000000
CN3603500000000,36,035,"Fulton County, NY",Nov-22,22302,21553,749,3.40000000
CN3603700000000,36,037,"Genesee County, NY",Nov-22,29068,28337,731,2.50000000
CN3603900000000,36,039,"Greene County, NY",Nov-22,19964,19387,577,2.90000000
CN3604100000000,36,041,"Hamilton County, NY",Nov-22,2097,1995,102,4.90000000
CN3604300000000,36,043,"Herkimer County, NY",Nov-22,27311,26411,900,3.30000000
CN3604500000000,36,045,"Jefferson County, NY",Nov-22,43803,42279,1524,3.50000000
CN3604700000000,36,047,"Kings County, NY",Nov-22,1174732,1110539,64193,5.50000000
CN3604900000000,36,049,"Lewis County, NY",Nov-22,11373,11016,357,3.10000000
CN3605100000000,36,051,"Livingston County, NY",Nov-22,29879,29107,772,2.60000000
CN3605300000000,36,053,"Madison County, NY",Nov-22,32630,31770,860,2.60000000
CN3605500000000,36,055,"Monroe County, NY",Nov-22,362937,352495,10442,2.90000000
CN3605700000000,36,057,"Montgomery County, NY",Nov-22,21858,21089,769,3.50000000
CN3605900000000,36,059,"Nassau County, NY",Nov-22,725139,708187,16952,2.30000000
CN3606100000000,36,061,"New York County, NY",Nov-22,893102,855858,37244,4.20000000
CN3606300000000,36,063,"Niagara County, NY",Nov-22,96970,93861,3109,3.20000000
CN3606500000000,36,065,"Oneida County, NY",Nov-22,100259,97310,2949,2.90000000
CN3606700000000,36,067,"Onondaga County, NY",Nov-22,224016,218019,5997,2.70000000
CN3606900000000,36,069,"Ontario County, NY",Nov-22,55344,53981,1363,2.50000000
CN3607100000000,36,071,"Orange County, NY",Nov-22,188635,183707,4928,2.60000000
CN3607300000000,36,073,"Orleans County, NY",Nov-22,16861,16357,504,3.00000000
CN3607500000000,36,075,"Oswego County, NY",Nov-22,52767,50955,1812,3.40000000
CN3607700000000,36,077,"Otsego County, NY",Nov-22,27116,26378,738,2.70000000
CN3607900000000,36,079,"Putnam County, NY",Nov-22,50940,49726,1214,2.40000000
CN3608100000000,36,081,"Queens County, NY",Nov-22,1108612,1055495,53117,4.80000000
CN3608300000000,36,083,"Rensselaer County, NY",Nov-22,81606,79603,2003,2.50000000
CN3608500000000,36,085,"Richmond County, NY",Nov-22,220474,209643,10831,4.90000000
CN3608700000000,36,087,"Rockland County, NY",Nov-22,158083,154426,3657,2.30000000
CN3608900000000,36,089,"St. Lawrence County, NY",Nov-22,42415,40947,1468,3.50000000
CN3609100000000,36,091,"Saratoga County, NY",Nov-22,120773,118194,2579,2.10000000
CN3609300000000,36,093,"Schenectady County, NY",Nov-22,77381,75285,2096,2.70000000
CN3609500000000,36,095,"Schoharie County, NY",Nov-22,14531,14127,404,2.80000000
CN3609700000000,36,097,"Schuyler County, NY",Nov-22,7794,7550,244,3.10000000
CN3609900000000,36,099,"Seneca County, NY",Nov-22,14972,14596,376,2.50000000
CN3610100000000,36,101,"Steuben County, NY",Nov-22,40448,39232,1216,3.00000000
CN3610300000000,36,103,"Suffolk County, NY",Nov-22,795456,775262,20194,2.50000000
CN3610500000000,36,105,"Sullivan County, NY",Nov-22,36926,35931,995,2.70000000
CN3610700000000,36,107,"Tioga County, NY",Nov-22,22444,21894,550,2.50000000
CN3610900000000,36,109,"Tompkins County, NY",Nov-22,49383,48223,1160,2.30000000
CN3611100000000,36,111,"Ulster County, NY",Nov-22,87640,85482,2158,2.50000000
CN3611300000000,36,113,"Warren County, NY",Nov-22,30612,29689,923,3.00000000
CN3611500000000,36,115,"Washington County, NY",Nov-22,26740,26028,712,2.70000000
CN3611700000000,36,117,"Wayne County, NY",Nov-22,42876,41794,1082,2.50000000
CN3611900000000,36,119,"Westchester County, NY",Nov-22,492110,479588,12522,2.50000000
CN3612100000000,36,121,"Wyoming County, NY",Nov-22,17492,17010,482,2.80000000
CN3612300000000,36,123,"Yates County, NY",Nov-22,11391,11107,284,2.50000000
CN3700100000000,37,001,"Alamance County, NC",Nov-22,82927,79822,3105,3.70000000
CN3700300000000,37,003,"Alexander County, NC",Nov-22,17722,17144,578,3.30000000
CN3700500000000,37,005,"Alleghany County, NC",Nov-22,4319,4152,167,3.90000000
CN3700700000000,37,007,"Anson County, NC",Nov-22,10187,9723,464,4.60000000
CN3700900000000,37,009,"Ashe County, NC",Nov-22,13114,12680,434,3.30000000
CN3701100000000,37,011,"Avery County, NC",Nov-22,7490,7248,242,3.20000000
CN3701300000000,37,013,"Beaufort County, NC",Nov-22,19755,18977,778,3.90000000
CN3701500000000,37,015,"Bertie County, NC",Nov-22,7268,6914,354,4.90000000
CN3701700000000,37,017,"Bladen County, NC",Nov-22,13849,13165,684,4.90000000
CN3701900000000,37,019,"Brunswick County, NC",Nov-22,55013,52291,2722,4.90000000
CN3702100000000,37,021,"Buncombe County, NC",Nov-22,139475,135318,4157,3.00000000
CN3702300000000,37,023,"Burke County, NC",Nov-22,40213,38780,1433,3.60000000
CN3702500000000,37,025,"Cabarrus County, NC",Nov-22,115161,111099,4062,3.50000000
CN3702700000000,37,027,"Caldwell County, NC",Nov-22,35808,34491,1317,3.70000000
CN3702900000000,37,029,"Camden County, NC",Nov-22,4593,4431,162,3.50000000
CN3703100000000,37,031,"Carteret County, NC",Nov-22,31386,30270,1116,3.60000000
CN3703300000000,37,033,"Caswell County, NC",Nov-22,9763,9375,388,4.00000000
CN3703500000000,37,035,"Catawba County, NC",Nov-22,78203,75424,2779,3.60000000
CN3703700000000,37,037,"Chatham County, NC",Nov-22,37870,36694,1176,3.10000000
CN3703900000000,37,039,"Cherokee County, NC",Nov-22,10850,10390,460,4.20000000
CN3704100000000,37,041,"Chowan County, NC",Nov-22,5817,5570,247,4.20000000
CN3704300000000,37,043,"Clay County, NC",Nov-22,4036,3867,169,4.20000000
CN3704500000000,37,045,"Cleveland County, NC",Nov-22,48726,46764,1962,4.00000000
CN3704700000000,37,047,"Columbus County, NC",Nov-22,22955,21908,1047,4.60000000
CN3704900000000,37,049,"Craven County, NC",Nov-22,41157,39558,1599,3.90000000
CN3705100000000,37,051,"Cumberland County, NC",Nov-22,128132,121050,7082,5.50000000
CN3705300000000,37,053,"Currituck County, NC",Nov-22,14471,13990,481,3.30000000
CN3705500000000,37,055,"Dare County, NC",Nov-22,18935,18172,763,4.00000000
CN3705700000000,37,057,"Davidson County, NC",Nov-22,81020,78132,2888,3.60000000
CN3705900000000,37,059,"Davie County, NC",Nov-22,20662,19951,711,3.40000000
CN3706100000000,37,061,"Duplin County, NC",Nov-22,24178,23268,910,3.80000000
CN3706300000000,37,063,"Durham County, NC",Nov-22,181479,175715,5764,3.20000000
CN3706500000000,37,065,"Edgecombe County, NC",Nov-22,20008,18559,1449,7.20000000
CN3706700000000,37,067,"Forsyth County, NC",Nov-22,187708,180619,7089,3.80000000
CN3706900000000,37,069,"Franklin County, NC",Nov-22,33716,32471,1245,3.70000000
CN3707100000000,37,071,"Gaston County, NC",Nov-22,113790,109430,4360,3.80000000
CN3707300000000,37,073,"Gates County, NC",Nov-22,5061,4883,178,3.50000000
CN3707500000000,37,075,"Graham County, NC",Nov-22,2964,2809,155,5.20000000
CN3707700000000,37,077,"Granville County, NC",Nov-22,30284,29327,957,3.20000000
CN3707900000000,37,079,"Greene County, NC",Nov-22,9483,9187,296,3.10000000
CN3708100000000,37,081,"Guilford County, NC",Nov-22,261056,249985,11071,4.20000000
CN3708300000000,37,083,"Halifax County, NC",Nov-22,18879,17724,1155,6.10000000
CN3708500000000,37,085,"Harnett County, NC",Nov-22,55060,52726,2334,4.20000000
CN3708700000000,37,087,"Haywood County, NC",Nov-22,29658,28715,943,3.20000000
CN3708900000000,37,089,"Henderson County, NC",Nov-22,54565,52818,1747,3.20000000
CN3709100000000,37,091,"Hertford County, NC",Nov-22,8535,8070,465,5.40000000
CN3709300000000,37,093,"Hoke County, NC",Nov-22,20335,19261,1074,5.30000000
CN3709500000000,37,095,"Hyde County, NC",Nov-22,1748,1660,88,5.00000000
CN3709700000000,37,097,"Iredell County, NC",Nov-22,93825,90551,3274,3.50000000
CN3709900000000,37,099,"Jackson County, NC",Nov-22,19974,19237,737,3.70000000
CN3710100000000,37,101,"Johnston County, NC",Nov-22,107168,103548,3620,3.40000000
CN3710300000000,37,103,"Jones County, NC",Nov-22,4235,4076,159,3.80000000
CN3710500000000,37,105,"Lee County, NC",Nov-22,26402,25260,1142,4.30000000
CN3710700000000,37,107,"Lenoir County, NC",Nov-22,26984,25968,1016,3.80000000
CN3710900000000,37,109,"Lincoln County, NC",Nov-22,45974,44489,1485,3.20000000
CN3711100000000,37,111,"McDowell County, NC",Nov-22,19537,18805,732,3.70000000
CN3711300000000,37,113,"Macon County, NC",Nov-22,15598,15055,543,3.50000000
CN3711500000000,37,115,"Madison County, NC",Nov-22,9913,9564,349,3.50000000
CN3711700000000,37,117,"Martin County, NC",Nov-22,8623,8230,393,4.60000000
CN3711900000000,37,119,"Mecklenburg County, NC",Nov-22,647013,623394,23619,3.70000000
CN3712100000000,37,121,"Mitchell County, NC",Nov-22,5971,5717,254,4.30000000
CN3712300000000,37,123,"Montgomery County, NC",Nov-22,11387,10967,420,3.70000000
CN3712500000000,37,125,"Moore County, NC",Nov-22,40979,39442,1537,3.80000000
CN3712700000000,37,127,"Nash County, NC",Nov-22,41608,39404,2204,5.30000000
CN3712900000000,37,129,"New Hanover County, NC",Nov-22,127507,123212,4295,3.40000000
CN3713100000000,37,131,"Northampton County, NC",Nov-22,7070,6733,337,4.80000000
CN3713300000000,37,133,"Onslow County, NC",Nov-22,66673,63704,2969,4.50000000
CN3713500000000,37,135,"Orange County, NC",Nov-22,82563,80068,2495,3.00000000
CN3713700000000,37,137,"Pamlico County, NC",Nov-22,5373,5177,196,3.60000000
CN3713900000000,37,139,"Pasquotank County, NC",Nov-22,16455,15713,742,4.50000000
CN3714100000000,37,141,"Pender County, NC",Nov-22,30290,29204,1086,3.60000000
CN3714300000000,37,143,"Perquimans County, NC",Nov-22,4894,4668,226,4.60000000
CN3714500000000,37,145,"Person County, NC",Nov-22,19102,18361,741,3.90000000
CN3714700000000,37,147,"Pitt County, NC",Nov-22,88593,84945,3648,4.10000000
CN3714900000000,37,149,"Polk County, NC",Nov-22,9338,8996,342,3.70000000
CN3715100000000,37,151,"Randolph County, NC",Nov-22,65475,63070,2405,3.70000000
CN3715300000000,37,153,"Richmond County, NC",Nov-22,16256,15322,934,5.70000000
CN3715500000000,37,155,"Robeson County, NC",Nov-22,47736,44830,2906,6.10000000
CN3715700000000,37,157,"Rockingham County, NC",Nov-22,39600,37897,1703,4.30000000
CN3715900000000,37,159,"Rowan County, NC",Nov-22,67145,64657,2488,3.70000000
CN3716100000000,37,161,"Rutherford County, NC",Nov-22,24095,22843,1252,5.20000000
CN3716300000000,37,163,"Sampson County, NC",Nov-22,28096,27058,1038,3.70000000
CN3716500000000,37,165,"Scotland County, NC",Nov-22,11153,10349,804,7.20000000
CN3716700000000,37,167,"Stanly County, NC",Nov-22,30208,29196,1012,3.40000000
CN3716900000000,37,169,"Stokes County, NC",Nov-22,21520,20801,719,3.30000000
CN3717100000000,37,171,"Surry County, NC",Nov-22,31589,30476,1113,3.50000000
CN3717300000000,37,173,"Swain County, NC",Nov-22,7201,6979,222,3.10000000
CN3717500000000,37,175,"Transylvania County, NC",Nov-22,14570,14052,518,3.60000000
CN3717700000000,37,177,"Tyrrell County, NC",Nov-22,1255,1188,67,5.30000000
CN3717900000000,37,179,"Union County, NC",Nov-22,129179,125004,4175,3.20000000
CN3718100000000,37,181,"Vance County, NC",Nov-22,16613,15523,1090,6.60000000
CN3718300000000,37,183,"Wake County, NC",Nov-22,625913,606351,19562,3.10000000
CN3718500000000,37,185,"Warren County, NC",Nov-22,6436,6008,428,6.70000000
CN3718700000000,37,187,"Washington County, NC",Nov-22,4281,4027,254,5.90000000
CN3718900000000,37,189,"Watauga County, NC",Nov-22,29510,28561,949,3.20000000
CN3719100000000,37,191,"Wayne County, NC",Nov-22,50931,48870,2061,4.00000000
CN3719300000000,37,193,"Wilkes County, NC",Nov-22,26927,25867,1060,3.90000000
CN3719500000000,37,195,"Wilson County, NC",Nov-22,32657,30843,1814,5.60000000
CN3719700000000,37,197,"Yadkin County, NC",Nov-22,17570,16951,619,3.50000000
CN3719900000000,37,199,"Yancey County, NC",Nov-22,8226,7939,287,3.50000000
CN3800100000000,38,001,"Adams County, ND",Nov-22,895,880,15,1.70000000
CN3800300000000,38,003,"Barnes County, ND",Nov-22,5254,5164,90,1.70000000
CN3800500000000,38,005,"Benson County, ND",Nov-22,2324,2263,61,2.60000000
CN3800700000000,38,007,"Billings County, ND",Nov-22,389,382,7,1.80000000
CN3800900000000,38,009,"Bottineau County, ND",Nov-22,2944,2873,71,2.40000000
CN3801100000000,38,011,"Bowman County, ND",Nov-22,1510,1487,23,1.50000000
CN3801300000000,38,013,"Burke County, ND",Nov-22,1032,1012,20,1.90000000
CN3801500000000,38,015,"Burleigh County, ND",Nov-22,50983,50140,843,1.70000000
CN3801700000000,38,017,"Cass County, ND",Nov-22,106973,105340,1633,1.50000000
CN3801900000000,38,019,"Cavalier County, ND",Nov-22,1770,1737,33,1.90000000
CN3802100000000,38,021,"Dickey County, ND",Nov-22,2144,2111,33,1.50000000
CN3802300000000,38,023,"Divide County, ND",Nov-22,1355,1335,20,1.50000000
CN3802500000000,38,025,"Dunn County, ND",Nov-22,3294,3261,33,1.00000000
CN3802700000000,38,027,"Eddy County, ND",Nov-22,1147,1120,27,2.40000000
CN3802900000000,38,029,"Emmons County, ND",Nov-22,1400,1344,56,4.00000000
CN3803100000000,38,031,"Foster County, ND",Nov-22,1442,1419,23,1.60000000
CN3803300000000,38,033,"Golden Valley County, ND",Nov-22,832,815,17,2.00000000
CN3803500000000,38,035,"Grand Forks County, ND",Nov-22,36998,36401,597,1.60000000
CN3803700000000,38,037,"Grant County, ND",Nov-22,1183,1161,22,1.90000000
CN3803900000000,38,039,"Griggs County, ND",Nov-22,998,978,20,2.00000000
CN3804100000000,38,041,"Hettinger County, ND",Nov-22,1404,1381,23,1.60000000
CN3804300000000,38,043,"Kidder County, ND",Nov-22,1272,1232,40,3.10000000
CN3804500000000,38,045,"LaMoure County, ND",Nov-22,2042,2009,33,1.60000000
CN3804700000000,38,047,"Logan County, ND",Nov-22,853,833,20,2.30000000
CN3804900000000,38,049,"McHenry County, ND",Nov-22,3048,2970,78,2.60000000
CN3805100000000,38,051,"McIntosh County, ND",Nov-22,1017,995,22,2.20000000
CN3805300000000,38,053,"McKenzie County, ND",Nov-22,9342,9166,176,1.90000000
CN3805500000000,38,055,"McLean County, ND",Nov-22,4583,4462,121,2.60000000
CN3805700000000,38,057,"Mercer County, ND",Nov-22,3456,3358,98,2.80000000
CN3805900000000,38,059,"Morton County, ND",Nov-22,16768,16416,352,2.10000000
CN3806100000000,38,061,"Mountrail County, ND",Nov-22,6237,6151,86,1.40000000
CN3806300000000,38,063,"Nelson County, ND",Nov-22,1430,1397,33,2.30000000
CN3806500000000,38,065,"Oliver County, ND",Nov-22,863,838,25,2.90000000
CN3806700000000,38,067,"Pembina County, ND",Nov-22,3117,3012,105,3.40000000
CN3806900000000,38,069,"Pierce County, ND",Nov-22,1619,1586,33,2.00000000
CN3807100000000,38,071,"Ramsey County, ND",Nov-22,5459,5345,114,2.10000000
CN3807300000000,38,073,"Ransom County, ND",Nov-22,2591,2558,33,1.30000000
CN3807500000000,38,075,"Renville County, ND",Nov-22,1191,1176,15,1.30000000
CN3807700000000,38,077,"Richland County, ND",Nov-22,8455,8332,123,1.50000000
CN3807900000000,38,079,"Rolette County, ND",Nov-22,4615,4349,266,5.80000000
CN3808100000000,38,081,"Sargent County, ND",Nov-22,2240,2212,28,1.30000000
CN3808300000000,38,083,"Sheridan County, ND",Nov-22,626,611,15,2.40000000
CN3808500000000,38,085,"Sioux County, ND",Nov-22,1194,1169,25,2.10000000
CN3808700000000,38,087,"Slope County, ND",Nov-22,327,319,8,2.40000000
CN3808900000000,38,089,"Stark County, ND",Nov-22,17798,17484,314,1.80000000
CN3809100000000,38,091,"Steele County, ND",Nov-22,925,910,15,1.60000000
CN3809300000000,38,093,"Stutsman County, ND",Nov-22,10206,10025,181,1.80000000
CN3809500000000,38,095,"Towner County, ND",Nov-22,1074,1049,25,2.30000000
CN3809700000000,38,097,"Traill County, ND",Nov-22,4363,4293,70,1.60000000
CN3809900000000,38,099,"Walsh County, ND",Nov-22,5060,4919,141,2.80000000
CN3810100000000,38,101,"Ward County, ND",Nov-22,31337,30731,606,1.90000000
CN3810300000000,38,103,"Wells County, ND",Nov-22,1843,1777,66,3.60000000
CN3810500000000,38,105,"Williams County, ND",Nov-22,21504,20968,536,2.50000000
CN3900100000000,39,001,"Adams County, OH",Nov-22,10840,10362,478,4.40000000
CN3900300000000,39,003,"Allen County, OH",Nov-22,46220,44689,1531,3.30000000
CN3900500000000,39,005,"Ashland County, OH",Nov-22,26580,25782,798,3.00000000
CN3900700000000,39,007,"Ashtabula County, OH",Nov-22,42651,41166,1485,3.50000000
CN3900900000000,39,009,"Athens County, OH",Nov-22,25984,25007,977,3.80000000
CN3901100000000,39,011,"Auglaize County, OH",Nov-22,23977,23435,542,2.30000000
CN3901300000000,39,013,"Belmont County, OH",Nov-22,27764,26683,1081,3.90000000
CN3901500000000,39,015,"Brown County, OH",Nov-22,19171,18504,667,3.50000000
CN3901700000000,39,017,"Butler County, OH",Nov-22,193059,187586,5473,2.80000000
CN3901900000000,39,019,"Carroll County, OH",Nov-22,12577,12128,449,3.60000000
CN3902100000000,39,021,"Champaign County, OH",Nov-22,19166,18647,519,2.70000000
CN3902300000000,39,023,"Clark County, OH",Nov-22,61619,59693,1926,3.10000000
CN3902500000000,39,025,"Clermont County, OH",Nov-22,105952,102971,2981,2.80000000
CN3902700000000,39,027,"Clinton County, OH",Nov-22,17933,17304,629,3.50000000
CN3902900000000,39,029,"Columbiana County, OH",Nov-22,44415,42787,1628,3.70000000
CN3903100000000,39,031,"Coshocton County, OH",Nov-22,13626,13115,511,3.80000000
CN3903300000000,39,033,"Crawford County, OH",Nov-22,17687,17036,651,3.70000000
CN3903500000000,39,035,"Cuyahoga County, OH",Nov-22,598459,571118,27341,4.60000000
CN3903700000000,39,037,"Darke County, OH",Nov-22,25891,25218,673,2.60000000
CN3903900000000,39,039,"Defiance County, OH",Nov-22,17447,16900,547,3.10000000
CN3904100000000,39,041,"Delaware County, OH",Nov-22,114768,111997,2771,2.40000000
CN3904300000000,39,043,"Erie County, OH",Nov-22,35739,34413,1326,3.70000000
CN3904500000000,39,045,"Fairfield County, OH",Nov-22,79807,77611,2196,2.80000000
CN3904700000000,39,047,"Fayette County, OH",Nov-22,13994,13583,411,2.90000000
CN3904900000000,39,049,"Franklin County, OH",Nov-22,702296,682726,19570,2.80000000
CN3905100000000,39,051,"Fulton County, OH",Nov-22,22287,21661,626,2.80000000
CN3905300000000,39,053,"Gallia County, OH",Nov-22,12194,11756,438,3.60000000
CN3905500000000,39,055,"Geauga County, OH",Nov-22,48319,46706,1613,3.30000000
CN3905700000000,39,057,"Greene County, OH",Nov-22,82155,79857,2298,2.80000000
CN3905900000000,39,059,"Guernsey County, OH",Nov-22,17638,16955,683,3.90000000
CN3906100000000,39,061,"Hamilton County, OH",Nov-22,409099,397013,12086,3.00000000
CN3906300000000,39,063,"Hancock County, OH",Nov-22,40447,39462,985,2.40000000
CN3906500000000,39,065,"Hardin County, OH",Nov-22,13723,13304,419,3.10000000
CN3906700000000,39,067,"Harrison County, OH",Nov-22,6409,6139,270,4.20000000
CN3906900000000,39,069,"Henry County, OH",Nov-22,12745,12297,448,3.50000000
CN3907100000000,39,071,"Highland County, OH",Nov-22,17612,16847,765,4.30000000
CN3907300000000,39,073,"Hocking County, OH",Nov-22,12823,12408,415,3.20000000
CN3907500000000,39,075,"Holmes County, OH",Nov-22,21949,21386,563,2.60000000
CN3907700000000,39,077,"Huron County, OH",Nov-22,27596,26623,973,3.50000000
CN3907900000000,39,079,"Jackson County, OH",Nov-22,12261,11786,475,3.90000000
CN3908100000000,39,081,"Jefferson County, OH",Nov-22,26715,25542,1173,4.40000000
CN3908300000000,39,083,"Knox County, OH",Nov-22,31050,30246,804,2.60000000
CN3908500000000,39,085,"Lake County, OH",Nov-22,124147,119598,4549,3.70000000
CN3908700000000,39,087,"Lawrence County, OH",Nov-22,23057,22220,837,3.60000000
CN3908900000000,39,089,"Licking County, OH",Nov-22,91452,89018,2434,2.70000000
CN3909100000000,39,091,"Logan County, OH",Nov-22,22516,21925,591,2.60000000
CN3909300000000,39,093,"Lorain County, OH",Nov-22,153132,146688,6444,4.20000000
CN3909500000000,39,095,"Lucas County, OH",Nov-22,207896,200320,7576,3.60000000
CN3909700000000,39,097,"Madison County, OH",Nov-22,21024,20505,519,2.50000000
CN3909900000000,39,099,"Mahoning County, OH",Nov-22,96877,93176,3701,3.80000000
CN3910100000000,39,101,"Marion County, OH",Nov-22,27101,26266,835,3.10000000
CN3910300000000,39,103,"Medina County, OH",Nov-22,97455,94109,3346,3.40000000
CN3910500000000,39,105,"Meigs County, OH",Nov-22,8507,8126,381,4.50000000
CN3910700000000,39,107,"Mercer County, OH",Nov-22,22970,22518,452,2.00000000
CN3910900000000,39,109,"Miami County, OH",Nov-22,53358,51933,1425,2.70000000
CN3911100000000,39,111,"Monroe County, OH",Nov-22,5032,4766,266,5.30000000
CN3911300000000,39,113,"Montgomery County, OH",Nov-22,245149,236936,8213,3.40000000
CN3911500000000,39,115,"Morgan County, OH",Nov-22,6755,6484,271,4.00000000
CN3911700000000,39,117,"Morrow County, OH",Nov-22,16915,16414,501,3.00000000
CN3911900000000,39,119,"Muskingum County, OH",Nov-22,40994,39591,1403,3.40000000
CN3912100000000,39,121,"Noble County, OH",Nov-22,4527,4302,225,5.00000000
CN3912300000000,39,123,"Ottawa County, OH",Nov-22,19876,18875,1001,5.00000000
CN3912500000000,39,125,"Paulding County, OH",Nov-22,8706,8482,224,2.60000000
CN3912700000000,39,127,"Perry County, OH",Nov-22,15835,15307,528,3.30000000
CN3912900000000,39,129,"Pickaway County, OH",Nov-22,26713,25945,768,2.90000000
CN3913100000000,39,131,"Pike County, OH",Nov-22,11020,10553,467,4.20000000
CN3913300000000,39,133,"Portage County, OH",Nov-22,83418,80934,2484,3.00000000
CN3913500000000,39,135,"Preble County, OH",Nov-22,21890,21341,549,2.50000000
CN3913700000000,39,137,"Putnam County, OH",Nov-22,18967,18556,411,2.20000000
CN3913900000000,39,139,"Richland County, OH",Nov-22,51190,49355,1835,3.60000000
CN3914100000000,39,141,"Ross County, OH",Nov-22,35056,33992,1064,3.00000000
CN3914300000000,39,143,"Sandusky County, OH",Nov-22,29746,28737,1009,3.40000000
CN3914500000000,39,145,"Scioto County, OH",Nov-22,29074,27844,1230,4.20000000
CN3914700000000,39,147,"Seneca County, OH",Nov-22,26138,25309,829,3.20000000
CN3914900000000,39,149,"Shelby County, OH",Nov-22,23305,22701,604,2.60000000
CN3915100000000,39,151,"Stark County, OH",Nov-22,179266,173504,5762,3.20000000
CN3915300000000,39,153,"Summit County, OH",Nov-22,259465,250965,8500,3.30000000
CN3915500000000,39,155,"Trumbull County, OH",Nov-22,81866,78579,3287,4.00000000
CN3915700000000,39,157,"Tuscarawas County, OH",Nov-22,44152,42837,1315,3.00000000
CN3915900000000,39,159,"Union County, OH",Nov-22,30227,29557,670,2.20000000
CN3916100000000,39,161,"Van Wert County, OH",Nov-22,14276,13945,331,2.30000000
CN3916300000000,39,163,"Vinton County, OH",Nov-22,5397,5179,218,4.00000000
CN3916500000000,39,165,"Warren County, OH",Nov-22,120273,117067,3206,2.70000000
CN3916700000000,39,167,"Washington County, OH",Nov-22,26662,25716,946,3.50000000
CN3916900000000,39,169,"Wayne County, OH",Nov-22,61232,59797,1435,2.30000000
CN3917100000000,39,171,"Williams County, OH",Nov-22,17897,17435,462,2.60000000
CN3917300000000,39,173,"Wood County, OH",Nov-22,71014,69152,1862,2.60000000
CN3917500000000,39,175,"Wyandot County, OH",Nov-22,13343,13070,273,2.00000000
CN4000100000000,40,001,"Adair County, OK",Nov-22,8550,8262,288,3.40000000
CN4000300000000,40,003,"Alfalfa County, OK",Nov-22,2665,2608,57,2.10000000
CN4000500000000,40,005,"Atoka County, OK",Nov-22,5101,4902,199,3.90000000
CN4000700000000,40,007,"Beaver County, OK",Nov-22,2622,2573,49,1.90000000
CN4000900000000,40,009,"Beckham County, OK",Nov-22,10484,10220,264,2.50000000
CN4001100000000,40,011,"Blaine County, OK",Nov-22,4337,4249,88,2.00000000
CN4001300000000,40,013,"Bryan County, OK",Nov-22,23485,22871,614,2.60000000
CN4001500000000,40,015,"Caddo County, OK",Nov-22,11870,11484,386,3.30000000
CN4001700000000,40,017,"Canadian County, OK",Nov-22,80606,78609,1997,2.50000000
CN4001900000000,40,019,"Carter County, OK",Nov-22,21474,20752,722,3.40000000
CN4002100000000,40,021,"Cherokee County, OK",Nov-22,20020,19368,652,3.30000000
CN4002300000000,40,023,"Choctaw County, OK",Nov-22,5919,5640,279,4.70000000
CN4002500000000,40,025,"Cimarron County, OK",Nov-22,1588,1566,22,1.40000000
CN4002700000000,40,027,"Cleveland County, OK",Nov-22,148609,144871,3738,2.50000000
CN4002900000000,40,029,"Coal County, OK",Nov-22,2326,2260,66,2.80000000
CN4003100000000,40,031,"Comanche County, OK",Nov-22,47927,46234,1693,3.50000000
CN4003300000000,40,033,"Cotton County, OK",Nov-22,2680,2595,85,3.20000000
CN4003500000000,40,035,"Craig County, OK",Nov-22,5758,5576,182,3.20000000
CN4003700000000,40,037,"Creek County, OK",Nov-22,32009,30925,1084,3.40000000
CN4003900000000,40,039,"Custer County, OK",Nov-22,14814,14450,364,2.50000000
CN4004100000000,40,041,"Delaware County, OK",Nov-22,19585,19004,581,3.00000000
CN4004300000000,40,043,"Dewey County, OK",Nov-22,3069,3010,59,1.90000000
CN4004500000000,40,045,"Ellis County, OK",Nov-22,1989,1938,51,2.60000000
CN4004700000000,40,047,"Garfield County, OK",Nov-22,26749,26003,746,2.80000000
CN4004900000000,40,049,"Garvin County, OK",Nov-22,12904,12543,361,2.80000000
CN4005100000000,40,051,"Grady County, OK",Nov-22,27293,26530,763,2.80000000
CN4005300000000,40,053,"Grant County, OK",Nov-22,2737,2685,52,1.90000000
CN4005500000000,40,055,"Greer County, OK",Nov-22,1763,1701,62,3.50000000
CN4005700000000,40,057,"Harmon County, OK",Nov-22,1148,1116,32,2.80000000
CN4005900000000,40,059,"Harper County, OK",Nov-22,1754,1722,32,1.80000000
CN4006100000000,40,061,"Haskell County, OK",Nov-22,4189,4013,176,4.20000000
CN4006300000000,40,063,"Hughes County, OK",Nov-22,5127,4933,194,3.80000000
CN4006500000000,40,065,"Jackson County, OK",Nov-22,10687,10402,285,2.70000000
CN4006700000000,40,067,"Jefferson County, OK",Nov-22,2458,2389,69,2.80000000
CN4006900000000,40,069,"Johnston County, OK",Nov-22,3690,3547,143,3.90000000
CN4007100000000,40,071,"Kay County, OK",Nov-22,18229,17595,634,3.50000000
CN4007300000000,40,073,"Kingfisher County, OK",Nov-22,8874,8709,165,1.90000000
CN4007500000000,40,075,"Kiowa County, OK",Nov-22,3581,3472,109,3.00000000
CN4007700000000,40,077,"Latimer County, OK",Nov-22,3115,2922,193,6.20000000
CN4007900000000,40,079,"Le Flore County, OK",Nov-22,19494,18777,717,3.70000000
CN4008100000000,40,081,"Lincoln County, OK",Nov-22,16135,15628,507,3.10000000
CN4008300000000,40,083,"Logan County, OK",Nov-22,23325,22722,603,2.60000000
CN4008500000000,40,085,"Love County, OK",Nov-22,5742,5609,133,2.30000000
CN4008700000000,40,087,"McClain County, OK",Nov-22,20833,20272,561,2.70000000
CN4008900000000,40,089,"McCurtain County, OK",Nov-22,15686,15103,583,3.70000000
CN4009100000000,40,091,"McIntosh County, OK",Nov-22,7215,6845,370,5.10000000
CN4009300000000,40,093,"Major County, OK",Nov-22,3754,3658,96,2.60000000
CN4009500000000,40,095,"Marshall County, OK",Nov-22,7409,7182,227,3.10000000
CN4009700000000,40,097,"Mayes County, OK",Nov-22,19833,19221,612,3.10000000
CN4009900000000,40,099,"Murray County, OK",Nov-22,6080,5895,185,3.00000000
CN4010100000000,40,101,"Muskogee County, OK",Nov-22,28652,27677,975,3.40000000
CN4010300000000,40,103,"Noble County, OK",Nov-22,5828,5708,120,2.10000000
CN4010500000000,40,105,"Nowata County, OK",Nov-22,4660,4535,125,2.70000000
CN4010700000000,40,107,"Okfuskee County, OK",Nov-22,4415,4233,182,4.10000000
CN4010900000000,40,109,"Oklahoma County, OK",Nov-22,398676,386870,11806,3.00000000
CN4011100000000,40,111,"Okmulgee County, OK",Nov-22,15888,15223,665,4.20000000
CN4011300000000,40,113,"Osage County, OK",Nov-22,20921,20218,703,3.40000000
CN4011500000000,40,115,"Ottawa County, OK",Nov-22,15226,14816,410,2.70000000
CN4011700000000,40,117,"Pawnee County, OK",Nov-22,7465,7201,264,3.50000000
CN4011900000000,40,119,"Payne County, OK",Nov-22,39406,38370,1036,2.60000000
CN4012100000000,40,121,"Pittsburg County, OK",Nov-22,16387,15668,719,4.40000000
CN4012300000000,40,123,"Pontotoc County, OK",Nov-22,19663,19166,497,2.50000000
CN4012500000000,40,125,"Pottawatomie County, OK",Nov-22,33303,32163,1140,3.40000000
CN4012700000000,40,127,"Pushmataha County, OK",Nov-22,4480,4296,184,4.10000000
CN4012900000000,40,129,"Roger Mills County, OK",Nov-22,1800,1758,42,2.30000000
CN4013100000000,40,131,"Rogers County, OK",Nov-22,46557,45272,1285,2.80000000
CN4013300000000,40,133,"Seminole County, OK",Nov-22,9004,8617,387,4.30000000
CN4013500000000,40,135,"Sequoyah County, OK",Nov-22,16710,16149,561,3.40000000
CN4013700000000,40,137,"Stephens County, OK",Nov-22,19080,18431,649,3.40000000
CN4013900000000,40,139,"Texas County, OK",Nov-22,11826,11642,184,1.60000000
CN4014100000000,40,141,"Tillman County, OK",Nov-22,2838,2725,113,4.00000000
CN4014300000000,40,143,"Tulsa County, OK",Nov-22,332832,323013,9819,3.00000000
CN4014500000000,40,145,"Wagoner County, OK",Nov-22,39986,38800,1186,3.00000000
CN4014700000000,40,147,"Washington County, OK",Nov-22,21973,21262,711,3.20000000
CN4014900000000,40,149,"Washita County, OK",Nov-22,5202,5054,148,2.80000000
CN4015100000000,40,151,"Woods County, OK",Nov-22,4779,4700,79,1.70000000
CN4015300000000,40,153,"Woodward County, OK",Nov-22,8296,8035,261,3.10000000
CN4100100000000,41,001,"Baker County, OR",Nov-22,7470,7108,362,4.80000000
CN4100300000000,41,003,"Benton County, OR",Nov-22,49072,47473,1599,3.30000000
CN4100500000000,41,005,"Clackamas County, OR",Nov-22,230075,221522,8553,3.70000000
CN4100700000000,41,007,"Clatsop County, OR",Nov-22,19162,18267,895,4.70000000
CN4100900000000,41,009,"Columbia County, OR",Nov-22,25553,24282,1271,5.00000000
CN4101100000000,41,011,"Coos County, OR",Nov-22,26328,24802,1526,5.80000000
CN4101300000000,41,013,"Crook County, OR",Nov-22,11165,10507,658,5.90000000
CN4101500000000,41,015,"Curry County, OR",Nov-22,8856,8314,542,6.10000000
CN4101700000000,41,017,"Deschutes County, OR",Nov-22,103515,99048,4467,4.30000000
CN4101900000000,41,019,"Douglas County, OR",Nov-22,47253,44530,2723,5.80000000
CN4102100000000,41,021,"Gilliam County, OR",Nov-22,855,823,32,3.70000000
CN4102300000000,41,023,"Grant County, OR",Nov-22,3105,2913,192,6.20000000
CN4102500000000,41,025,"Harney County, OR",Nov-22,3723,3521,202,5.40000000
CN4102700000000,41,027,"Hood River County, OR",Nov-22,13743,13267,476,3.50000000
CN4102900000000,41,029,"Jackson County, OR",Nov-22,107461,102303,5158,4.80000000
CN4103100000000,41,031,"Jefferson County, OR",Nov-22,10356,9750,606,5.90000000
CN4103300000000,41,033,"Josephine County, OR",Nov-22,37228,34986,2242,6.00000000
CN4103500000000,41,035,"Klamath County, OR",Nov-22,30162,28084,2078,6.90000000
CN4103700000000,41,037,"Lake County, OR",Nov-22,3590,3376,214,6.00000000
CN4103900000000,41,039,"Lane County, OR",Nov-22,184519,175662,8857,4.80000000
CN4104100000000,41,041,"Lincoln County, OR",Nov-22,20386,19174,1212,5.90000000
CN4104300000000,41,043,"Linn County, OR",Nov-22,61268,58304,2964,4.80000000
CN4104500000000,41,045,"Malheur County, OR",Nov-22,12386,11866,520,4.20000000
CN4104700000000,41,047,"Marion County, OR",Nov-22,167787,160496,7291,4.30000000
CN4104900000000,41,049,"Morrow County, OR",Nov-22,5876,5642,234,4.00000000
CN4105100000000,41,051,"Multnomah County, OR",Nov-22,476019,456389,19630,4.10000000
CN4105300000000,41,053,"Polk County, OR",Nov-22,42462,40686,1776,4.20000000
CN4105500000000,41,055,"Sherman County, OR",Nov-22,924,894,30,3.20000000
CN4105700000000,41,057,"Tillamook County, OR",Nov-22,12151,11599,552,4.50000000
CN4105900000000,41,059,"Umatilla County, OR",Nov-22,37142,35474,1668,4.50000000
CN4106100000000,41,061,"Union County, OR",Nov-22,12102,11510,592,4.90000000
CN4106300000000,41,063,"Wallowa County, OR",Nov-22,3525,3316,209,5.90000000
CN4106500000000,41,065,"Wasco County, OR",Nov-22,12900,12254,646,5.00000000
CN4106700000000,41,067,"Washington County, OR",Nov-22,339689,328216,11473,3.40000000
CN4106900000000,41,069,"Wheeler County, OR",Nov-22,732,710,22,3.00000000
CN4107100000000,41,071,"Yamhill County, OR",Nov-22,56710,54623,2087,3.70000000
CN4200100000000,42,001,"Adams County, PA",Nov-22,55131,53886,1245,2.30000000
CN4200300000000,42,003,"Allegheny County, PA",Nov-22,629785,608818,20967,3.30000000
CN4200500000000,42,005,"Armstrong County, PA",Nov-22,30975,29727,1248,4.00000000
CN4200700000000,42,007,"Beaver County, PA",Nov-22,81726,78020,3706,4.50000000
CN4200900000000,42,009,"Bedford County, PA",Nov-22,23504,22662,842,3.60000000
CN4201100000000,42,011,"Berks County, PA",Nov-22,210070,202840,7230,3.40000000
CN4201300000000,42,013,"Blair County, PA",Nov-22,59190,57243,1947,3.30000000
CN4201500000000,42,015,"Bradford County, PA",Nov-22,27379,26537,842,3.10000000
CN4201700000000,42,017,"Bucks County, PA",Nov-22,344690,334489,10201,3.00000000
CN4201900000000,42,019,"Butler County, PA",Nov-22,98166,95225,2941,3.00000000
CN4202100000000,42,021,"Cambria County, PA",Nov-22,55146,52931,2215,4.00000000
CN4202300000000,42,023,"Cameron County, PA",Nov-22,1914,1821,93,4.90000000
CN4202500000000,42,025,"Carbon County, PA",Nov-22,32730,31405,1325,4.00000000
CN4202700000000,42,027,"Centre County, PA",Nov-22,77978,76000,1978,2.50000000
CN4202900000000,42,029,"Chester County, PA",Nov-22,290731,284021,6710,2.30000000
CN4203100000000,42,031,"Clarion County, PA",Nov-22,16519,15917,602,3.60000000
CN4203300000000,42,033,"Clearfield County, PA",Nov-22,34610,33146,1464,4.20000000
CN4203500000000,42,035,"Clinton County, PA",Nov-22,17143,16463,680,4.00000000
CN4203700000000,42,037,"Columbia County, PA",Nov-22,33131,31909,1222,3.70000000
CN4203900000000,42,039,"Crawford County, PA",Nov-22,37182,35778,1404,3.80000000
CN4204100000000,42,041,"Cumberland County, PA",Nov-22,136093,132843,3250,2.40000000
CN4204300000000,42,043,"Dauphin County, PA",Nov-22,147496,142872,4624,3.10000000
CN4204500000000,42,045,"Delaware County, PA",Nov-22,297770,287634,10136,3.40000000
CN4204700000000,42,047,"Elk County, PA",Nov-22,14203,13688,515,3.60000000
CN4204900000000,42,049,"Erie County, PA",Nov-22,126346,121266,5080,4.00000000
CN4205100000000,42,051,"Fayette County, PA",Nov-22,54757,52091,2666,4.90000000
CN4205300000000,42,053,"Forest County, PA",Nov-22,1673,1583,90,5.40000000
CN4205500000000,42,055,"Franklin County, PA",Nov-22,76930,74808,2122,2.80000000
CN4205700000000,42,057,"Fulton County, PA",Nov-22,6991,6784,207,3.00000000
CN4205900000000,42,059,"Greene County, PA",Nov-22,15289,14673,616,4.00000000
CN4206100000000,42,061,"Huntingdon County, PA",Nov-22,18980,18138,842,4.40000000
CN4206300000000,42,063,"Indiana County, PA",Nov-22,36083,34674,1409,3.90000000
CN4206500000000,42,065,"Jefferson County, PA",Nov-22,19166,18455,711,3.70000000
CN4206700000000,42,067,"Juniata County, PA",Nov-22,12460,12104,356,2.90000000
CN4206900000000,42,069,"Lackawanna County, PA",Nov-22,103523,99599,3924,3.80000000
CN4207100000000,42,071,"Lancaster County, PA",Nov-22,283758,276680,7078,2.50000000
CN4207300000000,42,073,"Lawrence County, PA",Nov-22,38666,37012,1654,4.30000000
CN4207500000000,42,075,"Lebanon County, PA",Nov-22,74199,72269,1930,2.60000000
CN4207700000000,42,077,"Lehigh County, PA",Nov-22,198673,191617,7056,3.60000000
CN4207900000000,42,079,"Luzerne County, PA",Nov-22,156031,149000,7031,4.50000000
CN4208100000000,42,081,"Lycoming County, PA",Nov-22,54412,52402,2010,3.70000000
CN4208300000000,42,083,"McKean County, PA",Nov-22,16311,15579,732,4.50000000
CN4208500000000,42,085,"Mercer County, PA",Nov-22,46718,44861,1857,4.00000000
CN4208700000000,42,087,"Mifflin County, PA",Nov-22,20446,19698,748,3.70000000
CN4208900000000,42,089,"Monroe County, PA",Nov-22,81799,77788,4011,4.90000000
CN4209100000000,42,091,"Montgomery County, PA",Nov-22,458477,446529,11948,2.60000000
CN4209300000000,42,093,"Montour County, PA",Nov-22,9002,8775,227,2.50000000
CN4209500000000,42,095,"Northampton County, PA",Nov-22,165264,159882,5382,3.30000000
CN4209700000000,42,097,"Northumberland County, PA",Nov-22,40628,38914,1714,4.20000000
CN4209900000000,42,099,"Perry County, PA",Nov-22,24900,24264,636,2.60000000
CN4210100000000,42,101,"Philadelphia County/city, PA",Nov-22,724429,689655,34774,4.80000000
CN4210300000000,42,103,"Pike County, PA",Nov-22,25440,24218,1222,4.80000000
CN4210500000000,42,105,"Potter County, PA",Nov-22,7004,6707,297,4.20000000
CN4210700000000,42,107,"Schuylkill County, PA",Nov-22,63640,61048,2592,4.10000000
CN4210900000000,42,109,"Snyder County, PA",Nov-22,19492,18924,568,2.90000000
CN4211100000000,42,111,"Somerset County, PA",Nov-22,31582,30257,1325,4.20000000
CN4211300000000,42,113,"Sullivan County, PA",Nov-22,2447,2363,84,3.40000000
CN4211500000000,42,115,"Susquehanna County, PA",Nov-22,20017,19395,622,3.10000000
CN4211700000000,42,117,"Tioga County, PA",Nov-22,18685,17969,716,3.80000000
CN4211900000000,42,119,"Union County, PA",Nov-22,19379,18853,526,2.70000000
CN4212100000000,42,121,"Venango County, PA",Nov-22,20519,19678,841,4.10000000
CN4212300000000,42,123,"Warren County, PA",Nov-22,17047,16412,635,3.70000000
CN4212500000000,42,125,"Washington County, PA",Nov-22,104214,100552,3662,3.50000000
CN4212700000000,42,127,"Wayne County, PA",Nov-22,21761,20897,864,4.00000000
CN4212900000000,42,129,"Westmoreland County, PA",Nov-22,174719,168718,6001,3.40000000
CN4213100000000,42,131,"Wyoming County, PA",Nov-22,13294,12815,479,3.60000000
CN4213300000000,42,133,"York County, PA",Nov-22,236691,230068,6623,2.80000000
CN4400100000000,44,001,"Bristol County, RI",Nov-22,26712,25983,729,2.70000000
CN4400300000000,44,003,"Kent County, RI",Nov-22,94300,91448,2852,3.00000000
CN4400500000000,44,005,"Newport County, RI",Nov-22,45448,44089,1359,3.00000000
CN4400700000000,44,007,"Providence County, RI",Nov-22,337282,324625,12657,3.80000000
CN4400900000000,44,009,"Washington County, RI",Nov-22,70430,68362,2068,2.90000000
CN4500100000000,45,001,"Abbeville County, SC",Nov-22,9488,9188,300,3.20000000
CN4500300000000,45,003,"Aiken County, SC",Nov-22,72535,70642,1893,2.60000000
CN4500500000000,45,005,"Allendale County, SC",Nov-22,2151,2038,113,5.30000000
CN4500700000000,45,007,"Anderson County, SC",Nov-22,91025,88819,2206,2.40000000
CN4500900000000,45,009,"Bamberg County, SC",Nov-22,4474,4250,224,5.00000000
CN4501100000000,45,011,"Barnwell County, SC",Nov-22,7330,7033,297,4.10000000
CN4501300000000,45,013,"Beaufort County, SC",Nov-22,74534,72645,1889,2.50000000
CN4501500000000,45,015,"Berkeley County, SC",Nov-22,111080,108418,2662,2.40000000
CN4501700000000,45,017,"Calhoun County, SC",Nov-22,6216,6040,176,2.80000000
CN4501900000000,45,019,"Charleston County, SC",Nov-22,218183,213498,4685,2.10000000
CN4502100000000,45,021,"Cherokee County, SC",Nov-22,24328,23371,957,3.90000000
CN4502300000000,45,023,"Chester County, SC",Nov-22,13354,12846,508,3.80000000
CN4502500000000,45,025,"Chesterfield County, SC",Nov-22,20811,20172,639,3.10000000
CN4502700000000,45,027,"Clarendon County, SC",Nov-22,11530,11100,430,3.70000000
CN4502900000000,45,029,"Colleton County, SC",Nov-22,15617,15177,440,2.80000000
CN4503100000000,45,031,"Darlington County, SC",Nov-22,28501,27623,878,3.10000000
CN4503300000000,45,033,"Dillon County, SC",Nov-22,12675,12120,555,4.40000000
CN4503500000000,45,035,"Dorchester County, SC",Nov-22,80549,78719,1830,2.30000000
CN4503700000000,45,037,"Edgefield County, SC",Nov-22,10150,9854,296,2.90000000
CN4503900000000,45,039,"Fairfield County, SC",Nov-22,8941,8589,352,3.90000000
CN4504100000000,45,041,"Florence County, SC",Nov-22,63479,61713,1766,2.80000000
CN4504300000000,45,043,"Georgetown County, SC",Nov-22,25247,24479,768,3.00000000
CN4504500000000,45,045,"Greenville County, SC",Nov-22,259012,253052,5960,2.30000000
CN4504700000000,45,047,"Greenwood County, SC",Nov-22,29776,28846,930,3.10000000
CN4504900000000,45,049,"Hampton County, SC",Nov-22,7644,7459,185,2.40000000
CN4505100000000,45,051,"Horry County, SC",Nov-22,146536,141644,4892,3.30000000
CN4505300000000,45,053,"Jasper County, SC",Nov-22,12886,12582,304,2.40000000
CN4505500000000,45,055,"Kershaw County, SC",Nov-22,28563,27766,797,2.80000000
CN4505700000000,45,057,"Lancaster County, SC",Nov-22,43626,42302,1324,3.00000000
CN4505900000000,45,059,"Laurens County, SC",Nov-22,29900,29081,819,2.70000000
CN4506100000000,45,061,"Lee County, SC",Nov-22,6203,5930,273,4.40000000
CN4506300000000,45,063,"Lexington County, SC",Nov-22,147360,144055,3305,2.20000000
CN4506500000000,45,065,"McCormick County, SC",Nov-22,3397,3301,96,2.80000000
CN4506700000000,45,067,"Marion County, SC",Nov-22,12307,11748,559,4.50000000
CN4506900000000,45,069,"Marlboro County, SC",Nov-22,8337,7742,595,7.10000000
CN4507100000000,45,071,"Newberry County, SC",Nov-22,18527,18095,432,2.30000000
CN4507300000000,45,073,"Oconee County, SC",Nov-22,33516,32718,798,2.40000000
CN4507500000000,45,075,"Orangeburg County, SC",Nov-22,32360,30901,1459,4.50000000
CN4507700000000,45,077,"Pickens County, SC",Nov-22,57825,56284,1541,2.70000000
CN4507900000000,45,079,"Richland County, SC",Nov-22,192295,186897,5398,2.80000000
CN4508100000000,45,081,"Saluda County, SC",Nov-22,8072,7878,194,2.40000000
CN4508300000000,45,083,"Spartanburg County, SC",Nov-22,155349,151364,3985,2.60000000
CN4508500000000,45,085,"Sumter County, SC",Nov-22,40373,38960,1413,3.50000000
CN4508700000000,45,087,"Union County, SC",Nov-22,11305,10818,487,4.30000000
CN4508900000000,45,089,"Williamsburg County, SC",Nov-22,10500,10047,453,4.30000000
CN4509100000000,45,091,"York County, SC",Nov-22,148533,144676,3857,2.60000000
CN4600300000000,46,003,"Aurora County, SD",Nov-22,1461,1432,29,2.00000000
CN4600500000000,46,005,"Beadle County, SD",Nov-22,9181,9025,156,1.70000000
CN4600700000000,46,007,"Bennett County, SD",Nov-22,1072,1041,31,2.90000000
CN4600900000000,46,009,"Bon Homme County, SD",Nov-22,2790,2733,57,2.00000000
CN4601100000000,46,011,"Brookings County, SD",Nov-22,19442,19072,370,1.90000000
CN4601300000000,46,013,"Brown County, SD",Nov-22,20047,19610,437,2.20000000
CN4601500000000,46,015,"Brule County, SD",Nov-22,2628,2587,41,1.60000000
CN4601700000000,46,017,"Buffalo County, SD",Nov-22,718,675,43,6.00000000
CN4601900000000,46,019,"Butte County, SD",Nov-22,4986,4887,99,2.00000000
CN4602100000000,46,021,"Campbell County, SD",Nov-22,772,749,23,3.00000000
CN4602300000000,46,023,"Charles Mix County, SD",Nov-22,3766,3682,84,2.20000000
CN4602500000000,46,025,"Clark County, SD",Nov-22,1890,1855,35,1.90000000
CN4602700000000,46,027,"Clay County, SD",Nov-22,7754,7594,160,2.10000000
CN4602900000000,46,029,"Codington County, SD",Nov-22,15907,15609,298,1.90000000
CN4603100000000,46,031,"Corson County, SD",Nov-22,1260,1223,37,2.90000000
CN4603300000000,46,033,"Custer County, SD",Nov-22,4231,4093,138,3.30000000
CN4603500000000,46,035,"Davison County, SD",Nov-22,11025,10840,185,1.70000000
CN4603700000000,46,037,"Day County, SD",Nov-22,2603,2543,60,2.30000000
CN4603900000000,46,039,"Deuel County, SD",Nov-22,2259,2195,64,2.80000000
CN4604100000000,46,041,"Dewey County, SD",Nov-22,2308,2174,134,5.80000000
CN4604300000000,46,043,"Douglas County, SD",Nov-22,1487,1462,25,1.70000000
CN4604500000000,46,045,"Edmunds County, SD",Nov-22,1977,1944,33,1.70000000
CN4604700000000,46,047,"Fall River County, SD",Nov-22,3097,3021,76,2.50000000
CN4604900000000,46,049,"Faulk County, SD",Nov-22,1069,1046,23,2.20000000
CN4605100000000,46,051,"Grant County, SD",Nov-22,4382,4287,95,2.20000000
CN4605300000000,46,053,"Gregory County, SD",Nov-22,2218,2177,41,1.80000000
CN4605500000000,46,055,"Haakon County, SD",Nov-22,1068,1050,18,1.70000000
CN4605700000000,46,057,"Hamlin County, SD",Nov-22,3562,3502,60,1.70000000
CN4605900000000,46,059,"Hand County, SD",Nov-22,1795,1766,29,1.60000000
CN4606100000000,46,061,"Hanson County, SD",Nov-22,1760,1723,37,2.10000000
CN4606300000000,46,063,"Harding County, SD",Nov-22,732,716,16,2.20000000
CN4606500000000,46,065,"Hughes County, SD",Nov-22,9846,9696,150,1.50000000
CN4606700000000,46,067,"Hutchinson County, SD",Nov-22,3566,3498,68,1.90000000
CN4606900000000,46,069,"Hyde County, SD",Nov-22,650,634,16,2.50000000
CN4607100000000,46,071,"Jackson County, SD",Nov-22,1154,1113,41,3.60000000
CN4607300000000,46,073,"Jerauld County, SD",Nov-22,1317,1299,18,1.40000000
CN4607500000000,46,075,"Jones County, SD",Nov-22,521,507,14,2.70000000
CN4607700000000,46,077,"Kingsbury County, SD",Nov-22,2867,2816,51,1.80000000
CN4607900000000,46,079,"Lake County, SD",Nov-22,6763,6636,127,1.90000000
CN4608100000000,46,081,"Lawrence County, SD",Nov-22,14037,13752,285,2.00000000
CN4608300000000,46,083,"Lincoln County, SD",Nov-22,38035,37454,581,1.50000000
CN4608500000000,46,085,"Lyman County, SD",Nov-22,1696,1645,51,3.00000000
CN4608700000000,46,087,"McCook County, SD",Nov-22,3135,3088,47,1.50000000
CN4608900000000,46,089,"McPherson County, SD",Nov-22,956,931,25,2.60000000
CN4609100000000,46,091,"Marshall County, SD",Nov-22,2450,2386,64,2.60000000
CN4609300000000,46,093,"Meade County, SD",Nov-22,14508,14200,308,2.10000000
CN4609500000000,46,095,"Mellette County, SD",Nov-22,739,718,21,2.80000000
CN4609700000000,46,097,"Miner County, SD",Nov-22,1210,1191,19,1.60000000
CN4609900000000,46,099,"Minnehaha County, SD",Nov-22,118199,116114,2085,1.80000000
CN4610100000000,46,101,"Moody County, SD",Nov-22,3979,3901,78,2.00000000
CN4610200000000,46,102,"Oglala Lakota County, SD",Nov-22,3871,3643,228,5.90000000
CN4610300000000,46,103,"Pennington County, SD",Nov-22,59761,58500,1261,2.10000000
CN4610500000000,46,105,"Perkins County, SD",Nov-22,1411,1380,31,2.20000000
CN4610700000000,46,107,"Potter County, SD",Nov-22,1027,1002,25,2.40000000
CN4610900000000,46,109,"Roberts County, SD",Nov-22,4651,4524,127,2.70000000
CN4611100000000,46,111,"Sanborn County, SD",Nov-22,1196,1171,25,2.10000000
CN4611500000000,46,115,"Spink County, SD",Nov-22,2961,2899,62,2.10000000
CN4611700000000,46,117,"Stanley County, SD",Nov-22,1906,1875,31,1.60000000
CN4611900000000,46,119,"Sully County, SD",Nov-22,804,788,16,2.00000000
CN4612100000000,46,121,"Todd County, SD",Nov-22,3013,2914,99,3.30000000
CN4612300000000,46,123,"Tripp County, SD",Nov-22,3094,3043,51,1.60000000
CN4612500000000,46,125,"Turner County, SD",Nov-22,4818,4723,95,2.00000000
CN4612700000000,46,127,"Union County, SD",Nov-22,8646,8449,197,2.30000000
CN4612900000000,46,129,"Walworth County, SD",Nov-22,2099,2023,76,3.60000000
CN4613500000000,46,135,"Yankton County, SD",Nov-22,11621,11420,201,1.70000000
CN4613700000000,46,137,"Ziebach County, SD",Nov-22,952,915,37,3.90000000
CN4700100000000,47,001,"Anderson County, TN",Nov-22,35063,33962,1101,3.10000000
CN4700300000000,47,003,"Bedford County, TN",Nov-22,20711,19992,719,3.50000000
CN4700500000000,47,005,"Benton County, TN",Nov-22,6483,6225,258,4.00000000
CN4700700000000,47,007,"Bledsoe County, TN",Nov-22,4217,3991,226,5.40000000
CN4700900000000,47,009,"Blount County, TN",Nov-22,65139,63255,1884,2.90000000
CN4701100000000,47,011,"Bradley County, TN",Nov-22,49388,47650,1738,3.50000000
CN4701300000000,47,013,"Campbell County, TN",Nov-22,14872,14285,587,3.90000000
CN4701500000000,47,015,"Cannon County, TN",Nov-22,6795,6603,192,2.80000000
CN4701700000000,47,017,"Carroll County, TN",Nov-22,11012,10579,433,3.90000000
CN4701900000000,47,019,"Carter County, TN",Nov-22,23754,22921,833,3.50000000
CN4702100000000,47,021,"Cheatham County, TN",Nov-22,22331,21775,556,2.50000000
CN4702300000000,47,023,"Chester County, TN",Nov-22,8311,8054,257,3.10000000
CN4702500000000,47,025,"Claiborne County, TN",Nov-22,12579,12119,460,3.70000000
CN4702700000000,47,027,"Clay County, TN",Nov-22,2660,2544,116,4.40000000
CN4702900000000,47,029,"Cocke County, TN",Nov-22,13859,13245,614,4.40000000
CN4703100000000,47,031,"Coffee County, TN",Nov-22,24375,23566,809,3.30000000
CN4703300000000,47,033,"Crockett County, TN",Nov-22,6674,6470,204,3.10000000
CN4703500000000,47,035,"Cumberland County, TN",Nov-22,21540,20607,933,4.30000000
CN4703700000000,47,037,"Davidson County, TN",Nov-22,408257,397432,10825,2.70000000
CN4703900000000,47,039,"Decatur County, TN",Nov-22,4052,3854,198,4.90000000
CN4704100000000,47,041,"DeKalb County, TN",Nov-22,7619,7332,287,3.80000000
CN4704300000000,47,043,"Dickson County, TN",Nov-22,27659,26854,805,2.90000000
CN4704500000000,47,045,"Dyer County, TN",Nov-22,15435,14863,572,3.70000000
CN4704700000000,47,047,"Fayette County, TN",Nov-22,19131,18490,641,3.40000000
CN4704900000000,47,049,"Fentress County, TN",Nov-22,7328,7049,279,3.80000000
CN4705100000000,47,051,"Franklin County, TN",Nov-22,18985,18343,642,3.40000000
CN4705300000000,47,053,"Gibson County, TN",Nov-22,20574,19855,719,3.50000000
CN4705500000000,47,055,"Giles County, TN",Nov-22,14247,13795,452,3.20000000
CN4705700000000,47,057,"Grainger County, TN",Nov-22,9662,9319,343,3.50000000
CN4705900000000,47,059,"Greene County, TN",Nov-22,27454,26309,1145,4.20000000
CN4706100000000,47,061,"Grundy County, TN",Nov-22,4955,4745,210,4.20000000
CN4706300000000,47,063,"Hamblen County, TN",Nov-22,27635,26710,925,3.30000000
CN4706500000000,47,065,"Hamilton County, TN",Nov-22,179058,173339,5719,3.20000000
CN4706700000000,47,067,"Hancock County, TN",Nov-22,2221,2134,87,3.90000000
CN4706900000000,47,069,"Hardeman County, TN",Nov-22,8515,8156,359,4.20000000
CN4707100000000,47,071,"Hardin County, TN",Nov-22,9522,9133,389,4.10000000
CN4707300000000,47,073,"Hawkins County, TN",Nov-22,22626,21781,845,3.70000000
CN4707500000000,47,075,"Haywood County, TN",Nov-22,7349,7006,343,4.70000000
CN4707700000000,47,077,"Henderson County, TN",Nov-22,11425,11014,411,3.60000000
CN4707900000000,47,079,"Henry County, TN",Nov-22,13700,13220,480,3.50000000
CN4708100000000,47,081,"Hickman County, TN",Nov-22,11623,11293,330,2.80000000
CN4708300000000,47,083,"Houston County, TN",Nov-22,3137,2998,139,4.40000000
CN4708500000000,47,085,"Humphreys County, TN",Nov-22,8378,8099,279,3.30000000
CN4708700000000,47,087,"Jackson County, TN",Nov-22,4686,4506,180,3.80000000
CN4708900000000,47,089,"Jefferson County, TN",Nov-22,24561,23735,826,3.40000000
CN4709100000000,47,091,"Johnson County, TN",Nov-22,7457,7219,238,3.20000000
CN4709300000000,47,093,"Knox County, TN",Nov-22,249708,242825,6883,2.80000000
CN4709500000000,47,095,"Lake County, TN",Nov-22,1548,1473,75,4.80000000
CN4709700000000,47,097,"Lauderdale County, TN",Nov-22,9339,8898,441,4.70000000
CN4709900000000,47,099,"Lawrence County, TN",Nov-22,18793,18158,635,3.40000000
CN4710100000000,47,101,"Lewis County, TN",Nov-22,5577,5383,194,3.50000000
CN4710300000000,47,103,"Lincoln County, TN",Nov-22,15466,14965,501,3.20000000
CN4710500000000,47,105,"Loudon County, TN",Nov-22,24288,23536,752,3.10000000
CN4710700000000,47,107,"McMinn County, TN",Nov-22,20790,19945,845,4.10000000
CN4710900000000,47,109,"McNairy County, TN",Nov-22,7892,7506,386,4.90000000
CN4711100000000,47,111,"Macon County, TN",Nov-22,11581,11242,339,2.90000000
CN4711300000000,47,113,"Madison County, TN",Nov-22,47618,45993,1625,3.40000000
CN4711500000000,47,115,"Marion County, TN",Nov-22,11991,11560,431,3.60000000
CN4711700000000,47,117,"Marshall County, TN",Nov-22,15121,14630,491,3.20000000
CN4711900000000,47,119,"Maury County, TN",Nov-22,52399,50896,1503,2.90000000
CN4712100000000,47,121,"Meigs County, TN",Nov-22,4984,4777,207,4.20000000
CN4712300000000,47,123,"Monroe County, TN",Nov-22,20460,19744,716,3.50000000
CN4712500000000,47,125,"Montgomery County, TN",Nov-22,86276,83142,3134,3.60000000
CN4712700000000,47,127,"Moore County, TN",Nov-22,3587,3496,91,2.50000000
CN4712900000000,47,129,"Morgan County, TN",Nov-22,7824,7534,290,3.70000000
CN4713100000000,47,131,"Obion County, TN",Nov-22,11762,11310,452,3.80000000
CN4713300000000,47,133,"Overton County, TN",Nov-22,9740,9419,321,3.30000000
CN4713500000000,47,135,"Perry County, TN",Nov-22,2672,2539,133,5.00000000
CN4713700000000,47,137,"Pickett County, TN",Nov-22,2043,1958,85,4.20000000
CN4713900000000,47,139,"Polk County, TN",Nov-22,6931,6676,255,3.70000000
CN4714100000000,47,141,"Putnam County, TN",Nov-22,34695,33523,1172,3.40000000
CN4714300000000,47,143,"Rhea County, TN",Nov-22,13683,13105,578,4.20000000
CN4714500000000,47,145,"Roane County, TN",Nov-22,23648,22817,831,3.50000000
CN4714700000000,47,147,"Robertson County, TN",Nov-22,38881,37821,1060,2.70000000
CN4714900000000,47,149,"Rutherford County, TN",Nov-22,193593,188597,4996,2.60000000
CN4715100000000,47,151,"Scott County, TN",Nov-22,7815,7425,390,5.00000000
CN4715300000000,47,153,"Sequatchie County, TN",Nov-22,6019,5790,229,3.80000000
CN4715500000000,47,155,"Sevier County, TN",Nov-22,53879,52423,1456,2.70000000
CN4715700000000,47,157,"Shelby County, TN",Nov-22,435644,416250,19394,4.50000000
CN4715900000000,47,159,"Smith County, TN",Nov-22,9655,9385,270,2.80000000
CN4716100000000,47,161,"Stewart County, TN",Nov-22,5235,5036,199,3.80000000
CN4716300000000,47,163,"Sullivan County, TN",Nov-22,67177,64900,2277,3.40000000
CN4716500000000,47,165,"Sumner County, TN",Nov-22,107598,104762,2836,2.60000000
CN4716700000000,47,167,"Tipton County, TN",Nov-22,27455,26509,946,3.40000000
CN4716900000000,47,169,"Trousdale County, TN",Nov-22,5674,5508,166,2.90000000
CN4717100000000,47,171,"Unicoi County, TN",Nov-22,7012,6711,301,4.30000000
CN4717300000000,47,173,"Union County, TN",Nov-22,7790,7517,273,3.50000000
CN4717500000000,47,175,"Van Buren County, TN",Nov-22,1961,1876,85,4.30000000
CN4717700000000,47,177,"Warren County, TN",Nov-22,16064,15460,604,3.80000000
CN4717900000000,47,179,"Washington County, TN",Nov-22,60719,58766,1953,3.20000000
CN4718100000000,47,181,"Wayne County, TN",Nov-22,6187,5919,268,4.30000000
CN4718300000000,47,183,"Weakley County, TN",Nov-22,15326,14841,485,3.20000000
CN4718500000000,47,185,"White County, TN",Nov-22,11280,10856,424,3.80000000
CN4718700000000,47,187,"Williamson County, TN",Nov-22,136811,133454,3357,2.50000000
CN4718900000000,47,189,"Wilson County, TN",Nov-22,81177,79090,2087,2.60000000
CN4800100000000,48,001,"Anderson County, TX",Nov-22,23452,22732,720,3.10000000
CN4800300000000,48,003,"Andrews County, TX",Nov-22,8499,8220,279,3.30000000
CN4800500000000,48,005,"Angelina County, TX",Nov-22,35943,34401,1542,4.30000000
CN4800700000000,48,007,"Aransas County, TX",Nov-22,9253,8781,472,5.10000000
CN4800900000000,48,009,"Archer County, TX",Nov-22,3970,3856,114,2.90000000
CN4801100000000,48,011,"Armstrong County, TX",Nov-22,904,881,23,2.50000000
CN4801300000000,48,013,"Atascosa County, TX",Nov-22,22333,21481,852,3.80000000
CN4801500000000,48,015,"Austin County, TX",Nov-22,14124,13626,498,3.50000000
CN4801700000000,48,017,"Bailey County, TX",Nov-22,2178,2085,93,4.30000000
CN4801900000000,48,019,"Bandera County, TX",Nov-22,10545,10178,367,3.50000000
CN4802100000000,48,021,"Bastrop County, TX",Nov-22,47184,45720,1464,3.10000000
CN4802300000000,48,023,"Baylor County, TX",Nov-22,1794,1749,45,2.50000000
CN4802500000000,48,025,"Bee County, TX",Nov-22,8518,8001,517,6.10000000
CN4802700000000,48,027,"Bell County, TX",Nov-22,149228,143017,6211,4.20000000
CN4802900000000,48,029,"Bexar County, TX",Nov-22,978428,944268,34160,3.50000000
CN4803100000000,48,031,"Blanco County, TX",Nov-22,7119,6942,177,2.50000000
CN4803300000000,48,033,"Borden County, TX",Nov-22,721,710,11,1.50000000
CN4803500000000,48,035,"Bosque County, TX",Nov-22,8503,8223,280,3.30000000
CN4803700000000,48,037,"Bowie County, TX",Nov-22,39278,37653,1625,4.10000000
CN4803900000000,48,039,"Brazoria County, TX",Nov-22,186582,178484,8098,4.30000000
CN4804100000000,48,041,"Brazos County, TX",Nov-22,125793,122027,3766,3.00000000
CN4804300000000,48,043,"Brewster County, TX",Nov-22,4073,3947,126,3.10000000
CN4804500000000,48,045,"Briscoe County, TX",Nov-22,540,521,19,3.50000000
CN4804700000000,48,047,"Brooks County, TX",Nov-22,2416,2286,130,5.40000000
CN4804900000000,48,049,"Brown County, TX",Nov-22,15184,14487,697,4.60000000
CN4805100000000,48,051,"Burleson County, TX",Nov-22,8621,8319,302,3.50000000
CN4805300000000,48,053,"Burnet County, TX",Nov-22,24829,24122,707,2.80000000
CN4805500000000,48,055,"Caldwell County, TX",Nov-22,20865,20187,678,3.20000000
CN4805700000000,48,057,"Calhoun County, TX",Nov-22,12082,11692,390,3.20000000
CN4805900000000,48,059,"Callahan County, TX",Nov-22,6129,5925,204,3.30000000
CN4806100000000,48,061,"Cameron County, TX",Nov-22,174900,165013,9887,5.70000000
CN4806300000000,48,063,"Camp County, TX",Nov-22,5236,5014,222,4.20000000
CN4806500000000,48,065,"Carson County, TX",Nov-22,2916,2832,84,2.90000000
CN4806700000000,48,067,"Cass County, TX",Nov-22,12082,11546,536,4.40000000
CN4806900000000,48,069,"Castro County, TX",Nov-22,3143,3046,97,3.10000000
CN4807100000000,48,071,"Chambers County, TX",Nov-22,21262,20188,1074,5.10000000
CN4807300000000,48,073,"Cherokee County, TX",Nov-22,20105,19242,863,4.30000000
CN4807500000000,48,075,"Childress County, TX",Nov-22,2900,2817,83,2.90000000
CN4807700000000,48,077,"Clay County, TX",Nov-22,4798,4632,166,3.50000000
CN4807900000000,48,079,"Cochran County, TX",Nov-22,961,912,49,5.10000000
CN4808100000000,48,081,"Coke County, TX",Nov-22,1333,1290,43,3.20000000
CN4808300000000,48,083,"Coleman County, TX",Nov-22,2857,2727,130,4.60000000
CN4808500000000,48,085,"Collin County, TX",Nov-22,639469,620724,18745,2.90000000
CN4808700000000,48,087,"Collingsworth County, TX",Nov-22,1027,993,34,3.30000000
CN4808900000000,48,089,"Colorado County, TX",Nov-22,10025,9700,325,3.20000000
CN4809100000000,48,091,"Comal County, TX",Nov-22,82122,79487,2635,3.20000000
CN4809300000000,48,093,"Comanche County, TX",Nov-22,6175,5960,215,3.50000000
CN4809500000000,48,095,"Concho County, TX",Nov-22,1291,1254,37,2.90000000
CN4809700000000,48,097,"Cooke County, TX",Nov-22,19213,18611,602,3.10000000
CN4809900000000,48,099,"Coryell County, TX",Nov-22,24633,23602,1031,4.20000000
CN4810100000000,48,101,"Cottle County, TX",Nov-22,599,577,22,3.70000000
CN4810300000000,48,103,"Crane County, TX",Nov-22,1546,1468,78,5.00000000
CN4810500000000,48,105,"Crockett County, TX",Nov-22,1312,1263,49,3.70000000
CN4810700000000,48,107,"Crosby County, TX",Nov-22,2303,2210,93,4.00000000
CN4810900000000,48,109,"Culberson County, TX",Nov-22,1038,1008,30,2.90000000
CN4811100000000,48,111,"Dallam County, TX",Nov-22,3597,3508,89,2.50000000
CN4811300000000,48,113,"Dallas County, TX",Nov-22,1452957,1402468,50489,3.50000000
CN4811500000000,48,115,"Dawson County, TX",Nov-22,4324,4133,191,4.40000000
CN4811700000000,48,117,"Deaf Smith County, TX",Nov-22,8550,8307,243,2.80000000
CN4811900000000,48,119,"Delta County, TX",Nov-22,2438,2343,95,3.90000000
CN4812100000000,48,121,"Denton County, TX",Nov-22,563981,547345,16636,2.90000000
CN4812300000000,48,123,"DeWitt County, TX",Nov-22,9411,9135,276,2.90000000
CN4812500000000,48,125,"Dickens County, TX",Nov-22,697,667,30,4.30000000
CN4812700000000,48,127,"Dimmit County, TX",Nov-22,5583,5360,223,4.00000000
CN4812900000000,48,129,"Donley County, TX",Nov-22,1479,1428,51,3.40000000
CN4813100000000,48,131,"Duval County, TX",Nov-22,5373,5148,225,4.20000000
CN4813300000000,48,133,"Eastland County, TX",Nov-22,6928,6643,285,4.10000000
CN4813500000000,48,135,"Ector County, TX",Nov-22,81456,78185,3271,4.00000000
CN4813700000000,48,137,"Edwards County, TX",Nov-22,1241,1210,31,2.50000000
CN4813900000000,48,139,"Ellis County, TX",Nov-22,105450,102090,3360,3.20000000
CN4814100000000,48,141,"El Paso County, TX",Nov-22,363660,348278,15382,4.20000000
CN4814300000000,48,143,"Erath County, TX",Nov-22,20864,20151,713,3.40000000
CN4814500000000,48,145,"Falls County, TX",Nov-22,6653,6399,254,3.80000000
CN4814700000000,48,147,"Fannin County, TX",Nov-22,17548,16900,648,3.70000000
CN4814900000000,48,149,"Fayette County, TX",Nov-22,11390,11009,381,3.30000000
CN4815100000000,48,151,"Fisher County, TX",Nov-22,1539,1490,49,3.20000000
CN4815300000000,48,153,"Floyd County, TX",Nov-22,2350,2255,95,4.00000000
CN4815500000000,48,155,"Foard County, TX",Nov-22,600,584,16,2.70000000
CN4815700000000,48,157,"Fort Bend County, TX",Nov-22,423753,407759,15994,3.80000000
CN4815900000000,48,159,"Franklin County, TX",Nov-22,5120,4943,177,3.50000000
CN4816100000000,48,161,"Freestone County, TX",Nov-22,5975,5658,317,5.30000000
CN4816300000000,48,163,"Frio County, TX",Nov-22,9079,8799,280,3.10000000
CN4816500000000,48,165,"Gaines County, TX",Nov-22,9465,9182,283,3.00000000
CN4816700000000,48,167,"Galveston County, TX",Nov-22,170886,163704,7182,4.20000000
CN4816900000000,48,169,"Garza County, TX",Nov-22,1913,1840,73,3.80000000
CN4817100000000,48,171,"Gillespie County, TX",Nov-22,15032,14695,337,2.20000000
CN4817300000000,48,173,"Glasscock County, TX",Nov-22,756,736,20,2.60000000
CN4817500000000,48,175,"Goliad County, TX",Nov-22,3151,3012,139,4.40000000
CN4817700000000,48,177,"Gonzales County, TX",Nov-22,9341,9056,285,3.10000000
CN4817900000000,48,179,"Gray County, TX",Nov-22,7531,7197,334,4.40000000
CN4818100000000,48,181,"Grayson County, TX",Nov-22,67792,65542,2250,3.30000000
CN4818300000000,48,183,"Gregg County, TX",Nov-22,56702,54367,2335,4.10000000
CN4818500000000,48,185,"Grimes County, TX",Nov-22,11026,10524,502,4.60000000
CN4818700000000,48,187,"Guadalupe County, TX",Nov-22,85492,82800,2692,3.10000000
CN4818900000000,48,189,"Hale County, TX",Nov-22,11734,11175,559,4.80000000
CN4819100000000,48,191,"Hall County, TX",Nov-22,1036,993,43,4.20000000
CN4819300000000,48,193,"Hamilton County, TX",Nov-22,3674,3551,123,3.30000000
CN4819500000000,48,195,"Hansford County, TX",Nov-22,2459,2394,65,2.60000000
CN4819700000000,48,197,"Hardeman County, TX",Nov-22,1646,1592,54,3.30000000
CN4819900000000,48,199,"Hardin County, TX",Nov-22,24892,23649,1243,5.00000000
CN4820100000000,48,201,"Harris County, TX",Nov-22,2366993,2271234,95759,4.00000000
CN4820300000000,48,203,"Harrison County, TX",Nov-22,27937,26710,1227,4.40000000
CN4820500000000,48,205,"Hartley County, TX",Nov-22,2654,2607,47,1.80000000
CN4820700000000,48,207,"Haskell County, TX",Nov-22,2653,2575,78,2.90000000
CN4820900000000,48,209,"Hays County, TX",Nov-22,136258,132354,3904,2.90000000
CN4821100000000,48,211,"Hemphill County, TX",Nov-22,1426,1376,50,3.50000000
CN4821300000000,48,213,"Henderson County, TX",Nov-22,39407,38061,1346,3.40000000
CN4821500000000,48,215,"Hidalgo County, TX",Nov-22,374406,350534,23872,6.40000000
CN4821700000000,48,217,"Hill County, TX",Nov-22,17274,16529,745,4.30000000
CN4821900000000,48,219,"Hockley County, TX",Nov-22,10973,10604,369,3.40000000
CN4822100000000,48,221,"Hood County, TX",Nov-22,29943,28891,1052,3.50000000
CN4822300000000,48,223,"Hopkins County, TX",Nov-22,18279,17561,718,3.90000000
CN4822500000000,48,225,"Houston County, TX",Nov-22,10732,10410,322,3.00000000
CN4822700000000,48,227,"Howard County, TX",Nov-22,13382,12823,559,4.20000000
CN4822900000000,48,229,"Hudspeth County, TX",Nov-22,1784,1712,72,4.00000000
CN4823100000000,48,231,"Hunt County, TX",Nov-22,47774,45988,1786,3.70000000
CN4823300000000,48,233,"Hutchinson County, TX",Nov-22,8035,7685,350,4.40000000
CN4823500000000,48,235,"Irion County, TX",Nov-22,749,729,20,2.70000000
CN4823700000000,48,237,"Jack County, TX",Nov-22,3433,3310,123,3.60000000
CN4823900000000,48,239,"Jackson County, TX",Nov-22,6882,6660,222,3.20000000
CN4824100000000,48,241,"Jasper County, TX",Nov-22,12751,11943,808,6.30000000
CN4824300000000,48,243,"Jeff Davis County, TX",Nov-22,963,932,31,3.20000000
CN4824500000000,48,245,"Jefferson County, TX",Nov-22,101255,94921,6334,6.30000000
CN4824700000000,48,247,"Jim Hogg County, TX",Nov-22,1773,1681,92,5.20000000
CN4824900000000,48,249,"Jim Wells County, TX",Nov-22,15153,14252,901,5.90000000
CN4825100000000,48,251,"Johnson County, TX",Nov-22,89411,86531,2880,3.20000000
CN4825300000000,48,253,"Jones County, TX",Nov-22,5619,5385,234,4.20000000
CN4825500000000,48,255,"Karnes County, TX",Nov-22,6895,6695,200,2.90000000
CN4825700000000,48,257,"Kaufman County, TX",Nov-22,76805,74089,2716,3.50000000
CN4825900000000,48,259,"Kendall County, TX",Nov-22,23534,22839,695,3.00000000
CN4826100000000,48,261,"Kenedy County, TX",Nov-22,174,165,9,5.20000000
CN4826300000000,48,263,"Kent County, TX",Nov-22,417,402,15,3.60000000
CN4826500000000,48,265,"Kerr County, TX",Nov-22,21914,21182,732,3.30000000
CN4826700000000,48,267,"Kimble County, TX",Nov-22,1871,1817,54,2.90000000
CN4826900000000,48,269,"King County, TX",Nov-22,614,609,5,0.80000000
CN4827100000000,48,271,"Kinney County, TX",Nov-22,1153,1102,51,4.40000000
CN4827300000000,48,273,"Kleberg County, TX",Nov-22,12983,12358,625,4.80000000
CN4827500000000,48,275,"Knox County, TX",Nov-22,1344,1295,49,3.60000000
CN4827700000000,48,277,"Lamar County, TX",Nov-22,24160,23155,1005,4.20000000
CN4827900000000,48,279,"Lamb County, TX",Nov-22,4944,4752,192,3.90000000
CN4828100000000,48,281,"Lampasas County, TX",Nov-22,9356,9041,315,3.40000000
CN4828300000000,48,283,"La Salle County, TX",Nov-22,3864,3768,96,2.50000000
CN4828500000000,48,285,"Lavaca County, TX",Nov-22,8497,8229,268,3.20000000
CN4828700000000,48,287,"Lee County, TX",Nov-22,8790,8522,268,3.00000000
CN4828900000000,48,289,"Leon County, TX",Nov-22,5928,5632,296,5.00000000
CN4829100000000,48,291,"Liberty County, TX",Nov-22,35560,33559,2001,5.60000000
CN4829300000000,48,293,"Limestone County, TX",Nov-22,8434,8074,360,4.30000000
CN4829500000000,48,295,"Lipscomb County, TX",Nov-22,1418,1375,43,3.00000000
CN4829700000000,48,297,"Live Oak County, TX",Nov-22,4636,4436,200,4.30000000
CN4829900000000,48,299,"Llano County, TX",Nov-22,8996,8679,317,3.50000000
CN4830100000000,48,301,"Loving County, TX",Nov-22,536,531,5,0.90000000
CN4830300000000,48,303,"Lubbock County, TX",Nov-22,163847,158774,5073,3.10000000
CN4830500000000,48,305,"Lynn County, TX",Nov-22,2748,2661,87,3.20000000
CN4830700000000,48,307,"McCulloch County, TX",Nov-22,2962,2831,131,4.40000000
CN4830900000000,48,309,"McLennan County, TX",Nov-22,125346,121202,4144,3.30000000
CN4831100000000,48,311,"McMullen County, TX",Nov-22,772,760,12,1.60000000
CN4831300000000,48,313,"Madison County, TX",Nov-22,4670,4478,192,4.10000000
CN4831500000000,48,315,"Marion County, TX",Nov-22,4223,4027,196,4.60000000
CN4831700000000,48,317,"Martin County, TX",Nov-22,2629,2555,74,2.80000000
CN4831900000000,48,319,"Mason County, TX",Nov-22,1777,1723,54,3.00000000
CN4832100000000,48,321,"Matagorda County, TX",Nov-22,16101,15120,981,6.10000000
CN4832300000000,48,323,"Maverick County, TX",Nov-22,22570,20848,1722,7.60000000
CN4832500000000,48,325,"Medina County, TX",Nov-22,22479,21673,806,3.60000000
CN4832700000000,48,327,"Menard County, TX",Nov-22,771,745,26,3.40000000
CN4832900000000,48,329,"Midland County, TX",Nov-22,102166,99299,2867,2.80000000
CN4833100000000,48,331,"Milam County, TX",Nov-22,10120,9702,418,4.10000000
CN4833300000000,48,333,"Mills County, TX",Nov-22,1817,1739,78,4.30000000
CN4833500000000,48,335,"Mitchell County, TX",Nov-22,2255,2164,91,4.00000000
CN4833700000000,48,337,"Montague County, TX",Nov-22,9249,8943,306,3.30000000
CN4833900000000,48,339,"Montgomery County, TX",Nov-22,304979,293762,11217,3.70000000
CN4834100000000,48,341,"Moore County, TX",Nov-22,10824,10541,283,2.60000000
CN4834300000000,48,343,"Morris County, TX",Nov-22,4396,4113,283,6.40000000
CN4834500000000,48,345,"Motley County, TX",Nov-22,421,405,16,3.80000000
CN4834700000000,48,347,"Nacogdoches County, TX",Nov-22,27843,26677,1166,4.20000000
CN4834900000000,48,349,"Navarro County, TX",Nov-22,24205,23378,827,3.40000000
CN4835100000000,48,351,"Newton County, TX",Nov-22,4875,4530,345,7.10000000
CN4835300000000,48,353,"Nolan County, TX",Nov-22,6801,6572,229,3.40000000
CN4835500000000,48,355,"Nueces County, TX",Nov-22,164205,156916,7289,4.40000000
CN4835700000000,48,357,"Ochiltree County, TX",Nov-22,3831,3701,130,3.40000000
CN4835900000000,48,359,"Oldham County, TX",Nov-22,898,874,24,2.70000000
CN4836100000000,48,361,"Orange County, TX",Nov-22,34926,32932,1994,5.70000000
CN4836300000000,48,363,"Palo Pinto County, TX",Nov-22,12610,12137,473,3.80000000
CN4836500000000,48,365,"Panola County, TX",Nov-22,9478,9068,410,4.30000000
CN4836700000000,48,367,"Parker County, TX",Nov-22,74807,72545,2262,3.00000000
CN4836900000000,48,369,"Parmer County, TX",Nov-22,4687,4571,116,2.50000000
CN4837100000000,48,371,"Pecos County, TX",Nov-22,5597,5352,245,4.40000000
CN4837300000000,48,373,"Polk County, TX",Nov-22,18260,17267,993,5.40000000
CN4837500000000,48,375,"Potter County, TX",Nov-22,54435,52851,1584,2.90000000
CN4837700000000,48,377,"Presidio County, TX",Nov-22,3107,2919,188,6.10000000
CN4837900000000,48,379,"Rains County, TX",Nov-22,6650,6439,211,3.20000000
CN4838100000000,48,381,"Randall County, TX",Nov-22,75135,73113,2022,2.70000000
CN4838300000000,48,383,"Reagan County, TX",Nov-22,1534,1477,57,3.70000000
CN4838500000000,48,385,"Real County, TX",Nov-22,1071,1017,54,5.00000000
CN4838700000000,48,387,"Red River County, TX",Nov-22,5284,5049,235,4.40000000
CN4838900000000,48,389,"Reeves County, TX",Nov-22,9203,8877,326,3.50000000
CN4839100000000,48,391,"Refugio County, TX",Nov-22,2936,2812,124,4.20000000
CN4839300000000,48,393,"Roberts County, TX",Nov-22,377,365,12,3.20000000
CN4839500000000,48,395,"Robertson County, TX",Nov-22,7709,7429,280,3.60000000
CN4839700000000,48,397,"Rockwall County, TX",Nov-22,60548,58673,1875,3.10000000
CN4839900000000,48,399,"Runnels County, TX",Nov-22,4504,4354,150,3.30000000
CN4840100000000,48,401,"Rusk County, TX",Nov-22,22228,21338,890,4.00000000
CN4840300000000,48,403,"Sabine County, TX",Nov-22,3935,3674,261,6.60000000
CN4840500000000,48,405,"San Augustine County, TX",Nov-22,2918,2748,170,5.80000000
CN4840700000000,48,407,"San Jacinto County, TX",Nov-22,11926,11356,570,4.80000000
CN4840900000000,48,409,"San Patricio County, TX",Nov-22,29133,27519,1614,5.50000000
CN4841100000000,48,411,"San Saba County, TX",Nov-22,2081,2011,70,3.40000000
CN4841300000000,48,413,"Schleicher County, TX",Nov-22,1124,1085,39,3.50000000
CN4841500000000,48,415,"Scurry County, TX",Nov-22,5665,5419,246,4.30000000
CN4841700000000,48,417,"Shackelford County, TX",Nov-22,1767,1725,42,2.40000000
CN4841900000000,48,419,"Shelby County, TX",Nov-22,11422,10995,427,3.70000000
CN4842100000000,48,421,"Sherman County, TX",Nov-22,1388,1351,37,2.70000000
CN4842300000000,48,423,"Smith County, TX",Nov-22,112482,108614,3868,3.40000000
CN4842500000000,48,425,"Somervell County, TX",Nov-22,4596,4430,166,3.60000000
CN4842700000000,48,427,"Starr County, TX",Nov-22,23177,20634,2543,11.00000000
CN4842900000000,48,429,"Stephens County, TX",Nov-22,4233,4099,134,3.20000000
CN4843100000000,48,431,"Sterling County, TX",Nov-22,492,476,16,3.30000000
CN4843300000000,48,433,"Stonewall County, TX",Nov-22,554,535,19,3.40000000
CN4843500000000,48,435,"Sutton County, TX",Nov-22,1020,966,54,5.30000000
CN4843700000000,48,437,"Swisher County, TX",Nov-22,2521,2414,107,4.20000000
CN4843900000000,48,439,"Tarrant County, TX",Nov-22,1148038,1109221,38817,3.40000000
CN4844100000000,48,441,"Taylor County, TX",Nov-22,67403,65309,2094,3.10000000
CN4844300000000,48,443,"Terrell County, TX",Nov-22,428,416,12,2.80000000
CN4844500000000,48,445,"Terry County, TX",Nov-22,4382,4202,180,4.10000000
CN4844700000000,48,447,"Throckmorton County, TX",Nov-22,1458,1438,20,1.40000000
CN4844900000000,48,449,"Titus County, TX",Nov-22,13646,13083,563,4.10000000
CN4845100000000,48,451,"Tom Green County, TX",Nov-22,54027,52294,1733,3.20000000
CN4845300000000,48,453,"Travis County, TX",Nov-22,809695,787971,21724,2.70000000
CN4845500000000,48,455,"Trinity County, TX",Nov-22,5101,4833,268,5.30000000
CN4845700000000,48,457,"Tyler County, TX",Nov-22,7337,6928,409,5.60000000
CN4845900000000,48,459,"Upshur County, TX",Nov-22,17651,16945,706,4.00000000
CN4846100000000,48,461,"Upton County, TX",Nov-22,1654,1603,51,3.10000000
CN4846300000000,48,463,"Uvalde County, TX",Nov-22,10839,10379,460,4.20000000
CN4846500000000,48,465,"Val Verde County, TX",Nov-22,22285,21280,1005,4.50000000
CN4846700000000,48,467,"Van Zandt County, TX",Nov-22,27375,26479,896,3.30000000
CN4846900000000,48,469,"Victoria County, TX",Nov-22,40942,39311,1631,4.00000000
CN4847100000000,48,471,"Walker County, TX",Nov-22,23251,22188,1063,4.60000000
CN4847300000000,48,473,"Waller County, TX",Nov-22,25600,24520,1080,4.20000000
CN4847500000000,48,475,"Ward County, TX",Nov-22,6351,6130,221,3.50000000
CN4847700000000,48,477,"Washington County, TX",Nov-22,14558,13998,560,3.80000000
CN4847900000000,48,479,"Webb County, TX",Nov-22,118583,114039,4544,3.80000000
CN4848100000000,48,481,"Wharton County, TX",Nov-22,20655,19888,767,3.70000000
CN4848300000000,48,483,"Wheeler County, TX",Nov-22,1803,1729,74,4.10000000
CN4848500000000,48,485,"Wichita County, TX",Nov-22,55694,53726,1968,3.50000000
CN4848700000000,48,487,"Wilbarger County, TX",Nov-22,4591,4372,219,4.80000000
CN4848900000000,48,489,"Willacy County, TX",Nov-22,6939,6421,518,7.50000000
CN4849100000000,48,491,"Williamson County, TX",Nov-22,358924,348758,10166,2.80000000
CN4849300000000,48,493,"Wilson County, TX",Nov-22,25856,25094,762,2.90000000
CN4849500000000,48,495,"Winkler County, TX",Nov-22,3618,3469,149,4.10000000
CN4849700000000,48,497,"Wise County, TX",Nov-22,34304,33196,1108,3.20000000
CN4849900000000,48,499,"Wood County, TX",Nov-22,17695,16928,767,4.30000000
CN4850100000000,48,501,"Yoakum County, TX",Nov-22,2973,2844,129,4.30000000
CN4850300000000,48,503,"Young County, TX",Nov-22,7931,7689,242,3.10000000
CN4850500000000,48,505,"Zapata County, TX",Nov-22,4417,4100,317,7.20000000
CN4850700000000,48,507,"Zavala County, TX",Nov-22,3173,2900,273,8.60000000
CN4900100000000,49,001,"Beaver County, UT",Nov-22,2866,2791,75,2.60000000
CN4900300000000,49,003,"Box Elder County, UT",Nov-22,28034,27489,545,1.90000000
CN4900500000000,49,005,"Cache County, UT",Nov-22,73616,72311,1305,1.80000000
CN4900700000000,49,007,"Carbon County, UT",Nov-22,8497,8242,255,3.00000000
CN4900900000000,49,009,"Daggett County, UT",Nov-22,390,370,20,5.10000000
CN4901100000000,49,011,"Davis County, UT",Nov-22,187209,183563,3646,1.90000000
CN4901300000000,49,013,"Duchesne County, UT",Nov-22,8223,8026,197,2.40000000
CN4901500000000,49,015,"Emery County, UT",Nov-22,4466,4356,110,2.50000000
CN4901700000000,49,017,"Garfield County, UT",Nov-22,2665,2532,133,5.00000000
CN4901900000000,49,019,"Grand County, UT",Nov-22,6929,6759,170,2.50000000
CN4902100000000,49,021,"Iron County, UT",Nov-22,28927,28305,622,2.20000000
CN4902300000000,49,023,"Juab County, UT",Nov-22,6619,6517,102,1.50000000
CN4902500000000,49,025,"Kane County, UT",Nov-22,4135,4050,85,2.10000000
CN4902700000000,49,027,"Millard County, UT",Nov-22,6245,6123,122,2.00000000
CN4902900000000,49,029,"Morgan County, UT",Nov-22,6046,5932,114,1.90000000
CN4903100000000,49,031,"Piute County, UT",Nov-22,525,501,24,4.60000000
CN4903300000000,49,033,"Rich County, UT",Nov-22,1079,1054,25,2.30000000
CN4903500000000,49,035,"Salt Lake County, UT",Nov-22,680010,666322,13688,2.00000000
CN4903700000000,49,037,"San Juan County, UT",Nov-22,5576,5380,196,3.50000000
CN4903900000000,49,039,"Sanpete County, UT",Nov-22,13957,13627,330,2.40000000
CN4904100000000,49,041,"Sevier County, UT",Nov-22,10430,10189,241,2.30000000
CN4904300000000,49,043,"Summit County, UT",Nov-22,25700,25146,554,2.20000000
CN4904500000000,49,045,"Tooele County, UT",Nov-22,38413,37531,882,2.30000000
CN4904700000000,49,047,"Uintah County, UT",Nov-22,14382,13972,410,2.90000000
CN4904900000000,49,049,"Utah County, UT",Nov-22,356564,349701,6863,1.90000000
CN4905100000000,49,051,"Wasatch County, UT",Nov-22,17937,17554,383,2.10000000
CN4905300000000,49,053,"Washington County, UT",Nov-22,89017,87091,1926,2.20000000
CN4905500000000,49,055,"Wayne County, UT",Nov-22,1449,1393,56,3.90000000
CN4905700000000,49,057,"Weber County, UT",Nov-22,137307,134412,2895,2.10000000
CN5000100000000,50,001,"Addison County, VT",Nov-22,20695,20265,430,2.10000000
CN5000300000000,50,003,"Bennington County, VT",Nov-22,17585,17072,513,2.90000000
CN5000500000000,50,005,"Caledonia County, VT",Nov-22,14258,13852,406,2.80000000
CN5000700000000,50,007,"Chittenden County, VT",Nov-22,97614,95728,1886,1.90000000
CN5000900000000,50,009,"Essex County, VT",Nov-22,2599,2503,96,3.70000000
CN5001100000000,50,011,"Franklin County, VT",Nov-22,27715,27108,607,2.20000000
CN5001300000000,50,013,"Grand Isle County, VT",Nov-22,4168,4016,152,3.60000000
CN5001500000000,50,015,"Lamoille County, VT",Nov-22,13663,13245,418,3.10000000
CN5001700000000,50,017,"Orange County, VT",Nov-22,15400,15073,327,2.10000000
CN5001900000000,50,019,"Orleans County, VT",Nov-22,12708,12234,474,3.70000000
CN5002100000000,50,021,"Rutland County, VT",Nov-22,29348,28500,848,2.90000000
CN5002300000000,50,023,"Washington County, VT",Nov-22,33533,32788,745,2.20000000
CN5002500000000,50,025,"Windham County, VT",Nov-22,20473,19900,573,2.80000000
CN5002700000000,50,027,"Windsor County, VT",Nov-22,28180,27567,613,2.20000000
CN5100100000000,51,001,"Accomack County, VA",Nov-22,15695,15182,513,3.30000000
CN5100300000000,51,003,"Albemarle County, VA",Nov-22,56660,55143,1517,2.70000000
CN5100500000000,51,005,"Alleghany County, VA",Nov-22,6805,6602,203,3.00000000
CN5100700000000,51,007,"Amelia County, VA",Nov-22,6014,5837,177,2.90000000
CN5100900000000,51,009,"Amherst County, VA",Nov-22,14562,14100,462,3.20000000
CN5101100000000,51,011,"Appomattox County, VA",Nov-22,7010,6786,224,3.20000000
CN5101300000000,51,013,"Arlington County, VA",Nov-22,152442,149229,3213,2.10000000
CN5101500000000,51,015,"Augusta County, VA",Nov-22,37239,36299,940,2.50000000
CN5101700000000,51,017,"Bath County, VA",Nov-22,2397,2333,64,2.70000000
CN5101900000000,51,019,"Bedford County, VA",Nov-22,37785,36707,1078,2.90000000
CN5102100000000,51,021,"Bland County, VA",Nov-22,2837,2763,74,2.60000000
CN5102300000000,51,023,"Botetourt County, VA",Nov-22,17073,16621,452,2.60000000
CN5102500000000,51,025,"Brunswick County, VA",Nov-22,5977,5681,296,5.00000000
CN5102700000000,51,027,"Buchanan County, VA",Nov-22,6589,6265,324,4.90000000
CN5102900000000,51,029,"Buckingham County, VA",Nov-22,6328,6043,285,4.50000000
CN5103100000000,51,031,"Campbell County, VA",Nov-22,25323,24537,786,3.10000000
CN5103300000000,51,033,"Caroline County, VA",Nov-22,14682,14175,507,3.50000000
CN5103500000000,51,035,"Carroll County, VA",Nov-22,13688,13261,427,3.10000000
CN5103600000000,51,036,"Charles City County, VA",Nov-22,3446,3331,115,3.30000000
CN5103700000000,51,037,"Charlotte County, VA",Nov-22,5894,5715,179,3.00000000
CN5104100000000,51,041,"Chesterfield County, VA",Nov-22,184783,179292,5491,3.00000000
CN5104300000000,51,043,"Clarke County, VA",Nov-22,7479,7296,183,2.40000000
CN5104500000000,51,045,"Craig County, VA",Nov-22,2236,2168,68,3.00000000
CN5104700000000,51,047,"Culpeper County, VA",Nov-22,24884,24205,679,2.70000000
CN5104900000000,51,049,"Cumberland County, VA",Nov-22,4771,4611,160,3.40000000
CN5105100000000,51,051,"Dickenson County, VA",Nov-22,5212,5007,205,3.90000000
CN5105300000000,51,053,"Dinwiddie County, VA",Nov-22,13197,12756,441,3.30000000
CN5105700000000,51,057,"Essex County, VA",Nov-22,5317,5124,193,3.60000000
CN5105900000000,51,059,"Fairfax County, VA",Nov-22,621136,605586,15550,2.50000000
CN5106100000000,51,061,"Fauquier County, VA",Nov-22,36793,35847,946,2.60000000
CN5106300000000,51,063,"Floyd County, VA",Nov-22,8537,8328,209,2.40000000
CN5106500000000,51,065,"Fluvanna County, VA",Nov-22,13866,13499,367,2.60000000
CN5106700000000,51,067,"Franklin County, VA",Nov-22,25626,24858,768,3.00000000
CN5106900000000,51,069,"Frederick County, VA",Nov-22,49963,48705,1258,2.50000000
CN5107100000000,51,071,"Giles County, VA",Nov-22,8178,7909,269,3.30000000
CN5107300000000,51,073,"Gloucester County, VA",Nov-22,19064,18518,546,2.90000000
CN5107500000000,51,075,"Goochland County, VA",Nov-22,11317,11003,314,2.80000000
CN5107700000000,51,077,"Grayson County, VA",Nov-22,9119,8918,201,2.20000000
CN5107900000000,51,079,"Greene County, VA",Nov-22,10398,10133,265,2.50000000
CN5108100000000,51,081,"Greensville County, VA",Nov-22,4596,4434,162,3.50000000
CN5108300000000,51,083,"Halifax County, VA",Nov-22,16040,15395,645,4.00000000
CN5108500000000,51,085,"Hanover County, VA",Nov-22,57311,55847,1464,2.60000000
CN5108700000000,51,087,"Henrico County, VA",Nov-22,176795,171511,5284,3.00000000
CN5108900000000,51,089,"Henry County, VA",Nov-22,25753,24907,846,3.30000000
CN5109100000000,51,091,"Highland County, VA",Nov-22,1288,1255,33,2.60000000
CN5109300000000,51,093,"Isle of Wight County, VA",Nov-22,19244,18682,562,2.90000000
CN5109500000000,51,095,"James City County, VA",Nov-22,36070,35015,1055,2.90000000
CN5109700000000,51,097,"King and Queen County, VA",Nov-22,3980,3879,101,2.50000000
CN5109900000000,51,099,"King George County, VA",Nov-22,14532,14173,359,2.50000000
CN5110100000000,51,101,"King William County, VA",Nov-22,9155,8905,250,2.70000000
CN5110300000000,51,103,"Lancaster County, VA",Nov-22,5754,5573,181,3.10000000
CN5110500000000,51,105,"Lee County, VA",Nov-22,8800,8480,320,3.60000000
CN5110700000000,51,107,"Loudoun County, VA",Nov-22,225865,220263,5602,2.50000000
CN5110900000000,51,109,"Louisa County, VA",Nov-22,21587,21037,550,2.50000000
CN5111100000000,51,111,"Lunenburg County, VA",Nov-22,5308,5121,187,3.50000000
CN5111300000000,51,113,"Madison County, VA",Nov-22,7762,7600,162,2.10000000
CN5111500000000,51,115,"Mathews County, VA",Nov-22,3989,3876,113,2.80000000
CN5111700000000,51,117,"Mecklenburg County, VA",Nov-22,13585,13113,472,3.50000000
CN5111900000000,51,119,"Middlesex County, VA",Nov-22,5385,5239,146,2.70000000
CN5112100000000,51,121,"Montgomery County, VA",Nov-22,52171,50769,1402,2.70000000
CN5112500000000,51,125,"Nelson County, VA",Nov-22,7230,7029,201,2.80000000
CN5112700000000,51,127,"New Kent County, VA",Nov-22,12649,12323,326,2.60000000
CN5113100000000,51,131,"Northampton County, VA",Nov-22,5638,5408,230,4.10000000
CN5113300000000,51,133,"Northumberland County, VA",Nov-22,5927,5720,207,3.50000000
CN5113500000000,51,135,"Nottoway County, VA",Nov-22,7384,7175,209,2.80000000
CN5113700000000,51,137,"Orange County, VA",Nov-22,17749,17211,538,3.00000000
CN5113900000000,51,139,"Page County, VA",Nov-22,12718,12314,404,3.20000000
CN5114100000000,51,141,"Patrick County, VA",Nov-22,7386,7140,246,3.30000000
CN5114300000000,51,143,"Pittsylvania County, VA",Nov-22,32079,31166,913,2.80000000
CN5114500000000,51,145,"Powhatan County, VA",Nov-22,14018,13642,376,2.70000000
CN5114700000000,51,147,"Prince Edward County, VA",Nov-22,11148,10762,386,3.50000000
CN5114900000000,51,149,"Prince George County, VA",Nov-22,14702,14164,538,3.70000000
CN5115300000000,51,153,"Prince William County, VA",Nov-22,243863,237068,6795,2.80000000
CN5115500000000,51,155,"Pulaski County, VA",Nov-22,16677,16211,466,2.80000000
CN5115700000000,51,157,"Rappahannock County, VA",Nov-22,3627,3541,86,2.40000000
CN5115900000000,51,159,"Richmond County, VA",Nov-22,4147,4038,109,2.60000000
CN5116100000000,51,161,"Roanoke County, VA",Nov-22,48086,46830,1256,2.60000000
CN5116300000000,51,163,"Rockbridge County, VA",Nov-22,11324,11026,298,2.60000000
CN5116500000000,51,165,"Rockingham County, VA",Nov-22,42412,41338,1074,2.50000000
CN5116700000000,51,167,"Russell County, VA",Nov-22,11391,11011,380,3.30000000
CN5116900000000,51,169,"Scott County, VA",Nov-22,8947,8637,310,3.50000000
CN5117100000000,51,171,"Shenandoah County, VA",Nov-22,22824,22202,622,2.70000000
CN5117300000000,51,173,"Smyth County, VA",Nov-22,15683,15258,425,2.70000000
CN5117500000000,51,175,"Southampton County, VA",Nov-22,9167,8925,242,2.60000000
CN5117700000000,51,177,"Spotsylvania County, VA",Nov-22,67540,65479,2061,3.10000000
CN5117900000000,51,179,"Stafford County, VA",Nov-22,73567,71346,2221,3.00000000
CN5118100000000,51,181,"Surry County, VA",Nov-22,3676,3567,109,3.00000000
CN5118300000000,51,183,"Sussex County, VA",Nov-22,3579,3402,177,4.90000000
CN5118500000000,51,185,"Tazewell County, VA",Nov-22,16199,15571,628,3.90000000
CN5118700000000,51,187,"Warren County, VA",Nov-22,20172,19614,558,2.80000000
CN5119100000000,51,191,"Washington County, VA",Nov-22,25563,24806,757,3.00000000
CN5119300000000,51,193,"Westmoreland County, VA",Nov-22,10142,9832,310,3.10000000
CN5119500000000,51,195,"Wise County, VA",Nov-22,14683,14135,548,3.70000000
CN5119700000000,51,197,"Wythe County, VA",Nov-22,14824,14399,425,2.90000000
CN5119900000000,51,199,"York County, VA",Nov-22,32352,31436,916,2.80000000
CN5151000000000,51,510,"Alexandria city, VA",Nov-22,97968,95620,2348,2.40000000
CN5152000000000,51,520,"Bristol city, VA",Nov-22,7368,7091,277,3.80000000
CN5153000000000,51,530,"Buena Vista city, VA",Nov-22,3193,3107,86,2.70000000
CN5154000000000,51,540,"Charlottesville city, VA",Nov-22,25048,24391,657,2.60000000
CN5155000000000,51,550,"Chesapeake city, VA",Nov-22,120864,117192,3672,3.00000000
CN5157000000000,51,570,"Colonial Heights city, VA",Nov-22,8156,7867,289,3.50000000
CN5158000000000,51,580,"Covington city, VA",Nov-22,2382,2279,103,4.30000000
CN5159000000000,51,590,"Danville city, VA",Nov-22,20018,19027,991,5.00000000
CN5159500000000,51,595,"Emporia city, VA",Nov-22,2531,2406,125,4.90000000
CN5160000000000,51,600,"Fairfax city, VA",Nov-22,12549,12245,304,2.40000000
CN5161000000000,51,610,"Falls Church city, VA",Nov-22,8334,8139,195,2.30000000
CN5162000000000,51,620,"Franklin city, VA",Nov-22,3560,3392,168,4.70000000
CN5163000000000,51,630,"Fredericksburg city, VA",Nov-22,13981,13484,497,3.60000000
CN5164000000000,51,640,"Galax city, VA",Nov-22,3040,2954,86,2.80000000
CN5165000000000,51,650,"Hampton city, VA",Nov-22,63039,60342,2697,4.30000000
CN5166000000000,51,660,"Harrisonburg city, VA",Nov-22,24557,23732,825,3.40000000
CN5167000000000,51,670,"Hopewell city, VA",Nov-22,9255,8766,489,5.30000000
CN5167800000000,51,678,"Lexington city, VA",Nov-22,2264,2172,92,4.10000000
CN5168000000000,51,680,"Lynchburg city, VA",Nov-22,35035,33635,1400,4.00000000
CN5168300000000,51,683,"Manassas city, VA",Nov-22,21141,20576,565,2.70000000
CN5168500000000,51,685,"Manassas Park city, VA",Nov-22,9530,9286,244,2.60000000
CN5169000000000,51,690,"Martinsville city, VA",Nov-22,5984,5660,324,5.40000000
CN5170000000000,51,700,"Newport News city, VA",Nov-22,86432,82996,3436,4.00000000
CN5171000000000,51,710,"Norfolk city, VA",Nov-22,107710,103526,4184,3.90000000
CN5172000000000,51,720,"Norton city, VA",Nov-22,1804,1742,62,3.40000000
CN5173000000000,51,730,"Petersburg city, VA",Nov-22,12199,11341,858,7.00000000
CN5173500000000,51,735,"Poquoson city, VA",Nov-22,6211,6065,146,2.40000000
CN5174000000000,51,740,"Portsmouth city, VA",Nov-22,43222,41299,1923,4.40000000
CN5175000000000,51,750,"Radford city, VA",Nov-22,9022,8708,314,3.50000000
CN5176000000000,51,760,"Richmond city, VA",Nov-22,115635,111146,4489,3.90000000
CN5177000000000,51,770,"Roanoke city, VA",Nov-22,47389,45780,1609,3.40000000
CN5177500000000,51,775,"Salem city, VA",Nov-22,12423,12066,357,2.90000000
CN5179000000000,51,790,"Staunton city, VA",Nov-22,12091,11761,330,2.70000000
CN5180000000000,51,800,"Suffolk city, VA",Nov-22,44449,43047,1402,3.20000000
CN5181000000000,51,810,"Virginia Beach city, VA",Nov-22,226307,219681,6626,2.90000000
CN5182000000000,51,820,"Waynesboro city, VA",Nov-22,10504,10190,314,3.00000000
CN5183000000000,51,830,"Williamsburg city, VA",Nov-22,6658,6369,289,4.30000000
CN5184000000000,51,840,"Winchester city, VA",Nov-22,14653,14255,398,2.70000000
CN5300100000000,53,001,"Adams County, WA",Nov-22,9601,9128,473,4.90000000
CN5300300000000,53,003,"Asotin County, WA",Nov-22,10689,10311,378,3.50000000
CN5300500000000,53,005,"Benton County, WA",Nov-22,107889,102706,5183,4.80000000
CN5300700000000,53,007,"Chelan County, WA",Nov-22,43736,41660,2076,4.70000000
CN5300900000000,53,009,"Clallam County, WA",Nov-22,30117,28346,1771,5.90000000
CN5301100000000,53,011,"Clark County, WA",Nov-22,257586,245968,11618,4.50000000
CN5301300000000,53,013,"Columbia County, WA",Nov-22,1827,1734,93,5.10000000
CN5301500000000,53,015,"Cowlitz County, WA",Nov-22,49602,46785,2817,5.70000000
CN5301700000000,53,017,"Douglas County, WA",Nov-22,21539,20406,1133,5.30000000
CN5301900000000,53,019,"Ferry County, WA",Nov-22,2295,2064,231,10.10000000
CN5302100000000,53,021,"Franklin County, WA",Nov-22,44028,41396,2632,6.00000000
CN5302300000000,53,023,"Garfield County, WA",Nov-22,799,743,56,7.00000000
CN5302500000000,53,025,"Grant County, WA",Nov-22,47060,44096,2964,6.30000000
CN5302700000000,53,027,"Grays Harbor County, WA",Nov-22,29329,27231,2098,7.20000000
CN5302900000000,53,029,"Island County, WA",Nov-22,37222,35386,1836,4.90000000
CN5303100000000,53,031,"Jefferson County, WA",Nov-22,12930,12225,705,5.50000000
CN5303300000000,53,033,"King County, WA",Nov-22,1304223,1266319,37904,2.90000000
CN5303500000000,53,035,"Kitsap County, WA",Nov-22,130609,124988,5621,4.30000000
CN5303700000000,53,037,"Kittitas County, WA",Nov-22,22271,21064,1207,5.40000000
CN5303900000000,53,039,"Klickitat County, WA",Nov-22,9693,9155,538,5.60000000
CN5304100000000,53,041,"Lewis County, WA",Nov-22,35464,33347,2117,6.00000000
CN5304300000000,53,043,"Lincoln County, WA",Nov-22,4692,4452,240,5.10000000
CN5304500000000,53,045,"Mason County, WA",Nov-22,26288,24667,1621,6.20000000
CN5304700000000,53,047,"Okanogan County, WA",Nov-22,19471,18164,1307,6.70000000
CN5304900000000,53,049,"Pacific County, WA",Nov-22,8683,8034,649,7.50000000
CN5305100000000,53,051,"Pend Oreille County, WA",Nov-22,5280,4912,368,7.00000000
CN5305300000000,53,053,"Pierce County, WA",Nov-22,454678,431274,23404,5.10000000
CN5305500000000,53,055,"San Juan County, WA",Nov-22,8447,8112,335,4.00000000
CN5305700000000,53,057,"Skagit County, WA",Nov-22,62516,59242,3274,5.20000000
CN5305900000000,53,059,"Skamania County, WA",Nov-22,5764,5448,316,5.50000000
CN5306100000000,53,061,"Snohomish County, WA",Nov-22,444400,430095,14305,3.20000000
CN5306300000000,53,063,"Spokane County, WA",Nov-22,268535,256066,12469,4.60000000
CN5306500000000,53,065,"Stevens County, WA",Nov-22,19599,18308,1291,6.60000000
CN5306700000000,53,067,"Thurston County, WA",Nov-22,147733,140906,6827,4.60000000
CN5306900000000,53,069,"Wahkiakum County, WA",Nov-22,1350,1251,99,7.30000000
CN5307100000000,53,071,"Walla Walla County, WA",Nov-22,32096,30830,1266,3.90000000
CN5307300000000,53,073,"Whatcom County, WA",Nov-22,117288,111714,5574,4.80000000
CN5307500000000,53,075,"Whitman County, WA",Nov-22,23809,22956,853,3.60000000
CN5307700000000,53,077,"Yakima County, WA",Nov-22,128562,119981,8581,6.70000000
CN5400100000000,54,001,"Barbour County, WV",Nov-22,7253,6960,293,4.00000000
CN5400300000000,54,003,"Berkeley County, WV",Nov-22,59964,58324,1640,2.70000000
CN5400500000000,54,005,"Boone County, WV",Nov-22,7091,6807,284,4.00000000
CN5400700000000,54,007,"Braxton County, WV",Nov-22,5023,4761,262,5.20000000
CN5400900000000,54,009,"Brooke County, WV",Nov-22,9716,9326,390,4.00000000
CN5401100000000,54,011,"Cabell County, WV",Nov-22,40744,39434,1310,3.20000000
CN5401300000000,54,013,"Calhoun County, WV",Nov-22,2659,2449,210,7.90000000
CN5401500000000,54,015,"Clay County, WV",Nov-22,2993,2834,159,5.30000000
CN5401700000000,54,017,"Doddridge County, WV",Nov-22,3834,3725,109,2.80000000
CN5401900000000,54,019,"Fayette County, WV",Nov-22,16162,15454,708,4.40000000
CN5402100000000,54,021,"Gilmer County, WV",Nov-22,2434,2320,114,4.70000000
CN5402300000000,54,023,"Grant County, WV",Nov-22,6061,5870,191,3.20000000
CN5402500000000,54,025,"Greenbrier County, WV",Nov-22,15748,15246,502,3.20000000
CN5402700000000,54,027,"Hampshire County, WV",Nov-22,11422,11141,281,2.50000000
CN5402900000000,54,029,"Hancock County, WV",Nov-22,12799,12198,601,4.70000000
CN5403100000000,54,031,"Hardy County, WV",Nov-22,5996,5785,211,3.50000000
CN5403300000000,54,033,"Harrison County, WV",Nov-22,32830,31759,1071,3.30000000
CN5403500000000,54,035,"Jackson County, WV",Nov-22,11839,11373,466,3.90000000
CN5403700000000,54,037,"Jefferson County, WV",Nov-22,30647,29914,733,2.40000000
CN5403900000000,54,039,"Kanawha County, WV",Nov-22,80109,77392,2717,3.40000000
CN5404100000000,54,041,"Lewis County, WV",Nov-22,6020,5740,280,4.70000000
CN5404300000000,54,043,"Lincoln County, WV",Nov-22,6901,6598,303,4.40000000
CN5404500000000,54,045,"Logan County, WV",Nov-22,11000,10527,473,4.30000000
CN5404700000000,54,047,"McDowell County, WV",Nov-22,4334,4077,257,5.90000000
CN5404900000000,54,049,"Marion County, WV",Nov-22,25092,24123,969,3.90000000
CN5405100000000,54,051,"Marshall County, WV",Nov-22,13223,12629,594,4.50000000
CN5405300000000,54,053,"Mason County, WV",Nov-22,10149,9745,404,4.00000000
CN5405500000000,54,055,"Mercer County, WV",Nov-22,20746,19905,841,4.10000000
CN5405700000000,54,057,"Mineral County, WV",Nov-22,12147,11719,428,3.50000000
CN5405900000000,54,059,"Mingo County, WV",Nov-22,6126,5786,340,5.60000000
CN5406100000000,54,061,"Monongalia County, WV",Nov-22,57389,55773,1616,2.80000000
CN5406300000000,54,063,"Monroe County, WV",Nov-22,6416,6255,161,2.50000000
CN5406500000000,54,065,"Morgan County, WV",Nov-22,8766,8536,230,2.60000000
CN5406700000000,54,067,"Nicholas County, WV",Nov-22,9149,8761,388,4.20000000
CN5406900000000,54,069,"Ohio County, WV",Nov-22,20136,19432,704,3.50000000
CN5407100000000,54,071,"Pendleton County, WV",Nov-22,3962,3868,94,2.40000000
CN5407300000000,54,073,"Pleasants County, WV",Nov-22,2712,2568,144,5.30000000
CN5407500000000,54,075,"Pocahontas County, WV",Nov-22,4437,4244,193,4.30000000
CN5407700000000,54,077,"Preston County, WV",Nov-22,16284,15742,542,3.30000000
CN5407900000000,54,079,"Putnam County, WV",Nov-22,26582,25785,797,3.00000000
CN5408100000000,54,081,"Raleigh County, WV",Nov-22,30379,29368,1011,3.30000000
CN5408300000000,54,083,"Randolph County, WV",Nov-22,11810,11273,537,4.50000000
CN5408500000000,54,085,"Ritchie County, WV",Nov-22,4323,4165,158,3.70000000
CN5408700000000,54,087,"Roane County, WV",Nov-22,5015,4749,266,5.30000000
CN5408900000000,54,089,"Summers County, WV",Nov-22,4565,4422,143,3.10000000
CN5409100000000,54,091,"Taylor County, WV",Nov-22,7816,7562,254,3.20000000
CN5409300000000,54,093,"Tucker County, WV",Nov-22,3308,3186,122,3.70000000
CN5409500000000,54,095,"Tyler County, WV",Nov-22,2971,2809,162,5.50000000
CN5409700000000,54,097,"Upshur County, WV",Nov-22,9714,9302,412,4.20000000
CN5409900000000,54,099,"Wayne County, WV",Nov-22,15308,14751,557,3.60000000
CN5410100000000,54,101,"Webster County, WV",Nov-22,3445,3308,137,4.00000000
CN5410300000000,54,103,"Wetzel County, WV",Nov-22,6820,6495,325,4.80000000
CN5410500000000,54,105,"Wirt County, WV",Nov-22,2305,2188,117,5.10000000
CN5410700000000,54,107,"Wood County, WV",Nov-22,36871,35481,1390,3.80000000
CN5410900000000,54,109,"Wyoming County, WV",Nov-22,7353,7064,289,3.90000000
CN5500100000000,55,001,"Adams County, WI",Nov-22,7410,7081,329,4.40000000
CN5500300000000,55,003,"Ashland County, WI",Nov-22,7153,6923,230,3.20000000
CN5500500000000,55,005,"Barron County, WI",Nov-22,23040,22405,635,2.80000000
CN5500700000000,55,007,"Bayfield County, WI",Nov-22,7020,6728,292,4.20000000
CN5500900000000,55,009,"Brown County, WI",Nov-22,140841,137574,3267,2.30000000
CN5501100000000,55,011,"Buffalo County, WI",Nov-22,5909,5718,191,3.20000000
CN5501300000000,55,013,"Burnett County, WI",Nov-22,6978,6726,252,3.60000000
CN5501500000000,55,015,"Calumet County, WI",Nov-22,27388,26803,585,2.10000000
CN5501700000000,55,017,"Chippewa County, WI",Nov-22,33159,32263,896,2.70000000
CN5501900000000,55,019,"Clark County, WI",Nov-22,16905,16534,371,2.20000000
CN5502100000000,55,021,"Columbia County, WI",Nov-22,31739,31023,716,2.30000000
CN5502300000000,55,023,"Crawford County, WI",Nov-22,6839,6636,203,3.00000000
CN5502500000000,55,025,"Dane County, WI",Nov-22,331779,325248,6531,2.00000000
CN5502700000000,55,027,"Dodge County, WI",Nov-22,46658,45623,1035,2.20000000
CN5502900000000,55,029,"Door County, WI",Nov-22,14026,13635,391,2.80000000
CN5503100000000,55,031,"Douglas County, WI",Nov-22,23036,22268,768,3.30000000
CN5503300000000,55,033,"Dunn County, WI",Nov-22,24456,23824,632,2.60000000
CN5503500000000,55,035,"Eau Claire County, WI",Nov-22,59443,58124,1319,2.20000000
CN5503700000000,55,037,"Florence County, WI",Nov-22,1957,1883,74,3.80000000
CN5503900000000,55,039,"Fond du Lac County, WI",Nov-22,56208,54977,1231,2.20000000
CN5504100000000,55,041,"Forest County, WI",Nov-22,3674,3525,149,4.10000000
CN5504300000000,55,043,"Grant County, WI",Nov-22,26853,26236,617,2.30000000
CN5504500000000,55,045,"Green County, WI",Nov-22,20640,20203,437,2.10000000
CN5504700000000,55,047,"Green Lake County, WI",Nov-22,8694,8428,266,3.10000000
CN5504900000000,55,049,"Iowa County, WI",Nov-22,13365,13084,281,2.10000000
CN5505100000000,55,051,"Iron County, WI",Nov-22,2390,2278,112,4.70000000
CN5505300000000,55,053,"Jackson County, WI",Nov-22,9090,8791,299,3.30000000
CN5505500000000,55,055,"Jefferson County, WI",Nov-22,45416,44360,1056,2.30000000
CN5505700000000,55,057,"Juneau County, WI",Nov-22,12881,12485,396,3.10000000
CN5505900000000,55,059,"Kenosha County, WI",Nov-22,91491,88903,2588,2.80000000
CN5506100000000,55,061,"Kewaunee County, WI",Nov-22,10589,10351,238,2.20000000
CN5506300000000,55,063,"La Crosse County, WI",Nov-22,66511,65069,1442,2.20000000
CN5506500000000,55,065,"Lafayette County, WI",Nov-22,9972,9754,218,2.20000000
CN5506700000000,55,067,"Langlade County, WI",Nov-22,8918,8625,293,3.30000000
CN5506900000000,55,069,"Lincoln County, WI",Nov-22,14479,14148,331,2.30000000
CN5507100000000,55,071,"Manitowoc County, WI",Nov-22,39931,38918,1013,2.50000000
CN5507300000000,55,073,"Marathon County, WI",Nov-22,72680,71130,1550,2.10000000
CN5507500000000,55,075,"Marinette County, WI",Nov-22,18435,17796,639,3.50000000
CN5507700000000,55,077,"Marquette County, WI",Nov-22,7428,7198,230,3.10000000
CN5507800000000,55,078,"Menominee County, WI",Nov-22,1463,1393,70,4.80000000
CN5507900000000,55,079,"Milwaukee County, WI",Nov-22,455472,439460,16012,3.50000000
CN5508100000000,55,081,"Monroe County, WI",Nov-22,22477,21948,529,2.40000000
CN5508300000000,55,083,"Oconto County, WI",Nov-22,20310,19777,533,2.60000000
CN5508500000000,55,085,"Oneida County, WI",Nov-22,17159,16671,488,2.80000000
CN5508700000000,55,087,"Outagamie County, WI",Nov-22,104048,101813,2235,2.10000000
CN5508900000000,55,089,"Ozaukee County, WI",Nov-22,48210,47094,1116,2.30000000
CN5509100000000,55,091,"Pepin County, WI",Nov-22,3949,3857,92,2.30000000
CN5509300000000,55,093,"Pierce County, WI",Nov-22,25109,24443,666,2.70000000
CN5509500000000,55,095,"Polk County, WI",Nov-22,24168,23378,790,3.30000000
CN5509700000000,55,097,"Portage County, WI",Nov-22,37455,36525,930,2.50000000
CN5509900000000,55,099,"Price County, WI",Nov-22,6099,5908,191,3.10000000
CN5510100000000,55,101,"Racine County, WI",Nov-22,95504,92545,2959,3.10000000
CN5510300000000,55,103,"Richland County, WI",Nov-22,8589,8382,207,2.40000000
CN5510500000000,55,105,"Rock County, WI",Nov-22,85029,82427,2602,3.10000000
CN5510700000000,55,107,"Rusk County, WI",Nov-22,6228,6034,194,3.10000000
CN5510900000000,55,109,"St. Croix County, WI",Nov-22,51257,49941,1316,2.60000000
CN5511100000000,55,111,"Sauk County, WI",Nov-22,33558,32727,831,2.50000000
CN5511300000000,55,113,"Sawyer County, WI",Nov-22,7646,7362,284,3.70000000
CN5511500000000,55,115,"Shawano County, WI",Nov-22,19883,19408,475,2.40000000
CN5511700000000,55,117,"Sheboygan County, WI",Nov-22,61336,59968,1368,2.20000000
CN5511900000000,55,119,"Taylor County, WI",Nov-22,10168,9885,283,2.80000000
CN5512100000000,55,121,"Trempealeau County, WI",Nov-22,14278,13896,382,2.70000000
CN5512300000000,55,123,"Vernon County, WI",Nov-22,14792,14459,333,2.30000000
CN5512500000000,55,125,"Vilas County, WI",Nov-22,9503,9172,331,3.50000000
CN5512700000000,55,127,"Walworth County, WI",Nov-22,57007,55603,1404,2.50000000
CN5512900000000,55,129,"Washburn County, WI",Nov-22,7325,7096,229,3.10000000
CN5513100000000,55,131,"Washington County, WI",Nov-22,75523,73867,1656,2.20000000
CN5513300000000,55,133,"Waukesha County, WI",Nov-22,221217,216151,5066,2.30000000
CN5513500000000,55,135,"Waupaca County, WI",Nov-22,24538,23922,616,2.50000000
CN5513700000000,55,137,"Waushara County, WI",Nov-22,10732,10428,304,2.80000000
CN5513900000000,55,139,"Winnebago County, WI",Nov-22,92114,90010,2104,2.30000000
CN5514100000000,55,141,"Wood County, WI",Nov-22,32579,31602,977,3.00000000
CN5600100000000,56,001,"Albany County, WY",Nov-22,21771,21207,564,2.60000000
CN5600300000000,56,003,"Big Horn County, WY",Nov-22,5082,4920,162,3.20000000
CN5600500000000,56,005,"Campbell County, WY",Nov-22,22958,22282,676,2.90000000
CN5600700000000,56,007,"Carbon County, WY",Nov-22,7299,7053,246,3.40000000
CN5600900000000,56,009,"Converse County, WY",Nov-22,7613,7436,177,2.30000000
CN5601100000000,56,011,"Crook County, WY",Nov-22,3723,3632,91,2.40000000
CN5601300000000,56,013,"Fremont County, WY",Nov-22,19047,18408,639,3.40000000
CN5601500000000,56,015,"Goshen County, WY",Nov-22,6316,6154,162,2.60000000
CN5601700000000,56,017,"Hot Springs County, WY",Nov-22,2293,2239,54,2.40000000
CN5601900000000,56,019,"Johnson County, WY",Nov-22,4140,4013,127,3.10000000
CN5602100000000,56,021,"Laramie County, WY",Nov-22,50724,49253,1471,2.90000000
CN5602300000000,56,023,"Lincoln County, WY",Nov-22,9610,9327,283,2.90000000
CN5602500000000,56,025,"Natrona County, WY",Nov-22,39291,37896,1395,3.60000000
CN5602700000000,56,027,"Niobrara County, WY",Nov-22,1175,1141,34,2.90000000
CN5602900000000,56,029,"Park County, WY",Nov-22,14674,14183,491,3.30000000
CN5603100000000,56,031,"Platte County, WY",Nov-22,4336,4203,133,3.10000000
CN5603300000000,56,033,"Sheridan County, WY",Nov-22,15922,15456,466,2.90000000
CN5603500000000,56,035,"Sublette County, WY",Nov-22,3769,3635,134,3.60000000
CN5603700000000,56,037,"Sweetwater County, WY",Nov-22,19608,18902,706,3.60000000
CN5603900000000,56,039,"Teton County, WY",Nov-22,14870,14301,569,3.80000000
CN5604100000000,56,041,"Uinta County, WY",Nov-22,8909,8605,304,3.40000000
CN5604300000000,56,043,"Washakie County, WY",Nov-22,3801,3680,121,3.20000000
CN5604500000000,56,045,"Weston County, WY",Nov-22,3861,3779,82,2.10000000
CN7200100000000,72,001,"Adjuntas Municipio, PR",Nov-22,4623,4256,367,7.90000000
CN7200300000000,72,003,"Aguada Municipio, PR",Nov-22,13270,12291,979,7.40000000
CN7200500000000,72,005,"Aguadilla Municipio, PR",Nov-22,16229,14812,1417,8.70000000
CN7200700000000,72,007,"Aguas Buenas Municipio, PR",Nov-22,7298,6842,456,6.20000000
CN7200900000000,72,009,"Aibonito Municipio, PR",Nov-22,7100,6610,490,6.90000000
CN7201100000000,72,011,"Anasco Municipio, PR",Nov-22,10014,9344,670,6.70000000
CN7201300000000,72,013,"Arecibo Municipio, PR",Nov-22,26400,24593,1807,6.80000000
CN7201500000000,72,015,"Arroyo Municipio, PR",Nov-22,5107,4696,411,8.00000000
CN7201700000000,72,017,"Barceloneta Municipio, PR",Nov-22,6571,6032,539,8.20000000
CN7201900000000,72,019,"Barranquitas Municipio, PR",Nov-22,8176,7572,604,7.40000000
CN7202100000000,72,021,"Bayamon Municipio, PR",Nov-22,72136,68456,3680,5.10000000
CN7202300000000,72,023,"Cabo Rojo Municipio, PR",Nov-22,15586,14474,1112,7.10000000
CN7202500000000,72,025,"Caguas Municipio, PR",Nov-22,52987,50425,2562,4.80000000
CN7202700000000,72,027,"Camuy Municipio, PR",Nov-22,10652,9938,714,6.70000000
CN7202900000000,72,029,"Canovanas Municipio, PR",Nov-22,18173,17238,935,5.10000000
CN7203100000000,72,031,"Carolina Municipio, PR",Nov-22,68106,64798,3308,4.90000000
CN7203300000000,72,033,"Catano Municipio, PR",Nov-22,8620,8149,471,5.50000000
CN7203500000000,72,035,"Cayey Municipio, PR",Nov-22,17924,17057,867,4.80000000
CN7203700000000,72,037,"Ceiba Municipio, PR",Nov-22,3987,3701,286,7.20000000
CN7203900000000,72,039,"Ciales Municipio, PR",Nov-22,4085,3749,336,8.20000000
CN7204100000000,72,041,"Cidra Municipio, PR",Nov-22,17131,16343,788,4.60000000
CN7204300000000,72,043,"Coamo Municipio, PR",Nov-22,11372,10453,919,8.10000000
CN7204500000000,72,045,"Comerio Municipio, PR",Nov-22,5482,5107,375,6.80000000
CN7204700000000,72,047,"Corozal Municipio, PR",Nov-22,9889,9126,763,7.70000000
CN7204900000000,72,049,"Culebra Municipio, PR",Nov-22,1026,1001,25,2.40000000
CN7205100000000,72,051,"Dorado Municipio, PR",Nov-22,14997,14377,620,4.10000000
CN7205300000000,72,053,"Fajardo Municipio, PR",Nov-22,11708,10905,803,6.90000000
CN7205400000000,72,054,"Florida Municipio, PR",Nov-22,3641,3340,301,8.30000000
CN7205500000000,72,055,"Guanica Municipio, PR",Nov-22,4295,3870,425,9.90000000
CN7205700000000,72,057,"Guayama Municipio, PR",Nov-22,12101,11232,869,7.20000000
CN7205900000000,72,059,"Guayanilla Municipio, PR",Nov-22,5427,4828,599,11.00000000
CN7206100000000,72,061,"Guaynabo Municipio, PR",Nov-22,42095,40861,1234,2.90000000
CN7206300000000,72,063,"Gurabo Municipio, PR",Nov-22,20860,20064,796,3.80000000
CN7206500000000,72,065,"Hatillo Municipio, PR",Nov-22,15436,13909,1527,9.90000000
CN7206700000000,72,067,"Hormigueros Municipio, PR",Nov-22,6046,5671,375,6.20000000
CN7206900000000,72,069,"Humacao Municipio, PR",Nov-22,19562,18328,1234,6.30000000
CN7207100000000,72,071,"Isabela Municipio, PR",Nov-22,13215,12298,917,6.90000000
CN7207300000000,72,073,"Jayuya Municipio, PR",Nov-22,4866,4389,477,9.80000000
CN7207500000000,72,075,"Juana Diaz Municipio, PR",Nov-22,17642,16339,1303,7.40000000
CN7207700000000,72,077,"Juncos Municipio, PR",Nov-22,13887,12968,919,6.60000000
CN7207900000000,72,079,"Lajas Municipio, PR",Nov-22,5926,5329,597,10.10000000
CN7208100000000,72,081,"Lares Municipio, PR",Nov-22,8244,7248,996,12.10000000
CN7208300000000,72,083,"Las Marias Municipio, PR",Nov-22,2998,2608,390,13.00000000
CN7208500000000,72,085,"Las Piedras Municipio, PR",Nov-22,12753,11988,765,6.00000000
CN7208700000000,72,087,"Loiza Municipio, PR",Nov-22,9229,8671,558,6.00000000
CN7208900000000,72,089,"Luquillo Municipio, PR",Nov-22,6828,6380,448,6.60000000
CN7209100000000,72,091,"Manati Municipio, PR",Nov-22,12549,11763,786,6.30000000
CN7209300000000,72,093,"Maricao Municipio, PR",Nov-22,2196,2005,191,8.70000000
CN7209500000000,72,095,"Maunabo Municipio, PR",Nov-22,3101,2804,297,9.60000000
CN7209700000000,72,097,"Mayaguez Municipio, PR",Nov-22,24344,22595,1749,7.20000000
CN7209900000000,72,099,"Moca Municipio, PR",Nov-22,11861,10793,1068,9.00000000
CN7210100000000,72,101,"Morovis Municipio, PR",Nov-22,9012,8359,653,7.20000000
CN7210300000000,72,103,"Naguabo Municipio, PR",Nov-22,9162,8625,537,5.90000000
CN7210500000000,72,105,"Naranjito Municipio, PR",Nov-22,7904,7311,593,7.50000000
CN7210700000000,72,107,"Orocovis Municipio, PR",Nov-22,5410,4950,460,8.50000000
CN7210900000000,72,109,"Patillas Municipio, PR",Nov-22,4576,4159,417,9.10000000
CN7211100000000,72,111,"Penuelas Municipio, PR",Nov-22,6384,5712,672,10.50000000
CN7211300000000,72,113,"Ponce Municipio, PR",Nov-22,50312,46525,3787,7.50000000
CN7211500000000,72,115,"Quebradillas Municipio, PR",Nov-22,6704,6158,546,8.10000000
CN7211700000000,72,117,"Rincon Municipio, PR",Nov-22,5382,4751,631,11.70000000
CN7211900000000,72,119,"Rio Grande Municipio, PR",Nov-22,18895,17852,1043,5.50000000
CN7212100000000,72,121,"Sabana Grande Municipio, PR",Nov-22,6602,6050,552,8.40000000
CN7212300000000,72,123,"Salinas Municipio, PR",Nov-22,7817,7081,736,9.40000000
CN7212500000000,72,125,"San German Municipio, PR",Nov-22,10717,9885,832,7.80000000
CN7212700000000,72,127,"San Juan Municipio, PR",Nov-22,148542,141610,6932,4.70000000
CN7212900000000,72,129,"San Lorenzo Municipio, PR",Nov-22,12858,12051,807,6.30000000
CN7213100000000,72,131,"San Sebastian Municipio, PR",Nov-22,11563,10333,1230,10.60000000
CN7213300000000,72,133,"Santa Isabel Municipio, PR",Nov-22,8815,7996,819,9.30000000
CN7213500000000,72,135,"Toa Alta Municipio, PR",Nov-22,30972,29605,1367,4.40000000
CN7213700000000,72,137,"Toa Baja Municipio, PR",Nov-22,32247,30727,1520,4.70000000
CN7213900000000,72,139,"Trujillo Alto Municipio, PR",Nov-22,30025,29040,985,3.30000000
CN7214100000000,72,141,"Utuado Municipio, PR",Nov-22,7413,6785,628,8.50000000
CN7214300000000,72,143,"Vega Alta Municipio, PR",Nov-22,10953,10167,786,7.20000000
CN7214500000000,72,145,"Vega Baja Municipio, PR",Nov-22,14697,13567,1130,7.70000000
CN7214700000000,72,147,"Vieques Municipio, PR",Nov-22,2739,2550,189,6.90000000
CN7214900000000,72,149,"Villalba Municipio, PR",Nov-22,8038,7165,873,10.90000000
CN7215100000000,72,151,"Yabucoa Municipio, PR",Nov-22,9477,8710,767,8.10000000
CN7215300000000,72,153,"Yauco Municipio, PR",Nov-22,10802,9663,1139,10.50000000
CN0100100000000,01,001,"Autauga County, AL",Dec-22 p,26823,26301,522,1.90000000
CN0100300000000,01,003,"Baldwin County, AL",Dec-22 p,99370,97273,2097,2.10000000
CN0100500000000,01,005,"Barbour County, AL",Dec-22 p,8634,8277,357,4.10000000
CN0100700000000,01,007,"Bibb County, AL",Dec-22 p,8770,8575,195,2.20000000
CN0100900000000,01,009,"Blount County, AL",Dec-22 p,25880,25413,467,1.80000000
CN0101100000000,01,011,"Bullock County, AL",Dec-22 p,4547,4434,113,2.50000000
CN0101300000000,01,013,"Butler County, AL",Dec-22 p,8899,8621,278,3.10000000
CN0101500000000,01,015,"Calhoun County, AL",Dec-22 p,46442,45326,1116,2.40000000
CN0101700000000,01,017,"Chambers County, AL",Dec-22 p,16008,15646,362,2.30000000
CN0101900000000,01,019,"Cherokee County, AL",Dec-22 p,11521,11278,243,2.10000000
CN0102100000000,01,021,"Chilton County, AL",Dec-22 p,20369,20000,369,1.80000000
CN0102300000000,01,023,"Choctaw County, AL",Dec-22 p,4610,4446,164,3.60000000
CN0102500000000,01,025,"Clarke County, AL",Dec-22 p,8048,7520,528,6.60000000
CN0102700000000,01,027,"Clay County, AL",Dec-22 p,6449,6314,135,2.10000000
CN0102900000000,01,029,"Cleburne County, AL",Dec-22 p,6316,6199,117,1.90000000
CN0103100000000,01,031,"Coffee County, AL",Dec-22 p,21952,21490,462,2.10000000
CN0103300000000,01,033,"Colbert County, AL",Dec-22 p,23766,23120,646,2.70000000
CN0103500000000,01,035,"Conecuh County, AL",Dec-22 p,4241,4106,135,3.20000000
CN0103700000000,01,037,"Coosa County, AL",Dec-22 p,4566,4467,99,2.20000000
CN0103900000000,01,039,"Covington County, AL",Dec-22 p,15443,15078,365,2.40000000
CN0104100000000,01,041,"Crenshaw County, AL",Dec-22 p,5906,5783,123,2.10000000
CN0104300000000,01,043,"Cullman County, AL",Dec-22 p,40709,40047,662,1.60000000
CN0104500000000,01,045,"Dale County, AL",Dec-22 p,21162,20674,488,2.30000000
CN0104700000000,01,047,"Dallas County, AL",Dec-22 p,13722,12989,733,5.30000000
CN0104900000000,01,049,"DeKalb County, AL",Dec-22 p,31970,31362,608,1.90000000
CN0105100000000,01,051,"Elmore County, AL",Dec-22 p,38268,37537,731,1.90000000
CN0105300000000,01,053,"Escambia County, AL",Dec-22 p,14437,13987,450,3.10000000
CN0105500000000,01,055,"Etowah County, AL",Dec-22 p,39204,38231,973,2.50000000
CN0105700000000,01,057,"Fayette County, AL",Dec-22 p,6605,6453,152,2.30000000
CN0105900000000,01,059,"Franklin County, AL",Dec-22 p,14935,14585,350,2.30000000
CN0106100000000,01,061,"Geneva County, AL",Dec-22 p,11216,11001,215,1.90000000
CN0106300000000,01,063,"Greene County, AL",Dec-22 p,2814,2698,116,4.10000000
CN0106500000000,01,065,"Hale County, AL",Dec-22 p,5982,5770,212,3.50000000
CN0106700000000,01,067,"Henry County, AL",Dec-22 p,6983,6830,153,2.20000000
CN0106900000000,01,069,"Houston County, AL",Dec-22 p,47625,46517,1108,2.30000000
CN0107100000000,01,071,"Jackson County, AL",Dec-22 p,23437,22945,492,2.10000000
CN0107300000000,01,073,"Jefferson County, AL",Dec-22 p,324078,317069,7009,2.20000000
CN0107500000000,01,075,"Lamar County, AL",Dec-22 p,5831,5691,140,2.40000000
CN0107700000000,01,077,"Lauderdale County, AL",Dec-22 p,42695,41719,976,2.30000000
CN0107900000000,01,079,"Lawrence County, AL",Dec-22 p,14585,14300,285,2.00000000
CN0108100000000,01,081,"Lee County, AL",Dec-22 p,78506,76949,1557,2.00000000
CN0108300000000,01,083,"Limestone County, AL",Dec-22 p,47685,46837,848,1.80000000
CN0108500000000,01,085,"Lowndes County, AL",Dec-22 p,3537,3355,182,5.10000000
CN0108700000000,01,087,"Macon County, AL",Dec-22 p,7904,7644,260,3.30000000
CN0108900000000,01,089,"Madison County, AL",Dec-22 p,196329,192759,3570,1.80000000
CN0109100000000,01,091,"Marengo County, AL",Dec-22 p,7850,7610,240,3.10000000
CN0109300000000,01,093,"Marion County, AL",Dec-22 p,14132,13781,351,2.50000000
CN0109500000000,01,095,"Marshall County, AL",Dec-22 p,45678,44906,772,1.70000000
CN0109700000000,01,097,"Mobile County, AL",Dec-22 p,190953,185269,5684,3.00000000
CN0109900000000,01,099,"Monroe County, AL",Dec-22 p,7583,7287,296,3.90000000
CN0110100000000,01,101,"Montgomery County, AL",Dec-22 p,107447,104411,3036,2.80000000
CN0110300000000,01,103,"Morgan County, AL",Dec-22 p,60185,59154,1031,1.70000000
CN0110500000000,01,105,"Perry County, AL",Dec-22 p,3199,3035,164,5.10000000
CN0110700000000,01,107,"Pickens County, AL",Dec-22 p,7641,7434,207,2.70000000
CN0110900000000,01,109,"Pike County, AL",Dec-22 p,16441,16067,374,2.30000000
CN0111100000000,01,111,"Randolph County, AL",Dec-22 p,9821,9618,203,2.10000000
CN0111300000000,01,113,"Russell County, AL",Dec-22 p,23874,23327,547,2.30000000
CN0111500000000,01,115,"St. Clair County, AL",Dec-22 p,42308,41553,755,1.80000000
CN0111700000000,01,117,"Shelby County, AL",Dec-22 p,121735,119900,1835,1.50000000
CN0111900000000,01,119,"Sumter County, AL",Dec-22 p,4608,4482,126,2.70000000
CN0112100000000,01,121,"Talladega County, AL",Dec-22 p,36648,35669,979,2.70000000
CN0112300000000,01,123,"Tallapoosa County, AL",Dec-22 p,17993,17568,425,2.40000000
CN0112500000000,01,125,"Tuscaloosa County, AL",Dec-22 p,102495,100375,2120,2.10000000
CN0112700000000,01,127,"Walker County, AL",Dec-22 p,25598,24999,599,2.30000000
CN0112900000000,01,129,"Washington County, AL",Dec-22 p,6680,6416,264,4.00000000
CN0113100000000,01,131,"Wilcox County, AL",Dec-22 p,2662,2419,243,9.10000000
CN0113300000000,01,133,"Winston County, AL",Dec-22 p,10396,10165,231,2.20000000
CN0201300000000,02,013,"Aleutians East Borough, AK",Dec-22 p,1055,1001,54,5.10000000
CN0201600000000,02,016,"Aleutians West Census Area, AK",Dec-22 p,2706,2586,120,4.40000000
CN0202000000000,02,020,"Anchorage Borough/municipality, AK",Dec-22 p,155471,150605,4866,3.10000000
CN0205000000000,02,050,"Bethel Census Area, AK",Dec-22 p,7266,6660,606,8.30000000
CN0206000000000,02,060,"Bristol Bay Borough, AK",Dec-22 p,253,232,21,8.30000000
CN0206300000000,02,063,"Chugach Census Area, AK",Dec-22 p,2891,2778,113,3.90000000
CN0206600000000,02,066,"Copper River Census Area, AK",Dec-22 p,1252,1081,171,13.70000000
CN0206800000000,02,068,"Denali Borough, AK",Dec-22 p,603,521,82,13.60000000
CN0207000000000,02,070,"Dillingham Census Area, AK",Dec-22 p,1716,1622,94,5.50000000
CN0209000000000,02,090,"Fairbanks North Star Borough, AK",Dec-22 p,46672,44975,1697,3.60000000
CN0210000000000,02,100,"Haines Borough, AK",Dec-22 p,905,817,88,9.70000000
CN0210500000000,02,105,"Hoonah-Angoon Census Area, AK",Dec-22 p,1053,947,106,10.10000000
CN0211000000000,02,110,"Juneau Borough/city, AK",Dec-22 p,16500,16017,483,2.90000000
CN0212200000000,02,122,"Kenai Peninsula Borough, AK",Dec-22 p,27194,25767,1427,5.20000000
CN0213000000000,02,130,"Ketchikan Gateway Borough, AK",Dec-22 p,6176,5889,287,4.60000000
CN0215000000000,02,150,"Kodiak Island Borough, AK",Dec-22 p,5376,5020,356,6.60000000
CN0215800000000,02,158,"Kusilvak Census Area, AK",Dec-22 p,2573,2237,336,13.10000000
CN0216400000000,02,164,"Lake and Peninsula Borough, AK",Dec-22 p,594,549,45,7.60000000
CN0217000000000,02,170,"Matanuska-Susitna Borough, AK",Dec-22 p,51374,48964,2410,4.70000000
CN0218000000000,02,180,"Nome Census Area, AK",Dec-22 p,4213,3932,281,6.70000000
CN0218500000000,02,185,"North Slope Borough, AK",Dec-22 p,3046,2902,144,4.70000000
CN0218800000000,02,188,"Northwest Arctic Borough, AK",Dec-22 p,2966,2680,286,9.60000000
CN0219500000000,02,195,"Petersburg Borough, AK",Dec-22 p,1319,1225,94,7.10000000
CN0219800000000,02,198,"Prince of Wales-Hyder Census Area, AK",Dec-22 p,2631,2475,156,5.90000000
CN0222000000000,02,220,"Sitka Borough/city, AK",Dec-22 p,4291,4170,121,2.80000000
CN0223000000000,02,230,"Skagway Municipality, AK",Dec-22 p,582,506,76,13.10000000
CN0224000000000,02,240,"Southeast Fairbanks Census Area, AK",Dec-22 p,3287,3115,172,5.20000000
CN0227500000000,02,275,"Wrangell Borough/city, AK",Dec-22 p,899,846,53,5.90000000
CN0228200000000,02,282,"Yakutat Borough/city, AK",Dec-22 p,273,255,18,6.60000000
CN0229000000000,02,290,"Yukon-Koyukuk Census Area, AK",Dec-22 p,2364,2158,206,8.70000000
CN0400100000000,04,001,"Apache County, AZ",Dec-22 p,18351,16945,1406,7.70000000
CN0400300000000,04,003,"Cochise County, AZ",Dec-22 p,49874,48087,1787,3.60000000
CN0400500000000,04,005,"Coconino County, AZ",Dec-22 p,76606,73676,2930,3.80000000
CN0400700000000,04,007,"Gila County, AZ",Dec-22 p,20481,19793,688,3.40000000
CN0400900000000,04,009,"Graham County, AZ",Dec-22 p,16384,15936,448,2.70000000
CN0401100000000,04,011,"Greenlee County, AZ",Dec-22 p,4389,4282,107,2.40000000
CN0401200000000,04,012,"La Paz County, AZ",Dec-22 p,9636,9254,382,4.00000000
CN0401300000000,04,013,"Maricopa County, AZ",Dec-22 p,2388522,2324785,63737,2.70000000
CN0401500000000,04,015,"Mohave County, AZ",Dec-22 p,89448,85949,3499,3.90000000
CN0401700000000,04,017,"Navajo County, AZ",Dec-22 p,39875,37897,1978,5.00000000
CN0401900000000,04,019,"Pima County, AZ",Dec-22 p,492280,477224,15056,3.10000000
CN0402100000000,04,021,"Pinal County, AZ",Dec-22 p,201834,195518,6316,3.10000000
CN0402300000000,04,023,"Santa Cruz County, AZ",Dec-22 p,20246,18826,1420,7.00000000
CN0402500000000,04,025,"Yavapai County, AZ",Dec-22 p,109004,106045,2959,2.70000000
CN0402700000000,04,027,"Yuma County, AZ",Dec-22 p,105123,90743,14380,13.70000000
CN0500100000000,05,001,"Arkansas County, AR",Dec-22 p,9476,9233,243,2.60000000
CN0500300000000,05,003,"Ashley County, AR",Dec-22 p,6613,6215,398,6.00000000
CN0500500000000,05,005,"Baxter County, AR",Dec-22 p,16577,16051,526,3.20000000
CN0500700000000,05,007,"Benton County, AR",Dec-22 p,146786,143701,3085,2.10000000
CN0500900000000,05,009,"Boone County, AR",Dec-22 p,15705,15292,413,2.60000000
CN0501100000000,05,011,"Bradley County, AR",Dec-22 p,4015,3821,194,4.80000000
CN0501300000000,05,013,"Calhoun County, AR",Dec-22 p,2330,2262,68,2.90000000
CN0501500000000,05,015,"Carroll County, AR",Dec-22 p,12272,11949,323,2.60000000
CN0501700000000,05,017,"Chicot County, AR",Dec-22 p,2816,2650,166,5.90000000
CN0501900000000,05,019,"Clark County, AR",Dec-22 p,8537,8188,349,4.10000000
CN0502100000000,05,021,"Clay County, AR",Dec-22 p,5263,5057,206,3.90000000
CN0502300000000,05,023,"Cleburne County, AR",Dec-22 p,8795,8465,330,3.80000000
CN0502500000000,05,025,"Cleveland County, AR",Dec-22 p,3071,2976,95,3.10000000
CN0502700000000,05,027,"Columbia County, AR",Dec-22 p,8764,8395,369,4.20000000
CN0502900000000,05,029,"Conway County, AR",Dec-22 p,8402,8131,271,3.20000000
CN0503100000000,05,031,"Craighead County, AR",Dec-22 p,56859,55544,1315,2.30000000
CN0503300000000,05,033,"Crawford County, AR",Dec-22 p,26066,25383,683,2.60000000
CN0503500000000,05,035,"Crittenden County, AR",Dec-22 p,20804,20048,756,3.60000000
CN0503700000000,05,037,"Cross County, AR",Dec-22 p,6716,6499,217,3.20000000
CN0503900000000,05,039,"Dallas County, AR",Dec-22 p,2671,2570,101,3.80000000
CN0504100000000,05,041,"Desha County, AR",Dec-22 p,4885,4636,249,5.10000000
CN0504300000000,05,043,"Drew County, AR",Dec-22 p,7074,6776,298,4.20000000
CN0504500000000,05,045,"Faulkner County, AR",Dec-22 p,62105,60479,1626,2.60000000
CN0504700000000,05,047,"Franklin County, AR",Dec-22 p,7332,7140,192,2.60000000
CN0504900000000,05,049,"Fulton County, AR",Dec-22 p,4862,4721,141,2.90000000
CN0505100000000,05,051,"Garland County, AR",Dec-22 p,40743,39301,1442,3.50000000
CN0505300000000,05,053,"Grant County, AR",Dec-22 p,8272,8065,207,2.50000000
CN0505500000000,05,055,"Greene County, AR",Dec-22 p,19387,18848,539,2.80000000
CN0505700000000,05,057,"Hempstead County, AR",Dec-22 p,9187,8915,272,3.00000000
CN0505900000000,05,059,"Hot Spring County, AR",Dec-22 p,13530,13135,395,2.90000000
CN0506100000000,05,061,"Howard County, AR",Dec-22 p,5312,5158,154,2.90000000
CN0506300000000,05,063,"Independence County, AR",Dec-22 p,16590,16115,475,2.90000000
CN0506500000000,05,065,"Izard County, AR",Dec-22 p,4566,4315,251,5.50000000
CN0506700000000,05,067,"Jackson County, AR",Dec-22 p,5331,5053,278,5.20000000
CN0506900000000,05,069,"Jefferson County, AR",Dec-22 p,26014,24732,1282,4.90000000
CN0507100000000,05,071,"Johnson County, AR",Dec-22 p,10074,9714,360,3.60000000
CN0507300000000,05,073,"Lafayette County, AR",Dec-22 p,2255,2144,111,4.90000000
CN0507500000000,05,075,"Lawrence County, AR",Dec-22 p,6654,6447,207,3.10000000
CN0507700000000,05,077,"Lee County, AR",Dec-22 p,2464,2347,117,4.70000000
CN0507900000000,05,079,"Lincoln County, AR",Dec-22 p,3674,3534,140,3.80000000
CN0508100000000,05,081,"Little River County, AR",Dec-22 p,5339,5181,158,3.00000000
CN0508300000000,05,083,"Logan County, AR",Dec-22 p,8116,7841,275,3.40000000
CN0508500000000,05,085,"Lonoke County, AR",Dec-22 p,33513,32718,795,2.40000000
CN0508700000000,05,087,"Madison County, AR",Dec-22 p,7424,7264,160,2.20000000
CN0508900000000,05,089,"Marion County, AR",Dec-22 p,6226,6007,219,3.50000000
CN0509100000000,05,091,"Miller County, AR",Dec-22 p,19234,18628,606,3.20000000
CN0509300000000,05,093,"Mississippi County, AR",Dec-22 p,16267,15440,827,5.10000000
CN0509500000000,05,095,"Monroe County, AR",Dec-22 p,2448,2343,105,4.30000000
CN0509700000000,05,097,"Montgomery County, AR",Dec-22 p,2650,2519,131,4.90000000
CN0509900000000,05,099,"Nevada County, AR",Dec-22 p,3394,3280,114,3.40000000
CN0510100000000,05,101,"Newton County, AR",Dec-22 p,3130,3046,84,2.70000000
CN0510300000000,05,103,"Ouachita County, AR",Dec-22 p,9604,9268,336,3.50000000
CN0510500000000,05,105,"Perry County, AR",Dec-22 p,4117,3993,124,3.00000000
CN0510700000000,05,107,"Phillips County, AR",Dec-22 p,5430,5035,395,7.30000000
CN0510900000000,05,109,"Pike County, AR",Dec-22 p,3993,3873,120,3.00000000
CN0511100000000,05,111,"Poinsett County, AR",Dec-22 p,9739,9457,282,2.90000000
CN0511300000000,05,113,"Polk County, AR",Dec-22 p,7598,7347,251,3.30000000
CN0511500000000,05,115,"Pope County, AR",Dec-22 p,27404,26436,968,3.50000000
CN0511700000000,05,117,"Prairie County, AR",Dec-22 p,3443,3361,82,2.40000000
CN0511900000000,05,119,"Pulaski County, AR",Dec-22 p,186548,180899,5649,3.00000000
CN0512100000000,05,121,"Randolph County, AR",Dec-22 p,7026,6813,213,3.00000000
CN0512300000000,05,123,"St. Francis County, AR",Dec-22 p,7481,7131,350,4.70000000
CN0512500000000,05,125,"Saline County, AR",Dec-22 p,59085,57689,1396,2.40000000
CN0512700000000,05,127,"Scott County, AR",Dec-22 p,4006,3917,89,2.20000000
CN0512900000000,05,129,"Searcy County, AR",Dec-22 p,2872,2755,117,4.10000000
CN0513100000000,05,131,"Sebastian County, AR",Dec-22 p,54962,53556,1406,2.60000000
CN0513300000000,05,133,"Sevier County, AR",Dec-22 p,5345,5172,173,3.20000000
CN0513500000000,05,135,"Sharp County, AR",Dec-22 p,5778,5572,206,3.60000000
CN0513700000000,05,137,"Stone County, AR",Dec-22 p,4370,4196,174,4.00000000
CN0513900000000,05,139,"Union County, AR",Dec-22 p,14715,14034,681,4.60000000
CN0514100000000,05,141,"Van Buren County, AR",Dec-22 p,5862,5630,232,4.00000000
CN0514300000000,05,143,"Washington County, AR",Dec-22 p,129608,127053,2555,2.00000000
CN0514500000000,05,145,"White County, AR",Dec-22 p,33969,32972,997,2.90000000
CN0514700000000,05,147,"Woodruff County, AR",Dec-22 p,2736,2645,91,3.30000000
CN0514900000000,05,149,"Yell County, AR",Dec-22 p,7744,7473,271,3.50000000
CN0600100000000,06,001,"Alameda County, CA",Dec-22 p,831134,808388,22746,2.70000000
CN0600300000000,06,003,"Alpine County, CA",Dec-22 p,578,554,24,4.20000000
CN0600500000000,06,005,"Amador County, CA",Dec-22 p,14167,13584,583,4.10000000
CN0600700000000,06,007,"Butte County, CA",Dec-22 p,92616,88869,3747,4.00000000
CN0600900000000,06,009,"Calaveras County, CA",Dec-22 p,21904,21214,690,3.20000000
CN0601100000000,06,011,"Colusa County, CA",Dec-22 p,10720,9413,1307,12.20000000
CN0601300000000,06,013,"Contra Costa County, CA",Dec-22 p,554659,538444,16215,2.90000000
CN0601500000000,06,015,"Del Norte County, CA",Dec-22 p,9244,8805,439,4.70000000
CN0601700000000,06,017,"El Dorado County, CA",Dec-22 p,92511,89888,2623,2.80000000
CN0601900000000,06,019,"Fresno County, CA",Dec-22 p,450426,422304,28122,6.20000000
CN0602100000000,06,021,"Glenn County, CA",Dec-22 p,12711,12056,655,5.20000000
CN0602300000000,06,023,"Humboldt County, CA",Dec-22 p,60537,58506,2031,3.40000000
CN0602500000000,06,025,"Imperial County, CA",Dec-22 p,70917,60448,10469,14.80000000
CN0602700000000,06,027,"Inyo County, CA",Dec-22 p,8236,7979,257,3.10000000
CN0602900000000,06,029,"Kern County, CA",Dec-22 p,388872,363011,25861,6.70000000
CN0603100000000,06,031,"Kings County, CA",Dec-22 p,56525,52676,3849,6.80000000
CN0603300000000,06,033,"Lake County, CA",Dec-22 p,28127,26700,1427,5.10000000
CN0603500000000,06,035,"Lassen County, CA",Dec-22 p,8886,8526,360,4.10000000
CN0603700000000,06,037,"Los Angeles County, CA",Dec-22,4965511,4747043,218468,4.40000000
CN0603900000000,06,039,"Madera County, CA",Dec-22 p,63578,59775,3803,6.00000000
CN0604100000000,06,041,"Marin County, CA",Dec-22 p,128787,126018,2769,2.20000000
CN0604300000000,06,043,"Mariposa County, CA",Dec-22 p,6657,6356,301,4.50000000
CN0604500000000,06,045,"Mendocino County, CA",Dec-22 p,37512,36093,1419,3.80000000
CN0604700000000,06,047,"Merced County, CA",Dec-22 p,115421,106856,8565,7.40000000
CN0604900000000,06,049,"Modoc County, CA",Dec-22 p,3122,2953,169,5.40000000
CN0605100000000,06,051,"Mono County, CA",Dec-22 p,8879,8593,286,3.20000000
CN0605300000000,06,053,"Monterey County, CA",Dec-22 p,200340,186480,13860,6.90000000
CN0605500000000,06,055,"Napa County, CA",Dec-22 p,67404,65415,1989,3.00000000
CN0605700000000,06,057,"Nevada County, CA",Dec-22 p,48638,47271,1367,2.80000000
CN0605900000000,06,059,"Orange County, CA",Dec-22 p,1604854,1564182,40672,2.50000000
CN0606100000000,06,061,"Placer County, CA",Dec-22 p,192187,187354,4833,2.50000000
CN0606300000000,06,063,"Plumas County, CA",Dec-22 p,7093,6601,492,6.90000000
CN0606500000000,06,065,"Riverside County, CA",Dec-22 p,1173420,1130494,42926,3.70000000
CN0606700000000,06,067,"Sacramento County, CA",Dec-22 p,722404,697111,25293,3.50000000
CN0606900000000,06,069,"San Benito County, CA",Dec-22 p,32973,31445,1528,4.60000000
CN0607100000000,06,071,"San Bernardino County, CA",Dec-22 p,1026776,990124,36652,3.60000000
CN0607300000000,06,073,"San Diego County, CA",Dec-22 p,1588968,1543381,45587,2.90000000
CN0607500000000,06,075,"San Francisco County/city, CA",Dec-22 p,578421,566695,11726,2.00000000
CN0607700000000,06,077,"San Joaquin County, CA",Dec-22 p,337730,320221,17509,5.20000000
CN0607900000000,06,079,"San Luis Obispo County, CA",Dec-22 p,136057,132761,3296,2.40000000
CN0608100000000,06,081,"San Mateo County, CA",Dec-22 p,457565,449007,8558,1.90000000
CN0608300000000,06,083,"Santa Barbara County, CA",Dec-22 p,222256,215475,6781,3.10000000
CN0608500000000,06,085,"Santa Clara County, CA",Dec-22 p,1060507,1038807,21700,2.00000000
CN0608700000000,06,087,"Santa Cruz County, CA",Dec-22 p,133454,127414,6040,4.50000000
CN0608900000000,06,089,"Shasta County, CA",Dec-22 p,73387,70406,2981,4.10000000
CN0609100000000,06,091,"Sierra County, CA",Dec-22 p,1333,1285,48,3.60000000
CN0609300000000,06,093,"Siskiyou County, CA",Dec-22 p,15694,14795,899,5.70000000
CN0609500000000,06,095,"Solano County, CA",Dec-22 p,200722,193059,7663,3.80000000
CN0609700000000,06,097,"Sonoma County, CA",Dec-22 p,248408,242101,6307,2.50000000
CN0609900000000,06,099,"Stanislaus County, CA",Dec-22 p,236180,223722,12458,5.30000000
CN0610100000000,06,101,"Sutter County, CA",Dec-22 p,44718,41680,3038,6.80000000
CN0610300000000,06,103,"Tehama County, CA",Dec-22 p,25301,24145,1156,4.60000000
CN0610500000000,06,105,"Trinity County, CA",Dec-22 p,4310,4107,203,4.70000000
CN0610700000000,06,107,"Tulare County, CA",Dec-22 p,203906,187181,16725,8.20000000
CN0610900000000,06,109,"Tuolumne County, CA",Dec-22 p,19635,18857,778,4.00000000
CN0611100000000,06,111,"Ventura County, CA",Dec-22 p,412678,399303,13375,3.20000000
CN0611300000000,06,113,"Yolo County, CA",Dec-22 p,108409,104547,3862,3.60000000
CN0611500000000,06,115,"Yuba County, CA",Dec-22 p,30839,29126,1713,5.60000000
CN0800100000000,08,001,"Adams County, CO",Dec-22 p,283922,274863,9059,3.20000000
CN0800300000000,08,003,"Alamosa County, CO",Dec-22 p,8301,8014,287,3.50000000
CN0800500000000,08,005,"Arapahoe County, CO",Dec-22 p,377449,366823,10626,2.80000000
CN0800700000000,08,007,"Archuleta County, CO",Dec-22 p,6958,6765,193,2.80000000
CN0800900000000,08,009,"Baca County, CO",Dec-22 p,2121,2090,31,1.50000000
CN0801100000000,08,011,"Bent County, CO",Dec-22 p,1972,1910,62,3.10000000
CN0801300000000,08,013,"Boulder County, CO",Dec-22 p,201887,197458,4429,2.20000000
CN0801400000000,08,014,"Broomfield County/city, CO",Dec-22 p,42706,41695,1011,2.40000000
CN0801500000000,08,015,"Chaffee County, CO",Dec-22 p,10216,9962,254,2.50000000
CN0801700000000,08,017,"Cheyenne County, CO",Dec-22 p,1149,1129,20,1.70000000
CN0801900000000,08,019,"Clear Creek County, CO",Dec-22 p,6199,6033,166,2.70000000
CN0802100000000,08,021,"Conejos County, CO",Dec-22 p,4040,3929,111,2.70000000
CN0802300000000,08,023,"Costilla County, CO",Dec-22 p,1900,1824,76,4.00000000
CN0802500000000,08,025,"Crowley County, CO",Dec-22 p,1377,1328,49,3.60000000
CN0802700000000,08,027,"Custer County, CO",Dec-22 p,2491,2426,65,2.60000000
CN0802900000000,08,029,"Delta County, CO",Dec-22 p,13622,13179,443,3.30000000
CN0803100000000,08,031,"Denver County/city, CO",Dec-22 p,439359,426400,12959,2.90000000
CN0803300000000,08,033,"Dolores County, CO",Dec-22 p,1172,1142,30,2.60000000
CN0803500000000,08,035,"Douglas County, CO",Dec-22 p,208919,204200,4719,2.30000000
CN0803700000000,08,037,"Eagle County, CO",Dec-22 p,39949,39162,787,2.00000000
CN0803900000000,08,039,"Elbert County, CO",Dec-22 p,16169,15836,333,2.10000000
CN0804100000000,08,041,"El Paso County, CO",Dec-22 p,354571,343967,10604,3.00000000
CN0804300000000,08,043,"Fremont County, CO",Dec-22 p,14936,14286,650,4.40000000
CN0804500000000,08,045,"Garfield County, CO",Dec-22 p,32575,31738,837,2.60000000
CN0804700000000,08,047,"Gilpin County, CO",Dec-22 p,3962,3861,101,2.50000000
CN0804900000000,08,049,"Grand County, CO",Dec-22 p,10283,10053,230,2.20000000
CN0805100000000,08,051,"Gunnison County, CO",Dec-22 p,12017,11755,262,2.20000000
CN0805300000000,08,053,"Hinsdale County, CO",Dec-22 p,453,442,11,2.40000000
CN0805500000000,08,055,"Huerfano County, CO",Dec-22 p,2571,2413,158,6.10000000
CN0805700000000,08,057,"Jackson County, CO",Dec-22 p,960,942,18,1.90000000
CN0805900000000,08,059,"Jefferson County, CO",Dec-22 p,345099,336458,8641,2.50000000
CN0806100000000,08,061,"Kiowa County, CO",Dec-22 p,923,908,15,1.60000000
CN0806300000000,08,063,"Kit Carson County, CO",Dec-22 p,4168,4104,64,1.50000000
CN0806500000000,08,065,"Lake County, CO",Dec-22 p,5360,5255,105,2.00000000
CN0806700000000,08,067,"La Plata County, CO",Dec-22 p,29889,29014,875,2.90000000
CN0806900000000,08,069,"Larimer County, CO",Dec-22 p,212087,207057,5030,2.40000000
CN0807100000000,08,071,"Las Animas County, CO",Dec-22 p,6247,5958,289,4.60000000
CN0807300000000,08,073,"Lincoln County, CO",Dec-22 p,2270,2207,63,2.80000000
CN0807500000000,08,075,"Logan County, CO",Dec-22 p,10488,10257,231,2.20000000
CN0807700000000,08,077,"Mesa County, CO",Dec-22 p,78036,75581,2455,3.10000000
CN0807900000000,08,079,"Mineral County, CO",Dec-22 p,456,446,10,2.20000000
CN0808100000000,08,081,"Moffat County, CO",Dec-22 p,6783,6571,212,3.10000000
CN0808300000000,08,083,"Montezuma County, CO",Dec-22 p,13059,12610,449,3.40000000
CN0808500000000,08,085,"Montrose County, CO",Dec-22 p,22482,21835,647,2.90000000
CN0808700000000,08,087,"Morgan County, CO",Dec-22 p,15558,15140,418,2.70000000
CN0808900000000,08,089,"Otero County, CO",Dec-22 p,7918,7616,302,3.80000000
CN0809100000000,08,091,"Ouray County, CO",Dec-22 p,2802,2732,70,2.50000000
CN0809300000000,08,093,"Park County, CO",Dec-22 p,11757,11471,286,2.40000000
CN0809500000000,08,095,"Phillips County, CO",Dec-22 p,2537,2499,38,1.50000000
CN0809700000000,08,097,"Pitkin County, CO",Dec-22 p,11140,10847,293,2.60000000
CN0809900000000,08,099,"Prowers County, CO",Dec-22 p,6318,6174,144,2.30000000
CN0810100000000,08,101,"Pueblo County, CO",Dec-22 p,78452,75099,3353,4.30000000
CN0810300000000,08,103,"Rio Blanco County, CO",Dec-22 p,2738,2644,94,3.40000000
CN0810500000000,08,105,"Rio Grande County, CO",Dec-22 p,5300,5088,212,4.00000000
CN0810700000000,08,107,"Routt County, CO",Dec-22 p,16011,15667,344,2.10000000
CN0810900000000,08,109,"Saguache County, CO",Dec-22 p,3482,3377,105,3.00000000
CN0811100000000,08,111,"San Juan County, CO",Dec-22 p,634,617,17,2.70000000
CN0811300000000,08,113,"San Miguel County, CO",Dec-22 p,7050,6892,158,2.20000000
CN0811500000000,08,115,"Sedgwick County, CO",Dec-22 p,1185,1158,27,2.30000000
CN0811700000000,08,117,"Summit County, CO",Dec-22 p,25007,24593,414,1.70000000
CN0811900000000,08,119,"Teller County, CO",Dec-22 p,13282,12922,360,2.70000000
CN0812100000000,08,121,"Washington County, CO",Dec-22 p,2742,2684,58,2.10000000
CN0812300000000,08,123,"Weld County, CO",Dec-22 p,168716,163640,5076,3.00000000
CN0812500000000,08,125,"Yuma County, CO",Dec-22 p,5795,5707,88,1.50000000
CN0900100000000,09,001,"Fairfield County, CT",Dec-22 p,472451,457720,14731,3.10000000
CN0900300000000,09,003,"Hartford County, CT",Dec-22 p,473917,458894,15023,3.20000000
CN0900500000000,09,005,"Litchfield County, CT",Dec-22 p,102946,99990,2956,2.90000000
CN0900700000000,09,007,"Middlesex County, CT",Dec-22 p,93029,90548,2481,2.70000000
CN0900900000000,09,009,"New Haven County, CT",Dec-22 p,462342,447227,15115,3.30000000
CN0901100000000,09,011,"New London County, CT",Dec-22 p,129323,125082,4241,3.30000000
CN0901300000000,09,013,"Tolland County, CT",Dec-22 p,85688,83319,2369,2.80000000
CN0901500000000,09,015,"Windham County, CT",Dec-22 p,62650,60656,1994,3.20000000
CN1000100000000,10,001,"Kent County, DE",Dec-22 p,80565,76870,3695,4.60000000
CN1000300000000,10,003,"New Castle County, DE",Dec-22 p,304146,292682,11464,3.80000000
CN1000500000000,10,005,"Sussex County, DE",Dec-22 p,109644,104925,4719,4.30000000
CN1100100000000,11,001,District of Columbia,Dec-22,386520,370787,15733,4.10000000
CN1200100000000,12,001,"Alachua County, FL",Dec-22 p,143887,140968,2919,2.00000000
CN1200300000000,12,003,"Baker County, FL",Dec-22 p,12864,12608,256,2.00000000
CN1200500000000,12,005,"Bay County, FL",Dec-22 p,88846,86933,1913,2.20000000
CN1200700000000,12,007,"Bradford County, FL",Dec-22 p,11030,10776,254,2.30000000
CN1200900000000,12,009,"Brevard County, FL",Dec-22 p,302325,295643,6682,2.20000000
CN1201100000000,12,011,"Broward County, FL",Dec-22 p,1066747,1043555,23192,2.20000000
CN1201300000000,12,013,"Calhoun County, FL",Dec-22 p,5016,4900,116,2.30000000
CN1201500000000,12,015,"Charlotte County, FL",Dec-22 p,77567,75227,2340,3.00000000
CN1201700000000,12,017,"Citrus County, FL",Dec-22 p,47332,45684,1648,3.50000000
CN1201900000000,12,019,"Clay County, FL",Dec-22 p,115163,112880,2283,2.00000000
CN1202100000000,12,021,"Collier County, FL",Dec-22 p,189173,185072,4101,2.20000000
CN1202300000000,12,023,"Columbia County, FL",Dec-22 p,29798,29096,702,2.40000000
CN1202700000000,12,027,"DeSoto County, FL",Dec-22 p,15391,15027,364,2.40000000
CN1202900000000,12,029,"Dixie County, FL",Dec-22 p,6002,5849,153,2.50000000
CN1203100000000,12,031,"Duval County, FL",Dec-22 p,522080,510212,11868,2.30000000
CN1203300000000,12,033,"Escambia County, FL",Dec-22 p,149773,146121,3652,2.40000000
CN1203500000000,12,035,"Flagler County, FL",Dec-22 p,50522,49152,1370,2.70000000
CN1203700000000,12,037,"Franklin County, FL",Dec-22 p,4639,4533,106,2.30000000
CN1203900000000,12,039,"Gadsden County, FL",Dec-22 p,21386,20804,582,2.70000000
CN1204100000000,12,041,"Gilchrist County, FL",Dec-22 p,7471,7303,168,2.20000000
CN1204300000000,12,043,"Glades County, FL",Dec-22 p,5321,5200,121,2.30000000
CN1204500000000,12,045,"Gulf County, FL",Dec-22 p,5462,5351,111,2.00000000
CN1204700000000,12,047,"Hamilton County, FL",Dec-22 p,4133,4003,130,3.10000000
CN1204900000000,12,049,"Hardee County, FL",Dec-22 p,9111,8880,231,2.50000000
CN1205100000000,12,051,"Hendry County, FL",Dec-22 p,16294,15778,516,3.20000000
CN1205300000000,12,053,"Hernando County, FL",Dec-22 p,77036,74882,2154,2.80000000
CN1205500000000,12,055,"Highlands County, FL",Dec-22 p,34426,33180,1246,3.60000000
CN1205700000000,12,057,"Hillsborough County, FL",Dec-22 p,812239,794870,17369,2.10000000
CN1205900000000,12,059,"Holmes County, FL",Dec-22 p,7111,6950,161,2.30000000
CN1206100000000,12,061,"Indian River County, FL",Dec-22 p,67311,65565,1746,2.60000000
CN1206300000000,12,063,"Jackson County, FL",Dec-22 p,17389,16978,411,2.40000000
CN1206500000000,12,065,"Jefferson County, FL",Dec-22 p,5835,5702,133,2.30000000
CN1206700000000,12,067,"Lafayette County, FL",Dec-22 p,2764,2702,62,2.20000000
CN1206900000000,12,069,"Lake County, FL",Dec-22 p,169387,165339,4048,2.40000000
CN1207100000000,12,071,"Lee County, FL",Dec-22 p,377849,366908,10941,2.90000000
CN1207300000000,12,073,"Leon County, FL",Dec-22 p,161138,157604,3534,2.20000000
CN1207500000000,12,075,"Levy County, FL",Dec-22 p,17174,16743,431,2.50000000
CN1207700000000,12,077,"Liberty County, FL",Dec-22 p,2640,2580,60,2.30000000
CN1207900000000,12,079,"Madison County, FL",Dec-22 p,7953,7758,195,2.50000000
CN1208100000000,12,081,"Manatee County, FL",Dec-22 p,191188,187054,4134,2.20000000
CN1208300000000,12,083,"Marion County, FL",Dec-22 p,144671,140675,3996,2.80000000
CN1208500000000,12,085,"Martin County, FL",Dec-22 p,76645,75082,1563,2.00000000
CN1208600000000,12,086,"Miami-Dade County, FL",Dec-22,1397307,1369536,27771,2.00000000
CN1208700000000,12,087,"Monroe County, FL",Dec-22 p,52256,51544,712,1.40000000
CN1208900000000,12,089,"Nassau County, FL",Dec-22 p,45585,44687,898,2.00000000
CN1209100000000,12,091,"Okaloosa County, FL",Dec-22 p,101571,99643,1928,1.90000000
CN1209300000000,12,093,"Okeechobee County, FL",Dec-22 p,17644,17248,396,2.20000000
CN1209500000000,12,095,"Orange County, FL",Dec-22 p,782449,764737,17712,2.30000000
CN1209700000000,12,097,"Osceola County, FL",Dec-22 p,194906,189494,5412,2.80000000
CN1209900000000,12,099,"Palm Beach County, FL",Dec-22 p,768265,751604,16661,2.20000000
CN1210100000000,12,101,"Pasco County, FL",Dec-22 p,259377,253197,6180,2.40000000
CN1210300000000,12,103,"Pinellas County, FL",Dec-22 p,512843,502156,10687,2.10000000
CN1210500000000,12,105,"Polk County, FL",Dec-22 p,339911,330611,9300,2.70000000
CN1210700000000,12,107,"Putnam County, FL",Dec-22 p,27390,26509,881,3.20000000
CN1210900000000,12,109,"St. Johns County, FL",Dec-22 p,151872,149163,2709,1.80000000
CN1211100000000,12,111,"St. Lucie County, FL",Dec-22 p,156228,152168,4060,2.60000000
CN1211300000000,12,113,"Santa Rosa County, FL",Dec-22 p,87912,86041,1871,2.10000000
CN1211500000000,12,115,"Sarasota County, FL",Dec-22 p,199582,195080,4502,2.30000000
CN1211700000000,12,117,"Seminole County, FL",Dec-22 p,260374,254829,5545,2.10000000
CN1211900000000,12,119,"Sumter County, FL",Dec-22 p,36140,34919,1221,3.40000000
CN1212100000000,12,121,"Suwannee County, FL",Dec-22 p,17583,17161,422,2.40000000
CN1212300000000,12,123,"Taylor County, FL",Dec-22 p,7880,7667,213,2.70000000
CN1212500000000,12,125,"Union County, FL",Dec-22 p,4702,4599,103,2.20000000
CN1212700000000,12,127,"Volusia County, FL",Dec-22 p,266226,259525,6701,2.50000000
CN1212900000000,12,129,"Wakulla County, FL",Dec-22 p,16307,16001,306,1.90000000
CN1213100000000,12,131,"Walton County, FL",Dec-22 p,34430,33728,702,2.00000000
CN1213300000000,12,133,"Washington County, FL",Dec-22 p,9761,9535,226,2.30000000
CN1300100000000,13,001,"Appling County, GA",Dec-22 p,8607,8304,303,3.50000000
CN1300300000000,13,003,"Atkinson County, GA",Dec-22 p,4398,4307,91,2.10000000
CN1300500000000,13,005,"Bacon County, GA",Dec-22 p,4572,4440,132,2.90000000
CN1300700000000,13,007,"Baker County, GA",Dec-22 p,1075,1034,41,3.80000000
CN1300900000000,13,009,"Baldwin County, GA",Dec-22 p,17498,16889,609,3.50000000
CN1301100000000,13,011,"Banks County, GA",Dec-22 p,10191,9975,216,2.10000000
CN1301300000000,13,013,"Barrow County, GA",Dec-22 p,43549,42570,979,2.20000000
CN1301500000000,13,015,"Bartow County, GA",Dec-22 p,52807,51447,1360,2.60000000
CN1301700000000,13,017,"Ben Hill County, GA",Dec-22 p,5366,5139,227,4.20000000
CN1301900000000,13,019,"Berrien County, GA",Dec-22 p,7518,7300,218,2.90000000
CN1302100000000,13,021,"Bibb County, GA",Dec-22 p,67748,65580,2168,3.20000000
CN1302300000000,13,023,"Bleckley County, GA",Dec-22 p,4525,4357,168,3.70000000
CN1302500000000,13,025,"Brantley County, GA",Dec-22 p,7254,7036,218,3.00000000
CN1302700000000,13,027,"Brooks County, GA",Dec-22 p,6538,6358,180,2.80000000
CN1302900000000,13,029,"Bryan County, GA",Dec-22 p,20225,19772,453,2.20000000
CN1303100000000,13,031,"Bulloch County, GA",Dec-22 p,37341,36237,1104,3.00000000
CN1303300000000,13,033,"Burke County, GA",Dec-22 p,8953,8538,415,4.60000000
CN1303500000000,13,035,"Butts County, GA",Dec-22 p,11446,11159,287,2.50000000
CN1303700000000,13,037,"Calhoun County, GA",Dec-22 p,2184,2127,57,2.60000000
CN1303900000000,13,039,"Camden County, GA",Dec-22 p,21867,21293,574,2.60000000
CN1304300000000,13,043,"Candler County, GA",Dec-22 p,6040,5923,117,1.90000000
CN1304500000000,13,045,"Carroll County, GA",Dec-22 p,57687,56185,1502,2.60000000
CN1304700000000,13,047,"Catoosa County, GA",Dec-22 p,33371,32570,801,2.40000000
CN1304900000000,13,049,"Charlton County, GA",Dec-22 p,4950,4812,138,2.80000000
CN1305100000000,13,051,"Chatham County, GA",Dec-22 p,144776,141063,3713,2.60000000
CN1305300000000,13,053,"Chattahoochee County, GA",Dec-22 p,1905,1829,76,4.00000000
CN1305500000000,13,055,"Chattooga County, GA",Dec-22 p,9204,8739,465,5.10000000
CN1305700000000,13,057,"Cherokee County, GA",Dec-22 p,144316,141304,3012,2.10000000
CN1305900000000,13,059,"Clarke County, GA",Dec-22 p,61240,59627,1613,2.60000000
CN1306100000000,13,061,"Clay County, GA",Dec-22 p,804,752,52,6.50000000
CN1306300000000,13,063,"Clayton County, GA",Dec-22 p,141921,136634,5287,3.70000000
CN1306500000000,13,065,"Clinch County, GA",Dec-22 p,3014,2943,71,2.40000000
CN1306700000000,13,067,"Cobb County, GA",Dec-22 p,436148,426225,9923,2.30000000
CN1306900000000,13,069,"Coffee County, GA",Dec-22 p,17826,17224,602,3.40000000
CN1307100000000,13,071,"Colquitt County, GA",Dec-22 p,21501,20967,534,2.50000000
CN1307300000000,13,073,"Columbia County, GA",Dec-22 p,76003,74103,1900,2.50000000
CN1307500000000,13,075,"Cook County, GA",Dec-22 p,8105,7887,218,2.70000000
CN1307700000000,13,077,"Coweta County, GA",Dec-22 p,78519,76699,1820,2.30000000
CN1307900000000,13,079,"Crawford County, GA",Dec-22 p,5517,5377,140,2.50000000
CN1308100000000,13,081,"Crisp County, GA",Dec-22 p,9231,8867,364,3.90000000
CN1308300000000,13,083,"Dade County, GA",Dec-22 p,8003,7809,194,2.40000000
CN1308500000000,13,085,"Dawson County, GA",Dec-22 p,13518,13226,292,2.20000000
CN1308700000000,13,087,"Decatur County, GA",Dec-22 p,11046,10703,343,3.10000000
CN1308900000000,13,089,"DeKalb County, GA",Dec-22 p,409551,398225,11326,2.80000000
CN1309100000000,13,091,"Dodge County, GA",Dec-22 p,6899,6672,227,3.30000000
CN1309300000000,13,093,"Dooly County, GA",Dec-22 p,4622,4455,167,3.60000000
CN1309500000000,13,095,"Dougherty County, GA",Dec-22 p,36263,34825,1438,4.00000000
CN1309700000000,13,097,"Douglas County, GA",Dec-22 p,75880,73728,2152,2.80000000
CN1309900000000,13,099,"Early County, GA",Dec-22 p,4090,3950,140,3.40000000
CN1310100000000,13,101,"Echols County, GA",Dec-22 p,1808,1771,37,2.00000000
CN1310300000000,13,103,"Effingham County, GA",Dec-22 p,33852,33098,754,2.20000000
CN1310500000000,13,105,"Elbert County, GA",Dec-22 p,7609,7361,248,3.30000000
CN1310700000000,13,107,"Emanuel County, GA",Dec-22 p,8630,8292,338,3.90000000
CN1310900000000,13,109,"Evans County, GA",Dec-22 p,5140,5015,125,2.40000000
CN1311100000000,13,111,"Fannin County, GA",Dec-22 p,11992,11700,292,2.40000000
CN1311300000000,13,113,"Fayette County, GA",Dec-22 p,60200,58852,1348,2.20000000
CN1311500000000,13,115,"Floyd County, GA",Dec-22 p,44253,43047,1206,2.70000000
CN1311700000000,13,117,"Forsyth County, GA",Dec-22 p,131587,128928,2659,2.00000000
CN1311900000000,13,119,"Franklin County, GA",Dec-22 p,9952,9686,266,2.70000000
CN1312100000000,13,121,"Fulton County, GA",Dec-22 p,581491,565156,16335,2.80000000
CN1312300000000,13,123,"Gilmer County, GA",Dec-22 p,12275,11931,344,2.80000000
CN1312500000000,13,125,"Glascock County, GA",Dec-22 p,1244,1208,36,2.90000000
CN1312700000000,13,127,"Glynn County, GA",Dec-22 p,39210,38209,1001,2.60000000
CN1312900000000,13,129,"Gordon County, GA",Dec-22 p,29080,28314,766,2.60000000
CN1313100000000,13,131,"Grady County, GA",Dec-22 p,10977,10706,271,2.50000000
CN1313300000000,13,133,"Greene County, GA",Dec-22 p,7139,6932,207,2.90000000
CN1313500000000,13,135,"Gwinnett County, GA",Dec-22 p,506303,494408,11895,2.30000000
CN1313700000000,13,137,"Habersham County, GA",Dec-22 p,18429,17875,554,3.00000000
CN1313900000000,13,139,"Hall County, GA",Dec-22 p,106065,103805,2260,2.10000000
CN1314100000000,13,141,"Hancock County, GA",Dec-22 p,2447,2328,119,4.90000000
CN1314300000000,13,143,"Haralson County, GA",Dec-22 p,13137,12793,344,2.60000000
CN1314500000000,13,145,"Harris County, GA",Dec-22 p,16872,16466,406,2.40000000
CN1314700000000,13,147,"Hart County, GA",Dec-22 p,11575,11255,320,2.80000000
CN1314900000000,13,149,"Heard County, GA",Dec-22 p,5362,5223,139,2.60000000
CN1315100000000,13,151,"Henry County, GA",Dec-22 p,121944,118608,3336,2.70000000
CN1315300000000,13,153,"Houston County, GA",Dec-22 p,70738,68840,1898,2.70000000
CN1315500000000,13,155,"Irwin County, GA",Dec-22 p,3409,3288,121,3.50000000
CN1315700000000,13,157,"Jackson County, GA",Dec-22 p,45547,44711,836,1.80000000
CN1315900000000,13,159,"Jasper County, GA",Dec-22 p,7251,7081,170,2.30000000
CN1316100000000,13,161,"Jeff Davis County, GA",Dec-22 p,6099,5892,207,3.40000000
CN1316300000000,13,163,"Jefferson County, GA",Dec-22 p,6919,6696,223,3.20000000
CN1316500000000,13,165,"Jenkins County, GA",Dec-22 p,3159,3026,133,4.20000000
CN1316700000000,13,167,"Johnson County, GA",Dec-22 p,3994,3894,100,2.50000000
CN1316900000000,13,169,"Jones County, GA",Dec-22 p,13753,13405,348,2.50000000
CN1317100000000,13,171,"Lamar County, GA",Dec-22 p,8449,8218,231,2.70000000
CN1317300000000,13,173,"Lanier County, GA",Dec-22 p,3755,3640,115,3.10000000
CN1317500000000,13,175,"Laurens County, GA",Dec-22 p,19198,18529,669,3.50000000
CN1317700000000,13,177,"Lee County, GA",Dec-22 p,14942,14578,364,2.40000000
CN1317900000000,13,179,"Liberty County, GA",Dec-22 p,25948,25222,726,2.80000000
CN1318100000000,13,181,"Lincoln County, GA",Dec-22 p,3469,3366,103,3.00000000
CN1318300000000,13,183,"Long County, GA",Dec-22 p,8343,8121,222,2.70000000
CN1318500000000,13,185,"Lowndes County, GA",Dec-22 p,50384,48938,1446,2.90000000
CN1318700000000,13,187,"Lumpkin County, GA",Dec-22 p,17689,17302,387,2.20000000
CN1318900000000,13,189,"McDuffie County, GA",Dec-22 p,8414,8072,342,4.10000000
CN1319100000000,13,191,"McIntosh County, GA",Dec-22 p,6090,5920,170,2.80000000
CN1319300000000,13,193,"Macon County, GA",Dec-22 p,4402,4242,160,3.60000000
CN1319500000000,13,195,"Madison County, GA",Dec-22 p,14101,13763,338,2.40000000
CN1319700000000,13,197,"Marion County, GA",Dec-22 p,3252,3144,108,3.30000000
CN1319900000000,13,199,"Meriwether County, GA",Dec-22 p,9027,8723,304,3.40000000
CN1320100000000,13,201,"Miller County, GA",Dec-22 p,2692,2628,64,2.40000000
CN1320500000000,13,205,"Mitchell County, GA",Dec-22 p,7751,7485,266,3.40000000
CN1320700000000,13,207,"Monroe County, GA",Dec-22 p,13181,12875,306,2.30000000
CN1320900000000,13,209,"Montgomery County, GA",Dec-22 p,3737,3602,135,3.60000000
CN1321100000000,13,211,"Morgan County, GA",Dec-22 p,9704,9480,224,2.30000000
CN1321300000000,13,213,"Murray County, GA",Dec-22 p,15293,14668,625,4.10000000
CN1321500000000,13,215,"Muscogee County, GA",Dec-22 p,75939,73103,2836,3.70000000
CN1321700000000,13,217,"Newton County, GA",Dec-22 p,54730,53141,1589,2.90000000
CN1321900000000,13,219,"Oconee County, GA",Dec-22 p,21128,20718,410,1.90000000
CN1322100000000,13,221,"Oglethorpe County, GA",Dec-22 p,7258,7086,172,2.40000000
CN1322300000000,13,223,"Paulding County, GA",Dec-22 p,92388,90273,2115,2.30000000
CN1322500000000,13,225,"Peach County, GA",Dec-22 p,11755,11369,386,3.30000000
CN1322700000000,13,227,"Pickens County, GA",Dec-22 p,16086,15727,359,2.20000000
CN1322900000000,13,229,"Pierce County, GA",Dec-22 p,8444,8222,222,2.60000000
CN1323100000000,13,231,"Pike County, GA",Dec-22 p,9273,9053,220,2.40000000
CN1323300000000,13,233,"Polk County, GA",Dec-22 p,18323,17820,503,2.70000000
CN1323500000000,13,235,"Pulaski County, GA",Dec-22 p,3963,3851,112,2.80000000
CN1323700000000,13,237,"Putnam County, GA",Dec-22 p,8718,8446,272,3.10000000
CN1323900000000,13,239,"Quitman County, GA",Dec-22 p,753,717,36,4.80000000
CN1324100000000,13,241,"Rabun County, GA",Dec-22 p,7558,7346,212,2.80000000
CN1324300000000,13,243,"Randolph County, GA",Dec-22 p,2320,2225,95,4.10000000
CN1324500000000,13,245,"Richmond County, GA",Dec-22 p,82863,79656,3207,3.90000000
CN1324700000000,13,247,"Rockdale County, GA",Dec-22 p,45695,44296,1399,3.10000000
CN1324900000000,13,249,"Schley County, GA",Dec-22 p,2074,2005,69,3.30000000
CN1325100000000,13,251,"Screven County, GA",Dec-22 p,4897,4682,215,4.40000000
CN1325300000000,13,253,"Seminole County, GA",Dec-22 p,2891,2791,100,3.50000000
CN1325500000000,13,255,"Spalding County, GA",Dec-22 p,29630,28744,886,3.00000000
CN1325700000000,13,257,"Stephens County, GA",Dec-22 p,10265,9927,338,3.30000000
CN1325900000000,13,259,"Stewart County, GA",Dec-22 p,2558,2475,83,3.20000000
CN1326100000000,13,261,"Sumter County, GA",Dec-22 p,11802,11331,471,4.00000000
CN1326300000000,13,263,"Talbot County, GA",Dec-22 p,2771,2691,80,2.90000000
CN1326500000000,13,265,"Taliaferro County, GA",Dec-22 p,520,503,17,3.30000000
CN1326700000000,13,267,"Tattnall County, GA",Dec-22 p,9558,9318,240,2.50000000
CN1326900000000,13,269,"Taylor County, GA",Dec-22 p,2755,2640,115,4.20000000
CN1327100000000,13,271,"Telfair County, GA",Dec-22 p,3518,3296,222,6.30000000
CN1327300000000,13,273,"Terrell County, GA",Dec-22 p,3464,3310,154,4.40000000
CN1327500000000,13,275,"Thomas County, GA",Dec-22 p,17241,16739,502,2.90000000
CN1327700000000,13,277,"Tift County, GA",Dec-22 p,21356,20827,529,2.50000000
CN1327900000000,13,279,"Toombs County, GA",Dec-22 p,11740,11323,417,3.60000000
CN1328100000000,13,281,"Towns County, GA",Dec-22 p,4149,4005,144,3.50000000
CN1328300000000,13,283,"Treutlen County, GA",Dec-22 p,2523,2430,93,3.70000000
CN1328500000000,13,285,"Troup County, GA",Dec-22 p,37529,36595,934,2.50000000
CN1328700000000,13,287,"Turner County, GA",Dec-22 p,3152,3036,116,3.70000000
CN1328900000000,13,289,"Twiggs County, GA",Dec-22 p,2818,2706,112,4.00000000
CN1329100000000,13,291,"Union County, GA",Dec-22 p,11084,10809,275,2.50000000
CN1329300000000,13,293,"Upson County, GA",Dec-22 p,11682,11384,298,2.60000000
CN1329500000000,13,295,"Walker County, GA",Dec-22 p,31292,30304,988,3.20000000
CN1329700000000,13,297,"Walton County, GA",Dec-22 p,48505,47324,1181,2.40000000
CN1329900000000,13,299,"Ware County, GA",Dec-22 p,15062,14628,434,2.90000000
CN1330100000000,13,301,"Warren County, GA",Dec-22 p,2628,2552,76,2.90000000
CN1330300000000,13,303,"Washington County, GA",Dec-22 p,6451,6205,246,3.80000000
CN1330500000000,13,305,"Wayne County, GA",Dec-22 p,11651,11317,334,2.90000000
CN1330700000000,13,307,"Webster County, GA",Dec-22 p,962,933,29,3.00000000
CN1330900000000,13,309,"Wheeler County, GA",Dec-22 p,1591,1508,83,5.20000000
CN1331100000000,13,311,"White County, GA",Dec-22 p,16697,16343,354,2.10000000
CN1331300000000,13,313,"Whitfield County, GA",Dec-22 p,42954,41343,1611,3.80000000
CN1331500000000,13,315,"Wilcox County, GA",Dec-22 p,2630,2553,77,2.90000000
CN1331700000000,13,317,"Wilkes County, GA",Dec-22 p,3568,3441,127,3.60000000
CN1331900000000,13,319,"Wilkinson County, GA",Dec-22 p,3611,3499,112,3.10000000
CN1332100000000,13,321,"Worth County, GA",Dec-22 p,8668,8412,256,3.00000000
CN1500100000000,15,001,"Hawaii County, HI",Dec-22 p,94410,90839,3571,3.80000000
CN1500300000000,15,003,"Honolulu County/city, HI",Dec-22 p,457096,441407,15689,3.40000000
CN1500700000000,15,007,"Kauai County, HI",Dec-22 p,36779,35324,1455,4.00000000
CN1500900000000,15,009,"Maui County, HI",Dec-22 p,87575,84259,3316,3.80000000
CN1600100000000,16,001,"Ada County, ID",Dec-22 p,282546,277193,5353,1.90000000
CN1600300000000,16,003,"Adams County, ID",Dec-22 p,1746,1666,80,4.60000000
CN1600500000000,16,005,"Bannock County, ID",Dec-22 p,45160,44171,989,2.20000000
CN1600700000000,16,007,"Bear Lake County, ID",Dec-22 p,3320,3255,65,2.00000000
CN1600900000000,16,009,"Benewah County, ID",Dec-22 p,4091,3921,170,4.20000000
CN1601100000000,16,011,"Bingham County, ID",Dec-22 p,24620,24023,597,2.40000000
CN1601300000000,16,013,"Blaine County, ID",Dec-22 p,13481,13208,273,2.00000000
CN1601500000000,16,015,"Boise County, ID",Dec-22 p,3896,3767,129,3.30000000
CN1601700000000,16,017,"Bonner County, ID",Dec-22 p,22436,21619,817,3.60000000
CN1601900000000,16,019,"Bonneville County, ID",Dec-22 p,64107,62803,1304,2.00000000
CN1602100000000,16,021,"Boundary County, ID",Dec-22 p,5663,5435,228,4.00000000
CN1602300000000,16,023,"Butte County, ID",Dec-22 p,1512,1468,44,2.90000000
CN1602500000000,16,025,"Camas County, ID",Dec-22 p,725,703,22,3.00000000
CN1602700000000,16,027,"Canyon County, ID",Dec-22 p,115474,112500,2974,2.60000000
CN1602900000000,16,029,"Caribou County, ID",Dec-22 p,4137,4027,110,2.70000000
CN1603100000000,16,031,"Cassia County, ID",Dec-22 p,12878,12619,259,2.00000000
CN1603300000000,16,033,"Clark County, ID",Dec-22 p,388,374,14,3.60000000
CN1603500000000,16,035,"Clearwater County, ID",Dec-22 p,3026,2890,136,4.50000000
CN1603700000000,16,037,"Custer County, ID",Dec-22 p,2015,1945,70,3.50000000
CN1603900000000,16,039,"Elmore County, ID",Dec-22 p,12180,11889,291,2.40000000
CN1604100000000,16,041,"Franklin County, ID",Dec-22 p,7815,7647,168,2.10000000
CN1604300000000,16,043,"Fremont County, ID",Dec-22 p,8636,8447,189,2.20000000
CN1604500000000,16,045,"Gem County, ID",Dec-22 p,9122,8891,231,2.50000000
CN1604700000000,16,047,"Gooding County, ID",Dec-22 p,8584,8382,202,2.40000000
CN1604900000000,16,049,"Idaho County, ID",Dec-22 p,6966,6737,229,3.30000000
CN1605100000000,16,051,"Jefferson County, ID",Dec-22 p,15421,15134,287,1.90000000
CN1605300000000,16,053,"Jerome County, ID",Dec-22 p,12968,12654,314,2.40000000
CN1605500000000,16,055,"Kootenai County, ID",Dec-22 p,86111,83339,2772,3.20000000
CN1605700000000,16,057,"Latah County, ID",Dec-22 p,20143,19775,368,1.80000000
CN1605900000000,16,059,"Lemhi County, ID",Dec-22 p,3700,3574,126,3.40000000
CN1606100000000,16,061,"Lewis County, ID",Dec-22 p,1643,1599,44,2.70000000
CN1606300000000,16,063,"Lincoln County, ID",Dec-22 p,2799,2702,97,3.50000000
CN1606500000000,16,065,"Madison County, ID",Dec-22 p,24855,24509,346,1.40000000
CN1606700000000,16,067,"Minidoka County, ID",Dec-22 p,12055,11776,279,2.30000000
CN1606900000000,16,069,"Nez Perce County, ID",Dec-22 p,21596,21099,497,2.30000000
CN1607100000000,16,071,"Oneida County, ID",Dec-22 p,2769,2699,70,2.50000000
CN1607300000000,16,073,"Owyhee County, ID",Dec-22 p,5648,5468,180,3.20000000
CN1607500000000,16,075,"Payette County, ID",Dec-22 p,12257,11945,312,2.50000000
CN1607700000000,16,077,"Power County, ID",Dec-22 p,4037,3911,126,3.10000000
CN1607900000000,16,079,"Shoshone County, ID",Dec-22 p,5529,5250,279,5.00000000
CN1608100000000,16,081,"Teton County, ID",Dec-22 p,7472,7348,124,1.70000000
CN1608300000000,16,083,"Twin Falls County, ID",Dec-22 p,44318,43268,1050,2.40000000
CN1608500000000,16,085,"Valley County, ID",Dec-22 p,5809,5615,194,3.30000000
CN1608700000000,16,087,"Washington County, ID",Dec-22 p,4916,4776,140,2.80000000
CN1700100000000,17,001,"Adams County, IL",Dec-22 p,29910,29019,891,3.00000000
CN1700300000000,17,003,"Alexander County, IL",Dec-22 p,1782,1679,103,5.80000000
CN1700500000000,17,005,"Bond County, IL",Dec-22 p,7340,7087,253,3.40000000
CN1700700000000,17,007,"Boone County, IL",Dec-22 p,25170,23670,1500,6.00000000
CN1700900000000,17,009,"Brown County, IL",Dec-22 p,3143,3087,56,1.80000000
CN1701100000000,17,011,"Bureau County, IL",Dec-22 p,15613,14932,681,4.40000000
CN1701300000000,17,013,"Calhoun County, IL",Dec-22 p,2138,2058,80,3.70000000
CN1701500000000,17,015,"Carroll County, IL",Dec-22 p,7303,7042,261,3.60000000
CN1701700000000,17,017,"Cass County, IL",Dec-22 p,5471,5245,226,4.10000000
CN1701900000000,17,019,"Champaign County, IL",Dec-22 p,109405,105897,3508,3.20000000
CN1702100000000,17,021,"Christian County, IL",Dec-22 p,12961,12410,551,4.30000000
CN1702300000000,17,023,"Clark County, IL",Dec-22 p,7020,6737,283,4.00000000
CN1702500000000,17,025,"Clay County, IL",Dec-22 p,5573,5329,244,4.40000000
CN1702700000000,17,027,"Clinton County, IL",Dec-22 p,19627,19103,524,2.70000000
CN1702900000000,17,029,"Coles County, IL",Dec-22 p,22445,21615,830,3.70000000
CN1703100000000,17,031,"Cook County, IL",Dec-22 p,2634688,2512442,122246,4.60000000
CN1703300000000,17,033,"Crawford County, IL",Dec-22 p,8394,8111,283,3.40000000
CN1703500000000,17,035,"Cumberland County, IL",Dec-22 p,5916,5734,182,3.10000000
CN1703700000000,17,037,"DeKalb County, IL",Dec-22 p,53374,51343,2031,3.80000000
CN1703900000000,17,039,"De Witt County, IL",Dec-22 p,7217,6942,275,3.80000000
CN1704100000000,17,041,"Douglas County, IL",Dec-22 p,10017,9707,310,3.10000000
CN1704300000000,17,043,"DuPage County, IL",Dec-22 p,512730,497166,15564,3.00000000
CN1704500000000,17,045,"Edgar County, IL",Dec-22 p,8707,8443,264,3.00000000
CN1704700000000,17,047,"Edwards County, IL",Dec-22 p,2411,2323,88,3.60000000
CN1704900000000,17,049,"Effingham County, IL",Dec-22 p,19457,18914,543,2.80000000
CN1705100000000,17,051,"Fayette County, IL",Dec-22 p,9589,9178,411,4.30000000
CN1705300000000,17,053,"Ford County, IL",Dec-22 p,6222,5996,226,3.60000000
CN1705500000000,17,055,"Franklin County, IL",Dec-22 p,15337,14536,801,5.20000000
CN1705700000000,17,057,"Fulton County, IL",Dec-22 p,14081,13405,676,4.80000000
CN1705900000000,17,059,"Gallatin County, IL",Dec-22 p,1949,1859,90,4.60000000
CN1706100000000,17,061,"Greene County, IL",Dec-22 p,5710,5490,220,3.90000000
CN1706300000000,17,063,"Grundy County, IL",Dec-22 p,25955,24768,1187,4.60000000
CN1706500000000,17,065,"Hamilton County, IL",Dec-22 p,4194,4069,125,3.00000000
CN1706700000000,17,067,"Hancock County, IL",Dec-22 p,7942,7675,267,3.40000000
CN1706900000000,17,069,"Hardin County, IL",Dec-22 p,1321,1259,62,4.70000000
CN1707100000000,17,071,"Henderson County, IL",Dec-22 p,3501,3377,124,3.50000000
CN1707300000000,17,073,"Henry County, IL",Dec-22 p,23962,23065,897,3.70000000
CN1707500000000,17,075,"Iroquois County, IL",Dec-22 p,12486,11989,497,4.00000000
CN1707700000000,17,077,"Jackson County, IL",Dec-22 p,27197,26237,960,3.50000000
CN1707900000000,17,079,"Jasper County, IL",Dec-22 p,4664,4507,157,3.40000000
CN1708100000000,17,081,"Jefferson County, IL",Dec-22 p,15936,15251,685,4.30000000
CN1708300000000,17,083,"Jersey County, IL",Dec-22 p,10445,10113,332,3.20000000
CN1708500000000,17,085,"Jo Daviess County, IL",Dec-22 p,10151,9783,368,3.60000000
CN1708700000000,17,087,"Johnson County, IL",Dec-22 p,4061,3851,210,5.20000000
CN1708900000000,17,089,"Kane County, IL",Dec-22 p,263167,251623,11544,4.40000000
CN1709100000000,17,091,"Kankakee County, IL",Dec-22 p,52251,49599,2652,5.10000000
CN1709300000000,17,093,"Kendall County, IL",Dec-22 p,71761,69205,2556,3.60000000
CN1709500000000,17,095,"Knox County, IL",Dec-22 p,19436,18465,971,5.00000000
CN1709700000000,17,097,"Lake County, IL",Dec-22 p,371443,356187,15256,4.10000000
CN1709900000000,17,099,"LaSalle County, IL",Dec-22 p,51378,48916,2462,4.80000000
CN1710100000000,17,101,"Lawrence County, IL",Dec-22 p,5416,5171,245,4.50000000
CN1710300000000,17,103,"Lee County, IL",Dec-22 p,16276,15654,622,3.80000000
CN1710500000000,17,105,"Livingston County, IL",Dec-22 p,15052,14515,537,3.60000000
CN1710700000000,17,107,"Logan County, IL",Dec-22 p,11481,11031,450,3.90000000
CN1710900000000,17,109,"McDonough County, IL",Dec-22 p,12806,12386,420,3.30000000
CN1711100000000,17,111,"McHenry County, IL",Dec-22 p,167710,161766,5944,3.50000000
CN1711300000000,17,113,"McLean County, IL",Dec-22 p,87422,84790,2632,3.00000000
CN1711500000000,17,115,"Macon County, IL",Dec-22 p,45645,43316,2329,5.10000000
CN1711700000000,17,117,"Macoupin County, IL",Dec-22 p,21761,21022,739,3.40000000
CN1711900000000,17,119,"Madison County, IL",Dec-22 p,129464,125204,4260,3.30000000
CN1712100000000,17,121,"Marion County, IL",Dec-22 p,16268,15569,699,4.30000000
CN1712300000000,17,123,"Marshall County, IL",Dec-22 p,5044,4818,226,4.50000000
CN1712500000000,17,125,"Mason County, IL",Dec-22 p,5596,5342,254,4.50000000
CN1712700000000,17,127,"Massac County, IL",Dec-22 p,5244,5014,230,4.40000000
CN1712900000000,17,129,"Menard County, IL",Dec-22 p,6250,6048,202,3.20000000
CN1713100000000,17,131,"Mercer County, IL",Dec-22 p,7638,7340,298,3.90000000
CN1713300000000,17,133,"Monroe County, IL",Dec-22 p,18433,17989,444,2.40000000
CN1713500000000,17,135,"Montgomery County, IL",Dec-22 p,10823,10351,472,4.40000000
CN1713700000000,17,137,"Morgan County, IL",Dec-22 p,15398,14843,555,3.60000000
CN1713900000000,17,139,"Moultrie County, IL",Dec-22 p,7294,7087,207,2.80000000
CN1714100000000,17,141,"Ogle County, IL",Dec-22 p,22760,21697,1063,4.70000000
CN1714300000000,17,143,"Peoria County, IL",Dec-22 p,81768,77789,3979,4.90000000
CN1714500000000,17,145,"Perry County, IL",Dec-22 p,7812,7471,341,4.40000000
CN1714700000000,17,147,"Piatt County, IL",Dec-22 p,8560,8305,255,3.00000000
CN1714900000000,17,149,"Pike County, IL",Dec-22 p,6472,6210,262,4.00000000
CN1715100000000,17,151,"Pope County, IL",Dec-22 p,1653,1582,71,4.30000000
CN1715300000000,17,153,"Pulaski County, IL",Dec-22 p,1643,1535,108,6.60000000
CN1715500000000,17,155,"Putnam County, IL",Dec-22 p,2842,2698,144,5.10000000
CN1715700000000,17,157,"Randolph County, IL",Dec-22 p,13454,13020,434,3.20000000
CN1715900000000,17,159,"Richland County, IL",Dec-22 p,6996,6769,227,3.20000000
CN1716100000000,17,161,"Rock Island County, IL",Dec-22 p,68580,65882,2698,3.90000000
CN1716300000000,17,163,"St. Clair County, IL",Dec-22 p,121657,116957,4700,3.90000000
CN1716500000000,17,165,"Saline County, IL",Dec-22 p,8973,8537,436,4.90000000
CN1716700000000,17,167,"Sangamon County, IL",Dec-22 p,98800,95262,3538,3.60000000
CN1716900000000,17,169,"Schuyler County, IL",Dec-22 p,3139,3008,131,4.20000000
CN1717100000000,17,171,"Scott County, IL",Dec-22 p,2295,2166,129,5.60000000
CN1717300000000,17,173,"Shelby County, IL",Dec-22 p,10050,9690,360,3.60000000
CN1717500000000,17,175,"Stark County, IL",Dec-22 p,2348,2230,118,5.00000000
CN1717700000000,17,177,"Stephenson County, IL",Dec-22 p,20214,19317,897,4.40000000
CN1717900000000,17,179,"Tazewell County, IL",Dec-22 p,61266,59007,2259,3.70000000
CN1718100000000,17,181,"Union County, IL",Dec-22 p,7213,6854,359,5.00000000
CN1718300000000,17,183,"Vermilion County, IL",Dec-22 p,31218,29709,1509,4.80000000
CN1718500000000,17,185,"Wabash County, IL",Dec-22 p,5514,5355,159,2.90000000
CN1718700000000,17,187,"Warren County, IL",Dec-22 p,7262,7003,259,3.60000000
CN1718900000000,17,189,"Washington County, IL",Dec-22 p,9633,9434,199,2.10000000
CN1719100000000,17,191,"Wayne County, IL",Dec-22 p,6877,6643,234,3.40000000
CN1719300000000,17,193,"White County, IL",Dec-22 p,5857,5649,208,3.60000000
CN1719500000000,17,195,"Whiteside County, IL",Dec-22 p,26939,25929,1010,3.70000000
CN1719700000000,17,197,"Will County, IL",Dec-22 p,364371,349150,15221,4.20000000
CN1719900000000,17,199,"Williamson County, IL",Dec-22 p,31215,30040,1175,3.80000000
CN1720100000000,17,201,"Winnebago County, IL",Dec-22 p,133817,126744,7073,5.30000000
CN1720300000000,17,203,"Woodford County, IL",Dec-22 p,18027,17460,567,3.10000000
CN1800100000000,18,001,"Adams County, IN",Dec-22 p,17082,16797,285,1.70000000
CN1800300000000,18,003,"Allen County, IN",Dec-22 p,188578,184365,4213,2.20000000
CN1800500000000,18,005,"Bartholomew County, IN",Dec-22 p,43738,42897,841,1.90000000
CN1800700000000,18,007,"Benton County, IN",Dec-22 p,4446,4354,92,2.10000000
CN1800900000000,18,009,"Blackford County, IN",Dec-22 p,4880,4761,119,2.40000000
CN1801100000000,18,011,"Boone County, IN",Dec-22 p,38236,37634,602,1.60000000
CN1801300000000,18,013,"Brown County, IN",Dec-22 p,7852,7652,200,2.50000000
CN1801500000000,18,015,"Carroll County, IN",Dec-22 p,9979,9777,202,2.00000000
CN1801700000000,18,017,"Cass County, IN",Dec-22 p,17166,16718,448,2.60000000
CN1801900000000,18,019,"Clark County, IN",Dec-22 p,64037,62713,1324,2.10000000
CN1802100000000,18,021,"Clay County, IN",Dec-22 p,11678,11359,319,2.70000000
CN1802300000000,18,023,"Clinton County, IN",Dec-22 p,17144,16815,329,1.90000000
CN1802500000000,18,025,"Crawford County, IN",Dec-22 p,4790,4650,140,2.90000000
CN1802700000000,18,027,"Daviess County, IN",Dec-22 p,16473,16219,254,1.50000000
CN1802900000000,18,029,"Dearborn County, IN",Dec-22 p,25576,25002,574,2.20000000
CN1803100000000,18,031,"Decatur County, IN",Dec-22 p,14496,14203,293,2.00000000
CN1803300000000,18,033,"DeKalb County, IN",Dec-22 p,22518,22060,458,2.00000000
CN1803500000000,18,035,"Delaware County, IN",Dec-22 p,54251,52923,1328,2.40000000
CN1803700000000,18,037,"Dubois County, IN",Dec-22 p,21847,21466,381,1.70000000
CN1803900000000,18,039,"Elkhart County, IN",Dec-22 p,119011,116013,2998,2.50000000
CN1804100000000,18,041,"Fayette County, IN",Dec-22 p,8188,7897,291,3.60000000
CN1804300000000,18,043,"Floyd County, IN",Dec-22 p,43177,42349,828,1.90000000
CN1804500000000,18,045,"Fountain County, IN",Dec-22 p,7998,7809,189,2.40000000
CN1804700000000,18,047,"Franklin County, IN",Dec-22 p,11313,11065,248,2.20000000
CN1804900000000,18,049,"Fulton County, IN",Dec-22 p,9292,9051,241,2.60000000
CN1805100000000,18,051,"Gibson County, IN",Dec-22 p,20247,19912,335,1.70000000
CN1805300000000,18,053,"Grant County, IN",Dec-22 p,31907,31114,793,2.50000000
CN1805500000000,18,055,"Greene County, IN",Dec-22 p,13491,13106,385,2.90000000
CN1805700000000,18,057,"Hamilton County, IN",Dec-22 p,195283,192065,3218,1.60000000
CN1805900000000,18,059,"Hancock County, IN",Dec-22 p,42732,41891,841,2.00000000
CN1806100000000,18,061,"Harrison County, IN",Dec-22 p,20905,20505,400,1.90000000
CN1806300000000,18,063,"Hendricks County, IN",Dec-22 p,95063,93339,1724,1.80000000
CN1806500000000,18,065,"Henry County, IN",Dec-22 p,22131,21556,575,2.60000000
CN1806700000000,18,067,"Howard County, IN",Dec-22 p,33951,32490,1461,4.30000000
CN1806900000000,18,069,"Huntington County, IN",Dec-22 p,18434,18036,398,2.20000000
CN1807100000000,18,071,"Jackson County, IN",Dec-22 p,23621,23149,472,2.00000000
CN1807300000000,18,073,"Jasper County, IN",Dec-22 p,15897,15437,460,2.90000000
CN1807500000000,18,075,"Jay County, IN",Dec-22 p,8851,8647,204,2.30000000
CN1807700000000,18,077,"Jefferson County, IN",Dec-22 p,15110,14750,360,2.40000000
CN1807900000000,18,079,"Jennings County, IN",Dec-22 p,13513,13186,327,2.40000000
CN1808100000000,18,081,"Johnson County, IN",Dec-22 p,86855,85287,1568,1.80000000
CN1808300000000,18,083,"Knox County, IN",Dec-22 p,18094,17723,371,2.10000000
CN1808500000000,18,085,"Kosciusko County, IN",Dec-22 p,40335,39367,968,2.40000000
CN1808700000000,18,087,"LaGrange County, IN",Dec-22 p,20900,20473,427,2.00000000
CN1808900000000,18,089,"Lake County, IN",Dec-22 p,227190,217181,10009,4.40000000
CN1809100000000,18,091,"LaPorte County, IN",Dec-22 p,46467,44914,1553,3.30000000
CN1809300000000,18,093,"Lawrence County, IN",Dec-22 p,20889,20325,564,2.70000000
CN1809500000000,18,095,"Madison County, IN",Dec-22 p,60139,58559,1580,2.60000000
CN1809700000000,18,097,"Marion County, IN",Dec-22 p,506570,493997,12573,2.50000000
CN1809900000000,18,099,"Marshall County, IN",Dec-22 p,23551,22927,624,2.60000000
CN1810100000000,18,101,"Martin County, IN",Dec-22 p,5497,5385,112,2.00000000
CN1810300000000,18,103,"Miami County, IN",Dec-22 p,13988,13568,420,3.00000000
CN1810500000000,18,105,"Monroe County, IN",Dec-22 p,72045,70677,1368,1.90000000
CN1810700000000,18,107,"Montgomery County, IN",Dec-22 p,18831,18469,362,1.90000000
CN1810900000000,18,109,"Morgan County, IN",Dec-22 p,37324,36537,787,2.10000000
CN1811100000000,18,111,"Newton County, IN",Dec-22 p,6748,6531,217,3.20000000
CN1811300000000,18,113,"Noble County, IN",Dec-22 p,21967,21407,560,2.50000000
CN1811500000000,18,115,"Ohio County, IN",Dec-22 p,3162,3100,62,2.00000000
CN1811700000000,18,117,"Orange County, IN",Dec-22 p,8329,8110,219,2.60000000
CN1811900000000,18,119,"Owen County, IN",Dec-22 p,9559,9291,268,2.80000000
CN1812100000000,18,121,"Parke County, IN",Dec-22 p,6985,6812,173,2.50000000
CN1812300000000,18,123,"Perry County, IN",Dec-22 p,8757,8538,219,2.50000000
CN1812500000000,18,125,"Pike County, IN",Dec-22 p,5915,5784,131,2.20000000
CN1812700000000,18,127,"Porter County, IN",Dec-22 p,85462,82972,2490,2.90000000
CN1812900000000,18,129,"Posey County, IN",Dec-22 p,13145,12916,229,1.70000000
CN1813100000000,18,131,"Pulaski County, IN",Dec-22 p,6647,6503,144,2.20000000
CN1813300000000,18,133,"Putnam County, IN",Dec-22 p,16887,16504,383,2.30000000
CN1813500000000,18,135,"Randolph County, IN",Dec-22 p,11671,11398,273,2.30000000
CN1813700000000,18,137,"Ripley County, IN",Dec-22 p,12788,12470,318,2.50000000
CN1813900000000,18,139,"Rush County, IN",Dec-22 p,8967,8803,164,1.80000000
CN1814100000000,18,141,"St. Joseph County, IN",Dec-22 p,134823,130959,3864,2.90000000
CN1814300000000,18,143,"Scott County, IN",Dec-22 p,10770,10493,277,2.60000000
CN1814500000000,18,145,"Shelby County, IN",Dec-22 p,23701,23247,454,1.90000000
CN1814700000000,18,147,"Spencer County, IN",Dec-22 p,10080,9864,216,2.10000000
CN1814900000000,18,149,"Starke County, IN",Dec-22 p,9492,9138,354,3.70000000
CN1815100000000,18,151,"Steuben County, IN",Dec-22 p,20513,20130,383,1.90000000
CN1815300000000,18,153,"Sullivan County, IN",Dec-22 p,7996,7765,231,2.90000000
CN1815500000000,18,155,"Switzerland County, IN",Dec-22 p,4636,4540,96,2.10000000
CN1815700000000,18,157,"Tippecanoe County, IN",Dec-22 p,97457,95532,1925,2.00000000
CN1815900000000,18,159,"Tipton County, IN",Dec-22 p,8981,8769,212,2.40000000
CN1816100000000,18,161,"Union County, IN",Dec-22 p,3553,3470,83,2.30000000
CN1816300000000,18,163,"Vanderburgh County, IN",Dec-22 p,93224,91044,2180,2.30000000
CN1816500000000,18,165,"Vermillion County, IN",Dec-22 p,6622,6399,223,3.40000000
CN1816700000000,18,167,"Vigo County, IN",Dec-22 p,45986,44637,1349,2.90000000
CN1816900000000,18,169,"Wabash County, IN",Dec-22 p,14548,14234,314,2.20000000
CN1817100000000,18,171,"Warren County, IN",Dec-22 p,4114,4016,98,2.40000000
CN1817300000000,18,173,"Warrick County, IN",Dec-22 p,32704,32028,676,2.10000000
CN1817500000000,18,175,"Washington County, IN",Dec-22 p,14085,13794,291,2.10000000
CN1817700000000,18,177,"Wayne County, IN",Dec-22 p,29519,28784,735,2.50000000
CN1817900000000,18,179,"Wells County, IN",Dec-22 p,14325,14065,260,1.80000000
CN1818100000000,18,181,"White County, IN",Dec-22 p,12826,12560,266,2.10000000
CN1818300000000,18,183,"Whitley County, IN",Dec-22 p,17824,17491,333,1.90000000
CN1900100000000,19,001,"Adair County, IA",Dec-22 p,4408,4318,90,2.00000000
CN1900300000000,19,003,"Adams County, IA",Dec-22 p,2011,1973,38,1.90000000
CN1900500000000,19,005,"Allamakee County, IA",Dec-22 p,7116,6757,359,5.00000000
CN1900700000000,19,007,"Appanoose County, IA",Dec-22 p,5941,5739,202,3.40000000
CN1900900000000,19,009,"Audubon County, IA",Dec-22 p,3047,2988,59,1.90000000
CN1901100000000,19,011,"Benton County, IA",Dec-22 p,13018,12556,462,3.50000000
CN1901300000000,19,013,"Black Hawk County, IA",Dec-22 p,68783,66519,2264,3.30000000
CN1901500000000,19,015,"Boone County, IA",Dec-22 p,14797,14442,355,2.40000000
CN1901700000000,19,017,"Bremer County, IA",Dec-22 p,14186,13826,360,2.50000000
CN1901900000000,19,019,"Buchanan County, IA",Dec-22 p,11224,10881,343,3.10000000
CN1902100000000,19,021,"Buena Vista County, IA",Dec-22 p,12414,12153,261,2.10000000
CN1902300000000,19,023,"Butler County, IA",Dec-22 p,8169,7883,286,3.50000000
CN1902500000000,19,025,"Calhoun County, IA",Dec-22 p,4074,3963,111,2.70000000
CN1902700000000,19,027,"Carroll County, IA",Dec-22 p,10729,10517,212,2.00000000
CN1902900000000,19,029,"Cass County, IA",Dec-22 p,6699,6533,166,2.50000000
CN1903100000000,19,031,"Cedar County, IA",Dec-22 p,10571,10247,324,3.10000000
CN1903300000000,19,033,"Cerro Gordo County, IA",Dec-22 p,22329,21625,704,3.20000000
CN1903500000000,19,035,"Cherokee County, IA",Dec-22 p,6048,5901,147,2.40000000
CN1903700000000,19,037,"Chickasaw County, IA",Dec-22 p,6407,6233,174,2.70000000
CN1903900000000,19,039,"Clarke County, IA",Dec-22 p,4879,4738,141,2.90000000
CN1904100000000,19,041,"Clay County, IA",Dec-22 p,8618,8359,259,3.00000000
CN1904300000000,19,043,"Clayton County, IA",Dec-22 p,9685,9183,502,5.20000000
CN1904500000000,19,045,"Clinton County, IA",Dec-22 p,22028,21141,887,4.00000000
CN1904700000000,19,047,"Crawford County, IA",Dec-22 p,8187,7691,496,6.10000000
CN1904900000000,19,049,"Dallas County, IA",Dec-22 p,52980,51868,1112,2.10000000
CN1905100000000,19,051,"Davis County, IA",Dec-22 p,4288,4156,132,3.10000000
CN1905300000000,19,053,"Decatur County, IA",Dec-22 p,4316,4219,97,2.20000000
CN1905500000000,19,055,"Delaware County, IA",Dec-22 p,10614,10337,277,2.60000000
CN1905700000000,19,057,"Des Moines County, IA",Dec-22 p,18035,17205,830,4.60000000
CN1905900000000,19,059,"Dickinson County, IA",Dec-22 p,9862,9515,347,3.50000000
CN1906100000000,19,061,"Dubuque County, IA",Dec-22 p,55603,53829,1774,3.20000000
CN1906300000000,19,063,"Emmet County, IA",Dec-22 p,4861,4703,158,3.30000000
CN1906500000000,19,065,"Fayette County, IA",Dec-22 p,10237,9859,378,3.70000000
CN1906700000000,19,067,"Floyd County, IA",Dec-22 p,8220,7938,282,3.40000000
CN1906900000000,19,069,"Franklin County, IA",Dec-22 p,5609,5443,166,3.00000000
CN1907100000000,19,071,"Fremont County, IA",Dec-22 p,3689,3597,92,2.50000000
CN1907300000000,19,073,"Greene County, IA",Dec-22 p,5357,5248,109,2.00000000
CN1907500000000,19,075,"Grundy County, IA",Dec-22 p,6483,6302,181,2.80000000
CN1907700000000,19,077,"Guthrie County, IA",Dec-22 p,5555,5385,170,3.10000000
CN1907900000000,19,079,"Hamilton County, IA",Dec-22 p,6973,6775,198,2.80000000
CN1908100000000,19,081,"Hancock County, IA",Dec-22 p,5712,5569,143,2.50000000
CN1908300000000,19,083,"Hardin County, IA",Dec-22 p,7874,7632,242,3.10000000
CN1908500000000,19,085,"Harrison County, IA",Dec-22 p,7133,6952,181,2.50000000
CN1908700000000,19,087,"Henry County, IA",Dec-22 p,9627,9314,313,3.30000000
CN1908900000000,19,089,"Howard County, IA",Dec-22 p,5305,5122,183,3.40000000
CN1909100000000,19,091,"Humboldt County, IA",Dec-22 p,4967,4841,126,2.50000000
CN1909300000000,19,093,"Ida County, IA",Dec-22 p,3992,3887,105,2.60000000
CN1909500000000,19,095,"Iowa County, IA",Dec-22 p,10136,9863,273,2.70000000
CN1909700000000,19,097,"Jackson County, IA",Dec-22 p,10687,10327,360,3.40000000
CN1909900000000,19,099,"Jasper County, IA",Dec-22 p,18458,17844,614,3.30000000
CN1910100000000,19,101,"Jefferson County, IA",Dec-22 p,10024,9776,248,2.50000000
CN1910300000000,19,103,"Johnson County, IA",Dec-22 p,87825,85817,2008,2.30000000
CN1910500000000,19,105,"Jones County, IA",Dec-22 p,10308,9923,385,3.70000000
CN1910700000000,19,107,"Keokuk County, IA",Dec-22 p,5177,5007,170,3.30000000
CN1910900000000,19,109,"Kossuth County, IA",Dec-22 p,8209,8020,189,2.30000000
CN1911100000000,19,111,"Lee County, IA",Dec-22 p,15093,14374,719,4.80000000
CN1911300000000,19,113,"Linn County, IA",Dec-22 p,119401,115264,4137,3.50000000
CN1911500000000,19,115,"Louisa County, IA",Dec-22 p,5887,5681,206,3.50000000
CN1911700000000,19,117,"Lucas County, IA",Dec-22 p,4698,4605,93,2.00000000
CN1911900000000,19,119,"Lyon County, IA",Dec-22 p,7086,6928,158,2.20000000
CN1912100000000,19,121,"Madison County, IA",Dec-22 p,8614,8334,280,3.30000000
CN1912300000000,19,123,"Mahaska County, IA",Dec-22 p,12267,11945,322,2.60000000
CN1912500000000,19,125,"Marion County, IA",Dec-22 p,19466,19041,425,2.20000000
CN1912700000000,19,127,"Marshall County, IA",Dec-22 p,17246,15926,1320,7.70000000
CN1912900000000,19,129,"Mills County, IA",Dec-22 p,7143,6962,181,2.50000000
CN1913100000000,19,131,"Mitchell County, IA",Dec-22 p,5734,5610,124,2.20000000
CN1913300000000,19,133,"Monona County, IA",Dec-22 p,4373,4243,130,3.00000000
CN1913500000000,19,135,"Monroe County, IA",Dec-22 p,3961,3816,145,3.70000000
CN1913700000000,19,137,"Montgomery County, IA",Dec-22 p,4882,4750,132,2.70000000
CN1913900000000,19,139,"Muscatine County, IA",Dec-22 p,20452,19781,671,3.30000000
CN1914100000000,19,141,"O'Brien County, IA",Dec-22 p,8132,7915,217,2.70000000
CN1914300000000,19,143,"Osceola County, IA",Dec-22 p,3675,3604,71,1.90000000
CN1914500000000,19,145,"Page County, IA",Dec-22 p,6282,6120,162,2.60000000
CN1914700000000,19,147,"Palo Alto County, IA",Dec-22 p,4473,4359,114,2.50000000
CN1914900000000,19,149,"Plymouth County, IA",Dec-22 p,14697,14354,343,2.30000000
CN1915100000000,19,151,"Pocahontas County, IA",Dec-22 p,4474,4373,101,2.30000000
CN1915300000000,19,153,"Polk County, IA",Dec-22 p,271691,263660,8031,3.00000000
CN1915500000000,19,155,"Pottawattamie County, IA",Dec-22 p,47857,46446,1411,2.90000000
CN1915700000000,19,157,"Poweshiek County, IA",Dec-22 p,10738,10435,303,2.80000000
CN1915900000000,19,159,"Ringgold County, IA",Dec-22 p,2399,2353,46,1.90000000
CN1916100000000,19,161,"Sac County, IA",Dec-22 p,5257,5129,128,2.40000000
CN1916300000000,19,163,"Scott County, IA",Dec-22 p,90528,87328,3200,3.50000000
CN1916500000000,19,165,"Shelby County, IA",Dec-22 p,6253,6091,162,2.60000000
CN1916700000000,19,167,"Sioux County, IA",Dec-22 p,22293,21852,441,2.00000000
CN1916900000000,19,169,"Story County, IA",Dec-22 p,59701,58564,1137,1.90000000
CN1917100000000,19,171,"Tama County, IA",Dec-22 p,9353,8918,435,4.70000000
CN1917300000000,19,173,"Taylor County, IA",Dec-22 p,3102,3043,59,1.90000000
CN1917500000000,19,175,"Union County, IA",Dec-22 p,6143,5985,158,2.60000000
CN1917700000000,19,177,"Van Buren County, IA",Dec-22 p,3679,3563,116,3.20000000
CN1917900000000,19,179,"Wapello County, IA",Dec-22 p,17121,16371,750,4.40000000
CN1918100000000,19,181,"Warren County, IA",Dec-22 p,28758,28012,746,2.60000000
CN1918300000000,19,183,"Washington County, IA",Dec-22 p,11885,11561,324,2.70000000
CN1918500000000,19,185,"Wayne County, IA",Dec-22 p,2864,2797,67,2.30000000
CN1918700000000,19,187,"Webster County, IA",Dec-22 p,18303,17716,587,3.20000000
CN1918900000000,19,189,"Winnebago County, IA",Dec-22 p,4850,4699,151,3.10000000
CN1919100000000,19,191,"Winneshiek County, IA",Dec-22 p,11799,11412,387,3.30000000
CN1919300000000,19,193,"Woodbury County, IA",Dec-22 p,55745,53988,1757,3.20000000
CN1919500000000,19,195,"Worth County, IA",Dec-22 p,3965,3864,101,2.50000000
CN1919700000000,19,197,"Wright County, IA",Dec-22 p,6752,6594,158,2.30000000
CN2000100000000,20,001,"Allen County, KS",Dec-22 p,6486,6305,181,2.80000000
CN2000300000000,20,003,"Anderson County, KS",Dec-22 p,4546,4447,99,2.20000000
CN2000500000000,20,005,"Atchison County, KS",Dec-22 p,6841,6631,210,3.10000000
CN2000700000000,20,007,"Barber County, KS",Dec-22 p,2363,2318,45,1.90000000
CN2000900000000,20,009,"Barton County, KS",Dec-22 p,13378,13022,356,2.70000000
CN2001100000000,20,011,"Bourbon County, KS",Dec-22 p,6223,6000,223,3.60000000
CN2001300000000,20,013,"Brown County, KS",Dec-22 p,5154,5033,121,2.30000000
CN2001500000000,20,015,"Butler County, KS",Dec-22 p,32978,32040,938,2.80000000
CN2001700000000,20,017,"Chase County, KS",Dec-22 p,1444,1415,29,2.00000000
CN2001900000000,20,019,"Chautauqua County, KS",Dec-22 p,1524,1475,49,3.20000000
CN2002100000000,20,021,"Cherokee County, KS",Dec-22 p,10113,9861,252,2.50000000
CN2002300000000,20,023,"Cheyenne County, KS",Dec-22 p,1399,1367,32,2.30000000
CN2002500000000,20,025,"Clark County, KS",Dec-22 p,1145,1124,21,1.80000000
CN2002700000000,20,027,"Clay County, KS",Dec-22 p,3898,3807,91,2.30000000
CN2002900000000,20,029,"Cloud County, KS",Dec-22 p,3918,3813,105,2.70000000
CN2003100000000,20,031,"Coffey County, KS",Dec-22 p,3842,3716,126,3.30000000
CN2003300000000,20,033,"Comanche County, KS",Dec-22 p,960,939,21,2.20000000
CN2003500000000,20,035,"Cowley County, KS",Dec-22 p,16665,16202,463,2.80000000
CN2003700000000,20,037,"Crawford County, KS",Dec-22 p,19475,18938,537,2.80000000
CN2003900000000,20,039,"Decatur County, KS",Dec-22 p,1301,1267,34,2.60000000
CN2004100000000,20,041,"Dickinson County, KS",Dec-22 p,9094,8856,238,2.60000000
CN2004300000000,20,043,"Doniphan County, KS",Dec-22 p,4180,4088,92,2.20000000
CN2004500000000,20,045,"Douglas County, KS",Dec-22 p,65704,64023,1681,2.60000000
CN2004700000000,20,047,"Edwards County, KS",Dec-22 p,1450,1421,29,2.00000000
CN2004900000000,20,049,"Elk County, KS",Dec-22 p,1305,1271,34,2.60000000
CN2005100000000,20,051,"Ellis County, KS",Dec-22 p,17508,17170,338,1.90000000
CN2005300000000,20,053,"Ellsworth County, KS",Dec-22 p,2607,2549,58,2.20000000
CN2005500000000,20,055,"Finney County, KS",Dec-22 p,21176,20767,409,1.90000000
CN2005700000000,20,057,"Ford County, KS",Dec-22 p,18435,18058,377,2.00000000
CN2005900000000,20,059,"Franklin County, KS",Dec-22 p,14974,14623,351,2.30000000
CN2006100000000,20,061,"Geary County, KS",Dec-22 p,11340,10910,430,3.80000000
CN2006300000000,20,063,"Gove County, KS",Dec-22 p,1477,1450,27,1.80000000
CN2006500000000,20,065,"Graham County, KS",Dec-22 p,1272,1245,27,2.10000000
CN2006700000000,20,067,"Grant County, KS",Dec-22 p,2924,2845,79,2.70000000
CN2006900000000,20,069,"Gray County, KS",Dec-22 p,3503,3438,65,1.90000000
CN2007100000000,20,071,"Greeley County, KS",Dec-22 p,862,851,11,1.30000000
CN2007300000000,20,073,"Greenwood County, KS",Dec-22 p,3267,3196,71,2.20000000
CN2007500000000,20,075,"Hamilton County, KS",Dec-22 p,1758,1732,26,1.50000000
CN2007700000000,20,077,"Harper County, KS",Dec-22 p,2851,2791,60,2.10000000
CN2007900000000,20,079,"Harvey County, KS",Dec-22 p,17237,16816,421,2.40000000
CN2008100000000,20,081,"Haskell County, KS",Dec-22 p,2288,2246,42,1.80000000
CN2008300000000,20,083,"Hodgeman County, KS",Dec-22 p,1088,1062,26,2.40000000
CN2008500000000,20,085,"Jackson County, KS",Dec-22 p,7252,7092,160,2.20000000
CN2008700000000,20,087,"Jefferson County, KS",Dec-22 p,10361,10096,265,2.60000000
CN2008900000000,20,089,"Jewell County, KS",Dec-22 p,1249,1220,29,2.30000000
CN2009100000000,20,091,"Johnson County, KS",Dec-22 p,349348,341450,7898,2.30000000
CN2009300000000,20,093,"Kearny County, KS",Dec-22 p,2115,2076,39,1.80000000
CN2009500000000,20,095,"Kingman County, KS",Dec-22 p,3369,3288,81,2.40000000
CN2009700000000,20,097,"Kiowa County, KS",Dec-22 p,1321,1295,26,2.00000000
CN2009900000000,20,099,"Labette County, KS",Dec-22 p,9551,9284,267,2.80000000
CN2010100000000,20,101,"Lane County, KS",Dec-22 p,830,809,21,2.50000000
CN2010300000000,20,103,"Leavenworth County, KS",Dec-22 p,37393,36379,1014,2.70000000
CN2010500000000,20,105,"Lincoln County, KS",Dec-22 p,1831,1792,39,2.10000000
CN2010700000000,20,107,"Linn County, KS",Dec-22 p,4409,4250,159,3.60000000
CN2010900000000,20,109,"Logan County, KS",Dec-22 p,1714,1685,29,1.70000000
CN2011100000000,20,111,"Lyon County, KS",Dec-22 p,17399,16957,442,2.50000000
CN2011300000000,20,113,"McPherson County, KS",Dec-22 p,17893,17561,332,1.90000000
CN2011500000000,20,115,"Marion County, KS",Dec-22 p,6234,6100,134,2.10000000
CN2011700000000,20,117,"Marshall County, KS",Dec-22 p,5548,5440,108,1.90000000
CN2011900000000,20,119,"Meade County, KS",Dec-22 p,2274,2227,47,2.10000000
CN2012100000000,20,121,"Miami County, KS",Dec-22 p,18048,17592,456,2.50000000
CN2012300000000,20,123,"Mitchell County, KS",Dec-22 p,3444,3381,63,1.80000000
CN2012500000000,20,125,"Montgomery County, KS",Dec-22 p,14516,14065,451,3.10000000
CN2012700000000,20,127,"Morris County, KS",Dec-22 p,3212,3142,70,2.20000000
CN2012900000000,20,129,"Morton County, KS",Dec-22 p,1210,1183,27,2.20000000
CN2013100000000,20,131,"Nemaha County, KS",Dec-22 p,5892,5779,113,1.90000000
CN2013300000000,20,133,"Neosho County, KS",Dec-22 p,6138,5934,204,3.30000000
CN2013500000000,20,135,"Ness County, KS",Dec-22 p,1421,1392,29,2.00000000
CN2013700000000,20,137,"Norton County, KS",Dec-22 p,2685,2632,53,2.00000000
CN2013900000000,20,139,"Osage County, KS",Dec-22 p,8035,7818,217,2.70000000
CN2014100000000,20,141,"Osborne County, KS",Dec-22 p,1971,1929,42,2.10000000
CN2014300000000,20,143,"Ottawa County, KS",Dec-22 p,3139,3061,78,2.50000000
CN2014500000000,20,145,"Pawnee County, KS",Dec-22 p,2850,2785,65,2.30000000
CN2014700000000,20,147,"Phillips County, KS",Dec-22 p,2765,2708,57,2.10000000
CN2014900000000,20,149,"Pottawatomie County, KS",Dec-22 p,12400,12110,290,2.30000000
CN2015100000000,20,151,"Pratt County, KS",Dec-22 p,4978,4871,107,2.10000000
CN2015300000000,20,153,"Rawlins County, KS",Dec-22 p,1621,1595,26,1.60000000
CN2015500000000,20,155,"Reno County, KS",Dec-22 p,29215,28392,823,2.80000000
CN2015700000000,20,157,"Republic County, KS",Dec-22 p,2510,2463,47,1.90000000
CN2015900000000,20,159,"Rice County, KS",Dec-22 p,5440,5315,125,2.30000000
CN2016100000000,20,161,"Riley County, KS",Dec-22 p,34106,33178,928,2.70000000
CN2016300000000,20,163,"Rooks County, KS",Dec-22 p,2484,2423,61,2.50000000
CN2016500000000,20,165,"Rush County, KS",Dec-22 p,1703,1666,37,2.20000000
CN2016700000000,20,167,"Russell County, KS",Dec-22 p,3475,3401,74,2.10000000
CN2016900000000,20,169,"Saline County, KS",Dec-22 p,30527,29786,741,2.40000000
CN2017100000000,20,171,"Scott County, KS",Dec-22 p,2889,2837,52,1.80000000
CN2017300000000,20,173,"Sedgwick County, KS",Dec-22 p,256265,248562,7703,3.00000000
CN2017500000000,20,175,"Seward County, KS",Dec-22 p,10100,9851,249,2.50000000
CN2017700000000,20,177,"Shawnee County, KS",Dec-22 p,91100,88606,2494,2.70000000
CN2017900000000,20,179,"Sheridan County, KS",Dec-22 p,1571,1544,27,1.70000000
CN2018100000000,20,181,"Sherman County, KS",Dec-22 p,2905,2840,65,2.20000000
CN2018300000000,20,183,"Smith County, KS",Dec-22 p,2171,2131,40,1.80000000
CN2018500000000,20,185,"Stafford County, KS",Dec-22 p,2080,2036,44,2.10000000
CN2018700000000,20,187,"Stanton County, KS",Dec-22 p,1180,1157,23,1.90000000
CN2018900000000,20,189,"Stevens County, KS",Dec-22 p,3115,3054,61,2.00000000
CN2019100000000,20,191,"Sumner County, KS",Dec-22 p,10895,10583,312,2.90000000
CN2019300000000,20,193,"Thomas County, KS",Dec-22 p,4381,4300,81,1.80000000
CN2019500000000,20,195,"Trego County, KS",Dec-22 p,1375,1336,39,2.80000000
CN2019700000000,20,197,"Wabaunsee County, KS",Dec-22 p,3771,3685,86,2.30000000
CN2019900000000,20,199,"Wallace County, KS",Dec-22 p,880,862,18,2.00000000
CN2020100000000,20,201,"Washington County, KS",Dec-22 p,3212,3155,57,1.80000000
CN2020300000000,20,203,"Wichita County, KS",Dec-22 p,1179,1156,23,2.00000000
CN2020500000000,20,205,"Wilson County, KS",Dec-22 p,3856,3738,118,3.10000000
CN2020700000000,20,207,"Woodson County, KS",Dec-22 p,1556,1504,52,3.30000000
CN2020900000000,20,209,"Wyandotte County, KS",Dec-22 p,78008,75452,2556,3.30000000
CN2100100000000,21,001,"Adair County, KY",Dec-22 p,7237,6938,299,4.10000000
CN2100300000000,21,003,"Allen County, KY",Dec-22 p,9002,8712,290,3.20000000
CN2100500000000,21,005,"Anderson County, KY",Dec-22 p,11890,11580,310,2.60000000
CN2100700000000,21,007,"Ballard County, KY",Dec-22 p,3422,3280,142,4.10000000
CN2100900000000,21,009,"Barren County, KY",Dec-22 p,17433,16784,649,3.70000000
CN2101100000000,21,011,"Bath County, KY",Dec-22 p,4668,4442,226,4.80000000
CN2101300000000,21,013,"Bell County, KY",Dec-22 p,8075,7689,386,4.80000000
CN2101500000000,21,015,"Boone County, KY",Dec-22 p,70852,68874,1978,2.80000000
CN2101700000000,21,017,"Bourbon County, KY",Dec-22 p,9835,9561,274,2.80000000
CN2101900000000,21,019,"Boyd County, KY",Dec-22 p,17069,16184,885,5.20000000
CN2102100000000,21,021,"Boyle County, KY",Dec-22 p,12407,11977,430,3.50000000
CN2102300000000,21,023,"Bracken County, KY",Dec-22 p,3754,3600,154,4.10000000
CN2102500000000,21,025,"Breathitt County, KY",Dec-22 p,3165,2956,209,6.60000000
CN2102700000000,21,027,"Breckinridge County, KY",Dec-22 p,7909,7585,324,4.10000000
CN2102900000000,21,029,"Bullitt County, KY",Dec-22 p,43377,42137,1240,2.90000000
CN2103100000000,21,031,"Butler County, KY",Dec-22 p,4951,4781,170,3.40000000
CN2103300000000,21,033,"Caldwell County, KY",Dec-22 p,6048,5852,196,3.20000000
CN2103500000000,21,035,"Calloway County, KY",Dec-22 p,16643,16068,575,3.50000000
CN2103700000000,21,037,"Campbell County, KY",Dec-22 p,49693,48262,1431,2.90000000
CN2103900000000,21,039,"Carlisle County, KY",Dec-22 p,2216,2156,60,2.70000000
CN2104100000000,21,041,"Carroll County, KY",Dec-22 p,5509,5359,150,2.70000000
CN2104300000000,21,043,"Carter County, KY",Dec-22 p,9697,8970,727,7.50000000
CN2104500000000,21,045,"Casey County, KY",Dec-22 p,6734,6509,225,3.30000000
CN2104700000000,21,047,"Christian County, KY",Dec-22 p,25130,23998,1132,4.50000000
CN2104900000000,21,049,"Clark County, KY",Dec-22 p,17221,16678,543,3.20000000
CN2105100000000,21,051,"Clay County, KY",Dec-22 p,5040,4782,258,5.10000000
CN2105300000000,21,053,"Clinton County, KY",Dec-22 p,3916,3757,159,4.10000000
CN2105500000000,21,055,"Crittenden County, KY",Dec-22 p,3754,3616,138,3.70000000
CN2105700000000,21,057,"Cumberland County, KY",Dec-22 p,3415,3316,99,2.90000000
CN2105900000000,21,059,"Daviess County, KY",Dec-22 p,46170,44486,1684,3.60000000
CN2106100000000,21,061,"Edmonson County, KY",Dec-22 p,4702,4502,200,4.30000000
CN2106300000000,21,063,"Elliott County, KY",Dec-22 p,1866,1701,165,8.80000000
CN2106500000000,21,065,"Estill County, KY",Dec-22 p,5106,4899,207,4.10000000
CN2106700000000,21,067,"Fayette County, KY",Dec-22 p,174916,170430,4486,2.60000000
CN2106900000000,21,069,"Fleming County, KY",Dec-22 p,6058,5809,249,4.10000000
CN2107100000000,21,071,"Floyd County, KY",Dec-22 p,10755,10139,616,5.70000000
CN2107300000000,21,073,"Franklin County, KY",Dec-22 p,24922,24220,702,2.80000000
CN2107500000000,21,075,"Fulton County, KY",Dec-22 p,2051,1977,74,3.60000000
CN2107700000000,21,077,"Gallatin County, KY",Dec-22 p,3967,3841,126,3.20000000
CN2107900000000,21,079,"Garrard County, KY",Dec-22 p,7647,7389,258,3.40000000
CN2108100000000,21,081,"Grant County, KY",Dec-22 p,11502,11125,377,3.30000000
CN2108300000000,21,083,"Graves County, KY",Dec-22 p,15632,15073,559,3.60000000
CN2108500000000,21,085,"Grayson County, KY",Dec-22 p,10543,10117,426,4.00000000
CN2108700000000,21,087,"Green County, KY",Dec-22 p,5426,5260,166,3.10000000
CN2108900000000,21,089,"Greenup County, KY",Dec-22 p,12932,12124,808,6.20000000
CN2109100000000,21,091,"Hancock County, KY",Dec-22 p,3839,3699,140,3.60000000
CN2109300000000,21,093,"Hardin County, KY",Dec-22 p,46983,45350,1633,3.50000000
CN2109500000000,21,095,"Harlan County, KY",Dec-22 p,6604,6231,373,5.60000000
CN2109700000000,21,097,"Harrison County, KY",Dec-22 p,8793,8552,241,2.70000000
CN2109900000000,21,099,"Hart County, KY",Dec-22 p,7474,7202,272,3.60000000
CN2110100000000,21,101,"Henderson County, KY",Dec-22 p,20768,20106,662,3.20000000
CN2110300000000,21,103,"Henry County, KY",Dec-22 p,8289,8075,214,2.60000000
CN2110500000000,21,105,"Hickman County, KY",Dec-22 p,1695,1637,58,3.40000000
CN2110700000000,21,107,"Hopkins County, KY",Dec-22 p,17532,16849,683,3.90000000
CN2110900000000,21,109,"Jackson County, KY",Dec-22 p,4122,3924,198,4.80000000
CN2111100000000,21,111,"Jefferson County, KY",Dec-22 p,398800,387119,11681,2.90000000
CN2111300000000,21,113,"Jessamine County, KY",Dec-22 p,26449,25722,727,2.70000000
CN2111500000000,21,115,"Johnson County, KY",Dec-22 p,6494,6103,391,6.00000000
CN2111700000000,21,117,"Kenton County, KY",Dec-22 p,86100,83576,2524,2.90000000
CN2111900000000,21,119,"Knott County, KY",Dec-22 p,4233,3992,241,5.70000000
CN2112100000000,21,121,"Knox County, KY",Dec-22 p,10055,9567,488,4.90000000
CN2112300000000,21,123,"Larue County, KY",Dec-22 p,5772,5556,216,3.70000000
CN2112500000000,21,125,"Laurel County, KY",Dec-22 p,25394,24465,929,3.70000000
CN2112700000000,21,127,"Lawrence County, KY",Dec-22 p,5559,5274,285,5.10000000
CN2112900000000,21,129,"Lee County, KY",Dec-22 p,1966,1865,101,5.10000000
CN2113100000000,21,131,"Leslie County, KY",Dec-22 p,2502,2339,163,6.50000000
CN2113300000000,21,133,"Letcher County, KY",Dec-22 p,6029,5665,364,6.00000000
CN2113500000000,21,135,"Lewis County, KY",Dec-22 p,4759,4407,352,7.40000000
CN2113700000000,21,137,"Lincoln County, KY",Dec-22 p,9169,8732,437,4.80000000
CN2113900000000,21,139,"Livingston County, KY",Dec-22 p,3576,3420,156,4.40000000
CN2114100000000,21,141,"Logan County, KY",Dec-22 p,12487,12105,382,3.10000000
CN2114300000000,21,143,"Lyon County, KY",Dec-22 p,2958,2838,120,4.10000000
CN2114500000000,21,145,"McCracken County, KY",Dec-22 p,29216,28172,1044,3.60000000
CN2114700000000,21,147,"McCreary County, KY",Dec-22 p,4936,4715,221,4.50000000
CN2114900000000,21,149,"McLean County, KY",Dec-22 p,4043,3880,163,4.00000000
CN2115100000000,21,151,"Madison County, KY",Dec-22 p,47311,45929,1382,2.90000000
CN2115300000000,21,153,"Magoffin County, KY",Dec-22 p,3274,2970,304,9.30000000
CN2115500000000,21,155,"Marion County, KY",Dec-22 p,9255,8995,260,2.80000000
CN2115700000000,21,157,"Marshall County, KY",Dec-22 p,14070,13520,550,3.90000000
CN2115900000000,21,159,"Martin County, KY",Dec-22 p,2149,2000,149,6.90000000
CN2116100000000,21,161,"Mason County, KY",Dec-22 p,6545,6241,304,4.60000000
CN2116300000000,21,163,"Meade County, KY",Dec-22 p,11639,11197,442,3.80000000
CN2116500000000,21,165,"Menifee County, KY",Dec-22 p,2318,2191,127,5.50000000
CN2116700000000,21,167,"Mercer County, KY",Dec-22 p,9740,9406,334,3.40000000
CN2116900000000,21,169,"Metcalfe County, KY",Dec-22 p,3880,3712,168,4.30000000
CN2117100000000,21,171,"Monroe County, KY",Dec-22 p,4613,4471,142,3.10000000
CN2117300000000,21,173,"Montgomery County, KY",Dec-22 p,11611,11125,486,4.20000000
CN2117500000000,21,175,"Morgan County, KY",Dec-22 p,4287,4085,202,4.70000000
CN2117700000000,21,177,"Muhlenberg County, KY",Dec-22 p,9421,8881,540,5.70000000
CN2117900000000,21,179,"Nelson County, KY",Dec-22 p,23673,22978,695,2.90000000
CN2118100000000,21,181,"Nicholas County, KY",Dec-22 p,3348,3235,113,3.40000000
CN2118300000000,21,183,"Ohio County, KY",Dec-22 p,8904,8485,419,4.70000000
CN2118500000000,21,185,"Oldham County, KY",Dec-22 p,33725,32922,803,2.40000000
CN2118700000000,21,187,"Owen County, KY",Dec-22 p,4915,4758,157,3.20000000
CN2118900000000,21,189,"Owsley County, KY",Dec-22 p,1037,970,67,6.50000000
CN2119100000000,21,191,"Pendleton County, KY",Dec-22 p,6820,6609,211,3.10000000
CN2119300000000,21,193,"Perry County, KY",Dec-22 p,7894,7524,370,4.70000000
CN2119500000000,21,195,"Pike County, KY",Dec-22 p,18643,17757,886,4.80000000
CN2119700000000,21,197,"Powell County, KY",Dec-22 p,5179,4979,200,3.90000000
CN2119900000000,21,199,"Pulaski County, KY",Dec-22 p,25669,24636,1033,4.00000000
CN2120100000000,21,201,"Robertson County, KY",Dec-22 p,808,778,30,3.70000000
CN2120300000000,21,203,"Rockcastle County, KY",Dec-22 p,6558,6300,258,3.90000000
CN2120500000000,21,205,"Rowan County, KY",Dec-22 p,9789,9389,400,4.10000000
CN2120700000000,21,207,"Russell County, KY",Dec-22 p,6035,5731,304,5.00000000
CN2120900000000,21,209,"Scott County, KY",Dec-22 p,30276,29494,782,2.60000000
CN2121100000000,21,211,"Shelby County, KY",Dec-22 p,26330,25658,672,2.60000000
CN2121300000000,21,213,"Simpson County, KY",Dec-22 p,8850,8579,271,3.10000000
CN2121500000000,21,215,"Spencer County, KY",Dec-22 p,10676,10395,281,2.60000000
CN2121700000000,21,217,"Taylor County, KY",Dec-22 p,12997,12615,382,2.90000000
CN2121900000000,21,219,"Todd County, KY",Dec-22 p,5551,5379,172,3.10000000
CN2122100000000,21,221,"Trigg County, KY",Dec-22 p,6195,5928,267,4.30000000
CN2122300000000,21,223,"Trimble County, KY",Dec-22 p,3886,3766,120,3.10000000
CN2122500000000,21,225,"Union County, KY",Dec-22 p,6024,5810,214,3.60000000
CN2122700000000,21,227,"Warren County, KY",Dec-22 p,64978,62993,1985,3.10000000
CN2122900000000,21,229,"Washington County, KY",Dec-22 p,6185,6010,175,2.80000000
CN2123100000000,21,231,"Wayne County, KY",Dec-22 p,7106,6784,322,4.50000000
CN2123300000000,21,233,"Webster County, KY",Dec-22 p,5284,5098,186,3.50000000
CN2123500000000,21,235,"Whitley County, KY",Dec-22 p,14044,13529,515,3.70000000
CN2123700000000,21,237,"Wolfe County, KY",Dec-22 p,2156,2027,129,6.00000000
CN2123900000000,21,239,"Woodford County, KY",Dec-22 p,15309,14937,372,2.40000000
CN2200100000000,22,001,"Acadia Parish, LA",Dec-22 p,23990,23201,789,3.30000000
CN2200300000000,22,003,"Allen Parish, LA",Dec-22 p,7966,7652,314,3.90000000
CN2200500000000,22,005,"Ascension Parish, LA",Dec-22 p,66365,64635,1730,2.60000000
CN2200700000000,22,007,"Assumption Parish, LA",Dec-22 p,8775,8384,391,4.50000000
CN2200900000000,22,009,"Avoyelles Parish, LA",Dec-22 p,13051,12518,533,4.10000000
CN2201100000000,22,011,"Beauregard Parish, LA",Dec-22 p,14397,13929,468,3.30000000
CN2201300000000,22,013,"Bienville Parish, LA",Dec-22 p,4757,4554,203,4.30000000
CN2201500000000,22,015,"Bossier Parish, LA",Dec-22 p,58540,56959,1581,2.70000000
CN2201700000000,22,017,"Caddo Parish, LA",Dec-22 p,102640,98750,3890,3.80000000
CN2201900000000,22,019,"Calcasieu Parish, LA",Dec-22 p,98551,95549,3002,3.00000000
CN2202100000000,22,021,"Caldwell Parish, LA",Dec-22 p,3642,3521,121,3.30000000
CN2202300000000,22,023,"Cameron Parish, LA",Dec-22 p,3663,3571,92,2.50000000
CN2202500000000,22,025,"Catahoula Parish, LA",Dec-22 p,3345,3209,136,4.10000000
CN2202700000000,22,027,"Claiborne Parish, LA",Dec-22 p,5309,5136,173,3.30000000
CN2202900000000,22,029,"Concordia Parish, LA",Dec-22 p,6946,6649,297,4.30000000
CN2203100000000,22,031,"De Soto Parish, LA",Dec-22 p,10991,10619,372,3.40000000
CN2203300000000,22,033,"East Baton Rouge Parish, LA",Dec-22 p,231470,224406,7064,3.10000000
CN2203500000000,22,035,"East Carroll Parish, LA",Dec-22 p,1608,1484,124,7.70000000
CN2203700000000,22,037,"East Feliciana Parish, LA",Dec-22 p,7823,7592,231,3.00000000
CN2203900000000,22,039,"Evangeline Parish, LA",Dec-22 p,11936,11514,422,3.50000000
CN2204100000000,22,041,"Franklin Parish, LA",Dec-22 p,7404,7060,344,4.60000000
CN2204300000000,22,043,"Grant Parish, LA",Dec-22 p,8388,8124,264,3.10000000
CN2204500000000,22,045,"Iberia Parish, LA",Dec-22 p,27749,26627,1122,4.00000000
CN2204700000000,22,047,"Iberville Parish, LA",Dec-22 p,13834,13234,600,4.30000000
CN2204900000000,22,049,"Jackson Parish, LA",Dec-22 p,6818,6627,191,2.80000000
CN2205100000000,22,051,"Jefferson Parish, LA",Dec-22 p,214564,207598,6966,3.20000000
CN2205300000000,22,053,"Jefferson Davis Parish, LA",Dec-22 p,12538,12143,395,3.20000000
CN2205500000000,22,055,"Lafayette Parish, LA",Dec-22 p,117019,113785,3234,2.80000000
CN2205700000000,22,057,"Lafourche Parish, LA",Dec-22 p,39927,38762,1165,2.90000000
CN2205900000000,22,059,"LaSalle Parish, LA",Dec-22 p,6640,6478,162,2.40000000
CN2206100000000,22,061,"Lincoln Parish, LA",Dec-22 p,21147,20491,656,3.10000000
CN2206300000000,22,063,"Livingston Parish, LA",Dec-22 p,71140,69295,1845,2.60000000
CN2206500000000,22,065,"Madison Parish, LA",Dec-22 p,3412,3254,158,4.60000000
CN2206700000000,22,067,"Morehouse Parish, LA",Dec-22 p,9846,9326,520,5.30000000
CN2206900000000,22,069,"Natchitoches Parish, LA",Dec-22 p,16574,15997,577,3.50000000
CN2207100000000,22,071,"Orleans Parish, LA",Dec-22 p,180265,172381,7884,4.40000000
CN2207300000000,22,073,"Ouachita Parish, LA",Dec-22 p,69216,66954,2262,3.30000000
CN2207500000000,22,075,"Plaquemines Parish, LA",Dec-22 p,9956,9675,281,2.80000000
CN2207700000000,22,077,"Pointe Coupee Parish, LA",Dec-22 p,9689,9354,335,3.50000000
CN2207900000000,22,079,"Rapides Parish, LA",Dec-22 p,56615,54993,1622,2.90000000
CN2208100000000,22,081,"Red River Parish, LA",Dec-22 p,3751,3638,113,3.00000000
CN2208300000000,22,083,"Richland Parish, LA",Dec-22 p,8052,7761,291,3.60000000
CN2208500000000,22,085,"Sabine Parish, LA",Dec-22 p,9125,8840,285,3.10000000
CN2208700000000,22,087,"St. Bernard Parish, LA",Dec-22 p,20367,19580,787,3.90000000
CN2208900000000,22,089,"St. Charles Parish, LA",Dec-22 p,25251,24532,719,2.80000000
CN2209100000000,22,091,"St. Helena Parish, LA",Dec-22 p,4252,4024,228,5.40000000
CN2209300000000,22,093,"St. James Parish, LA",Dec-22 p,9107,8713,394,4.30000000
CN2209500000000,22,095,"St. John the Baptist Parish, LA",Dec-22 p,19501,18595,906,4.60000000
CN2209700000000,22,097,"St. Landry Parish, LA",Dec-22 p,32077,30740,1337,4.20000000
CN2209900000000,22,099,"St. Martin Parish, LA",Dec-22 p,22214,21493,721,3.20000000
CN2210100000000,22,101,"St. Mary Parish, LA",Dec-22 p,18429,17658,771,4.20000000
CN2210300000000,22,103,"St. Tammany Parish, LA",Dec-22 p,121809,118670,3139,2.60000000
CN2210500000000,22,105,"Tangipahoa Parish, LA",Dec-22 p,56371,54016,2355,4.20000000
CN2210700000000,22,107,"Tensas Parish, LA",Dec-22 p,1177,1119,58,4.90000000
CN2210900000000,22,109,"Terrebonne Parish, LA",Dec-22 p,43938,42444,1494,3.40000000
CN2211100000000,22,111,"Union Parish, LA",Dec-22 p,9029,8707,322,3.60000000
CN2211300000000,22,113,"Vermilion Parish, LA",Dec-22 p,24117,23361,756,3.10000000
CN2211500000000,22,115,"Vernon Parish, LA",Dec-22 p,15603,14867,736,4.70000000
CN2211700000000,22,117,"Washington Parish, LA",Dec-22 p,17062,16417,645,3.80000000
CN2211900000000,22,119,"Webster Parish, LA",Dec-22 p,14293,13744,549,3.80000000
CN2212100000000,22,121,"West Baton Rouge Parish, LA",Dec-22 p,13898,13492,406,2.90000000
CN2212300000000,22,123,"West Carroll Parish, LA",Dec-22 p,3554,3368,186,5.20000000
CN2212500000000,22,125,"West Feliciana Parish, LA",Dec-22 p,5392,5267,125,2.30000000
CN2212700000000,22,127,"Winn Parish, LA",Dec-22 p,4523,4352,171,3.80000000
CN2300100000000,23,001,"Androscoggin County, ME",Dec-22 p,53503,51646,1857,3.50000000
CN2300300000000,23,003,"Aroostook County, ME",Dec-22 p,27247,25902,1345,4.90000000
CN2300500000000,23,005,"Cumberland County, ME",Dec-22 p,161828,157335,4493,2.80000000
CN2300700000000,23,007,"Franklin County, ME",Dec-22 p,13437,12849,588,4.40000000
CN2300900000000,23,009,"Hancock County, ME",Dec-22 p,26234,25013,1221,4.70000000
CN2301100000000,23,011,"Kennebec County, ME",Dec-22 p,59854,57957,1897,3.20000000
CN2301300000000,23,013,"Knox County, ME",Dec-22 p,18600,17932,668,3.60000000
CN2301500000000,23,015,"Lincoln County, ME",Dec-22 p,15551,14980,571,3.70000000
CN2301700000000,23,017,"Oxford County, ME",Dec-22 p,25622,24616,1006,3.90000000
CN2301900000000,23,019,"Penobscot County, ME",Dec-22 p,74927,72325,2602,3.50000000
CN2302100000000,23,021,"Piscataquis County, ME",Dec-22 p,7032,6727,305,4.30000000
CN2302300000000,23,023,"Sagadahoc County, ME",Dec-22 p,18500,17993,507,2.70000000
CN2302500000000,23,025,"Somerset County, ME",Dec-22 p,21174,20095,1079,5.10000000
CN2302700000000,23,027,"Waldo County, ME",Dec-22 p,19616,18895,721,3.70000000
CN2302900000000,23,029,"Washington County, ME",Dec-22 p,12888,12265,623,4.80000000
CN2303100000000,23,031,"York County, ME",Dec-22 p,110733,107357,3376,3.00000000
CN2400100000000,24,001,"Allegany County, MD",Dec-22 p,29970,28677,1293,4.30000000
CN2400300000000,24,003,"Anne Arundel County, MD",Dec-22 p,317458,309074,8384,2.60000000
CN2400500000000,24,005,"Baltimore County, MD",Dec-22 p,450166,435574,14592,3.20000000
CN2400900000000,24,009,"Calvert County, MD",Dec-22 p,49268,47906,1362,2.80000000
CN2401100000000,24,011,"Caroline County, MD",Dec-22 p,18044,17529,515,2.90000000
CN2401300000000,24,013,"Carroll County, MD",Dec-22 p,96161,93821,2340,2.40000000
CN2401500000000,24,015,"Cecil County, MD",Dec-22 p,52884,51174,1710,3.20000000
CN2401700000000,24,017,"Charles County, MD",Dec-22 p,86661,83881,2780,3.20000000
CN2401900000000,24,019,"Dorchester County, MD",Dec-22 p,16238,15661,577,3.60000000
CN2402100000000,24,021,"Frederick County, MD",Dec-22 p,137124,133256,3868,2.80000000
CN2402300000000,24,023,"Garrett County, MD",Dec-22 p,15243,14721,522,3.40000000
CN2402500000000,24,025,"Harford County, MD",Dec-22 p,142020,138098,3922,2.80000000
CN2402700000000,24,027,"Howard County, MD",Dec-22 p,189728,185054,4674,2.50000000
CN2402900000000,24,029,"Kent County, MD",Dec-22 p,10243,9880,363,3.50000000
CN2403100000000,24,031,"Montgomery County, MD",Dec-22 p,546421,531391,15030,2.80000000
CN2403300000000,24,033,"Prince George's County, MD",Dec-22 p,497825,479621,18204,3.70000000
CN2403500000000,24,035,"Queen Anne's County, MD",Dec-22 p,28615,27874,741,2.60000000
CN2403700000000,24,037,"St. Mary's County, MD",Dec-22 p,57741,56076,1665,2.90000000
CN2403900000000,24,039,"Somerset County, MD",Dec-22 p,8916,8460,456,5.10000000
CN2404100000000,24,041,"Talbot County, MD",Dec-22 p,17772,17179,593,3.30000000
CN2404300000000,24,043,"Washington County, MD",Dec-22 p,73090,70743,2347,3.20000000
CN2404500000000,24,045,"Wicomico County, MD",Dec-22 p,49239,47069,2170,4.40000000
CN2404700000000,24,047,"Worcester County, MD",Dec-22 p,24716,22966,1750,7.10000000
CN2451000000000,24,510,"Baltimore city, MD",Dec-22 p,278592,266256,12336,4.40000000
CN2500100000000,25,001,"Barnstable County, MA",Dec-22 p,104762,99551,5211,5.00000000
CN2500300000000,25,003,"Berkshire County, MA",Dec-22 p,59527,56975,2552,4.30000000
CN2500500000000,25,005,"Bristol County, MA",Dec-22 p,293746,281600,12146,4.10000000
CN2500700000000,25,007,"Dukes County, MA",Dec-22 p,8374,7873,501,6.00000000
CN2500900000000,25,009,"Essex County, MA",Dec-22 p,417985,403646,14339,3.40000000
CN2501100000000,25,011,"Franklin County, MA",Dec-22 p,39521,38379,1142,2.90000000
CN2501300000000,25,013,"Hampden County, MA",Dec-22 p,221620,212076,9544,4.30000000
CN2501500000000,25,015,"Hampshire County, MA",Dec-22 p,88644,86060,2584,2.90000000
CN2501700000000,25,017,"Middlesex County, MA",Dec-22 p,911258,888311,22947,2.50000000
CN2501900000000,25,019,"Nantucket County/town, MA",Dec-22 p,6989,6460,529,7.60000000
CN2502100000000,25,021,"Norfolk County, MA",Dec-22 p,391516,380792,10724,2.70000000
CN2502300000000,25,023,"Plymouth County, MA",Dec-22 p,281485,271956,9529,3.40000000
CN2502500000000,25,025,"Suffolk County, MA",Dec-22 p,451634,438504,13130,2.90000000
CN2502700000000,25,027,"Worcester County, MA",Dec-22 p,435376,420586,14790,3.40000000
CN2600100000000,26,001,"Alcona County, MI",Dec-22 p,3765,3477,288,7.60000000
CN2600300000000,26,003,"Alger County, MI",Dec-22 p,3059,2744,315,10.30000000
CN2600500000000,26,005,"Allegan County, MI",Dec-22 p,61876,59710,2166,3.50000000
CN2600700000000,26,007,"Alpena County, MI",Dec-22 p,13521,12855,666,4.90000000
CN2600900000000,26,009,"Antrim County, MI",Dec-22 p,9625,8998,627,6.50000000
CN2601100000000,26,011,"Arenac County, MI",Dec-22 p,5732,5244,488,8.50000000
CN2601300000000,26,013,"Baraga County, MI",Dec-22 p,3093,2852,241,7.80000000
CN2601500000000,26,015,"Barry County, MI",Dec-22 p,32119,30947,1172,3.60000000
CN2601700000000,26,017,"Bay County, MI",Dec-22 p,48734,46253,2481,5.10000000
CN2601900000000,26,019,"Benzie County, MI",Dec-22 p,8670,8171,499,5.80000000
CN2602100000000,26,021,"Berrien County, MI",Dec-22 p,70877,67639,3238,4.60000000
CN2602300000000,26,023,"Branch County, MI",Dec-22 p,19249,18474,775,4.00000000
CN2602500000000,26,025,"Calhoun County, MI",Dec-22 p,59917,57205,2712,4.50000000
CN2602700000000,26,027,"Cass County, MI",Dec-22 p,24014,22977,1037,4.30000000
CN2602900000000,26,029,"Charlevoix County, MI",Dec-22 p,11877,11198,679,5.70000000
CN2603100000000,26,031,"Cheboygan County, MI",Dec-22 p,9623,8578,1045,10.90000000
CN2603300000000,26,033,"Chippewa County, MI",Dec-22 p,16306,15182,1124,6.90000000
CN2603500000000,26,035,"Clare County, MI",Dec-22 p,11186,10384,802,7.20000000
CN2603700000000,26,037,"Clinton County, MI",Dec-22 p,40782,39446,1336,3.30000000
CN2603900000000,26,039,"Crawford County, MI",Dec-22 p,5301,4907,394,7.40000000
CN2604100000000,26,041,"Delta County, MI",Dec-22 p,16130,15173,957,5.90000000
CN2604300000000,26,043,"Dickinson County, MI",Dec-22 p,11995,11516,479,4.00000000
CN2604500000000,26,045,"Eaton County, MI",Dec-22 p,56668,54625,2043,3.60000000
CN2604700000000,26,047,"Emmet County, MI",Dec-22 p,16082,14979,1103,6.90000000
CN2604900000000,26,049,"Genesee County, MI",Dec-22 p,176881,167347,9534,5.40000000
CN2605100000000,26,051,"Gladwin County, MI",Dec-22 p,9596,8963,633,6.60000000
CN2605300000000,26,053,"Gogebic County, MI",Dec-22 p,5675,5376,299,5.30000000
CN2605500000000,26,055,"Grand Traverse County, MI",Dec-22 p,48685,46892,1793,3.70000000
CN2605700000000,26,057,"Gratiot County, MI",Dec-22 p,17043,16304,739,4.30000000
CN2605900000000,26,059,"Hillsdale County, MI",Dec-22 p,19472,18607,865,4.40000000
CN2606100000000,26,061,"Houghton County, MI",Dec-22 p,16405,15669,736,4.50000000
CN2606300000000,26,063,"Huron County, MI",Dec-22 p,14701,14015,686,4.70000000
CN2606500000000,26,065,"Ingham County, MI",Dec-22 p,148177,142822,5355,3.60000000
CN2606700000000,26,067,"Ionia County, MI",Dec-22 p,30132,29103,1029,3.40000000
CN2606900000000,26,069,"Iosco County, MI",Dec-22 p,10046,9339,707,7.00000000
CN2607100000000,26,071,"Iron County, MI",Dec-22 p,4814,4510,304,6.30000000
CN2607300000000,26,073,"Isabella County, MI",Dec-22 p,32707,31347,1360,4.20000000
CN2607500000000,26,075,"Jackson County, MI",Dec-22 p,72600,69568,3032,4.20000000
CN2607700000000,26,077,"Kalamazoo County, MI",Dec-22 p,131864,127222,4642,3.50000000
CN2607900000000,26,079,"Kalkaska County, MI",Dec-22 p,7822,7307,515,6.60000000
CN2608100000000,26,081,"Kent County, MI",Dec-22 p,363071,351968,11103,3.10000000
CN2608300000000,26,083,"Keweenaw County, MI",Dec-22 p,931,860,71,7.60000000
CN2608500000000,26,085,"Lake County, MI",Dec-22 p,4055,3736,319,7.90000000
CN2608700000000,26,087,"Lapeer County, MI",Dec-22 p,40415,38769,1646,4.10000000
CN2608900000000,26,089,"Leelanau County, MI",Dec-22 p,10157,9728,429,4.20000000
CN2609100000000,26,091,"Lenawee County, MI",Dec-22 p,44622,42774,1848,4.10000000
CN2609300000000,26,093,"Livingston County, MI",Dec-22 p,102978,100478,2500,2.40000000
CN2609500000000,26,095,"Luce County, MI",Dec-22 p,2091,1928,163,7.80000000
CN2609700000000,26,097,"Mackinac County, MI",Dec-22 p,4279,3598,681,15.90000000
CN2609900000000,26,099,"Macomb County, MI",Dec-22 p,441893,427585,14308,3.20000000
CN2610100000000,26,101,"Manistee County, MI",Dec-22 p,9898,9233,665,6.70000000
CN2610300000000,26,103,"Marquette County, MI",Dec-22 p,31425,29874,1551,4.90000000
CN2610500000000,26,105,"Mason County, MI",Dec-22 p,12739,11990,749,5.90000000
CN2610700000000,26,107,"Mecosta County, MI",Dec-22 p,18657,17663,994,5.30000000
CN2610900000000,26,109,"Menominee County, MI",Dec-22 p,10337,9885,452,4.40000000
CN2611100000000,26,111,"Midland County, MI",Dec-22 p,38616,37026,1590,4.10000000
CN2611300000000,26,113,"Missaukee County, MI",Dec-22 p,6776,6442,334,4.90000000
CN2611500000000,26,115,"Monroe County, MI",Dec-22 p,73532,70411,3121,4.20000000
CN2611700000000,26,117,"Montcalm County, MI",Dec-22 p,28145,26937,1208,4.30000000
CN2611900000000,26,119,"Montmorency County, MI",Dec-22 p,2979,2695,284,9.50000000
CN2612100000000,26,121,"Muskegon County, MI",Dec-22 p,76673,72855,3818,5.00000000
CN2612300000000,26,123,"Newaygo County, MI",Dec-22 p,23536,22496,1040,4.40000000
CN2612500000000,26,125,"Oakland County, MI",Dec-22 p,665746,648892,16854,2.50000000
CN2612700000000,26,127,"Oceana County, MI",Dec-22 p,11559,10770,789,6.80000000
CN2612900000000,26,129,"Ogemaw County, MI",Dec-22 p,7986,7311,675,8.50000000
CN2613100000000,26,131,"Ontonagon County, MI",Dec-22 p,2049,1892,157,7.70000000
CN2613300000000,26,133,"Osceola County, MI",Dec-22 p,11591,11070,521,4.50000000
CN2613500000000,26,135,"Oscoda County, MI",Dec-22 p,2504,2260,244,9.70000000
CN2613700000000,26,137,"Otsego County, MI",Dec-22 p,11346,10719,627,5.50000000
CN2613900000000,26,139,"Ottawa County, MI",Dec-22 p,163455,158751,4704,2.90000000
CN2614100000000,26,141,"Presque Isle County, MI",Dec-22 p,4898,4464,434,8.90000000
CN2614300000000,26,143,"Roscommon County, MI",Dec-22 p,7163,6430,733,10.20000000
CN2614500000000,26,145,"Saginaw County, MI",Dec-22 p,82713,78154,4559,5.50000000
CN2614700000000,26,147,"St. Clair County, MI",Dec-22 p,74563,71909,2654,3.60000000
CN2614900000000,26,149,"St. Joseph County, MI",Dec-22 p,28017,26857,1160,4.10000000
CN2615100000000,26,151,"Sanilac County, MI",Dec-22 p,19170,18238,932,4.90000000
CN2615300000000,26,153,"Schoolcraft County, MI",Dec-22 p,3230,2955,275,8.50000000
CN2615500000000,26,155,"Shiawassee County, MI",Dec-22 p,32422,31002,1420,4.40000000
CN2615700000000,26,157,"Tuscola County, MI",Dec-22 p,23011,21797,1214,5.30000000
CN2615900000000,26,159,"Van Buren County, MI",Dec-22 p,34718,32867,1851,5.30000000
CN2616100000000,26,161,"Washtenaw County, MI",Dec-22 p,196315,190417,5898,3.00000000
CN2616300000000,26,163,"Wayne County, MI",Dec-22 p,793324,761373,31951,4.00000000
CN2616500000000,26,165,"Wexford County, MI",Dec-22 p,14590,13888,702,4.80000000
CN2700100000000,27,001,"Aitkin County, MN",Dec-22 p,7406,6938,468,6.30000000
CN2700300000000,27,003,"Anoka County, MN",Dec-22 p,200276,194813,5463,2.70000000
CN2700500000000,27,005,"Becker County, MN",Dec-22 p,18632,17892,740,4.00000000
CN2700700000000,27,007,"Beltrami County, MN",Dec-22 p,23960,23007,953,4.00000000
CN2700900000000,27,009,"Benton County, MN",Dec-22 p,21813,20865,948,4.30000000
CN2701100000000,27,011,"Big Stone County, MN",Dec-22 p,2342,2238,104,4.40000000
CN2701300000000,27,013,"Blue Earth County, MN",Dec-22 p,40138,39119,1019,2.50000000
CN2701500000000,27,015,"Brown County, MN",Dec-22 p,13186,12785,401,3.00000000
CN2701700000000,27,017,"Carlton County, MN",Dec-22 p,17442,16656,786,4.50000000
CN2701900000000,27,019,"Carver County, MN",Dec-22 p,59866,58494,1372,2.30000000
CN2702100000000,27,021,"Cass County, MN",Dec-22 p,15603,14758,845,5.40000000
CN2702300000000,27,023,"Chippewa County, MN",Dec-22 p,6416,6225,191,3.00000000
CN2702500000000,27,025,"Chisago County, MN",Dec-22 p,30393,29241,1152,3.80000000
CN2702700000000,27,027,"Clay County, MN",Dec-22 p,36502,35654,848,2.30000000
CN2702900000000,27,029,"Clearwater County, MN",Dec-22 p,4567,4212,355,7.80000000
CN2703100000000,27,031,"Cook County, MN",Dec-22 p,2676,2540,136,5.10000000
CN2703300000000,27,033,"Cottonwood County, MN",Dec-22 p,6776,6596,180,2.70000000
CN2703500000000,27,035,"Crow Wing County, MN",Dec-22 p,31118,29658,1460,4.70000000
CN2703700000000,27,037,"Dakota County, MN",Dec-22 p,244196,238128,6068,2.50000000
CN2703900000000,27,039,"Dodge County, MN",Dec-22 p,12023,11674,349,2.90000000
CN2704100000000,27,041,"Douglas County, MN",Dec-22 p,20709,20072,637,3.10000000
CN2704300000000,27,043,"Faribault County, MN",Dec-22 p,6829,6542,287,4.20000000
CN2704500000000,27,045,"Fillmore County, MN",Dec-22 p,11603,11242,361,3.10000000
CN2704700000000,27,047,"Freeborn County, MN",Dec-22 p,15038,14573,465,3.10000000
CN2704900000000,27,049,"Goodhue County, MN",Dec-22 p,26022,25257,765,2.90000000
CN2705100000000,27,051,"Grant County, MN",Dec-22 p,3215,3091,124,3.90000000
CN2705300000000,27,053,"Hennepin County, MN",Dec-22 p,708226,691419,16807,2.40000000
CN2705500000000,27,055,"Houston County, MN",Dec-22 p,10335,10037,298,2.90000000
CN2705700000000,27,057,"Hubbard County, MN",Dec-22 p,9790,9231,559,5.70000000
CN2705900000000,27,059,"Isanti County, MN",Dec-22 p,22150,21164,986,4.50000000
CN2706100000000,27,061,"Itasca County, MN",Dec-22 p,20576,19378,1198,5.80000000
CN2706300000000,27,063,"Jackson County, MN",Dec-22 p,5301,5165,136,2.60000000
CN2706500000000,27,065,"Kanabec County, MN",Dec-22 p,9267,8608,659,7.10000000
CN2706700000000,27,067,"Kandiyohi County, MN",Dec-22 p,22551,21743,808,3.60000000
CN2706900000000,27,069,"Kittson County, MN",Dec-22 p,2235,2163,72,3.20000000
CN2707100000000,27,071,"Koochiching County, MN",Dec-22 p,5388,5150,238,4.40000000
CN2707300000000,27,073,"Lac qui Parle County, MN",Dec-22 p,3349,3233,116,3.50000000
CN2707500000000,27,075,"Lake County, MN",Dec-22 p,5100,4816,284,5.60000000
CN2707700000000,27,077,"Lake of the Woods County, MN",Dec-22 p,2383,2296,87,3.70000000
CN2707900000000,27,079,"Le Sueur County, MN",Dec-22 p,16348,15488,860,5.30000000
CN2708100000000,27,081,"Lincoln County, MN",Dec-22 p,2953,2845,108,3.70000000
CN2708300000000,27,083,"Lyon County, MN",Dec-22 p,13879,13484,395,2.80000000
CN2708500000000,27,085,"McLeod County, MN",Dec-22 p,18841,18146,695,3.70000000
CN2708700000000,27,087,"Mahnomen County, MN",Dec-22 p,2187,2045,142,6.50000000
CN2708900000000,27,089,"Marshall County, MN",Dec-22 p,5259,4963,296,5.60000000
CN2709100000000,27,091,"Martin County, MN",Dec-22 p,9229,8963,266,2.90000000
CN2709300000000,27,093,"Meeker County, MN",Dec-22 p,13198,12639,559,4.20000000
CN2709500000000,27,095,"Mille Lacs County, MN",Dec-22 p,13038,12207,831,6.40000000
CN2709700000000,27,097,"Morrison County, MN",Dec-22 p,17452,16332,1120,6.40000000
CN2709900000000,27,099,"Mower County, MN",Dec-22 p,20230,19657,573,2.80000000
CN2710100000000,27,101,"Murray County, MN",Dec-22 p,4619,4392,227,4.90000000
CN2710300000000,27,103,"Nicollet County, MN",Dec-22 p,20598,20124,474,2.30000000
CN2710500000000,27,105,"Nobles County, MN",Dec-22 p,11124,10842,282,2.50000000
CN2710700000000,27,107,"Norman County, MN",Dec-22 p,3262,3128,134,4.10000000
CN2710900000000,27,109,"Olmsted County, MN",Dec-22 p,91417,89371,2046,2.20000000
CN2711100000000,27,111,"Otter Tail County, MN",Dec-22 p,30407,29180,1227,4.00000000
CN2711300000000,27,113,"Pennington County, MN",Dec-22 p,8633,8235,398,4.60000000
CN2711500000000,27,115,"Pine County, MN",Dec-22 p,14287,13367,920,6.40000000
CN2711700000000,27,117,"Pipestone County, MN",Dec-22 p,4418,4288,130,2.90000000
CN2711900000000,27,119,"Polk County, MN",Dec-22 p,15829,15334,495,3.10000000
CN2712100000000,27,121,"Pope County, MN",Dec-22 p,6296,6072,224,3.60000000
CN2712300000000,27,123,"Ramsey County, MN",Dec-22 p,287000,279624,7376,2.60000000
CN2712500000000,27,125,"Red Lake County, MN",Dec-22 p,2151,2067,84,3.90000000
CN2712700000000,27,127,"Redwood County, MN",Dec-22 p,7440,7216,224,3.00000000
CN2712900000000,27,129,"Renville County, MN",Dec-22 p,8084,7765,319,3.90000000
CN2713100000000,27,131,"Rice County, MN",Dec-22 p,36527,35388,1139,3.10000000
CN2713300000000,27,133,"Rock County, MN",Dec-22 p,6005,5890,115,1.90000000
CN2713500000000,27,135,"Roseau County, MN",Dec-22 p,7811,7579,232,3.00000000
CN2713700000000,27,137,"St. Louis County, MN",Dec-22 p,98804,95275,3529,3.60000000
CN2713900000000,27,139,"Scott County, MN",Dec-22 p,85071,83019,2052,2.40000000
CN2714100000000,27,141,"Sherburne County, MN",Dec-22 p,53875,52015,1860,3.50000000
CN2714300000000,27,143,"Sibley County, MN",Dec-22 p,8288,7952,336,4.10000000
CN2714500000000,27,145,"Stearns County, MN",Dec-22 p,89864,87075,2789,3.10000000
CN2714700000000,27,147,"Steele County, MN",Dec-22 p,19274,18670,604,3.10000000
CN2714900000000,27,149,"Stevens County, MN",Dec-22 p,5233,5076,157,3.00000000
CN2715100000000,27,151,"Swift County, MN",Dec-22 p,4657,4484,173,3.70000000
CN2715300000000,27,153,"Todd County, MN",Dec-22 p,13329,12752,577,4.30000000
CN2715500000000,27,155,"Traverse County, MN",Dec-22 p,1645,1594,51,3.10000000
CN2715700000000,27,157,"Wabasha County, MN",Dec-22 p,12328,11956,372,3.00000000
CN2715900000000,27,159,"Wadena County, MN",Dec-22 p,5961,5613,348,5.80000000
CN2716100000000,27,161,"Waseca County, MN",Dec-22 p,8421,8064,357,4.20000000
CN2716300000000,27,163,"Washington County, MN",Dec-22 p,146002,142587,3415,2.30000000
CN2716500000000,27,165,"Watonwan County, MN",Dec-22 p,6509,6329,180,2.80000000
CN2716700000000,27,167,"Wilkin County, MN",Dec-22 p,3308,3221,87,2.60000000
CN2716900000000,27,169,"Winona County, MN",Dec-22 p,27005,26324,681,2.50000000
CN2717100000000,27,171,"Wright County, MN",Dec-22 p,77698,75179,2519,3.20000000
CN2717300000000,27,173,"Yellow Medicine County, MN",Dec-22 p,4982,4814,168,3.40000000
CN2800100000000,28,001,"Adams County, MS",Dec-22 p,10328,9832,496,4.80000000
CN2800300000000,28,003,"Alcorn County, MS",Dec-22 p,15308,14842,466,3.00000000
CN2800500000000,28,005,"Amite County, MS",Dec-22 p,4297,4082,215,5.00000000
CN2800700000000,28,007,"Attala County, MS",Dec-22 p,7092,6839,253,3.60000000
CN2800900000000,28,009,"Benton County, MS",Dec-22 p,3092,2953,139,4.50000000
CN2801100000000,28,011,"Bolivar County, MS",Dec-22 p,10878,10415,463,4.30000000
CN2801300000000,28,013,"Calhoun County, MS",Dec-22 p,5364,5142,222,4.10000000
CN2801500000000,28,015,"Carroll County, MS",Dec-22 p,3439,3302,137,4.00000000
CN2801700000000,28,017,"Chickasaw County, MS",Dec-22 p,6760,6422,338,5.00000000
CN2801900000000,28,019,"Choctaw County, MS",Dec-22 p,3539,3429,110,3.10000000
CN2802100000000,28,021,"Claiborne County, MS",Dec-22 p,2819,2614,205,7.30000000
CN2802300000000,28,023,"Clarke County, MS",Dec-22 p,5523,5293,230,4.20000000
CN2802500000000,28,025,"Clay County, MS",Dec-22 p,8191,7847,344,4.20000000
CN2802700000000,28,027,"Coahoma County, MS",Dec-22 p,7500,7085,415,5.50000000
CN2802900000000,28,029,"Copiah County, MS",Dec-22 p,10464,10049,415,4.00000000
CN2803100000000,28,031,"Covington County, MS",Dec-22 p,8058,7817,241,3.00000000
CN2803300000000,28,033,"DeSoto County, MS",Dec-22 p,94813,92257,2556,2.70000000
CN2803500000000,28,035,"Forrest County, MS",Dec-22 p,32608,31549,1059,3.20000000
CN2803700000000,28,037,"Franklin County, MS",Dec-22 p,2581,2448,133,5.20000000
CN2803900000000,28,039,"George County, MS",Dec-22 p,8417,8002,415,4.90000000
CN2804100000000,28,041,"Greene County, MS",Dec-22 p,4136,3906,230,5.60000000
CN2804300000000,28,043,"Grenada County, MS",Dec-22 p,8747,8456,291,3.30000000
CN2804500000000,28,045,"Hancock County, MS",Dec-22 p,18841,18183,658,3.50000000
CN2804700000000,28,047,"Harrison County, MS",Dec-22 p,86631,83838,2793,3.20000000
CN2804900000000,28,049,"Hinds County, MS",Dec-22 p,98962,95595,3367,3.40000000
CN2805100000000,28,051,"Holmes County, MS",Dec-22 p,4850,4540,310,6.40000000
CN2805300000000,28,053,"Humphreys County, MS",Dec-22 p,1883,1748,135,7.20000000
CN2805500000000,28,055,"Issaquena County, MS",Dec-22 p,310,288,22,7.10000000
CN2805700000000,28,057,"Itawamba County, MS",Dec-22 p,10238,9913,325,3.20000000
CN2805900000000,28,059,"Jackson County, MS",Dec-22 p,58046,55895,2151,3.70000000
CN2806100000000,28,061,"Jasper County, MS",Dec-22 p,5658,5395,263,4.60000000
CN2806300000000,28,063,"Jefferson County, MS",Dec-22 p,1818,1605,213,11.70000000
CN2806500000000,28,065,"Jefferson Davis County, MS",Dec-22 p,3805,3621,184,4.80000000
CN2806700000000,28,067,"Jones County, MS",Dec-22 p,24082,23253,829,3.40000000
CN2806900000000,28,069,"Kemper County, MS",Dec-22 p,3183,3012,171,5.40000000
CN2807100000000,28,071,"Lafayette County, MS",Dec-22 p,28704,28012,692,2.40000000
CN2807300000000,28,073,"Lamar County, MS",Dec-22 p,31020,30233,787,2.50000000
CN2807500000000,28,075,"Lauderdale County, MS",Dec-22 p,28413,27423,990,3.50000000
CN2807700000000,28,077,"Lawrence County, MS",Dec-22 p,4540,4325,215,4.70000000
CN2807900000000,28,079,"Leake County, MS",Dec-22 p,7841,7562,279,3.60000000
CN2808100000000,28,081,"Lee County, MS",Dec-22 p,40739,39508,1231,3.00000000
CN2808300000000,28,083,"Leflore County, MS",Dec-22 p,9725,9235,490,5.00000000
CN2808500000000,28,085,"Lincoln County, MS",Dec-22 p,14157,13663,494,3.50000000
CN2808700000000,28,087,"Lowndes County, MS",Dec-22 p,25126,24255,871,3.50000000
CN2808900000000,28,089,"Madison County, MS",Dec-22 p,51908,50550,1358,2.60000000
CN2809100000000,28,091,"Marion County, MS",Dec-22 p,10115,9783,332,3.30000000
CN2809300000000,28,093,"Marshall County, MS",Dec-22 p,14394,13890,504,3.50000000
CN2809500000000,28,095,"Monroe County, MS",Dec-22 p,15644,14964,680,4.30000000
CN2809700000000,28,097,"Montgomery County, MS",Dec-22 p,3787,3638,149,3.90000000
CN2809900000000,28,099,"Neshoba County, MS",Dec-22 p,9716,9356,360,3.70000000
CN2810100000000,28,101,"Newton County, MS",Dec-22 p,8093,7824,269,3.30000000
CN2810300000000,28,103,"Noxubee County, MS",Dec-22 p,3348,3171,177,5.30000000
CN2810500000000,28,105,"Oktibbeha County, MS",Dec-22 p,22018,21287,731,3.30000000
CN2810700000000,28,107,"Panola County, MS",Dec-22 p,12537,12037,500,4.00000000
CN2810900000000,28,109,"Pearl River County, MS",Dec-22 p,23321,22549,772,3.30000000
CN2811100000000,28,111,"Perry County, MS",Dec-22 p,4164,3978,186,4.50000000
CN2811300000000,28,113,"Pike County, MS",Dec-22 p,14037,13446,591,4.20000000
CN2811500000000,28,115,"Pontotoc County, MS",Dec-22 p,14847,14408,439,3.00000000
CN2811700000000,28,117,"Prentiss County, MS",Dec-22 p,11415,11098,317,2.80000000
CN2811900000000,28,119,"Quitman County, MS",Dec-22 p,2254,2128,126,5.60000000
CN2812100000000,28,121,"Rankin County, MS",Dec-22 p,74526,72668,1858,2.50000000
CN2812300000000,28,123,"Scott County, MS",Dec-22 p,12015,11682,333,2.80000000
CN2812500000000,28,125,"Sharkey County, MS",Dec-22 p,1337,1268,69,5.20000000
CN2812700000000,28,127,"Simpson County, MS",Dec-22 p,10282,9949,333,3.20000000
CN2812900000000,28,129,"Smith County, MS",Dec-22 p,6433,6227,206,3.20000000
CN2813100000000,28,131,"Stone County, MS",Dec-22 p,6868,6612,256,3.70000000
CN2813300000000,28,133,"Sunflower County, MS",Dec-22 p,7270,6858,412,5.70000000
CN2813500000000,28,135,"Tallahatchie County, MS",Dec-22 p,4437,4276,161,3.60000000
CN2813700000000,28,137,"Tate County, MS",Dec-22 p,12228,11833,395,3.20000000
CN2813900000000,28,139,"Tippah County, MS",Dec-22 p,9809,9522,287,2.90000000
CN2814100000000,28,141,"Tishomingo County, MS",Dec-22 p,8306,8008,298,3.60000000
CN2814300000000,28,143,"Tunica County, MS",Dec-22 p,4202,4022,180,4.30000000
CN2814500000000,28,145,"Union County, MS",Dec-22 p,14377,14016,361,2.50000000
CN2814700000000,28,147,"Walthall County, MS",Dec-22 p,4821,4605,216,4.50000000
CN2814900000000,28,149,"Warren County, MS",Dec-22 p,18793,18112,681,3.60000000
CN2815100000000,28,151,"Washington County, MS",Dec-22 p,15189,14446,743,4.90000000
CN2815300000000,28,153,"Wayne County, MS",Dec-22 p,7224,6939,285,3.90000000
CN2815500000000,28,155,"Webster County, MS",Dec-22 p,3861,3729,132,3.40000000
CN2815700000000,28,157,"Wilkinson County, MS",Dec-22 p,2558,2400,158,6.20000000
CN2815900000000,28,159,"Winston County, MS",Dec-22 p,6889,6636,253,3.70000000
CN2816100000000,28,161,"Yalobusha County, MS",Dec-22 p,4837,4669,168,3.50000000
CN2816300000000,28,163,"Yazoo County, MS",Dec-22 p,8593,8257,336,3.90000000
CN2900100000000,29,001,"Adair County, MO",Dec-22 p,10079,9835,244,2.40000000
CN2900300000000,29,003,"Andrew County, MO",Dec-22 p,9682,9510,172,1.80000000
CN2900500000000,29,005,"Atchison County, MO",Dec-22 p,2642,2590,52,2.00000000
CN2900700000000,29,007,"Audrain County, MO",Dec-22 p,10122,9859,263,2.60000000
CN2900900000000,29,009,"Barry County, MO",Dec-22 p,14379,14023,356,2.50000000
CN2901100000000,29,011,"Barton County, MO",Dec-22 p,5246,5136,110,2.10000000
CN2901300000000,29,013,"Bates County, MO",Dec-22 p,7634,7438,196,2.60000000
CN2901500000000,29,015,"Benton County, MO",Dec-22 p,7367,7099,268,3.60000000
CN2901700000000,29,017,"Bollinger County, MO",Dec-22 p,5320,5191,129,2.40000000
CN2901900000000,29,019,"Boone County, MO",Dec-22 p,100708,98981,1727,1.70000000
CN2902100000000,29,021,"Buchanan County, MO",Dec-22 p,43413,42506,907,2.10000000
CN2902300000000,29,023,"Butler County, MO",Dec-22 p,18606,17994,612,3.30000000
CN2902500000000,29,025,"Caldwell County, MO",Dec-22 p,4231,4132,99,2.30000000
CN2902700000000,29,027,"Callaway County, MO",Dec-22 p,21362,20917,445,2.10000000
CN2902900000000,29,029,"Camden County, MO",Dec-22 p,18647,17996,651,3.50000000
CN2903100000000,29,031,"Cape Girardeau County, MO",Dec-22 p,40638,39821,817,2.00000000
CN2903300000000,29,033,"Carroll County, MO",Dec-22 p,4394,4291,103,2.30000000
CN2903500000000,29,035,"Carter County, MO",Dec-22 p,2546,2453,93,3.70000000
CN2903700000000,29,037,"Cass County, MO",Dec-22 p,54881,53671,1210,2.20000000
CN2903900000000,29,039,"Cedar County, MO",Dec-22 p,5732,5581,151,2.60000000
CN2904100000000,29,041,"Chariton County, MO",Dec-22 p,3761,3703,58,1.50000000
CN2904300000000,29,043,"Christian County, MO",Dec-22 p,47126,46260,866,1.80000000
CN2904500000000,29,045,"Clark County, MO",Dec-22 p,3024,2922,102,3.40000000
CN2904700000000,29,047,"Clay County, MO",Dec-22 p,138169,135290,2879,2.10000000
CN2904900000000,29,049,"Clinton County, MO",Dec-22 p,10553,10315,238,2.30000000
CN2905100000000,29,051,"Cole County, MO",Dec-22 p,38817,38116,701,1.80000000
CN2905300000000,29,053,"Cooper County, MO",Dec-22 p,7142,6988,154,2.20000000
CN2905500000000,29,055,"Crawford County, MO",Dec-22 p,10825,10550,275,2.50000000
CN2905700000000,29,057,"Dade County, MO",Dec-22 p,3495,3421,74,2.10000000
CN2905900000000,29,059,"Dallas County, MO",Dec-22 p,7170,6984,186,2.60000000
CN2906100000000,29,061,"Daviess County, MO",Dec-22 p,3998,3921,77,1.90000000
CN2906300000000,29,063,"DeKalb County, MO",Dec-22 p,4119,4042,77,1.90000000
CN2906500000000,29,065,"Dent County, MO",Dec-22 p,6126,5956,170,2.80000000
CN2906700000000,29,067,"Douglas County, MO",Dec-22 p,5212,5074,138,2.60000000
CN2906900000000,29,069,"Dunklin County, MO",Dec-22 p,11111,10657,454,4.10000000
CN2907100000000,29,071,"Franklin County, MO",Dec-22 p,53155,52004,1151,2.20000000
CN2907300000000,29,073,"Gasconade County, MO",Dec-22 p,7697,7523,174,2.30000000
CN2907500000000,29,075,"Gentry County, MO",Dec-22 p,3247,3190,57,1.80000000
CN2907700000000,29,077,"Greene County, MO",Dec-22 p,153905,150957,2948,1.90000000
CN2907900000000,29,079,"Grundy County, MO",Dec-22 p,4129,4035,94,2.30000000
CN2908100000000,29,081,"Harrison County, MO",Dec-22 p,3791,3708,83,2.20000000
CN2908300000000,29,083,"Henry County, MO",Dec-22 p,10326,10074,252,2.40000000
CN2908500000000,29,085,"Hickory County, MO",Dec-22 p,4000,3884,116,2.90000000
CN2908700000000,29,087,"Holt County, MO",Dec-22 p,2481,2445,36,1.50000000
CN2908900000000,29,089,"Howard County, MO",Dec-22 p,4775,4674,101,2.10000000
CN2909100000000,29,091,"Howell County, MO",Dec-22 p,16263,15814,449,2.80000000
CN2909300000000,29,093,"Iron County, MO",Dec-22 p,3532,3394,138,3.90000000
CN2909500000000,29,095,"Jackson County, MO",Dec-22 p,359663,350001,9662,2.70000000
CN2909700000000,29,097,"Jasper County, MO",Dec-22 p,58100,56850,1250,2.20000000
CN2909900000000,29,099,"Jefferson County, MO",Dec-22 p,118676,116085,2591,2.20000000
CN2910100000000,29,101,"Johnson County, MO",Dec-22 p,23010,22485,525,2.30000000
CN2910300000000,29,103,"Knox County, MO",Dec-22 p,1779,1726,53,3.00000000
CN2910500000000,29,105,"Laclede County, MO",Dec-22 p,16618,16196,422,2.50000000
CN2910700000000,29,107,"Lafayette County, MO",Dec-22 p,16663,16290,373,2.20000000
CN2910900000000,29,109,"Lawrence County, MO",Dec-22 p,17225,16849,376,2.20000000
CN2911100000000,29,111,"Lewis County, MO",Dec-22 p,4799,4702,97,2.00000000
CN2911300000000,29,113,"Lincoln County, MO",Dec-22 p,29323,28669,654,2.20000000
CN2911500000000,29,115,"Linn County, MO",Dec-22 p,5255,5113,142,2.70000000
CN2911700000000,29,117,"Livingston County, MO",Dec-22 p,7294,7175,119,1.60000000
CN2911900000000,29,119,"McDonald County, MO",Dec-22 p,10896,10662,234,2.10000000
CN2912100000000,29,121,"Macon County, MO",Dec-22 p,7364,7177,187,2.50000000
CN2912300000000,29,123,"Madison County, MO",Dec-22 p,5430,5278,152,2.80000000
CN2912500000000,29,125,"Maries County, MO",Dec-22 p,3892,3809,83,2.10000000
CN2912700000000,29,127,"Marion County, MO",Dec-22 p,13977,13674,303,2.20000000
CN2912900000000,29,129,"Mercer County, MO",Dec-22 p,1732,1696,36,2.10000000
CN2913100000000,29,131,"Miller County, MO",Dec-22 p,12820,12487,333,2.60000000
CN2913300000000,29,133,"Mississippi County, MO",Dec-22 p,5252,5102,150,2.90000000
CN2913500000000,29,135,"Moniteau County, MO",Dec-22 p,6977,6847,130,1.90000000
CN2913700000000,29,137,"Monroe County, MO",Dec-22 p,3823,3734,89,2.30000000
CN2913900000000,29,139,"Montgomery County, MO",Dec-22 p,5854,5721,133,2.30000000
CN2914100000000,29,141,"Morgan County, MO",Dec-22 p,8320,8080,240,2.90000000
CN2914300000000,29,143,"New Madrid County, MO",Dec-22 p,8267,8044,223,2.70000000
CN2914500000000,29,145,"Newton County, MO",Dec-22 p,27461,26878,583,2.10000000
CN2914700000000,29,147,"Nodaway County, MO",Dec-22 p,11105,10910,195,1.80000000
CN2914900000000,29,149,"Oregon County, MO",Dec-22 p,3828,3718,110,2.90000000
CN2915100000000,29,151,"Osage County, MO",Dec-22 p,6988,6865,123,1.80000000
CN2915300000000,29,153,"Ozark County, MO",Dec-22 p,3418,3276,142,4.20000000
CN2915500000000,29,155,"Pemiscot County, MO",Dec-22 p,5854,5624,230,3.90000000
CN2915700000000,29,157,"Perry County, MO",Dec-22 p,9637,9474,163,1.70000000
CN2915900000000,29,159,"Pettis County, MO",Dec-22 p,20425,19985,440,2.20000000
CN2916100000000,29,161,"Phelps County, MO",Dec-22 p,20458,20000,458,2.20000000
CN2916300000000,29,163,"Pike County, MO",Dec-22 p,7344,7187,157,2.10000000
CN2916500000000,29,165,"Platte County, MO",Dec-22 p,59806,58649,1157,1.90000000
CN2916700000000,29,167,"Polk County, MO",Dec-22 p,14673,14348,325,2.20000000
CN2916900000000,29,169,"Pulaski County, MO",Dec-22 p,14576,14176,400,2.70000000
CN2917100000000,29,171,"Putnam County, MO",Dec-22 p,2191,2147,44,2.00000000
CN2917300000000,29,173,"Ralls County, MO",Dec-22 p,5501,5380,121,2.20000000
CN2917500000000,29,175,"Randolph County, MO",Dec-22 p,10342,10115,227,2.20000000
CN2917700000000,29,177,"Ray County, MO",Dec-22 p,10780,10533,247,2.30000000
CN2917900000000,29,179,"Reynolds County, MO",Dec-22 p,2843,2758,85,3.00000000
CN2918100000000,29,181,"Ripley County, MO",Dec-22 p,5233,5069,164,3.10000000
CN2918300000000,29,183,"St. Charles County, MO",Dec-22 p,229812,225594,4218,1.80000000
CN2918500000000,29,185,"St. Clair County, MO",Dec-22 p,3871,3773,98,2.50000000
CN2918600000000,29,186,"Ste. Genevieve County, MO",Dec-22 p,9402,9214,188,2.00000000
CN2918700000000,29,187,"St. Francois County, MO",Dec-22 p,25743,24943,800,3.10000000
CN2918900000000,29,189,"St. Louis County, MO",Dec-22 p,528678,516886,11792,2.20000000
CN2919500000000,29,195,"Saline County, MO",Dec-22 p,10271,10035,236,2.30000000
CN2919700000000,29,197,"Schuyler County, MO",Dec-22 p,1850,1793,57,3.10000000
CN2919900000000,29,199,"Scotland County, MO",Dec-22 p,2274,2237,37,1.60000000
CN2920100000000,29,201,"Scott County, MO",Dec-22 p,20238,19811,427,2.10000000
CN2920300000000,29,203,"Shannon County, MO",Dec-22 p,3316,3180,136,4.10000000
CN2920500000000,29,205,"Shelby County, MO",Dec-22 p,2983,2920,63,2.10000000
CN2920700000000,29,207,"Stoddard County, MO",Dec-22 p,13355,12985,370,2.80000000
CN2920900000000,29,209,"Stone County, MO",Dec-22 p,13523,13067,456,3.40000000
CN2921100000000,29,211,"Sullivan County, MO",Dec-22 p,2516,2454,62,2.50000000
CN2921300000000,29,213,"Taney County, MO",Dec-22 p,25823,25001,822,3.20000000
CN2921500000000,29,215,"Texas County, MO",Dec-22 p,9337,9084,253,2.70000000
CN2921700000000,29,217,"Vernon County, MO",Dec-22 p,9077,8856,221,2.40000000
CN2921900000000,29,219,"Warren County, MO",Dec-22 p,18828,18410,418,2.20000000
CN2922100000000,29,221,"Washington County, MO",Dec-22 p,10107,9778,329,3.30000000
CN2922300000000,29,223,"Wayne County, MO",Dec-22 p,4825,4646,179,3.70000000
CN2922500000000,29,225,"Webster County, MO",Dec-22 p,17471,17146,325,1.90000000
CN2922700000000,29,227,"Worth County, MO",Dec-22 p,1154,1133,21,1.80000000
CN2922900000000,29,229,"Wright County, MO",Dec-22 p,7693,7506,187,2.40000000
CN2951000000000,29,510,"St. Louis city, MO",Dec-22 p,149690,145026,4664,3.10000000
CN3000100000000,30,001,"Beaverhead County, MT",Dec-22 p,5155,5051,104,2.00000000
CN3000300000000,30,003,"Big Horn County, MT",Dec-22 p,4723,4535,188,4.00000000
CN3000500000000,30,005,"Blaine County, MT",Dec-22 p,2234,2165,69,3.10000000
CN3000700000000,30,007,"Broadwater County, MT",Dec-22 p,2751,2660,91,3.30000000
CN3000900000000,30,009,"Carbon County, MT",Dec-22 p,5872,5742,130,2.20000000
CN3001100000000,30,011,"Carter County, MT",Dec-22 p,728,717,11,1.50000000
CN3001300000000,30,013,"Cascade County, MT",Dec-22 p,38984,38065,919,2.40000000
CN3001500000000,30,015,"Chouteau County, MT",Dec-22 p,2513,2463,50,2.00000000
CN3001700000000,30,017,"Custer County, MT",Dec-22 p,6503,6357,146,2.20000000
CN3001900000000,30,019,"Daniels County, MT",Dec-22 p,895,880,15,1.70000000
CN3002100000000,30,021,"Dawson County, MT",Dec-22 p,4714,4630,84,1.80000000
CN3002300000000,30,023,"Deer Lodge County, MT",Dec-22 p,5266,5131,135,2.60000000
CN3002500000000,30,025,"Fallon County, MT",Dec-22 p,1702,1677,25,1.50000000
CN3002700000000,30,027,"Fergus County, MT",Dec-22 p,5881,5711,170,2.90000000
CN3002900000000,30,029,"Flathead County, MT",Dec-22 p,51041,49534,1507,3.00000000
CN3003100000000,30,031,"Gallatin County, MT",Dec-22 p,78170,76884,1286,1.60000000
CN3003300000000,30,033,"Garfield County, MT",Dec-22 p,781,756,25,3.20000000
CN3003500000000,30,035,"Glacier County, MT",Dec-22 p,5766,5496,270,4.70000000
CN3003700000000,30,037,"Golden Valley County, MT",Dec-22 p,382,375,7,1.80000000
CN3003900000000,30,039,"Granite County, MT",Dec-22 p,1678,1621,57,3.40000000
CN3004100000000,30,041,"Hill County, MT",Dec-22 p,7521,7376,145,1.90000000
CN3004300000000,30,043,"Jefferson County, MT",Dec-22 p,6054,5916,138,2.30000000
CN3004500000000,30,045,"Judith Basin County, MT",Dec-22 p,1046,1023,23,2.20000000
CN3004700000000,30,047,"Lake County, MT",Dec-22 p,14105,13708,397,2.80000000
CN3004900000000,30,049,"Lewis and Clark County, MT",Dec-22 p,38171,37376,795,2.10000000
CN3005100000000,30,051,"Liberty County, MT",Dec-22 p,1026,1005,21,2.00000000
CN3005300000000,30,053,"Lincoln County, MT",Dec-22 p,8289,7897,392,4.70000000
CN3005500000000,30,055,"McCone County, MT",Dec-22 p,1001,986,15,1.50000000
CN3005700000000,30,057,"Madison County, MT",Dec-22 p,5982,5876,106,1.80000000
CN3005900000000,30,059,"Meagher County, MT",Dec-22 p,1065,1046,19,1.80000000
CN3006100000000,30,061,"Mineral County, MT",Dec-22 p,1732,1648,84,4.80000000
CN3006300000000,30,063,"Missoula County, MT",Dec-22 p,67545,65907,1638,2.40000000
CN3006500000000,30,065,"Musselshell County, MT",Dec-22 p,2376,2318,58,2.40000000
CN3006700000000,30,067,"Park County, MT",Dec-22 p,10171,9899,272,2.70000000
CN3006900000000,30,069,"Petroleum County, MT",Dec-22 p,281,274,7,2.50000000
CN3007100000000,30,071,"Phillips County, MT",Dec-22 p,1876,1813,63,3.40000000
CN3007300000000,30,073,"Pondera County, MT",Dec-22 p,2638,2581,57,2.20000000
CN3007500000000,30,075,"Powder River County, MT",Dec-22 p,1038,1019,19,1.80000000
CN3007700000000,30,077,"Powell County, MT",Dec-22 p,2964,2897,67,2.30000000
CN3007900000000,30,079,"Prairie County, MT",Dec-22 p,504,488,16,3.20000000
CN3008100000000,30,081,"Ravalli County, MT",Dec-22 p,21597,20998,599,2.80000000
CN3008300000000,30,083,"Richland County, MT",Dec-22 p,5700,5586,114,2.00000000
CN3008500000000,30,085,"Roosevelt County, MT",Dec-22 p,4305,4169,136,3.20000000
CN3008700000000,30,087,"Rosebud County, MT",Dec-22 p,3527,3424,103,2.90000000
CN3008900000000,30,089,"Sanders County, MT",Dec-22 p,5302,5061,241,4.50000000
CN3009100000000,30,091,"Sheridan County, MT",Dec-22 p,1774,1747,27,1.50000000
CN3009300000000,30,093,"Silver Bow County, MT",Dec-22 p,17757,17300,457,2.60000000
CN3009500000000,30,095,"Stillwater County, MT",Dec-22 p,5510,5406,104,1.90000000
CN3009700000000,30,097,"Sweet Grass County, MT",Dec-22 p,1938,1902,36,1.90000000
CN3009900000000,30,099,"Teton County, MT",Dec-22 p,2819,2739,80,2.80000000
CN3010100000000,30,101,"Toole County, MT",Dec-22 p,2051,2016,35,1.70000000
CN3010300000000,30,103,"Treasure County, MT",Dec-22 p,372,364,8,2.20000000
CN3010500000000,30,105,"Valley County, MT",Dec-22 p,3936,3852,84,2.10000000
CN3010700000000,30,107,"Wheatland County, MT",Dec-22 p,775,749,26,3.40000000
CN3010900000000,30,109,"Wibaux County, MT",Dec-22 p,455,446,9,2.00000000
CN3011100000000,30,111,"Yellowstone County, MT",Dec-22 p,87573,85775,1798,2.10000000
CN3100100000000,31,001,"Adams County, NE",Dec-22 p,17027,16651,376,2.20000000
CN3100300000000,31,003,"Antelope County, NE",Dec-22 p,3698,3631,67,1.80000000
CN3100500000000,31,005,"Arthur County, NE",Dec-22 p,231,227,4,1.70000000
CN3100700000000,31,007,"Banner County, NE",Dec-22 p,404,388,16,4.00000000
CN3100900000000,31,009,"Blaine County, NE",Dec-22 p,254,244,10,3.90000000
CN3101100000000,31,011,"Boone County, NE",Dec-22 p,3005,2956,49,1.60000000
CN3101300000000,31,013,"Box Butte County, NE",Dec-22 p,5267,5146,121,2.30000000
CN3101500000000,31,015,"Boyd County, NE",Dec-22 p,1043,1025,18,1.70000000
CN3101700000000,31,017,"Brown County, NE",Dec-22 p,1413,1372,41,2.90000000
CN3101900000000,31,019,"Buffalo County, NE",Dec-22 p,28317,27808,509,1.80000000
CN3102100000000,31,021,"Burt County, NE",Dec-22 p,3621,3539,82,2.30000000
CN3102300000000,31,023,"Butler County, NE",Dec-22 p,4666,4584,82,1.80000000
CN3102500000000,31,025,"Cass County, NE",Dec-22 p,13778,13465,313,2.30000000
CN3102700000000,31,027,"Cedar County, NE",Dec-22 p,4717,4633,84,1.80000000
CN3102900000000,31,029,"Chase County, NE",Dec-22 p,2285,2246,39,1.70000000
CN3103100000000,31,031,"Cherry County, NE",Dec-22 p,3406,3349,57,1.70000000
CN3103300000000,31,033,"Cheyenne County, NE",Dec-22 p,4187,4089,98,2.30000000
CN3103500000000,31,035,"Clay County, NE",Dec-22 p,3092,3014,78,2.50000000
CN3103700000000,31,037,"Colfax County, NE",Dec-22 p,5766,5654,112,1.90000000
CN3103900000000,31,039,"Cuming County, NE",Dec-22 p,4983,4891,92,1.80000000
CN3104100000000,31,041,"Custer County, NE",Dec-22 p,6397,6299,98,1.50000000
CN3104300000000,31,043,"Dakota County, NE",Dec-22 p,11072,10716,356,3.20000000
CN3104500000000,31,045,"Dawes County, NE",Dec-22 p,5136,5036,100,1.90000000
CN3104700000000,31,047,"Dawson County, NE",Dec-22 p,13588,13247,341,2.50000000
CN3104900000000,31,049,"Deuel County, NE",Dec-22 p,987,965,22,2.20000000
CN3105100000000,31,051,"Dixon County, NE",Dec-22 p,3058,2988,70,2.30000000
CN3105300000000,31,053,"Dodge County, NE",Dec-22 p,20718,20270,448,2.20000000
CN3105500000000,31,055,"Douglas County, NE",Dec-22 p,308857,300685,8172,2.60000000
CN3105700000000,31,057,"Dundy County, NE",Dec-22 p,1171,1153,18,1.50000000
CN3105900000000,31,059,"Fillmore County, NE",Dec-22 p,3347,3286,61,1.80000000
CN3106100000000,31,061,"Franklin County, NE",Dec-22 p,1521,1486,35,2.30000000
CN3106300000000,31,063,"Frontier County, NE",Dec-22 p,1532,1497,35,2.30000000
CN3106500000000,31,065,"Furnas County, NE",Dec-22 p,2557,2508,49,1.90000000
CN3106700000000,31,067,"Gage County, NE",Dec-22 p,11168,10916,252,2.30000000
CN3106900000000,31,069,"Garden County, NE",Dec-22 p,1068,1048,20,1.90000000
CN3107100000000,31,071,"Garfield County, NE",Dec-22 p,1117,1099,18,1.60000000
CN3107300000000,31,073,"Gosper County, NE",Dec-22 p,1149,1124,25,2.20000000
CN3107500000000,31,075,"Grant County, NE",Dec-22 p,429,423,6,1.40000000
CN3107700000000,31,077,"Greeley County, NE",Dec-22 p,1235,1208,27,2.20000000
CN3107900000000,31,079,"Hall County, NE",Dec-22 p,32280,31450,830,2.60000000
CN3108100000000,31,081,"Hamilton County, NE",Dec-22 p,4844,4750,94,1.90000000
CN3108300000000,31,083,"Harlan County, NE",Dec-22 p,1779,1744,35,2.00000000
CN3108500000000,31,085,"Hayes County, NE",Dec-22 p,621,611,10,1.60000000
CN3108700000000,31,087,"Hitchcock County, NE",Dec-22 p,1328,1299,29,2.20000000
CN3108900000000,31,089,"Holt County, NE",Dec-22 p,5709,5597,112,2.00000000
CN3109100000000,31,091,"Hooker County, NE",Dec-22 p,383,371,12,3.10000000
CN3109300000000,31,093,"Howard County, NE",Dec-22 p,3453,3369,84,2.40000000
CN3109500000000,31,095,"Jefferson County, NE",Dec-22 p,4194,4116,78,1.90000000
CN3109700000000,31,097,"Johnson County, NE",Dec-22 p,2029,1974,55,2.70000000
CN3109900000000,31,099,"Kearney County, NE",Dec-22 p,3794,3727,67,1.80000000
CN3110100000000,31,101,"Keith County, NE",Dec-22 p,4676,4592,84,1.80000000
CN3110300000000,31,103,"Keya Paha County, NE",Dec-22 p,607,591,16,2.60000000
CN3110500000000,31,105,"Kimball County, NE",Dec-22 p,1952,1921,31,1.60000000
CN3110700000000,31,107,"Knox County, NE",Dec-22 p,4674,4570,104,2.20000000
CN3110900000000,31,109,"Lancaster County, NE",Dec-22 p,182439,178560,3879,2.10000000
CN3111100000000,31,111,"Lincoln County, NE",Dec-22 p,18329,17940,389,2.10000000
CN3111300000000,31,113,"Logan County, NE",Dec-22 p,489,475,14,2.90000000
CN3111500000000,31,115,"Loup County, NE",Dec-22 p,444,432,12,2.70000000
CN3111700000000,31,117,"McPherson County, NE",Dec-22 p,438,428,10,2.30000000
CN3111900000000,31,119,"Madison County, NE",Dec-22 p,19916,19523,393,2.00000000
CN3112100000000,31,121,"Merrick County, NE",Dec-22 p,4134,4054,80,1.90000000
CN3112300000000,31,123,"Morrill County, NE",Dec-22 p,2666,2611,55,2.10000000
CN3112500000000,31,125,"Nance County, NE",Dec-22 p,1967,1924,43,2.20000000
CN3112700000000,31,127,"Nemaha County, NE",Dec-22 p,3735,3649,86,2.30000000
CN3112900000000,31,129,"Nuckolls County, NE",Dec-22 p,2518,2455,63,2.50000000
CN3113100000000,31,131,"Otoe County, NE",Dec-22 p,8579,8397,182,2.10000000
CN3113300000000,31,133,"Pawnee County, NE",Dec-22 p,1536,1505,31,2.00000000
CN3113500000000,31,135,"Perkins County, NE",Dec-22 p,1885,1852,33,1.80000000
CN3113700000000,31,137,"Phelps County, NE",Dec-22 p,4969,4873,96,1.90000000
CN3113900000000,31,139,"Pierce County, NE",Dec-22 p,4177,4101,76,1.80000000
CN3114100000000,31,141,"Platte County, NE",Dec-22 p,18480,18114,366,2.00000000
CN3114300000000,31,143,"Polk County, NE",Dec-22 p,2963,2898,65,2.20000000
CN3114500000000,31,145,"Red Willow County, NE",Dec-22 p,5991,5883,108,1.80000000
CN3114700000000,31,147,"Richardson County, NE",Dec-22 p,4188,4096,92,2.20000000
CN3114900000000,31,149,"Rock County, NE",Dec-22 p,908,896,12,1.30000000
CN3115100000000,31,151,"Saline County, NE",Dec-22 p,7255,7061,194,2.70000000
CN3115300000000,31,153,"Sarpy County, NE",Dec-22 p,100661,98414,2247,2.20000000
CN3115500000000,31,155,"Saunders County, NE",Dec-22 p,11637,11408,229,2.00000000
CN3115700000000,31,157,"Scotts Bluff County, NE",Dec-22 p,17925,17408,517,2.90000000
CN3115900000000,31,159,"Seward County, NE",Dec-22 p,9000,8814,186,2.10000000
CN3116100000000,31,161,"Sheridan County, NE",Dec-22 p,2784,2733,51,1.80000000
CN3116300000000,31,163,"Sherman County, NE",Dec-22 p,1676,1649,27,1.60000000
CN3116500000000,31,165,"Sioux County, NE",Dec-22 p,788,772,16,2.00000000
CN3116700000000,31,167,"Stanton County, NE",Dec-22 p,3586,3514,72,2.00000000
CN3116900000000,31,169,"Thayer County, NE",Dec-22 p,2780,2731,49,1.80000000
CN3117100000000,31,171,"Thomas County, NE",Dec-22 p,423,409,14,3.30000000
CN3117300000000,31,173,"Thurston County, NE",Dec-22 p,3255,3155,100,3.10000000
CN3117500000000,31,175,"Valley County, NE",Dec-22 p,2126,2077,49,2.30000000
CN3117700000000,31,177,"Washington County, NE",Dec-22 p,11588,11361,227,2.00000000
CN3117900000000,31,179,"Wayne County, NE",Dec-22 p,5964,5852,112,1.90000000
CN3118100000000,31,181,"Webster County, NE",Dec-22 p,1701,1654,47,2.80000000
CN3118300000000,31,183,"Wheeler County, NE",Dec-22 p,597,587,10,1.70000000
CN3118500000000,31,185,"York County, NE",Dec-22 p,7394,7241,153,2.10000000
CN3200100000000,32,001,"Churchill County, NV",Dec-22 p,10864,10477,387,3.60000000
CN3200300000000,32,003,"Clark County, NV",Dec-22 p,1149504,1087331,62173,5.40000000
CN3200500000000,32,005,"Douglas County, NV",Dec-22 p,21523,20664,859,4.00000000
CN3200700000000,32,007,"Elko County, NV",Dec-22 p,25342,24560,782,3.10000000
CN3200900000000,32,009,"Esmeralda County, NV",Dec-22 p,396,381,15,3.80000000
CN3201100000000,32,011,"Eureka County, NV",Dec-22 p,902,870,32,3.50000000
CN3201300000000,32,013,"Humboldt County, NV",Dec-22 p,7730,7499,231,3.00000000
CN3201500000000,32,015,"Lander County, NV",Dec-22 p,2987,2905,82,2.70000000
CN3201700000000,32,017,"Lincoln County, NV",Dec-22 p,2088,2005,83,4.00000000
CN3201900000000,32,019,"Lyon County, NV",Dec-22 p,23834,22637,1197,5.00000000
CN3202100000000,32,021,"Mineral County, NV",Dec-22 p,2075,1993,82,4.00000000
CN3202300000000,32,023,"Nye County, NV",Dec-22 p,17413,16428,985,5.70000000
CN3202700000000,32,027,"Pershing County, NV",Dec-22 p,2396,2303,93,3.90000000
CN3202900000000,32,029,"Storey County, NV",Dec-22 p,2114,2038,76,3.60000000
CN3203100000000,32,031,"Washoe County, NV",Dec-22 p,259512,250809,8703,3.40000000
CN3203300000000,32,033,"White Pine County, NV",Dec-22 p,4484,4339,145,3.20000000
CN3251000000000,32,510,"Carson City, NV",Dec-22 p,25767,24766,1001,3.90000000
CN3300100000000,33,001,"Belknap County, NH",Dec-22 p,30179,29393,786,2.60000000
CN3300300000000,33,003,"Carroll County, NH",Dec-22 p,22907,22280,627,2.70000000
CN3300500000000,33,005,"Cheshire County, NH",Dec-22 p,39208,38169,1039,2.60000000
CN3300700000000,33,007,"Coos County, NH",Dec-22 p,14260,13788,472,3.30000000
CN3300900000000,33,009,"Grafton County, NH",Dec-22 p,48658,47570,1088,2.20000000
CN3301100000000,33,011,"Hillsborough County, NH",Dec-22 p,248296,242051,6245,2.50000000
CN3301300000000,33,013,"Merrimack County, NH",Dec-22 p,82918,81116,1802,2.20000000
CN3301500000000,33,015,"Rockingham County, NH",Dec-22 p,191896,186980,4916,2.60000000
CN3301700000000,33,017,"Strafford County, NH",Dec-22 p,75007,73377,1630,2.20000000
CN3301900000000,33,019,"Sullivan County, NH",Dec-22 p,22612,22073,539,2.40000000
CN3400100000000,34,001,"Atlantic County, NJ",Dec-22 p,128025,122249,5776,4.50000000
CN3400300000000,34,003,"Bergen County, NJ",Dec-22 p,503279,489941,13338,2.70000000
CN3400500000000,34,005,"Burlington County, NJ",Dec-22 p,250105,243486,6619,2.60000000
CN3400700000000,34,007,"Camden County, NJ",Dec-22 p,273844,264235,9609,3.50000000
CN3400900000000,34,009,"Cape May County, NJ",Dec-22 p,44119,40671,3448,7.80000000
CN3401100000000,34,011,"Cumberland County, NJ",Dec-22 p,68643,65262,3381,4.90000000
CN3401300000000,34,013,"Essex County, NJ",Dec-22 p,386485,370928,15557,4.00000000
CN3401500000000,34,015,"Gloucester County, NJ",Dec-22 p,162920,157936,4984,3.10000000
CN3401700000000,34,017,"Hudson County, NJ",Dec-22 p,376749,365167,11582,3.10000000
CN3401900000000,34,019,"Hunterdon County, NJ",Dec-22 p,67601,66065,1536,2.30000000
CN3402100000000,34,021,"Mercer County, NJ",Dec-22 p,214497,209061,5436,2.50000000
CN3402300000000,34,023,"Middlesex County, NJ",Dec-22 p,459723,447476,12247,2.70000000
CN3402500000000,34,025,"Monmouth County, NJ",Dec-22 p,346681,337682,8999,2.60000000
CN3402700000000,34,027,"Morris County, NJ",Dec-22 p,267003,260761,6242,2.30000000
CN3402900000000,34,029,"Ocean County, NJ",Dec-22 p,297634,288514,9120,3.10000000
CN3403100000000,34,031,"Passaic County, NJ",Dec-22 p,252410,242213,10197,4.00000000
CN3403300000000,34,033,"Salem County, NJ",Dec-22 p,29644,28365,1279,4.30000000
CN3403500000000,34,035,"Somerset County, NJ",Dec-22 p,177896,173615,4281,2.40000000
CN3403700000000,34,037,"Sussex County, NJ",Dec-22 p,77139,74786,2353,3.10000000
CN3403900000000,34,039,"Union County, NJ",Dec-22 p,287586,278089,9497,3.30000000
CN3404100000000,34,041,"Warren County, NJ",Dec-22 p,59564,57970,1594,2.70000000
CN3500100000000,35,001,"Bernalillo County, NM",Dec-22 p,331434,321616,9818,3.00000000
CN3500300000000,35,003,"Catron County, NM",Dec-22 p,1096,1049,47,4.30000000
CN3500500000000,35,005,"Chaves County, NM",Dec-22 p,27481,26525,956,3.50000000
CN3500600000000,35,006,"Cibola County, NM",Dec-22 p,8311,7920,391,4.70000000
CN3500700000000,35,007,"Colfax County, NM",Dec-22 p,4281,4125,156,3.60000000
CN3500900000000,35,009,"Curry County, NM",Dec-22 p,21815,21299,516,2.40000000
CN3501100000000,35,011,"De Baca County, NM",Dec-22 p,694,678,16,2.30000000
CN3501300000000,35,013,"Dona Ana County, NM",Dec-22 p,99107,95399,3708,3.70000000
CN3501500000000,35,015,"Eddy County, NM",Dec-22 p,31812,31006,806,2.50000000
CN3501700000000,35,017,"Grant County, NM",Dec-22 p,11559,11160,399,3.50000000
CN3501900000000,35,019,"Guadalupe County, NM",Dec-22 p,1850,1784,66,3.60000000
CN3502100000000,35,021,"Harding County, NM",Dec-22 p,299,290,9,3.00000000
CN3502300000000,35,023,"Hidalgo County, NM",Dec-22 p,1780,1732,48,2.70000000
CN3502500000000,35,025,"Lea County, NM",Dec-22 p,28241,27191,1050,3.70000000
CN3502700000000,35,027,"Lincoln County, NM",Dec-22 p,8711,8413,298,3.40000000
CN3502800000000,35,028,"Los Alamos County, NM",Dec-22 p,10283,10127,156,1.50000000
CN3502900000000,35,029,"Luna County, NM",Dec-22 p,9600,8490,1110,11.60000000
CN3503100000000,35,031,"McKinley County, NM",Dec-22 p,23830,22744,1086,4.60000000
CN3503300000000,35,033,"Mora County, NM",Dec-22 p,1972,1881,91,4.60000000
CN3503500000000,35,035,"Otero County, NM",Dec-22 p,25857,24974,883,3.40000000
CN3503700000000,35,037,"Quay County, NM",Dec-22 p,2835,2738,97,3.40000000
CN3503900000000,35,039,"Rio Arriba County, NM",Dec-22 p,16163,15608,555,3.40000000
CN3504100000000,35,041,"Roosevelt County, NM",Dec-22 p,8340,8116,224,2.70000000
CN3504300000000,35,043,"Sandoval County, NM",Dec-22 p,66971,64865,2106,3.10000000
CN3504500000000,35,045,"San Juan County, NM",Dec-22 p,47855,45884,1971,4.10000000
CN3504700000000,35,047,"San Miguel County, NM",Dec-22 p,10839,10408,431,4.00000000
CN3504900000000,35,049,"Santa Fe County, NM",Dec-22 p,72151,70108,2043,2.80000000
CN3505100000000,35,051,"Sierra County, NM",Dec-22 p,3982,3778,204,5.10000000
CN3505300000000,35,053,"Socorro County, NM",Dec-22 p,6098,5880,218,3.60000000
CN3505500000000,35,055,"Taos County, NM",Dec-22 p,14767,14136,631,4.30000000
CN3505700000000,35,057,"Torrance County, NM",Dec-22 p,5391,5136,255,4.70000000
CN3505900000000,35,059,"Union County, NM",Dec-22 p,1552,1521,31,2.00000000
CN3506100000000,35,061,"Valencia County, NM",Dec-22 p,30556,29457,1099,3.60000000
CN3600100000000,36,001,"Albany County, NY",Dec-22 p,157250,153326,3924,2.50000000
CN3600300000000,36,003,"Allegany County, NY",Dec-22 p,19498,18779,719,3.70000000
CN3600500000000,36,005,"Bronx County, NY",Dec-22 p,587202,543346,43856,7.50000000
CN3600700000000,36,007,"Broome County, NY",Dec-22 p,82787,80110,2677,3.20000000
CN3600900000000,36,009,"Cattaraugus County, NY",Dec-22 p,32744,31506,1238,3.80000000
CN3601100000000,36,011,"Cayuga County, NY",Dec-22 p,34639,33610,1029,3.00000000
CN3601300000000,36,013,"Chautauqua County, NY",Dec-22 p,51420,49469,1951,3.80000000
CN3601500000000,36,015,"Chemung County, NY",Dec-22 p,34516,33397,1119,3.20000000
CN3601700000000,36,017,"Chenango County, NY",Dec-22 p,21485,20843,642,3.00000000
CN3601900000000,36,019,"Clinton County, NY",Dec-22 p,34265,33267,998,2.90000000
CN3602100000000,36,021,"Columbia County, NY",Dec-22 p,29677,29001,676,2.30000000
CN3602300000000,36,023,"Cortland County, NY",Dec-22 p,22452,21627,825,3.70000000
CN3602500000000,36,025,"Delaware County, NY",Dec-22 p,18325,17719,606,3.30000000
CN3602700000000,36,027,"Dutchess County, NY",Dec-22 p,142144,138591,3553,2.50000000
CN3602900000000,36,029,"Erie County, NY",Dec-22 p,440531,426558,13973,3.20000000
CN3603100000000,36,031,"Essex County, NY",Dec-22 p,16191,15618,573,3.50000000
CN3603300000000,36,033,"Franklin County, NY",Dec-22 p,18351,17728,623,3.40000000
CN3603500000000,36,035,"Fulton County, NY",Dec-22 p,22300,21476,824,3.70000000
CN3603700000000,36,037,"Genesee County, NY",Dec-22 p,29270,28420,850,2.90000000
CN3603900000000,36,039,"Greene County, NY",Dec-22 p,20381,19776,605,3.00000000
CN3604100000000,36,041,"Hamilton County, NY",Dec-22 p,2068,1958,110,5.30000000
CN3604300000000,36,043,"Herkimer County, NY",Dec-22 p,27302,26268,1034,3.80000000
CN3604500000000,36,045,"Jefferson County, NY",Dec-22 p,43720,42008,1712,3.90000000
CN3604700000000,36,047,"Kings County, NY",Dec-22 p,1176152,1110930,65222,5.50000000
CN3604900000000,36,049,"Lewis County, NY",Dec-22 p,11570,11097,473,4.10000000
CN3605100000000,36,051,"Livingston County, NY",Dec-22 p,29961,29106,855,2.90000000
CN3605300000000,36,053,"Madison County, NY",Dec-22 p,32641,31629,1012,3.10000000
CN3605500000000,36,055,"Monroe County, NY",Dec-22 p,361055,350492,10563,2.90000000
CN3605700000000,36,057,"Montgomery County, NY",Dec-22 p,21899,21022,877,4.00000000
CN3605900000000,36,059,"Nassau County, NY",Dec-22 p,721343,704660,16683,2.30000000
CN3606100000000,36,061,"New York County, NY",Dec-22 p,894552,856247,38305,4.30000000
CN3606300000000,36,063,"Niagara County, NY",Dec-22 p,97338,93909,3429,3.50000000
CN3606500000000,36,065,"Oneida County, NY",Dec-22 p,99663,96551,3112,3.10000000
CN3606700000000,36,067,"Onondaga County, NY",Dec-22 p,222211,216054,6157,2.80000000
CN3606900000000,36,069,"Ontario County, NY",Dec-22 p,55317,53834,1483,2.70000000
CN3607100000000,36,071,"Orange County, NY",Dec-22 p,187367,182454,4913,2.60000000
CN3607300000000,36,073,"Orleans County, NY",Dec-22 p,16953,16382,571,3.40000000
CN3607500000000,36,075,"Oswego County, NY",Dec-22 p,52609,50567,2042,3.90000000
CN3607700000000,36,077,"Otsego County, NY",Dec-22 p,26766,25901,865,3.20000000
CN3607900000000,36,079,"Putnam County, NY",Dec-22 p,50480,49269,1211,2.40000000
CN3608100000000,36,081,"Queens County, NY",Dec-22 p,1109676,1055786,53890,4.90000000
CN3608300000000,36,083,"Rensselaer County, NY",Dec-22 p,81131,79075,2056,2.50000000
CN3608500000000,36,085,"Richmond County, NY",Dec-22 p,220438,209464,10974,5.00000000
CN3608700000000,36,087,"Rockland County, NY",Dec-22 p,156945,153359,3586,2.30000000
CN3608900000000,36,089,"St. Lawrence County, NY",Dec-22 p,42241,40669,1572,3.70000000
CN3609100000000,36,091,"Saratoga County, NY",Dec-22 p,120217,117495,2722,2.30000000
CN3609300000000,36,093,"Schenectady County, NY",Dec-22 p,76884,74747,2137,2.80000000
CN3609500000000,36,095,"Schoharie County, NY",Dec-22 p,14633,14115,518,3.50000000
CN3609700000000,36,097,"Schuyler County, NY",Dec-22 p,7730,7448,282,3.60000000
CN3609900000000,36,099,"Seneca County, NY",Dec-22 p,14754,14338,416,2.80000000
CN3610100000000,36,101,"Steuben County, NY",Dec-22 p,40588,39226,1362,3.40000000
CN3610300000000,36,103,"Suffolk County, NY",Dec-22 p,791740,771418,20322,2.60000000
CN3610500000000,36,105,"Sullivan County, NY",Dec-22 p,36542,35518,1024,2.80000000
CN3610700000000,36,107,"Tioga County, NY",Dec-22 p,22393,21780,613,2.70000000
CN3610900000000,36,109,"Tompkins County, NY",Dec-22 p,49095,47930,1165,2.40000000
CN3611100000000,36,111,"Ulster County, NY",Dec-22 p,87232,84993,2239,2.60000000
CN3611300000000,36,113,"Warren County, NY",Dec-22 p,30563,29524,1039,3.40000000
CN3611500000000,36,115,"Washington County, NY",Dec-22 p,26814,26025,789,2.90000000
CN3611700000000,36,117,"Wayne County, NY",Dec-22 p,42963,41760,1203,2.80000000
CN3611900000000,36,119,"Westchester County, NY",Dec-22 p,488783,476519,12264,2.50000000
CN3612100000000,36,121,"Wyoming County, NY",Dec-22 p,17689,17106,583,3.30000000
CN3612300000000,36,123,"Yates County, NY",Dec-22 p,11549,11217,332,2.90000000
CN3700100000000,37,001,"Alamance County, NC",Dec-22 p,82464,79838,2626,3.20000000
CN3700300000000,37,003,"Alexander County, NC",Dec-22 p,17740,17242,498,2.80000000
CN3700500000000,37,005,"Alleghany County, NC",Dec-22 p,4357,4105,252,5.80000000
CN3700700000000,37,007,"Anson County, NC",Dec-22 p,10069,9666,403,4.00000000
CN3700900000000,37,009,"Ashe County, NC",Dec-22 p,13017,12661,356,2.70000000
CN3701100000000,37,011,"Avery County, NC",Dec-22 p,7405,7193,212,2.90000000
CN3701300000000,37,013,"Beaufort County, NC",Dec-22 p,19631,18967,664,3.40000000
CN3701500000000,37,015,"Bertie County, NC",Dec-22 p,7219,6914,305,4.20000000
CN3701700000000,37,017,"Bladen County, NC",Dec-22 p,13814,13223,591,4.30000000
CN3701900000000,37,019,"Brunswick County, NC",Dec-22 p,53875,51537,2338,4.30000000
CN3702100000000,37,021,"Buncombe County, NC",Dec-22 p,138278,134886,3392,2.50000000
CN3702300000000,37,023,"Burke County, NC",Dec-22 p,40141,39001,1140,2.80000000
CN3702500000000,37,025,"Cabarrus County, NC",Dec-22 p,114777,111352,3425,3.00000000
CN3702700000000,37,027,"Caldwell County, NC",Dec-22 p,35752,34688,1064,3.00000000
CN3702900000000,37,029,"Camden County, NC",Dec-22 p,4568,4429,139,3.00000000
CN3703100000000,37,031,"Carteret County, NC",Dec-22 p,31208,30263,945,3.00000000
CN3703300000000,37,033,"Caswell County, NC",Dec-22 p,9725,9395,330,3.40000000
CN3703500000000,37,035,"Catawba County, NC",Dec-22 p,78175,75889,2286,2.90000000
CN3703700000000,37,037,"Chatham County, NC",Dec-22 p,37637,36677,960,2.60000000
CN3703900000000,37,039,"Cherokee County, NC",Dec-22 p,10743,10343,400,3.70000000
CN3704100000000,37,041,"Chowan County, NC",Dec-22 p,5838,5626,212,3.60000000
CN3704300000000,37,043,"Clay County, NC",Dec-22 p,3944,3811,133,3.40000000
CN3704500000000,37,045,"Cleveland County, NC",Dec-22 p,47979,46333,1646,3.40000000
CN3704700000000,37,047,"Columbus County, NC",Dec-22 p,22784,21884,900,4.00000000
CN3704900000000,37,049,"Craven County, NC",Dec-22 p,40916,39593,1323,3.20000000
CN3705100000000,37,051,"Cumberland County, NC",Dec-22 p,127557,121375,6182,4.80000000
CN3705300000000,37,053,"Currituck County, NC",Dec-22 p,14400,13973,427,3.00000000
CN3705500000000,37,055,"Dare County, NC",Dec-22 p,18048,17245,803,4.40000000
CN3705700000000,37,057,"Davidson County, NC",Dec-22 p,80626,78079,2547,3.20000000
CN3705900000000,37,059,"Davie County, NC",Dec-22 p,20520,19936,584,2.80000000
CN3706100000000,37,061,"Duplin County, NC",Dec-22 p,24030,23296,734,3.10000000
CN3706300000000,37,063,"Durham County, NC",Dec-22 p,180613,175812,4801,2.70000000
CN3706500000000,37,065,"Edgecombe County, NC",Dec-22 p,19864,18579,1285,6.50000000
CN3706700000000,37,067,"Forsyth County, NC",Dec-22 p,186568,180528,6040,3.20000000
CN3706900000000,37,069,"Franklin County, NC",Dec-22 p,33602,32564,1038,3.10000000
CN3707100000000,37,071,"Gaston County, NC",Dec-22 p,113461,109689,3772,3.30000000
CN3707300000000,37,073,"Gates County, NC",Dec-22 p,5017,4876,141,2.80000000
CN3707500000000,37,075,"Graham County, NC",Dec-22 p,2881,2737,144,5.00000000
CN3707700000000,37,077,"Granville County, NC",Dec-22 p,30171,29381,790,2.60000000
CN3707900000000,37,079,"Greene County, NC",Dec-22 p,9408,9173,235,2.50000000
CN3708100000000,37,081,"Guilford County, NC",Dec-22 p,259740,250253,9487,3.70000000
CN3708300000000,37,083,"Halifax County, NC",Dec-22 p,18877,17886,991,5.20000000
CN3708500000000,37,085,"Harnett County, NC",Dec-22 p,54050,52099,1951,3.60000000
CN3708700000000,37,087,"Haywood County, NC",Dec-22 p,29412,28624,788,2.70000000
CN3708900000000,37,089,"Henderson County, NC",Dec-22 p,54057,52645,1412,2.60000000
CN3709100000000,37,091,"Hertford County, NC",Dec-22 p,8426,8054,372,4.40000000
CN3709300000000,37,093,"Hoke County, NC",Dec-22 p,20216,19305,911,4.50000000
CN3709500000000,37,095,"Hyde County, NC",Dec-22 p,1736,1617,119,6.90000000
CN3709700000000,37,097,"Iredell County, NC",Dec-22 p,93505,90750,2755,2.90000000
CN3709900000000,37,099,"Jackson County, NC",Dec-22 p,19660,19060,600,3.10000000
CN3710100000000,37,101,"Johnston County, NC",Dec-22 p,106807,103824,2983,2.80000000
CN3710300000000,37,103,"Jones County, NC",Dec-22 p,4201,4073,128,3.00000000
CN3710500000000,37,105,"Lee County, NC",Dec-22 p,26120,25158,962,3.70000000
CN3710700000000,37,107,"Lenoir County, NC",Dec-22 p,26887,26046,841,3.10000000
CN3710900000000,37,109,"Lincoln County, NC",Dec-22 p,45783,44573,1210,2.60000000
CN3711100000000,37,111,"McDowell County, NC",Dec-22 p,19334,18734,600,3.10000000
CN3711300000000,37,113,"Macon County, NC",Dec-22 p,15442,14989,453,2.90000000
CN3711500000000,37,115,"Madison County, NC",Dec-22 p,9818,9532,286,2.90000000
CN3711700000000,37,117,"Martin County, NC",Dec-22 p,8500,8182,318,3.70000000
CN3711900000000,37,119,"Mecklenburg County, NC",Dec-22 p,645296,624822,20474,3.20000000
CN3712100000000,37,121,"Mitchell County, NC",Dec-22 p,5862,5643,219,3.70000000
CN3712300000000,37,123,"Montgomery County, NC",Dec-22 p,11269,10926,343,3.00000000
CN3712500000000,37,125,"Moore County, NC",Dec-22 p,40664,39418,1246,3.10000000
CN3712700000000,37,127,"Nash County, NC",Dec-22 p,41362,39450,1912,4.60000000
CN3712900000000,37,129,"New Hanover County, NC",Dec-22 p,127214,123513,3701,2.90000000
CN3713100000000,37,131,"Northampton County, NC",Dec-22 p,7095,6790,305,4.30000000
CN3713300000000,37,133,"Onslow County, NC",Dec-22 p,66437,63953,2484,3.70000000
CN3713500000000,37,135,"Orange County, NC",Dec-22 p,82138,80081,2057,2.50000000
CN3713700000000,37,137,"Pamlico County, NC",Dec-22 p,5340,5181,159,3.00000000
CN3713900000000,37,139,"Pasquotank County, NC",Dec-22 p,16339,15706,633,3.90000000
CN3714100000000,37,141,"Pender County, NC",Dec-22 p,30193,29262,931,3.10000000
CN3714300000000,37,143,"Perquimans County, NC",Dec-22 p,4850,4662,188,3.90000000
CN3714500000000,37,145,"Person County, NC",Dec-22 p,18979,18366,613,3.20000000
CN3714700000000,37,147,"Pitt County, NC",Dec-22 p,87708,84626,3082,3.50000000
CN3714900000000,37,149,"Polk County, NC",Dec-22 p,9246,8969,277,3.00000000
CN3715100000000,37,151,"Randolph County, NC",Dec-22 p,65230,63124,2106,3.20000000
CN3715300000000,37,153,"Richmond County, NC",Dec-22 p,16149,15346,803,5.00000000
CN3715500000000,37,155,"Robeson County, NC",Dec-22 p,47374,44885,2489,5.30000000
CN3715700000000,37,157,"Rockingham County, NC",Dec-22 p,39387,37927,1460,3.70000000
CN3715900000000,37,159,"Rowan County, NC",Dec-22 p,66888,64788,2100,3.10000000
CN3716100000000,37,161,"Rutherford County, NC",Dec-22 p,23920,22869,1051,4.40000000
CN3716300000000,37,163,"Sampson County, NC",Dec-22 p,27771,26912,859,3.10000000
CN3716500000000,37,165,"Scotland County, NC",Dec-22 p,11056,10348,708,6.40000000
CN3716700000000,37,167,"Stanly County, NC",Dec-22 p,30112,29242,870,2.90000000
CN3716900000000,37,169,"Stokes County, NC",Dec-22 p,21353,20782,571,2.70000000
CN3717100000000,37,171,"Surry County, NC",Dec-22 p,31416,30496,920,2.90000000
CN3717300000000,37,173,"Swain County, NC",Dec-22 p,7081,6891,190,2.70000000
CN3717500000000,37,175,"Transylvania County, NC",Dec-22 p,14367,13960,407,2.80000000
CN3717700000000,37,177,"Tyrrell County, NC",Dec-22 p,1217,1131,86,7.10000000
CN3717900000000,37,179,"Union County, NC",Dec-22 p,128688,125246,3442,2.70000000
CN3718100000000,37,181,"Vance County, NC",Dec-22 p,16579,15617,962,5.80000000
CN3718300000000,37,183,"Wake County, NC",Dec-22 p,624474,608172,16302,2.60000000
CN3718500000000,37,185,"Warren County, NC",Dec-22 p,6326,5957,369,5.80000000
CN3718700000000,37,187,"Washington County, NC",Dec-22 p,4181,3962,219,5.20000000
CN3718900000000,37,189,"Watauga County, NC",Dec-22 p,29410,28662,748,2.50000000
CN3719100000000,37,191,"Wayne County, NC",Dec-22 p,50754,49044,1710,3.40000000
CN3719300000000,37,193,"Wilkes County, NC",Dec-22 p,26455,25610,845,3.20000000
CN3719500000000,37,195,"Wilson County, NC",Dec-22 p,32618,31043,1575,4.80000000
CN3719700000000,37,197,"Yadkin County, NC",Dec-22 p,17410,16936,474,2.70000000
CN3719900000000,37,199,"Yancey County, NC",Dec-22 p,8081,7853,228,2.80000000
CN3800100000000,38,001,"Adams County, ND",Dec-22 p,926,908,18,1.90000000
CN3800300000000,38,003,"Barnes County, ND",Dec-22 p,5311,5194,117,2.20000000
CN3800500000000,38,005,"Benson County, ND",Dec-22 p,2364,2291,73,3.10000000
CN3800700000000,38,007,"Billings County, ND",Dec-22 p,389,383,6,1.50000000
CN3800900000000,38,009,"Bottineau County, ND",Dec-22 p,2948,2859,89,3.00000000
CN3801100000000,38,011,"Bowman County, ND",Dec-22 p,1529,1502,27,1.80000000
CN3801300000000,38,013,"Burke County, ND",Dec-22 p,1046,1025,21,2.00000000
CN3801500000000,38,015,"Burleigh County, ND",Dec-22 p,50854,49811,1043,2.10000000
CN3801700000000,38,017,"Cass County, ND",Dec-22 p,106308,104392,1916,1.80000000
CN3801900000000,38,019,"Cavalier County, ND",Dec-22 p,1809,1756,53,2.90000000
CN3802100000000,38,021,"Dickey County, ND",Dec-22 p,2190,2144,46,2.10000000
CN3802300000000,38,023,"Divide County, ND",Dec-22 p,1358,1342,16,1.20000000
CN3802500000000,38,025,"Dunn County, ND",Dec-22 p,3337,3287,50,1.50000000
CN3802700000000,38,027,"Eddy County, ND",Dec-22 p,1197,1155,42,3.50000000
CN3802900000000,38,029,"Emmons County, ND",Dec-22 p,1449,1364,85,5.90000000
CN3803100000000,38,031,"Foster County, ND",Dec-22 p,1495,1453,42,2.80000000
CN3803300000000,38,033,"Golden Valley County, ND",Dec-22 p,839,823,16,1.90000000
CN3803500000000,38,035,"Grand Forks County, ND",Dec-22 p,36704,35990,714,1.90000000
CN3803700000000,38,037,"Grant County, ND",Dec-22 p,1206,1182,24,2.00000000
CN3803900000000,38,039,"Griggs County, ND",Dec-22 p,1018,992,26,2.60000000
CN3804100000000,38,041,"Hettinger County, ND",Dec-22 p,1410,1386,24,1.70000000
CN3804300000000,38,043,"Kidder County, ND",Dec-22 p,1332,1270,62,4.70000000
CN3804500000000,38,045,"LaMoure County, ND",Dec-22 p,2083,2043,40,1.90000000
CN3804700000000,38,047,"Logan County, ND",Dec-22 p,877,851,26,3.00000000
CN3804900000000,38,049,"McHenry County, ND",Dec-22 p,3124,3014,110,3.50000000
CN3805100000000,38,051,"McIntosh County, ND",Dec-22 p,1038,1016,22,2.10000000
CN3805300000000,38,053,"McKenzie County, ND",Dec-22 p,9369,9195,174,1.90000000
CN3805500000000,38,055,"McLean County, ND",Dec-22 p,4646,4475,171,3.70000000
CN3805700000000,38,057,"Mercer County, ND",Dec-22 p,3443,3315,128,3.70000000
CN3805900000000,38,059,"Morton County, ND",Dec-22 p,16841,16370,471,2.80000000
CN3806100000000,38,061,"Mountrail County, ND",Dec-22 p,6259,6173,86,1.40000000
CN3806300000000,38,063,"Nelson County, ND",Dec-22 p,1464,1421,43,2.90000000
CN3806500000000,38,065,"Oliver County, ND",Dec-22 p,873,841,32,3.70000000
CN3806700000000,38,067,"Pembina County, ND",Dec-22 p,3169,3052,117,3.70000000
CN3806900000000,38,069,"Pierce County, ND",Dec-22 p,1638,1593,45,2.70000000
CN3807100000000,38,071,"Ramsey County, ND",Dec-22 p,5449,5321,128,2.30000000
CN3807300000000,38,073,"Ransom County, ND",Dec-22 p,2614,2576,38,1.50000000
CN3807500000000,38,075,"Renville County, ND",Dec-22 p,1218,1194,24,2.00000000
CN3807700000000,38,077,"Richland County, ND",Dec-22 p,8508,8350,158,1.90000000
CN3807900000000,38,079,"Rolette County, ND",Dec-22 p,4640,4343,297,6.40000000
CN3808100000000,38,081,"Sargent County, ND",Dec-22 p,2270,2238,32,1.40000000
CN3808300000000,38,083,"Sheridan County, ND",Dec-22 p,661,639,22,3.30000000
CN3808500000000,38,085,"Sioux County, ND",Dec-22 p,1185,1166,19,1.60000000
CN3808700000000,38,087,"Slope County, ND",Dec-22 p,337,329,8,2.40000000
CN3808900000000,38,089,"Stark County, ND",Dec-22 p,17814,17469,345,1.90000000
CN3809100000000,38,091,"Steele County, ND",Dec-22 p,941,927,14,1.50000000
CN3809300000000,38,093,"Stutsman County, ND",Dec-22 p,10295,10075,220,2.10000000
CN3809500000000,38,095,"Towner County, ND",Dec-22 p,1086,1056,30,2.80000000
CN3809700000000,38,097,"Traill County, ND",Dec-22 p,4386,4303,83,1.90000000
CN3809900000000,38,099,"Walsh County, ND",Dec-22 p,5176,4978,198,3.80000000
CN3810100000000,38,101,"Ward County, ND",Dec-22 p,31316,30580,736,2.40000000
CN3810300000000,38,103,"Wells County, ND",Dec-22 p,1893,1813,80,4.20000000
CN3810500000000,38,105,"Williams County, ND",Dec-22 p,21374,20841,533,2.50000000
CN3900100000000,39,001,"Adams County, OH",Dec-22 p,10927,10238,689,6.30000000
CN3900300000000,39,003,"Allen County, OH",Dec-22 p,46492,44766,1726,3.70000000
CN3900500000000,39,005,"Ashland County, OH",Dec-22 p,26265,25271,994,3.80000000
CN3900700000000,39,007,"Ashtabula County, OH",Dec-22 p,42856,41033,1823,4.30000000
CN3900900000000,39,009,"Athens County, OH",Dec-22 p,25142,23986,1156,4.60000000
CN3901100000000,39,011,"Auglaize County, OH",Dec-22 p,23943,23370,573,2.40000000
CN3901300000000,39,013,"Belmont County, OH",Dec-22 p,27974,26630,1344,4.80000000
CN3901500000000,39,015,"Brown County, OH",Dec-22 p,19368,18497,871,4.50000000
CN3901700000000,39,017,"Butler County, OH",Dec-22 p,193888,187868,6020,3.10000000
CN3901900000000,39,019,"Carroll County, OH",Dec-22 p,12626,12092,534,4.20000000
CN3902100000000,39,021,"Champaign County, OH",Dec-22 p,19125,18538,587,3.10000000
CN3902300000000,39,023,"Clark County, OH",Dec-22 p,62150,59863,2287,3.70000000
CN3902500000000,39,025,"Clermont County, OH",Dec-22 p,106503,103142,3361,3.20000000
CN3902700000000,39,027,"Clinton County, OH",Dec-22 p,18024,17269,755,4.20000000
CN3902900000000,39,029,"Columbiana County, OH",Dec-22 p,44501,42582,1919,4.30000000
CN3903100000000,39,031,"Coshocton County, OH",Dec-22 p,13604,12987,617,4.50000000
CN3903300000000,39,033,"Crawford County, OH",Dec-22 p,17712,16938,774,4.40000000
CN3903500000000,39,035,"Cuyahoga County, OH",Dec-22 p,593967,572329,21638,3.60000000
CN3903700000000,39,037,"Darke County, OH",Dec-22 p,25794,24999,795,3.10000000
CN3903900000000,39,039,"Defiance County, OH",Dec-22 p,17500,16903,597,3.40000000
CN3904100000000,39,041,"Delaware County, OH",Dec-22 p,115368,112322,3046,2.60000000
CN3904300000000,39,043,"Erie County, OH",Dec-22 p,35782,34106,1676,4.70000000
CN3904500000000,39,045,"Fairfield County, OH",Dec-22 p,80228,77706,2522,3.10000000
CN3904700000000,39,047,"Fayette County, OH",Dec-22 p,13997,13465,532,3.80000000
CN3904900000000,39,049,"Franklin County, OH",Dec-22 p,706883,684997,21886,3.10000000
CN3905100000000,39,051,"Fulton County, OH",Dec-22 p,22327,21461,866,3.90000000
CN3905300000000,39,053,"Gallia County, OH",Dec-22 p,12241,11688,553,4.50000000
CN3905500000000,39,055,"Geauga County, OH",Dec-22 p,48114,46730,1384,2.90000000
CN3905700000000,39,057,"Greene County, OH",Dec-22 p,83020,80452,2568,3.10000000
CN3905900000000,39,059,"Guernsey County, OH",Dec-22 p,17706,16838,868,4.90000000
CN3906100000000,39,061,"Hamilton County, OH",Dec-22 p,410712,397893,12819,3.10000000
CN3906300000000,39,063,"Hancock County, OH",Dec-22 p,40541,39433,1108,2.70000000
CN3906500000000,39,065,"Hardin County, OH",Dec-22 p,13518,13068,450,3.30000000
CN3906700000000,39,067,"Harrison County, OH",Dec-22 p,6422,6084,338,5.30000000
CN3906900000000,39,069,"Henry County, OH",Dec-22 p,12677,12061,616,4.90000000
CN3907100000000,39,071,"Highland County, OH",Dec-22 p,17658,16551,1107,6.30000000
CN3907300000000,39,073,"Hocking County, OH",Dec-22 p,12967,12452,515,4.00000000
CN3907500000000,39,075,"Holmes County, OH",Dec-22 p,21935,21162,773,3.50000000
CN3907700000000,39,077,"Huron County, OH",Dec-22 p,27608,26090,1518,5.50000000
CN3907900000000,39,079,"Jackson County, OH",Dec-22 p,12302,11690,612,5.00000000
CN3908100000000,39,081,"Jefferson County, OH",Dec-22 p,26862,25472,1390,5.20000000
CN3908300000000,39,083,"Knox County, OH",Dec-22 p,30863,29879,984,3.20000000
CN3908500000000,39,085,"Lake County, OH",Dec-22 p,123776,119751,4025,3.30000000
CN3908700000000,39,087,"Lawrence County, OH",Dec-22 p,23168,22210,958,4.10000000
CN3908900000000,39,089,"Licking County, OH",Dec-22 p,91924,89156,2768,3.00000000
CN3909100000000,39,091,"Logan County, OH",Dec-22 p,22512,21787,725,3.20000000
CN3909300000000,39,093,"Lorain County, OH",Dec-22 p,152115,146772,5343,3.50000000
CN3909500000000,39,095,"Lucas County, OH",Dec-22 p,208260,199564,8696,4.20000000
CN3909700000000,39,097,"Madison County, OH",Dec-22 p,21042,20433,609,2.90000000
CN3909900000000,39,099,"Mahoning County, OH",Dec-22 p,97300,92956,4344,4.50000000
CN3910100000000,39,101,"Marion County, OH",Dec-22 p,27189,26265,924,3.40000000
CN3910300000000,39,103,"Medina County, OH",Dec-22 p,97028,94159,2869,3.00000000
CN3910500000000,39,105,"Meigs County, OH",Dec-22 p,8415,7912,503,6.00000000
CN3910700000000,39,107,"Mercer County, OH",Dec-22 p,22879,22393,486,2.10000000
CN3910900000000,39,109,"Miami County, OH",Dec-22 p,53998,52294,1704,3.20000000
CN3911100000000,39,111,"Monroe County, OH",Dec-22 p,5032,4691,341,6.80000000
CN3911300000000,39,113,"Montgomery County, OH",Dec-22 p,248301,239087,9214,3.70000000
CN3911500000000,39,115,"Morgan County, OH",Dec-22 p,6780,6378,402,5.90000000
CN3911700000000,39,117,"Morrow County, OH",Dec-22 p,17059,16433,626,3.70000000
CN3911900000000,39,119,"Muskingum County, OH",Dec-22 p,41052,39331,1721,4.20000000
CN3912100000000,39,121,"Noble County, OH",Dec-22 p,4558,4268,290,6.40000000
CN3912300000000,39,123,"Ottawa County, OH",Dec-22 p,19943,18638,1305,6.50000000
CN3912500000000,39,125,"Paulding County, OH",Dec-22 p,8641,8411,230,2.70000000
CN3912700000000,39,127,"Perry County, OH",Dec-22 p,15988,15311,677,4.20000000
CN3912900000000,39,129,"Pickaway County, OH",Dec-22 p,26850,25936,914,3.40000000
CN3913100000000,39,131,"Pike County, OH",Dec-22 p,11052,10467,585,5.30000000
CN3913300000000,39,133,"Portage County, OH",Dec-22 p,84068,80995,3073,3.70000000
CN3913500000000,39,135,"Preble County, OH",Dec-22 p,21936,21288,648,3.00000000
CN3913700000000,39,137,"Putnam County, OH",Dec-22 p,18855,18326,529,2.80000000
CN3913900000000,39,139,"Richland County, OH",Dec-22 p,52047,49767,2280,4.40000000
CN3914100000000,39,141,"Ross County, OH",Dec-22 p,35198,33951,1247,3.50000000
CN3914300000000,39,143,"Sandusky County, OH",Dec-22 p,29766,28576,1190,4.00000000
CN3914500000000,39,145,"Scioto County, OH",Dec-22 p,29336,27810,1526,5.20000000
CN3914700000000,39,147,"Seneca County, OH",Dec-22 p,26133,25159,974,3.70000000
CN3914900000000,39,149,"Shelby County, OH",Dec-22 p,23367,22688,679,2.90000000
CN3915100000000,39,151,"Stark County, OH",Dec-22 p,180454,173544,6910,3.80000000
CN3915300000000,39,153,"Summit County, OH",Dec-22 p,261567,251279,10288,3.90000000
CN3915500000000,39,155,"Trumbull County, OH",Dec-22 p,82299,78426,3873,4.70000000
CN3915700000000,39,157,"Tuscarawas County, OH",Dec-22 p,44473,42674,1799,4.00000000
CN3915900000000,39,159,"Union County, OH",Dec-22 p,30291,29500,791,2.60000000
CN3916100000000,39,161,"Van Wert County, OH",Dec-22 p,14283,13899,384,2.70000000
CN3916300000000,39,163,"Vinton County, OH",Dec-22 p,5422,5110,312,5.80000000
CN3916500000000,39,165,"Warren County, OH",Dec-22 p,120765,117249,3516,2.90000000
CN3916700000000,39,167,"Washington County, OH",Dec-22 p,26763,25535,1228,4.60000000
CN3916900000000,39,169,"Wayne County, OH",Dec-22 p,60642,58887,1755,2.90000000
CN3917100000000,39,171,"Williams County, OH",Dec-22 p,17982,17457,525,2.90000000
CN3917300000000,39,173,"Wood County, OH",Dec-22 p,70999,68816,2183,3.10000000
CN3917500000000,39,175,"Wyandot County, OH",Dec-22 p,13376,13055,321,2.40000000
CN4000100000000,40,001,"Adair County, OK",Dec-22 p,8487,8244,243,2.90000000
CN4000300000000,40,003,"Alfalfa County, OK",Dec-22 p,2712,2661,51,1.90000000
CN4000500000000,40,005,"Atoka County, OK",Dec-22 p,5076,4912,164,3.20000000
CN4000700000000,40,007,"Beaver County, OK",Dec-22 p,2637,2596,41,1.60000000
CN4000900000000,40,009,"Beckham County, OK",Dec-22 p,10496,10267,229,2.20000000
CN4001100000000,40,011,"Blaine County, OK",Dec-22 p,4359,4282,77,1.80000000
CN4001300000000,40,013,"Bryan County, OK",Dec-22 p,23369,22837,532,2.30000000
CN4001500000000,40,015,"Caddo County, OK",Dec-22 p,11817,11482,335,2.80000000
CN4001700000000,40,017,"Canadian County, OK",Dec-22 p,80190,78443,1747,2.20000000
CN4001900000000,40,019,"Carter County, OK",Dec-22 p,21330,20690,640,3.00000000
CN4002100000000,40,021,"Cherokee County, OK",Dec-22 p,19936,19351,585,2.90000000
CN4002300000000,40,023,"Choctaw County, OK",Dec-22 p,5946,5679,267,4.50000000
CN4002500000000,40,025,"Cimarron County, OK",Dec-22 p,1621,1604,17,1.00000000
CN4002700000000,40,027,"Cleveland County, OK",Dec-22 p,147567,144414,3153,2.10000000
CN4002900000000,40,029,"Coal County, OK",Dec-22 p,2349,2287,62,2.60000000
CN4003100000000,40,031,"Comanche County, OK",Dec-22 p,47499,45995,1504,3.20000000
CN4003300000000,40,033,"Cotton County, OK",Dec-22 p,2693,2613,80,3.00000000
CN4003500000000,40,035,"Craig County, OK",Dec-22 p,5782,5634,148,2.60000000
CN4003700000000,40,037,"Creek County, OK",Dec-22 p,31739,30819,920,2.90000000
CN4003900000000,40,039,"Custer County, OK",Dec-22 p,14859,14552,307,2.10000000
CN4004100000000,40,041,"Delaware County, OK",Dec-22 p,19552,19029,523,2.70000000
CN4004300000000,40,043,"Dewey County, OK",Dec-22 p,3104,3055,49,1.60000000
CN4004500000000,40,045,"Ellis County, OK",Dec-22 p,2012,1969,43,2.10000000
CN4004700000000,40,047,"Garfield County, OK",Dec-22 p,26669,26007,662,2.50000000
CN4004900000000,40,049,"Garvin County, OK",Dec-22 p,12881,12532,349,2.70000000
CN4005100000000,40,051,"Grady County, OK",Dec-22 p,27251,26583,668,2.50000000
CN4005300000000,40,053,"Grant County, OK",Dec-22 p,2782,2736,46,1.70000000
CN4005500000000,40,055,"Greer County, OK",Dec-22 p,1797,1743,54,3.00000000
CN4005700000000,40,057,"Harmon County, OK",Dec-22 p,1170,1141,29,2.50000000
CN4005900000000,40,059,"Harper County, OK",Dec-22 p,1795,1769,26,1.40000000
CN4006100000000,40,061,"Haskell County, OK",Dec-22 p,4179,4024,155,3.70000000
CN4006300000000,40,063,"Hughes County, OK",Dec-22 p,5154,4976,178,3.50000000
CN4006500000000,40,065,"Jackson County, OK",Dec-22 p,10667,10428,239,2.20000000
CN4006700000000,40,067,"Jefferson County, OK",Dec-22 p,2485,2414,71,2.90000000
CN4006900000000,40,069,"Johnston County, OK",Dec-22 p,3697,3574,123,3.30000000
CN4007100000000,40,071,"Kay County, OK",Dec-22 p,18113,17542,571,3.20000000
CN4007300000000,40,073,"Kingfisher County, OK",Dec-22 p,8939,8793,146,1.60000000
CN4007500000000,40,075,"Kiowa County, OK",Dec-22 p,3619,3519,100,2.80000000
CN4007700000000,40,077,"Latimer County, OK",Dec-22 p,3110,2930,180,5.80000000
CN4007900000000,40,079,"Le Flore County, OK",Dec-22 p,19358,18742,616,3.20000000
CN4008100000000,40,081,"Lincoln County, OK",Dec-22 p,16111,15681,430,2.70000000
CN4008300000000,40,083,"Logan County, OK",Dec-22 p,23271,22725,546,2.30000000
CN4008500000000,40,085,"Love County, OK",Dec-22 p,5722,5603,119,2.10000000
CN4008700000000,40,087,"McClain County, OK",Dec-22 p,20839,20354,485,2.30000000
CN4008900000000,40,089,"McCurtain County, OK",Dec-22 p,15798,15229,569,3.60000000
CN4009100000000,40,091,"McIntosh County, OK",Dec-22 p,7174,6831,343,4.80000000
CN4009300000000,40,093,"Major County, OK",Dec-22 p,3803,3720,83,2.20000000
CN4009500000000,40,095,"Marshall County, OK",Dec-22 p,7364,7163,201,2.70000000
CN4009700000000,40,097,"Mayes County, OK",Dec-22 p,19731,19160,571,2.90000000
CN4009900000000,40,099,"Murray County, OK",Dec-22 p,6030,5881,149,2.50000000
CN4010100000000,40,101,"Muskogee County, OK",Dec-22 p,28479,27595,884,3.10000000
CN4010300000000,40,103,"Noble County, OK",Dec-22 p,5771,5668,103,1.80000000
CN4010500000000,40,105,"Nowata County, OK",Dec-22 p,4662,4546,116,2.50000000
CN4010700000000,40,107,"Okfuskee County, OK",Dec-22 p,4388,4223,165,3.80000000
CN4010900000000,40,109,"Oklahoma County, OK",Dec-22 p,396363,385968,10395,2.60000000
CN4011100000000,40,111,"Okmulgee County, OK",Dec-22 p,15779,15188,591,3.70000000
CN4011300000000,40,113,"Osage County, OK",Dec-22 p,20775,20145,630,3.00000000
CN4011500000000,40,115,"Ottawa County, OK",Dec-22 p,15155,14791,364,2.40000000
CN4011700000000,40,117,"Pawnee County, OK",Dec-22 p,7445,7206,239,3.20000000
CN4011900000000,40,119,"Payne County, OK",Dec-22 p,38771,37886,885,2.30000000
CN4012100000000,40,121,"Pittsburg County, OK",Dec-22 p,16298,15660,638,3.90000000
CN4012300000000,40,123,"Pontotoc County, OK",Dec-22 p,19540,19108,432,2.20000000
CN4012500000000,40,125,"Pottawatomie County, OK",Dec-22 p,33054,32061,993,3.00000000
CN4012700000000,40,127,"Pushmataha County, OK",Dec-22 p,4516,4355,161,3.60000000
CN4012900000000,40,129,"Roger Mills County, OK",Dec-22 p,1813,1781,32,1.80000000
CN4013100000000,40,131,"Rogers County, OK",Dec-22 p,46071,44974,1097,2.40000000
CN4013300000000,40,133,"Seminole County, OK",Dec-22 p,8932,8599,333,3.70000000
CN4013500000000,40,135,"Sequoyah County, OK",Dec-22 p,16635,16138,497,3.00000000
CN4013700000000,40,137,"Stephens County, OK",Dec-22 p,19016,18457,559,2.90000000
CN4013900000000,40,139,"Texas County, OK",Dec-22 p,11909,11747,162,1.40000000
CN4014100000000,40,141,"Tillman County, OK",Dec-22 p,2888,2775,113,3.90000000
CN4014300000000,40,143,"Tulsa County, OK",Dec-22 p,330064,321512,8552,2.60000000
CN4014500000000,40,145,"Wagoner County, OK",Dec-22 p,39647,38614,1033,2.60000000
CN4014700000000,40,147,"Washington County, OK",Dec-22 p,21772,21136,636,2.90000000
CN4014900000000,40,149,"Washita County, OK",Dec-22 p,5226,5096,130,2.50000000
CN4015100000000,40,151,"Woods County, OK",Dec-22 p,4790,4725,65,1.40000000
CN4015300000000,40,153,"Woodward County, OK",Dec-22 p,8312,8096,216,2.60000000
CN4100100000000,41,001,"Baker County, OR",Dec-22 p,7411,6989,422,5.70000000
CN4100300000000,41,003,"Benton County, OR",Dec-22 p,48825,47075,1750,3.60000000
CN4100500000000,41,005,"Clackamas County, OR",Dec-22 p,229775,220822,8953,3.90000000
CN4100700000000,41,007,"Clatsop County, OR",Dec-22 p,18752,17803,949,5.10000000
CN4100900000000,41,009,"Columbia County, OR",Dec-22 p,25569,24236,1333,5.20000000
CN4101100000000,41,011,"Coos County, OR",Dec-22 p,26146,24561,1585,6.10000000
CN4101300000000,41,013,"Crook County, OR",Dec-22 p,11106,10333,773,7.00000000
CN4101500000000,41,015,"Curry County, OR",Dec-22 p,8771,8206,565,6.40000000
CN4101700000000,41,017,"Deschutes County, OR",Dec-22 p,103118,98139,4979,4.80000000
CN4101900000000,41,019,"Douglas County, OR",Dec-22 p,47156,44381,2775,5.90000000
CN4102100000000,41,021,"Gilliam County, OR",Dec-22 p,857,821,36,4.20000000
CN4102300000000,41,023,"Grant County, OR",Dec-22 p,3063,2830,233,7.60000000
CN4102500000000,41,025,"Harney County, OR",Dec-22 p,3643,3414,229,6.30000000
CN4102700000000,41,027,"Hood River County, OR",Dec-22 p,13960,13449,511,3.70000000
CN4102900000000,41,029,"Jackson County, OR",Dec-22 p,106538,101116,5422,5.10000000
CN4103100000000,41,031,"Jefferson County, OR",Dec-22 p,10292,9623,669,6.50000000
CN4103300000000,41,033,"Josephine County, OR",Dec-22 p,37109,34696,2413,6.50000000
CN4103500000000,41,035,"Klamath County, OR",Dec-22 p,29664,27469,2195,7.40000000
CN4103700000000,41,037,"Lake County, OR",Dec-22 p,3540,3308,232,6.60000000
CN4103900000000,41,039,"Lane County, OR",Dec-22 p,183357,174373,8984,4.90000000
CN4104100000000,41,041,"Lincoln County, OR",Dec-22 p,20055,18746,1309,6.50000000
CN4104300000000,41,043,"Linn County, OR",Dec-22 p,61012,57951,3061,5.00000000
CN4104500000000,41,045,"Malheur County, OR",Dec-22 p,12212,11600,612,5.00000000
CN4104700000000,41,047,"Marion County, OR",Dec-22 p,166323,158746,7577,4.60000000
CN4104900000000,41,049,"Morrow County, OR",Dec-22 p,5773,5521,252,4.40000000
CN4105100000000,41,051,"Multnomah County, OR",Dec-22 p,475323,455385,19938,4.20000000
CN4105300000000,41,053,"Polk County, OR",Dec-22 p,42018,40170,1848,4.40000000
CN4105500000000,41,055,"Sherman County, OR",Dec-22 p,930,897,33,3.50000000
CN4105700000000,41,057,"Tillamook County, OR",Dec-22 p,11968,11376,592,4.90000000
CN4105900000000,41,059,"Umatilla County, OR",Dec-22 p,36725,34810,1915,5.20000000
CN4106100000000,41,061,"Union County, OR",Dec-22 p,11954,11324,630,5.30000000
CN4106300000000,41,063,"Wallowa County, OR",Dec-22 p,3482,3245,237,6.80000000
CN4106500000000,41,065,"Wasco County, OR",Dec-22 p,12799,12121,678,5.30000000
CN4106700000000,41,067,"Washington County, OR",Dec-22 p,339564,327504,12060,3.60000000
CN4106900000000,41,069,"Wheeler County, OR",Dec-22 p,700,676,24,3.40000000
CN4107100000000,41,071,"Yamhill County, OR",Dec-22 p,56709,54475,2234,3.90000000
CN4200100000000,42,001,"Adams County, PA",Dec-22 p,55608,54315,1293,2.30000000
CN4200300000000,42,003,"Allegheny County, PA",Dec-22 p,630451,609274,21177,3.40000000
CN4200500000000,42,005,"Armstrong County, PA",Dec-22 p,31157,29767,1390,4.50000000
CN4200700000000,42,007,"Beaver County, PA",Dec-22 p,82023,78087,3936,4.80000000
CN4200900000000,42,009,"Bedford County, PA",Dec-22 p,23696,22668,1028,4.30000000
CN4201100000000,42,011,"Berks County, PA",Dec-22 p,211578,204386,7192,3.40000000
CN4201300000000,42,013,"Blair County, PA",Dec-22 p,59737,57619,2118,3.50000000
CN4201500000000,42,015,"Bradford County, PA",Dec-22 p,27592,26655,937,3.40000000
CN4201700000000,42,017,"Bucks County, PA",Dec-22 p,346974,336790,10184,2.90000000
CN4201900000000,42,019,"Butler County, PA",Dec-22 p,98621,95330,3291,3.30000000
CN4202100000000,42,021,"Cambria County, PA",Dec-22 p,55613,53142,2471,4.40000000
CN4202300000000,42,023,"Cameron County, PA",Dec-22 p,1934,1827,107,5.50000000
CN4202500000000,42,025,"Carbon County, PA",Dec-22 p,32927,31606,1321,4.00000000
CN4202700000000,42,027,"Centre County, PA",Dec-22 p,78451,76268,2183,2.80000000
CN4202900000000,42,029,"Chester County, PA",Dec-22 p,293091,286203,6888,2.40000000
CN4203100000000,42,031,"Clarion County, PA",Dec-22 p,16433,15758,675,4.10000000
CN4203300000000,42,033,"Clearfield County, PA",Dec-22 p,34889,33187,1702,4.90000000
CN4203500000000,42,035,"Clinton County, PA",Dec-22 p,17162,16380,782,4.60000000
CN4203700000000,42,037,"Columbia County, PA",Dec-22 p,33090,31829,1261,3.80000000
CN4203900000000,42,039,"Crawford County, PA",Dec-22 p,37403,35887,1516,4.10000000
CN4204100000000,42,041,"Cumberland County, PA",Dec-22 p,136897,133559,3338,2.40000000
CN4204300000000,42,043,"Dauphin County, PA",Dec-22 p,148156,143600,4556,3.10000000
CN4204500000000,42,045,"Delaware County, PA",Dec-22 p,298555,288829,9726,3.30000000
CN4204700000000,42,047,"Elk County, PA",Dec-22 p,14284,13741,543,3.80000000
CN4204900000000,42,049,"Erie County, PA",Dec-22 p,126612,121333,5279,4.20000000
CN4205100000000,42,051,"Fayette County, PA",Dec-22 p,55070,52149,2921,5.30000000
CN4205300000000,42,053,"Forest County, PA",Dec-22 p,1686,1583,103,6.10000000
CN4205500000000,42,055,"Franklin County, PA",Dec-22 p,77426,75231,2195,2.80000000
CN4205700000000,42,057,"Fulton County, PA",Dec-22 p,7043,6797,246,3.50000000
CN4205900000000,42,059,"Greene County, PA",Dec-22 p,15270,14624,646,4.20000000
CN4206100000000,42,061,"Huntingdon County, PA",Dec-22 p,19116,18087,1029,5.40000000
CN4206300000000,42,063,"Indiana County, PA",Dec-22 p,36145,34581,1564,4.30000000
CN4206500000000,42,065,"Jefferson County, PA",Dec-22 p,19317,18507,810,4.20000000
CN4206700000000,42,067,"Juniata County, PA",Dec-22 p,12649,12176,473,3.70000000
CN4206900000000,42,069,"Lackawanna County, PA",Dec-22 p,103816,99805,4011,3.90000000
CN4207100000000,42,071,"Lancaster County, PA",Dec-22 p,285439,278186,7253,2.50000000
CN4207300000000,42,073,"Lawrence County, PA",Dec-22 p,38848,36970,1878,4.80000000
CN4207500000000,42,075,"Lebanon County, PA",Dec-22 p,74927,72952,1975,2.60000000
CN4207700000000,42,077,"Lehigh County, PA",Dec-22 p,199774,192824,6950,3.50000000
CN4207900000000,42,079,"Luzerne County, PA",Dec-22 p,156485,149313,7172,4.60000000
CN4208100000000,42,081,"Lycoming County, PA",Dec-22 p,54425,52251,2174,4.00000000
CN4208300000000,42,083,"McKean County, PA",Dec-22 p,16415,15625,790,4.80000000
CN4208500000000,42,085,"Mercer County, PA",Dec-22 p,46748,44810,1938,4.10000000
CN4208700000000,42,087,"Mifflin County, PA",Dec-22 p,20602,19761,841,4.10000000
CN4208900000000,42,089,"Monroe County, PA",Dec-22 p,81988,78056,3932,4.80000000
CN4209100000000,42,091,"Montgomery County, PA",Dec-22 p,461635,449552,12083,2.60000000
CN4209300000000,42,093,"Montour County, PA",Dec-22 p,8998,8753,245,2.70000000
CN4209500000000,42,095,"Northampton County, PA",Dec-22 p,166251,160887,5364,3.20000000
CN4209700000000,42,097,"Northumberland County, PA",Dec-22 p,40809,39055,1754,4.30000000
CN4209900000000,42,099,"Perry County, PA",Dec-22 p,25107,24415,692,2.80000000
CN4210100000000,42,101,"Philadelphia County/city, PA",Dec-22 p,723233,690464,32769,4.50000000
CN4210300000000,42,103,"Pike County, PA",Dec-22 p,25586,24336,1250,4.90000000
CN4210500000000,42,105,"Potter County, PA",Dec-22 p,7105,6743,362,5.10000000
CN4210700000000,42,107,"Schuylkill County, PA",Dec-22 p,64127,61474,2653,4.10000000
CN4210900000000,42,109,"Snyder County, PA",Dec-22 p,19762,19061,701,3.50000000
CN4211100000000,42,111,"Somerset County, PA",Dec-22 p,32109,30551,1558,4.90000000
CN4211300000000,42,113,"Sullivan County, PA",Dec-22 p,2492,2385,107,4.30000000
CN4211500000000,42,115,"Susquehanna County, PA",Dec-22 p,20178,19498,680,3.40000000
CN4211700000000,42,117,"Tioga County, PA",Dec-22 p,18685,17887,798,4.30000000
CN4211900000000,42,119,"Union County, PA",Dec-22 p,19402,18856,546,2.80000000
CN4212100000000,42,121,"Venango County, PA",Dec-22 p,20659,19730,929,4.50000000
CN4212300000000,42,123,"Warren County, PA",Dec-22 p,17199,16425,774,4.50000000
CN4212500000000,42,125,"Washington County, PA",Dec-22 p,104453,100652,3801,3.60000000
CN4212700000000,42,127,"Wayne County, PA",Dec-22 p,21895,20925,970,4.40000000
CN4212900000000,42,129,"Westmoreland County, PA",Dec-22 p,175389,168896,6493,3.70000000
CN4213100000000,42,131,"Wyoming County, PA",Dec-22 p,13378,12854,524,3.90000000
CN4213300000000,42,133,"York County, PA",Dec-22 p,237868,231187,6681,2.80000000
CN4400100000000,44,001,"Bristol County, RI",Dec-22 p,26449,25959,490,1.90000000
CN4400300000000,44,003,"Kent County, RI",Dec-22 p,93262,91360,1902,2.00000000
CN4400500000000,44,005,"Newport County, RI",Dec-22 p,44975,44047,928,2.10000000
CN4400700000000,44,007,"Providence County, RI",Dec-22 p,332768,324313,8455,2.50000000
CN4400900000000,44,009,"Washington County, RI",Dec-22 p,69590,68255,1335,1.90000000
CN4500100000000,45,001,"Abbeville County, SC",Dec-22 p,9542,9216,326,3.40000000
CN4500300000000,45,003,"Aiken County, SC",Dec-22 p,72905,70820,2085,2.90000000
CN4500500000000,45,005,"Allendale County, SC",Dec-22 p,2176,2038,138,6.30000000
CN4500700000000,45,007,"Anderson County, SC",Dec-22 p,90855,88411,2444,2.70000000
CN4500900000000,45,009,"Bamberg County, SC",Dec-22 p,4498,4266,232,5.20000000
CN4501100000000,45,011,"Barnwell County, SC",Dec-22 p,7374,7041,333,4.50000000
CN4501300000000,45,013,"Beaufort County, SC",Dec-22 p,75596,73423,2173,2.90000000
CN4501500000000,45,015,"Berkeley County, SC",Dec-22 p,110840,107939,2901,2.60000000
CN4501700000000,45,017,"Calhoun County, SC",Dec-22 p,6242,6035,207,3.30000000
CN4501900000000,45,019,"Charleston County, SC",Dec-22 p,217542,212279,5263,2.40000000
CN4502100000000,45,021,"Cherokee County, SC",Dec-22 p,24229,23337,892,3.70000000
CN4502300000000,45,023,"Chester County, SC",Dec-22 p,13433,12874,559,4.20000000
CN4502500000000,45,025,"Chesterfield County, SC",Dec-22 p,20906,20203,703,3.40000000
CN4502700000000,45,027,"Clarendon County, SC",Dec-22 p,11614,11095,519,4.50000000
CN4502900000000,45,029,"Colleton County, SC",Dec-22 p,15599,15102,497,3.20000000
CN4503100000000,45,031,"Darlington County, SC",Dec-22 p,28917,27969,948,3.30000000
CN4503300000000,45,033,"Dillon County, SC",Dec-22 p,12765,12168,597,4.70000000
CN4503500000000,45,035,"Dorchester County, SC",Dec-22 p,80353,78351,2002,2.50000000
CN4503700000000,45,037,"Edgefield County, SC",Dec-22 p,10163,9851,312,3.10000000
CN4503900000000,45,039,"Fairfield County, SC",Dec-22 p,8987,8592,395,4.40000000
CN4504100000000,45,041,"Florence County, SC",Dec-22 p,64361,62485,1876,2.90000000
CN4504300000000,45,043,"Georgetown County, SC",Dec-22 p,25212,24305,907,3.60000000
CN4504500000000,45,045,"Greenville County, SC",Dec-22 p,258494,251938,6556,2.50000000
CN4504700000000,45,047,"Greenwood County, SC",Dec-22 p,29946,28950,996,3.30000000
CN4504900000000,45,049,"Hampton County, SC",Dec-22 p,7700,7497,203,2.60000000
CN4505100000000,45,051,"Horry County, SC",Dec-22 p,145214,139430,5784,4.00000000
CN4505300000000,45,053,"Jasper County, SC",Dec-22 p,12995,12651,344,2.60000000
CN4505500000000,45,055,"Kershaw County, SC",Dec-22 p,28637,27777,860,3.00000000
CN4505700000000,45,057,"Lancaster County, SC",Dec-22 p,43839,42381,1458,3.30000000
CN4505900000000,45,059,"Laurens County, SC",Dec-22 p,29829,28922,907,3.00000000
CN4506100000000,45,061,"Lee County, SC",Dec-22 p,6250,5955,295,4.70000000
CN4506300000000,45,063,"Lexington County, SC",Dec-22 p,147835,144165,3670,2.50000000
CN4506500000000,45,065,"McCormick County, SC",Dec-22 p,3436,3324,112,3.30000000
CN4506700000000,45,067,"Marion County, SC",Dec-22 p,12331,11722,609,4.90000000
CN4506900000000,45,069,"Marlboro County, SC",Dec-22 p,8438,7751,687,8.10000000
CN4507100000000,45,071,"Newberry County, SC",Dec-22 p,18583,18103,480,2.60000000
CN4507300000000,45,073,"Oconee County, SC",Dec-22 p,33380,32464,916,2.70000000
CN4507500000000,45,075,"Orangeburg County, SC",Dec-22 p,32555,30994,1561,4.80000000
CN4507700000000,45,077,"Pickens County, SC",Dec-22 p,57539,56013,1526,2.70000000
CN4507900000000,45,079,"Richland County, SC",Dec-22 p,192961,187301,5660,2.90000000
CN4508100000000,45,081,"Saluda County, SC",Dec-22 p,8059,7832,227,2.80000000
CN4508300000000,45,083,"Spartanburg County, SC",Dec-22 p,155882,151506,4376,2.80000000
CN4508500000000,45,085,"Sumter County, SC",Dec-22 p,40932,39292,1640,4.00000000
CN4508700000000,45,087,"Union County, SC",Dec-22 p,11347,10822,525,4.60000000
CN4508900000000,45,089,"Williamsburg County, SC",Dec-22 p,10561,10055,506,4.80000000
CN4509100000000,45,091,"York County, SC",Dec-22 p,149121,144986,4135,2.80000000
CN4600300000000,46,003,"Aurora County, SD",Dec-22 p,1479,1449,30,2.00000000
CN4600500000000,46,005,"Beadle County, SD",Dec-22 p,9219,9027,192,2.10000000
CN4600700000000,46,007,"Bennett County, SD",Dec-22 p,1079,1038,41,3.80000000
CN4600900000000,46,009,"Bon Homme County, SD",Dec-22 p,2825,2765,60,2.10000000
CN4601100000000,46,011,"Brookings County, SD",Dec-22 p,19260,18847,413,2.10000000
CN4601300000000,46,013,"Brown County, SD",Dec-22 p,19979,19515,464,2.30000000
CN4601500000000,46,015,"Brule County, SD",Dec-22 p,2635,2590,45,1.70000000
CN4601700000000,46,017,"Buffalo County, SD",Dec-22 p,720,679,41,5.70000000
CN4601900000000,46,019,"Butte County, SD",Dec-22 p,4941,4834,107,2.20000000
CN4602100000000,46,021,"Campbell County, SD",Dec-22 p,793,768,25,3.20000000
CN4602300000000,46,023,"Charles Mix County, SD",Dec-22 p,3787,3696,91,2.40000000
CN4602500000000,46,025,"Clark County, SD",Dec-22 p,1907,1860,47,2.50000000
CN4602700000000,46,027,"Clay County, SD",Dec-22 p,7407,7245,162,2.20000000
CN4602900000000,46,029,"Codington County, SD",Dec-22 p,15877,15545,332,2.10000000
CN4603100000000,46,031,"Corson County, SD",Dec-22 p,1279,1238,41,3.20000000
CN4603300000000,46,033,"Custer County, SD",Dec-22 p,4209,4069,140,3.30000000
CN4603500000000,46,035,"Davison County, SD",Dec-22 p,10993,10772,221,2.00000000
CN4603700000000,46,037,"Day County, SD",Dec-22 p,2613,2522,91,3.50000000
CN4603900000000,46,039,"Deuel County, SD",Dec-22 p,2254,2162,92,4.10000000
CN4604100000000,46,041,"Dewey County, SD",Dec-22 p,2308,2184,124,5.40000000
CN4604300000000,46,043,"Douglas County, SD",Dec-22 p,1518,1484,34,2.20000000
CN4604500000000,46,045,"Edmunds County, SD",Dec-22 p,1992,1952,40,2.00000000
CN4604700000000,46,047,"Fall River County, SD",Dec-22 p,3082,3005,77,2.50000000
CN4604900000000,46,049,"Faulk County, SD",Dec-22 p,1096,1075,21,1.90000000
CN4605100000000,46,051,"Grant County, SD",Dec-22 p,4452,4292,160,3.60000000
CN4605300000000,46,053,"Gregory County, SD",Dec-22 p,2218,2173,45,2.00000000
CN4605500000000,46,055,"Haakon County, SD",Dec-22 p,1069,1048,21,2.00000000
CN4605700000000,46,057,"Hamlin County, SD",Dec-22 p,3574,3493,81,2.30000000
CN4605900000000,46,059,"Hand County, SD",Dec-22 p,1806,1772,34,1.90000000
CN4606100000000,46,061,"Hanson County, SD",Dec-22 p,1777,1726,51,2.90000000
CN4606300000000,46,063,"Harding County, SD",Dec-22 p,744,731,13,1.70000000
CN4606500000000,46,065,"Hughes County, SD",Dec-22 p,9799,9627,172,1.80000000
CN4606700000000,46,067,"Hutchinson County, SD",Dec-22 p,3626,3532,94,2.60000000
CN4606900000000,46,069,"Hyde County, SD",Dec-22 p,656,643,13,2.00000000
CN4607100000000,46,071,"Jackson County, SD",Dec-22 p,1174,1123,51,4.30000000
CN4607300000000,46,073,"Jerauld County, SD",Dec-22 p,1322,1305,17,1.30000000
CN4607500000000,46,075,"Jones County, SD",Dec-22 p,524,509,15,2.90000000
CN4607700000000,46,077,"Kingsbury County, SD",Dec-22 p,2892,2835,57,2.00000000
CN4607900000000,46,079,"Lake County, SD",Dec-22 p,6673,6543,130,1.90000000
CN4608100000000,46,081,"Lawrence County, SD",Dec-22 p,13931,13639,292,2.10000000
CN4608300000000,46,083,"Lincoln County, SD",Dec-22 p,37693,37054,639,1.70000000
CN4608500000000,46,085,"Lyman County, SD",Dec-22 p,1695,1644,51,3.00000000
CN4608700000000,46,087,"McCook County, SD",Dec-22 p,3135,3075,60,1.90000000
CN4608900000000,46,089,"McPherson County, SD",Dec-22 p,984,958,26,2.60000000
CN4609100000000,46,091,"Marshall County, SD",Dec-22 p,2494,2413,81,3.20000000
CN4609300000000,46,093,"Meade County, SD",Dec-22 p,14325,14014,311,2.20000000
CN4609500000000,46,095,"Mellette County, SD",Dec-22 p,755,732,23,3.00000000
CN4609700000000,46,097,"Miner County, SD",Dec-22 p,1215,1192,23,1.90000000
CN4609900000000,46,099,"Minnehaha County, SD",Dec-22 p,117214,114823,2391,2.00000000
CN4610100000000,46,101,"Moody County, SD",Dec-22 p,3954,3875,79,2.00000000
CN4610200000000,46,102,"Oglala Lakota County, SD",Dec-22 p,3818,3614,204,5.30000000
CN4610300000000,46,103,"Pennington County, SD",Dec-22 p,58947,57695,1252,2.10000000
CN4610500000000,46,105,"Perkins County, SD",Dec-22 p,1430,1394,36,2.50000000
CN4610700000000,46,107,"Potter County, SD",Dec-22 p,1048,1023,25,2.40000000
CN4610900000000,46,109,"Roberts County, SD",Dec-22 p,4689,4466,223,4.80000000
CN4611100000000,46,111,"Sanborn County, SD",Dec-22 p,1225,1199,26,2.10000000
CN4611500000000,46,115,"Spink County, SD",Dec-22 p,2993,2927,66,2.20000000
CN4611700000000,46,117,"Stanley County, SD",Dec-22 p,1912,1876,36,1.90000000
CN4611900000000,46,119,"Sully County, SD",Dec-22 p,808,797,11,1.40000000
CN4612100000000,46,121,"Todd County, SD",Dec-22 p,3032,2919,113,3.70000000
CN4612300000000,46,123,"Tripp County, SD",Dec-22 p,3140,3083,57,1.80000000
CN4612500000000,46,125,"Turner County, SD",Dec-22 p,4805,4698,107,2.20000000
CN4612700000000,46,127,"Union County, SD",Dec-22 p,8607,8407,200,2.30000000
CN4612900000000,46,129,"Walworth County, SD",Dec-22 p,2132,2036,96,4.50000000
CN4613500000000,46,135,"Yankton County, SD",Dec-22 p,11589,11382,207,1.80000000
CN4613700000000,46,137,"Ziebach County, SD",Dec-22 p,960,924,36,3.80000000
CN4700100000000,47,001,"Anderson County, TN",Dec-22 p,34990,33996,994,2.80000000
CN4700300000000,47,003,"Bedford County, TN",Dec-22 p,20555,19916,639,3.10000000
CN4700500000000,47,005,"Benton County, TN",Dec-22 p,6400,6156,244,3.80000000
CN4700700000000,47,007,"Bledsoe County, TN",Dec-22 p,4165,3945,220,5.30000000
CN4700900000000,47,009,"Blount County, TN",Dec-22 p,64977,63243,1734,2.70000000
CN4701100000000,47,011,"Bradley County, TN",Dec-22 p,49074,47572,1502,3.10000000
CN4701300000000,47,013,"Campbell County, TN",Dec-22 p,14802,14278,524,3.50000000
CN4701500000000,47,015,"Cannon County, TN",Dec-22 p,6764,6593,171,2.50000000
CN4701700000000,47,017,"Carroll County, TN",Dec-22 p,10897,10501,396,3.60000000
CN4701900000000,47,019,"Carter County, TN",Dec-22 p,23549,22802,747,3.20000000
CN4702100000000,47,021,"Cheatham County, TN",Dec-22 p,22239,21745,494,2.20000000
CN4702300000000,47,023,"Chester County, TN",Dec-22 p,8263,8039,224,2.70000000
CN4702500000000,47,025,"Claiborne County, TN",Dec-22 p,12505,12080,425,3.40000000
CN4702700000000,47,027,"Clay County, TN",Dec-22 p,2641,2535,106,4.00000000
CN4702900000000,47,029,"Cocke County, TN",Dec-22 p,13787,13211,576,4.20000000
CN4703100000000,47,031,"Coffee County, TN",Dec-22 p,24235,23517,718,3.00000000
CN4703300000000,47,033,"Crockett County, TN",Dec-22 p,6593,6411,182,2.80000000
CN4703500000000,47,035,"Cumberland County, TN",Dec-22 p,21454,20464,990,4.60000000
CN4703700000000,47,037,"Davidson County, TN",Dec-22 p,407521,397879,9642,2.40000000
CN4703900000000,47,039,"Decatur County, TN",Dec-22 p,4059,3877,182,4.50000000
CN4704100000000,47,041,"DeKalb County, TN",Dec-22 p,7537,7289,248,3.30000000
CN4704300000000,47,043,"Dickson County, TN",Dec-22 p,27564,26862,702,2.50000000
CN4704500000000,47,045,"Dyer County, TN",Dec-22 p,15306,14795,511,3.30000000
CN4704700000000,47,047,"Fayette County, TN",Dec-22 p,18965,18389,576,3.00000000
CN4704900000000,47,049,"Fentress County, TN",Dec-22 p,7282,7021,261,3.60000000
CN4705100000000,47,051,"Franklin County, TN",Dec-22 p,18780,18216,564,3.00000000
CN4705300000000,47,053,"Gibson County, TN",Dec-22 p,20538,19887,651,3.20000000
CN4705500000000,47,055,"Giles County, TN",Dec-22 p,14136,13727,409,2.90000000
CN4705700000000,47,057,"Grainger County, TN",Dec-22 p,9593,9286,307,3.20000000
CN4705900000000,47,059,"Greene County, TN",Dec-22 p,27371,26210,1161,4.20000000
CN4706100000000,47,061,"Grundy County, TN",Dec-22 p,4893,4703,190,3.90000000
CN4706300000000,47,063,"Hamblen County, TN",Dec-22 p,27632,26799,833,3.00000000
CN4706500000000,47,065,"Hamilton County, TN",Dec-22 p,178539,173476,5063,2.80000000
CN4706700000000,47,067,"Hancock County, TN",Dec-22 p,2198,2118,80,3.60000000
CN4706900000000,47,069,"Hardeman County, TN",Dec-22 p,8410,8067,343,4.10000000
CN4707100000000,47,071,"Hardin County, TN",Dec-22 p,9457,9109,348,3.70000000
CN4707300000000,47,073,"Hawkins County, TN",Dec-22 p,22429,21659,770,3.40000000
CN4707500000000,47,075,"Haywood County, TN",Dec-22 p,7278,6962,316,4.30000000
CN4707700000000,47,077,"Henderson County, TN",Dec-22 p,11369,11003,366,3.20000000
CN4707900000000,47,079,"Henry County, TN",Dec-22 p,13738,13287,451,3.30000000
CN4708100000000,47,081,"Hickman County, TN",Dec-22 p,11554,11267,287,2.50000000
CN4708300000000,47,083,"Houston County, TN",Dec-22 p,3084,2963,121,3.90000000
CN4708500000000,47,085,"Humphreys County, TN",Dec-22 p,8279,8032,247,3.00000000
CN4708700000000,47,087,"Jackson County, TN",Dec-22 p,4656,4491,165,3.50000000
CN4708900000000,47,089,"Jefferson County, TN",Dec-22 p,24564,23811,753,3.10000000
CN4709100000000,47,091,"Johnson County, TN",Dec-22 p,7409,7192,217,2.90000000
CN4709300000000,47,093,"Knox County, TN",Dec-22 p,249013,243057,5956,2.40000000
CN4709500000000,47,095,"Lake County, TN",Dec-22 p,1527,1455,72,4.70000000
CN4709700000000,47,097,"Lauderdale County, TN",Dec-22 p,9290,8894,396,4.30000000
CN4709900000000,47,099,"Lawrence County, TN",Dec-22 p,18718,18159,559,3.00000000
CN4710100000000,47,101,"Lewis County, TN",Dec-22 p,5491,5320,171,3.10000000
CN4710300000000,47,103,"Lincoln County, TN",Dec-22 p,15270,14818,452,3.00000000
CN4710500000000,47,105,"Loudon County, TN",Dec-22 p,24138,23470,668,2.80000000
CN4710700000000,47,107,"McMinn County, TN",Dec-22 p,20644,19863,781,3.80000000
CN4710900000000,47,109,"McNairy County, TN",Dec-22 p,7821,7476,345,4.40000000
CN4711100000000,47,111,"Macon County, TN",Dec-22 p,11451,11148,303,2.60000000
CN4711300000000,47,113,"Madison County, TN",Dec-22 p,47443,46043,1400,3.00000000
CN4711500000000,47,115,"Marion County, TN",Dec-22 p,12004,11563,441,3.70000000
CN4711700000000,47,117,"Marshall County, TN",Dec-22 p,15061,14637,424,2.80000000
CN4711900000000,47,119,"Maury County, TN",Dec-22 p,52224,50907,1317,2.50000000
CN4712100000000,47,121,"Meigs County, TN",Dec-22 p,4984,4769,215,4.30000000
CN4712300000000,47,123,"Monroe County, TN",Dec-22 p,20291,19669,622,3.10000000
CN4712500000000,47,125,"Montgomery County, TN",Dec-22 p,86186,83385,2801,3.20000000
CN4712700000000,47,127,"Moore County, TN",Dec-22 p,3542,3463,79,2.20000000
CN4712900000000,47,129,"Morgan County, TN",Dec-22 p,7804,7530,274,3.50000000
CN4713100000000,47,131,"Obion County, TN",Dec-22 p,11669,11254,415,3.60000000
CN4713300000000,47,133,"Overton County, TN",Dec-22 p,9648,9345,303,3.10000000
CN4713500000000,47,135,"Perry County, TN",Dec-22 p,2631,2506,125,4.80000000
CN4713700000000,47,137,"Pickett County, TN",Dec-22 p,2016,1941,75,3.70000000
CN4713900000000,47,139,"Polk County, TN",Dec-22 p,6908,6655,253,3.70000000
CN4714100000000,47,141,"Putnam County, TN",Dec-22 p,34552,33501,1051,3.00000000
CN4714300000000,47,143,"Rhea County, TN",Dec-22 p,13602,13027,575,4.20000000
CN4714500000000,47,145,"Roane County, TN",Dec-22 p,23564,22823,741,3.10000000
CN4714700000000,47,147,"Robertson County, TN",Dec-22 p,38704,37747,957,2.50000000
CN4714900000000,47,149,"Rutherford County, TN",Dec-22 p,193236,188861,4375,2.30000000
CN4715100000000,47,151,"Scott County, TN",Dec-22 p,7763,7424,339,4.40000000
CN4715300000000,47,153,"Sequatchie County, TN",Dec-22 p,5989,5778,211,3.50000000
CN4715500000000,47,155,"Sevier County, TN",Dec-22 p,53575,52231,1344,2.50000000
CN4715700000000,47,157,"Shelby County, TN",Dec-22 p,433687,416377,17310,4.00000000
CN4715900000000,47,159,"Smith County, TN",Dec-22 p,9608,9364,244,2.50000000
CN4716100000000,47,161,"Stewart County, TN",Dec-22 p,5184,5004,180,3.50000000
CN4716300000000,47,163,"Sullivan County, TN",Dec-22 p,66626,64553,2073,3.10000000
CN4716500000000,47,165,"Sumner County, TN",Dec-22 p,107334,104806,2528,2.40000000
CN4716700000000,47,167,"Tipton County, TN",Dec-22 p,27296,26467,829,3.00000000
CN4716900000000,47,169,"Trousdale County, TN",Dec-22 p,5654,5500,154,2.70000000
CN4717100000000,47,171,"Unicoi County, TN",Dec-22 p,6912,6642,270,3.90000000
CN4717300000000,47,173,"Union County, TN",Dec-22 p,7762,7505,257,3.30000000
CN4717500000000,47,175,"Van Buren County, TN",Dec-22 p,1932,1856,76,3.90000000
CN4717700000000,47,177,"Warren County, TN",Dec-22 p,15896,15342,554,3.50000000
CN4717900000000,47,179,"Washington County, TN",Dec-22 p,60260,58521,1739,2.90000000
CN4718100000000,47,181,"Wayne County, TN",Dec-22 p,6144,5893,251,4.10000000
CN4718300000000,47,183,"Weakley County, TN",Dec-22 p,15091,14674,417,2.80000000
CN4718500000000,47,185,"White County, TN",Dec-22 p,11221,10845,376,3.40000000
CN4718700000000,47,187,"Williamson County, TN",Dec-22 p,136275,133417,2858,2.10000000
CN4718900000000,47,189,"Wilson County, TN",Dec-22 p,80919,79104,1815,2.20000000
CN4800100000000,48,001,"Anderson County, TX",Dec-22 p,23271,22569,702,3.00000000
CN4800300000000,48,003,"Andrews County, TX",Dec-22 p,8500,8238,262,3.10000000
CN4800500000000,48,005,"Angelina County, TX",Dec-22 p,36034,34538,1496,4.20000000
CN4800700000000,48,007,"Aransas County, TX",Dec-22 p,9268,8813,455,4.90000000
CN4800900000000,48,009,"Archer County, TX",Dec-22 p,3981,3869,112,2.80000000
CN4801100000000,48,011,"Armstrong County, TX",Dec-22 p,909,887,22,2.40000000
CN4801300000000,48,013,"Atascosa County, TX",Dec-22 p,22257,21436,821,3.70000000
CN4801500000000,48,015,"Austin County, TX",Dec-22 p,14185,13720,465,3.30000000
CN4801700000000,48,017,"Bailey County, TX",Dec-22 p,2199,2115,84,3.80000000
CN4801900000000,48,019,"Bandera County, TX",Dec-22 p,10501,10160,341,3.20000000
CN4802100000000,48,021,"Bastrop County, TX",Dec-22 p,47157,45777,1380,2.90000000
CN4802300000000,48,023,"Baylor County, TX",Dec-22 p,1814,1771,43,2.40000000
CN4802500000000,48,025,"Bee County, TX",Dec-22 p,8485,7998,487,5.70000000
CN4802700000000,48,027,"Bell County, TX",Dec-22 p,149337,143383,5954,4.00000000
CN4802900000000,48,029,"Bexar County, TX",Dec-22 p,973037,940543,32494,3.30000000
CN4803100000000,48,031,"Blanco County, TX",Dec-22 p,7191,7019,172,2.40000000
CN4803300000000,48,033,"Borden County, TX",Dec-22 p,734,722,12,1.60000000
CN4803500000000,48,035,"Bosque County, TX",Dec-22 p,8513,8239,274,3.20000000
CN4803700000000,48,037,"Bowie County, TX",Dec-22 p,39385,37817,1568,4.00000000
CN4803900000000,48,039,"Brazoria County, TX",Dec-22 p,187623,179452,8171,4.40000000
CN4804100000000,48,041,"Brazos County, TX",Dec-22 p,124608,121195,3413,2.70000000
CN4804300000000,48,043,"Brewster County, TX",Dec-22 p,4059,3941,118,2.90000000
CN4804500000000,48,045,"Briscoe County, TX",Dec-22 p,538,519,19,3.50000000
CN4804700000000,48,047,"Brooks County, TX",Dec-22 p,2416,2289,127,5.30000000
CN4804900000000,48,049,"Brown County, TX",Dec-22 p,15109,14397,712,4.70000000
CN4805100000000,48,051,"Burleson County, TX",Dec-22 p,8564,8277,287,3.40000000
CN4805300000000,48,053,"Burnet County, TX",Dec-22 p,24835,24170,665,2.70000000
CN4805500000000,48,055,"Caldwell County, TX",Dec-22 p,20859,20209,650,3.10000000
CN4805700000000,48,057,"Calhoun County, TX",Dec-22 p,11970,11576,394,3.30000000
CN4805900000000,48,059,"Callahan County, TX",Dec-22 p,6140,5943,197,3.20000000
CN4806100000000,48,061,"Cameron County, TX",Dec-22 p,176374,166276,10098,5.70000000
CN4806300000000,48,063,"Camp County, TX",Dec-22 p,5251,5049,202,3.80000000
CN4806500000000,48,065,"Carson County, TX",Dec-22 p,2927,2849,78,2.70000000
CN4806700000000,48,067,"Cass County, TX",Dec-22 p,12083,11568,515,4.30000000
CN4806900000000,48,069,"Castro County, TX",Dec-22 p,3182,3095,87,2.70000000
CN4807100000000,48,071,"Chambers County, TX",Dec-22 p,21450,20294,1156,5.40000000
CN4807300000000,48,073,"Cherokee County, TX",Dec-22 p,20174,19344,830,4.10000000
CN4807500000000,48,075,"Childress County, TX",Dec-22 p,2860,2791,69,2.40000000
CN4807700000000,48,077,"Clay County, TX",Dec-22 p,4814,4652,162,3.40000000
CN4807900000000,48,079,"Cochran County, TX",Dec-22 p,968,924,44,4.50000000
CN4808100000000,48,081,"Coke County, TX",Dec-22 p,1339,1296,43,3.20000000
CN4808300000000,48,083,"Coleman County, TX",Dec-22 p,2873,2746,127,4.40000000
CN4808500000000,48,085,"Collin County, TX",Dec-22 p,638789,620670,18119,2.80000000
CN4808700000000,48,087,"Collingsworth County, TX",Dec-22 p,1041,1009,32,3.10000000
CN4808900000000,48,089,"Colorado County, TX",Dec-22 p,10063,9760,303,3.00000000
CN4809100000000,48,091,"Comal County, TX",Dec-22 p,81733,79225,2508,3.10000000
CN4809300000000,48,093,"Comanche County, TX",Dec-22 p,6223,6016,207,3.30000000
CN4809500000000,48,095,"Concho County, TX",Dec-22 p,1280,1246,34,2.70000000
CN4809700000000,48,097,"Cooke County, TX",Dec-22 p,19277,18708,569,3.00000000
CN4809900000000,48,099,"Coryell County, TX",Dec-22 p,24659,23666,993,4.00000000
CN4810100000000,48,101,"Cottle County, TX",Dec-22 p,636,617,19,3.00000000
CN4810300000000,48,103,"Crane County, TX",Dec-22 p,1535,1460,75,4.90000000
CN4810500000000,48,105,"Crockett County, TX",Dec-22 p,1313,1264,49,3.70000000
CN4810700000000,48,107,"Crosby County, TX",Dec-22 p,2320,2233,87,3.80000000
CN4810900000000,48,109,"Culberson County, TX",Dec-22 p,1056,1030,26,2.50000000
CN4811100000000,48,111,"Dallam County, TX",Dec-22 p,3637,3558,79,2.20000000
CN4811300000000,48,113,"Dallas County, TX",Dec-22 p,1451105,1402397,48708,3.40000000
CN4811500000000,48,115,"Dawson County, TX",Dec-22 p,4326,4155,171,4.00000000
CN4811700000000,48,117,"Deaf Smith County, TX",Dec-22 p,8575,8357,218,2.50000000
CN4811900000000,48,119,"Delta County, TX",Dec-22 p,2449,2343,106,4.30000000
CN4812100000000,48,121,"Denton County, TX",Dec-22 p,563385,547259,16126,2.90000000
CN4812300000000,48,123,"DeWitt County, TX",Dec-22 p,9469,9210,259,2.70000000
CN4812500000000,48,125,"Dickens County, TX",Dec-22 p,703,675,28,4.00000000
CN4812700000000,48,127,"Dimmit County, TX",Dec-22 p,5664,5437,227,4.00000000
CN4812900000000,48,129,"Donley County, TX",Dec-22 p,1488,1442,46,3.10000000
CN4813100000000,48,131,"Duval County, TX",Dec-22 p,5365,5161,204,3.80000000
CN4813300000000,48,133,"Eastland County, TX",Dec-22 p,6895,6624,271,3.90000000
CN4813500000000,48,135,"Ector County, TX",Dec-22 p,81648,78576,3072,3.80000000
CN4813700000000,48,137,"Edwards County, TX",Dec-22 p,1235,1209,26,2.10000000
CN4813900000000,48,139,"Ellis County, TX",Dec-22 p,105390,102109,3281,3.10000000
CN4814100000000,48,141,"El Paso County, TX",Dec-22 p,364858,350323,14535,4.00000000
CN4814300000000,48,143,"Erath County, TX",Dec-22 p,20739,20108,631,3.00000000
CN4814500000000,48,145,"Falls County, TX",Dec-22 p,6676,6429,247,3.70000000
CN4814700000000,48,147,"Fannin County, TX",Dec-22 p,17563,16917,646,3.70000000
CN4814900000000,48,149,"Fayette County, TX",Dec-22 p,11395,11033,362,3.20000000
CN4815100000000,48,151,"Fisher County, TX",Dec-22 p,1522,1471,51,3.40000000
CN4815300000000,48,153,"Floyd County, TX",Dec-22 p,2348,2258,90,3.80000000
CN4815500000000,48,155,"Foard County, TX",Dec-22 p,617,602,15,2.40000000
CN4815700000000,48,157,"Fort Bend County, TX",Dec-22 p,425319,409951,15368,3.60000000
CN4815900000000,48,159,"Franklin County, TX",Dec-22 p,5118,4958,160,3.10000000
CN4816100000000,48,161,"Freestone County, TX",Dec-22 p,5997,5700,297,5.00000000
CN4816300000000,48,163,"Frio County, TX",Dec-22 p,9127,8867,260,2.80000000
CN4816500000000,48,165,"Gaines County, TX",Dec-22 p,9541,9291,250,2.60000000
CN4816700000000,48,167,"Galveston County, TX",Dec-22 p,171701,164611,7090,4.10000000
CN4816900000000,48,169,"Garza County, TX",Dec-22 p,1910,1839,71,3.70000000
CN4817100000000,48,171,"Gillespie County, TX",Dec-22 p,15095,14785,310,2.10000000
CN4817300000000,48,173,"Glasscock County, TX",Dec-22 p,775,757,18,2.30000000
CN4817500000000,48,175,"Goliad County, TX",Dec-22 p,3143,3018,125,4.00000000
CN4817700000000,48,177,"Gonzales County, TX",Dec-22 p,9428,9172,256,2.70000000
CN4817900000000,48,179,"Gray County, TX",Dec-22 p,7531,7219,312,4.10000000
CN4818100000000,48,181,"Grayson County, TX",Dec-22 p,68002,65803,2199,3.20000000
CN4818300000000,48,183,"Gregg County, TX",Dec-22 p,56563,54296,2267,4.00000000
CN4818500000000,48,185,"Grimes County, TX",Dec-22 p,10910,10426,484,4.40000000
CN4818700000000,48,187,"Guadalupe County, TX",Dec-22 p,84985,82478,2507,2.90000000
CN4818900000000,48,189,"Hale County, TX",Dec-22 p,11622,11111,511,4.40000000
CN4819100000000,48,191,"Hall County, TX",Dec-22 p,1037,997,40,3.90000000
CN4819300000000,48,193,"Hamilton County, TX",Dec-22 p,3713,3594,119,3.20000000
CN4819500000000,48,195,"Hansford County, TX",Dec-22 p,2502,2445,57,2.30000000
CN4819700000000,48,197,"Hardeman County, TX",Dec-22 p,1656,1600,56,3.40000000
CN4819900000000,48,199,"Hardin County, TX",Dec-22 p,24885,23637,1248,5.00000000
CN4820100000000,48,201,"Harris County, TX",Dec-22 p,2377903,2283552,94351,4.00000000
CN4820300000000,48,203,"Harrison County, TX",Dec-22 p,27986,26788,1198,4.30000000
CN4820500000000,48,205,"Hartley County, TX",Dec-22 p,2685,2641,44,1.60000000
CN4820700000000,48,207,"Haskell County, TX",Dec-22 p,2674,2599,75,2.80000000
CN4820900000000,48,209,"Hays County, TX",Dec-22 p,136181,132440,3741,2.70000000
CN4821100000000,48,211,"Hemphill County, TX",Dec-22 p,1428,1381,47,3.30000000
CN4821300000000,48,213,"Henderson County, TX",Dec-22 p,39591,38092,1499,3.80000000
CN4821500000000,48,215,"Hidalgo County, TX",Dec-22 p,376182,350629,25553,6.80000000
CN4821700000000,48,217,"Hill County, TX",Dec-22 p,17348,16618,730,4.20000000
CN4821900000000,48,219,"Hockley County, TX",Dec-22 p,10963,10629,334,3.00000000
CN4822100000000,48,221,"Hood County, TX",Dec-22 p,30041,29033,1008,3.40000000
CN4822300000000,48,223,"Hopkins County, TX",Dec-22 p,18254,17533,721,3.90000000
CN4822500000000,48,225,"Houston County, TX",Dec-22 p,10736,10417,319,3.00000000
CN4822700000000,48,227,"Howard County, TX",Dec-22 p,13347,12810,537,4.00000000
CN4822900000000,48,229,"Hudspeth County, TX",Dec-22 p,1803,1734,69,3.80000000
CN4823100000000,48,231,"Hunt County, TX",Dec-22 p,47718,46008,1710,3.60000000
CN4823300000000,48,233,"Hutchinson County, TX",Dec-22 p,7956,7599,357,4.50000000
CN4823500000000,48,235,"Irion County, TX",Dec-22 p,754,736,18,2.40000000
CN4823700000000,48,237,"Jack County, TX",Dec-22 p,3448,3336,112,3.20000000
CN4823900000000,48,239,"Jackson County, TX",Dec-22 p,6836,6620,216,3.20000000
CN4824100000000,48,241,"Jasper County, TX",Dec-22 p,12810,11976,834,6.50000000
CN4824300000000,48,243,"Jeff Davis County, TX",Dec-22 p,964,933,31,3.20000000
CN4824500000000,48,245,"Jefferson County, TX",Dec-22 p,101713,94888,6825,6.70000000
CN4824700000000,48,247,"Jim Hogg County, TX",Dec-22 p,1777,1690,87,4.90000000
CN4824900000000,48,249,"Jim Wells County, TX",Dec-22 p,15144,14301,843,5.60000000
CN4825100000000,48,251,"Johnson County, TX",Dec-22 p,89618,86890,2728,3.00000000
CN4825300000000,48,253,"Jones County, TX",Dec-22 p,5635,5411,224,4.00000000
CN4825500000000,48,255,"Karnes County, TX",Dec-22 p,6844,6663,181,2.60000000
CN4825700000000,48,257,"Kaufman County, TX",Dec-22 p,76669,74083,2586,3.40000000
CN4825900000000,48,259,"Kendall County, TX",Dec-22 p,23472,22808,664,2.80000000
CN4826100000000,48,261,"Kenedy County, TX",Dec-22 p,180,170,10,5.60000000
CN4826300000000,48,263,"Kent County, TX",Dec-22 p,425,413,12,2.80000000
CN4826500000000,48,265,"Kerr County, TX",Dec-22 p,21905,21218,687,3.10000000
CN4826700000000,48,267,"Kimble County, TX",Dec-22 p,1890,1839,51,2.70000000
CN4826900000000,48,269,"King County, TX",Dec-22 p,616,613,3,0.50000000
CN4827100000000,48,271,"Kinney County, TX",Dec-22 p,1161,1112,49,4.20000000
CN4827300000000,48,273,"Kleberg County, TX",Dec-22 p,12909,12315,594,4.60000000
CN4827500000000,48,275,"Knox County, TX",Dec-22 p,1372,1328,44,3.20000000
CN4827700000000,48,277,"Lamar County, TX",Dec-22 p,24200,23150,1050,4.30000000
CN4827900000000,48,279,"Lamb County, TX",Dec-22 p,4983,4804,179,3.60000000
CN4828100000000,48,281,"Lampasas County, TX",Dec-22 p,9376,9076,300,3.20000000
CN4828300000000,48,283,"La Salle County, TX",Dec-22 p,3864,3768,96,2.50000000
CN4828500000000,48,285,"Lavaca County, TX",Dec-22 p,8567,8310,257,3.00000000
CN4828700000000,48,287,"Lee County, TX",Dec-22 p,8684,8422,262,3.00000000
CN4828900000000,48,289,"Leon County, TX",Dec-22 p,5992,5696,296,4.90000000
CN4829100000000,48,291,"Liberty County, TX",Dec-22 p,35790,33760,2030,5.70000000
CN4829300000000,48,293,"Limestone County, TX",Dec-22 p,8448,8101,347,4.10000000
CN4829500000000,48,295,"Lipscomb County, TX",Dec-22 p,1443,1405,38,2.60000000
CN4829700000000,48,297,"Live Oak County, TX",Dec-22 p,4645,4463,182,3.90000000
CN4829900000000,48,299,"Llano County, TX",Dec-22 p,8982,8682,300,3.30000000
CN4830100000000,48,301,"Loving County, TX",Dec-22 p,520,516,4,0.80000000
CN4830300000000,48,303,"Lubbock County, TX",Dec-22 p,163565,158912,4653,2.80000000
CN4830500000000,48,305,"Lynn County, TX",Dec-22 p,2767,2686,81,2.90000000
CN4830700000000,48,307,"McCulloch County, TX",Dec-22 p,2975,2857,118,4.00000000
CN4830900000000,48,309,"McLennan County, TX",Dec-22 p,125445,121437,4008,3.20000000
CN4831100000000,48,311,"McMullen County, TX",Dec-22 p,766,753,13,1.70000000
CN4831300000000,48,313,"Madison County, TX",Dec-22 p,4655,4467,188,4.00000000
CN4831500000000,48,315,"Marion County, TX",Dec-22 p,4195,4005,190,4.50000000
CN4831700000000,48,317,"Martin County, TX",Dec-22 p,2655,2589,66,2.50000000
CN4831900000000,48,319,"Mason County, TX",Dec-22 p,1781,1732,49,2.80000000
CN4832100000000,48,321,"Matagorda County, TX",Dec-22 p,16152,15115,1037,6.40000000
CN4832300000000,48,323,"Maverick County, TX",Dec-22 p,22882,20921,1961,8.60000000
CN4832500000000,48,325,"Medina County, TX",Dec-22 p,22377,21627,750,3.40000000
CN4832700000000,48,327,"Menard County, TX",Dec-22 p,790,765,25,3.20000000
CN4832900000000,48,329,"Midland County, TX",Dec-22 p,102842,100172,2670,2.60000000
CN4833100000000,48,331,"Milam County, TX",Dec-22 p,10155,9737,418,4.10000000
CN4833300000000,48,333,"Mills County, TX",Dec-22 p,1809,1737,72,4.00000000
CN4833500000000,48,335,"Mitchell County, TX",Dec-22 p,2270,2183,87,3.80000000
CN4833700000000,48,337,"Montague County, TX",Dec-22 p,9209,8909,300,3.30000000
CN4833900000000,48,339,"Montgomery County, TX",Dec-22 p,306226,295397,10829,3.50000000
CN4834100000000,48,341,"Moore County, TX",Dec-22 p,10840,10575,265,2.40000000
CN4834300000000,48,343,"Morris County, TX",Dec-22 p,4353,4085,268,6.20000000
CN4834500000000,48,345,"Motley County, TX",Dec-22 p,419,403,16,3.80000000
CN4834700000000,48,347,"Nacogdoches County, TX",Dec-22 p,27692,26612,1080,3.90000000
CN4834900000000,48,349,"Navarro County, TX",Dec-22 p,23827,23028,799,3.40000000
CN4835100000000,48,351,"Newton County, TX",Dec-22 p,4884,4532,352,7.20000000
CN4835300000000,48,353,"Nolan County, TX",Dec-22 p,6830,6620,210,3.10000000
CN4835500000000,48,355,"Nueces County, TX",Dec-22 p,164410,157264,7146,4.30000000
CN4835700000000,48,357,"Ochiltree County, TX",Dec-22 p,3852,3737,115,3.00000000
CN4835900000000,48,359,"Oldham County, TX",Dec-22 p,905,881,24,2.70000000
CN4836100000000,48,361,"Orange County, TX",Dec-22 p,34972,32914,2058,5.90000000
CN4836300000000,48,363,"Palo Pinto County, TX",Dec-22 p,12625,12169,456,3.60000000
CN4836500000000,48,365,"Panola County, TX",Dec-22 p,9401,9014,387,4.10000000
CN4836700000000,48,367,"Parker County, TX",Dec-22 p,75012,72871,2141,2.90000000
CN4836900000000,48,369,"Parmer County, TX",Dec-22 p,4805,4699,106,2.20000000
CN4837100000000,48,371,"Pecos County, TX",Dec-22 p,5621,5387,234,4.20000000
CN4837300000000,48,373,"Polk County, TX",Dec-22 p,18320,17324,996,5.40000000
CN4837500000000,48,375,"Potter County, TX",Dec-22 p,54420,52947,1473,2.70000000
CN4837700000000,48,377,"Presidio County, TX",Dec-22 p,3120,2911,209,6.70000000
CN4837900000000,48,379,"Rains County, TX",Dec-22 p,6716,6509,207,3.10000000
CN4838100000000,48,381,"Randall County, TX",Dec-22 p,75107,73258,1849,2.50000000
CN4838300000000,48,383,"Reagan County, TX",Dec-22 p,1527,1476,51,3.30000000
CN4838500000000,48,385,"Real County, TX",Dec-22 p,1057,1007,50,4.70000000
CN4838700000000,48,387,"Red River County, TX",Dec-22 p,5316,5081,235,4.40000000
CN4838900000000,48,389,"Reeves County, TX",Dec-22 p,9200,8897,303,3.30000000
CN4839100000000,48,391,"Refugio County, TX",Dec-22 p,2945,2821,124,4.20000000
CN4839300000000,48,393,"Roberts County, TX",Dec-22 p,377,365,12,3.20000000
CN4839500000000,48,395,"Robertson County, TX",Dec-22 p,7660,7398,262,3.40000000
CN4839700000000,48,397,"Rockwall County, TX",Dec-22 p,60442,58675,1767,2.90000000
CN4839900000000,48,399,"Runnels County, TX",Dec-22 p,4534,4393,141,3.10000000
CN4840100000000,48,401,"Rusk County, TX",Dec-22 p,22209,21331,878,4.00000000
CN4840300000000,48,403,"Sabine County, TX",Dec-22 p,3952,3667,285,7.20000000
CN4840500000000,48,405,"San Augustine County, TX",Dec-22 p,2931,2756,175,6.00000000
CN4840700000000,48,407,"San Jacinto County, TX",Dec-22 p,11995,11440,555,4.60000000
CN4840900000000,48,409,"San Patricio County, TX",Dec-22 p,29202,27594,1608,5.50000000
CN4841100000000,48,411,"San Saba County, TX",Dec-22 p,2097,2029,68,3.20000000
CN4841300000000,48,413,"Schleicher County, TX",Dec-22 p,1133,1099,34,3.00000000
CN4841500000000,48,415,"Scurry County, TX",Dec-22 p,5663,5416,247,4.40000000
CN4841700000000,48,417,"Shackelford County, TX",Dec-22 p,1797,1757,40,2.20000000
CN4841900000000,48,419,"Shelby County, TX",Dec-22 p,11413,11010,403,3.50000000
CN4842100000000,48,421,"Sherman County, TX",Dec-22 p,1413,1379,34,2.40000000
CN4842300000000,48,423,"Smith County, TX",Dec-22 p,112444,108704,3740,3.30000000
CN4842500000000,48,425,"Somervell County, TX",Dec-22 p,4613,4447,166,3.60000000
CN4842700000000,48,427,"Starr County, TX",Dec-22 p,23368,20535,2833,12.10000000
CN4842900000000,48,429,"Stephens County, TX",Dec-22 p,4280,4139,141,3.30000000
CN4843100000000,48,431,"Sterling County, TX",Dec-22 p,496,480,16,3.20000000
CN4843300000000,48,433,"Stonewall County, TX",Dec-22 p,565,547,18,3.20000000
CN4843500000000,48,435,"Sutton County, TX",Dec-22 p,1030,979,51,5.00000000
CN4843700000000,48,437,"Swisher County, TX",Dec-22 p,2533,2430,103,4.10000000
CN4843900000000,48,439,"Tarrant County, TX",Dec-22 p,1150638,1113479,37159,3.20000000
CN4844100000000,48,441,"Taylor County, TX",Dec-22 p,67540,65432,2108,3.10000000
CN4844300000000,48,443,"Terrell County, TX",Dec-22 p,421,409,12,2.90000000
CN4844500000000,48,445,"Terry County, TX",Dec-22 p,4395,4223,172,3.90000000
CN4844700000000,48,447,"Throckmorton County, TX",Dec-22 p,1462,1441,21,1.40000000
CN4844900000000,48,449,"Titus County, TX",Dec-22 p,13638,13127,511,3.70000000
CN4845100000000,48,451,"Tom Green County, TX",Dec-22 p,54182,52534,1648,3.00000000
CN4845300000000,48,453,"Travis County, TX",Dec-22 p,809705,788468,21237,2.60000000
CN4845500000000,48,455,"Trinity County, TX",Dec-22 p,5098,4838,260,5.10000000
CN4845700000000,48,457,"Tyler County, TX",Dec-22 p,7391,6950,441,6.00000000
CN4845900000000,48,459,"Upshur County, TX",Dec-22 p,17639,16940,699,4.00000000
CN4846100000000,48,461,"Upton County, TX",Dec-22 p,1665,1618,47,2.80000000
CN4846300000000,48,463,"Uvalde County, TX",Dec-22 p,10849,10394,455,4.20000000
CN4846500000000,48,465,"Val Verde County, TX",Dec-22 p,22403,21369,1034,4.60000000
CN4846700000000,48,467,"Van Zandt County, TX",Dec-22 p,27390,26532,858,3.10000000
CN4846900000000,48,469,"Victoria County, TX",Dec-22 p,40886,39340,1546,3.80000000
CN4847100000000,48,471,"Walker County, TX",Dec-22 p,23145,22134,1011,4.40000000
CN4847300000000,48,473,"Waller County, TX",Dec-22 p,25708,24681,1027,4.00000000
CN4847500000000,48,475,"Ward County, TX",Dec-22 p,6335,6129,206,3.30000000
CN4847700000000,48,477,"Washington County, TX",Dec-22 p,14561,14061,500,3.40000000
CN4847900000000,48,479,"Webb County, TX",Dec-22 p,118859,114491,4368,3.70000000
CN4848100000000,48,481,"Wharton County, TX",Dec-22 p,20737,20000,737,3.60000000
CN4848300000000,48,483,"Wheeler County, TX",Dec-22 p,1812,1744,68,3.80000000
CN4848500000000,48,485,"Wichita County, TX",Dec-22 p,55665,53783,1882,3.40000000
CN4848700000000,48,487,"Wilbarger County, TX",Dec-22 p,4581,4369,212,4.60000000
CN4848900000000,48,489,"Willacy County, TX",Dec-22 p,7069,6476,593,8.40000000
CN4849100000000,48,491,"Williamson County, TX",Dec-22 p,358722,348897,9825,2.70000000
CN4849300000000,48,493,"Wilson County, TX",Dec-22 p,25732,25018,714,2.80000000
CN4849500000000,48,495,"Winkler County, TX",Dec-22 p,3641,3491,150,4.10000000
CN4849700000000,48,497,"Wise County, TX",Dec-22 p,34428,33358,1070,3.10000000
CN4849900000000,48,499,"Wood County, TX",Dec-22 p,17667,16948,719,4.10000000
CN4850100000000,48,501,"Yoakum County, TX",Dec-22 p,2984,2868,116,3.90000000
CN4850300000000,48,503,"Young County, TX",Dec-22 p,7894,7669,225,2.90000000
CN4850500000000,48,505,"Zapata County, TX",Dec-22 p,4416,4110,306,6.90000000
CN4850700000000,48,507,"Zavala County, TX",Dec-22 p,3168,2891,277,8.70000000
CN4900100000000,49,001,"Beaver County, UT",Dec-22 p,2873,2807,66,2.30000000
CN4900300000000,49,003,"Box Elder County, UT",Dec-22 p,28137,27576,561,2.00000000
CN4900500000000,49,005,"Cache County, UT",Dec-22 p,73679,72388,1291,1.80000000
CN4900700000000,49,007,"Carbon County, UT",Dec-22 p,8508,8257,251,3.00000000
CN4900900000000,49,009,"Daggett County, UT",Dec-22 p,358,342,16,4.50000000
CN4901100000000,49,011,"Davis County, UT",Dec-22 p,187747,184216,3531,1.90000000
CN4901300000000,49,013,"Duchesne County, UT",Dec-22 p,8270,8053,217,2.60000000
CN4901500000000,49,015,"Emery County, UT",Dec-22 p,4458,4338,120,2.70000000
CN4901700000000,49,017,"Garfield County, UT",Dec-22 p,2554,2326,228,8.90000000
CN4901900000000,49,019,"Grand County, UT",Dec-22 p,6623,6325,298,4.50000000
CN4902100000000,49,021,"Iron County, UT",Dec-22 p,29161,28571,590,2.00000000
CN4902300000000,49,023,"Juab County, UT",Dec-22 p,6627,6528,99,1.50000000
CN4902500000000,49,025,"Kane County, UT",Dec-22 p,4051,3945,106,2.60000000
CN4902700000000,49,027,"Millard County, UT",Dec-22 p,6252,6121,131,2.10000000
CN4902900000000,49,029,"Morgan County, UT",Dec-22 p,6051,5950,101,1.70000000
CN4903100000000,49,031,"Piute County, UT",Dec-22 p,524,499,25,4.80000000
CN4903300000000,49,033,"Rich County, UT",Dec-22 p,1045,1018,27,2.60000000
CN4903500000000,49,035,"Salt Lake County, UT",Dec-22 p,683820,670125,13695,2.00000000
CN4903700000000,49,037,"San Juan County, UT",Dec-22 p,5497,5269,228,4.10000000
CN4903900000000,49,039,"Sanpete County, UT",Dec-22 p,13942,13619,323,2.30000000
CN4904100000000,49,041,"Sevier County, UT",Dec-22 p,10465,10184,281,2.70000000
CN4904300000000,49,043,"Summit County, UT",Dec-22 p,27671,27223,448,1.60000000
CN4904500000000,49,045,"Tooele County, UT",Dec-22 p,38651,37773,878,2.30000000
CN4904700000000,49,047,"Uintah County, UT",Dec-22 p,14428,14025,403,2.80000000
CN4904900000000,49,049,"Utah County, UT",Dec-22 p,356770,350069,6701,1.90000000
CN4905100000000,49,051,"Wasatch County, UT",Dec-22 p,18445,18100,345,1.90000000
CN4905300000000,49,053,"Washington County, UT",Dec-22 p,88997,86993,2004,2.30000000
CN4905500000000,49,055,"Wayne County, UT",Dec-22 p,1410,1328,82,5.80000000
CN4905700000000,49,057,"Weber County, UT",Dec-22 p,137907,134960,2947,2.10000000
CN5000100000000,50,001,"Addison County, VT",Dec-22 p,20714,20222,492,2.40000000
CN5000300000000,50,003,"Bennington County, VT",Dec-22 p,17733,17151,582,3.30000000
CN5000500000000,50,005,"Caledonia County, VT",Dec-22 p,14335,13864,471,3.30000000
CN5000700000000,50,007,"Chittenden County, VT",Dec-22 p,97205,95247,1958,2.00000000
CN5000900000000,50,009,"Essex County, VT",Dec-22 p,2623,2512,111,4.20000000
CN5001100000000,50,011,"Franklin County, VT",Dec-22 p,27822,27115,707,2.50000000
CN5001300000000,50,013,"Grand Isle County, VT",Dec-22 p,4150,3996,154,3.70000000
CN5001500000000,50,015,"Lamoille County, VT",Dec-22 p,13888,13428,460,3.30000000
CN5001700000000,50,017,"Orange County, VT",Dec-22 p,15484,15083,401,2.60000000
CN5001900000000,50,019,"Orleans County, VT",Dec-22 p,13188,12526,662,5.00000000
CN5002100000000,50,021,"Rutland County, VT",Dec-22 p,29503,28560,943,3.20000000
CN5002300000000,50,023,"Washington County, VT",Dec-22 p,33908,33061,847,2.50000000
CN5002500000000,50,025,"Windham County, VT",Dec-22 p,20704,20100,604,2.90000000
CN5002700000000,50,027,"Windsor County, VT",Dec-22 p,28835,28133,702,2.40000000
CN5100100000000,51,001,"Accomack County, VA",Dec-22 p,15735,15195,540,3.40000000
CN5100300000000,51,003,"Albemarle County, VA",Dec-22 p,56813,55498,1315,2.30000000
CN5100500000000,51,005,"Alleghany County, VA",Dec-22 p,6858,6667,191,2.80000000
CN5100700000000,51,007,"Amelia County, VA",Dec-22 p,6046,5889,157,2.60000000
CN5100900000000,51,009,"Amherst County, VA",Dec-22 p,14662,14257,405,2.80000000
CN5101100000000,51,011,"Appomattox County, VA",Dec-22 p,7071,6864,207,2.90000000
CN5101300000000,51,013,"Arlington County, VA",Dec-22 p,153073,150256,2817,1.80000000
CN5101500000000,51,015,"Augusta County, VA",Dec-22 p,37214,36370,844,2.30000000
CN5101700000000,51,017,"Bath County, VA",Dec-22 p,2412,2356,56,2.30000000
CN5101900000000,51,019,"Bedford County, VA",Dec-22 p,38034,37064,970,2.60000000
CN5102100000000,51,021,"Bland County, VA",Dec-22 p,2840,2774,66,2.30000000
CN5102300000000,51,023,"Botetourt County, VA",Dec-22 p,17273,16890,383,2.20000000
CN5102500000000,51,025,"Brunswick County, VA",Dec-22 p,6055,5779,276,4.60000000
CN5102700000000,51,027,"Buchanan County, VA",Dec-22 p,6598,6310,288,4.40000000
CN5102900000000,51,029,"Buckingham County, VA",Dec-22 p,6365,6085,280,4.40000000
CN5103100000000,51,031,"Campbell County, VA",Dec-22 p,25513,24798,715,2.80000000
CN5103300000000,51,033,"Caroline County, VA",Dec-22 p,14751,14298,453,3.10000000
CN5103500000000,51,035,"Carroll County, VA",Dec-22 p,13896,13459,437,3.10000000
CN5103600000000,51,036,"Charles City County, VA",Dec-22 p,3479,3368,111,3.20000000
CN5103700000000,51,037,"Charlotte County, VA",Dec-22 p,5973,5824,149,2.50000000
CN5104100000000,51,041,"Chesterfield County, VA",Dec-22 p,185779,180869,4910,2.60000000
CN5104300000000,51,043,"Clarke County, VA",Dec-22 p,7511,7346,165,2.20000000
CN5104500000000,51,045,"Craig County, VA",Dec-22 p,2259,2199,60,2.70000000
CN5104700000000,51,047,"Culpeper County, VA",Dec-22 p,24942,24324,618,2.50000000
CN5104900000000,51,049,"Cumberland County, VA",Dec-22 p,4810,4659,151,3.10000000
CN5105100000000,51,051,"Dickenson County, VA",Dec-22 p,5234,5051,183,3.50000000
CN5105300000000,51,053,"Dinwiddie County, VA",Dec-22 p,13259,12848,411,3.10000000
CN5105700000000,51,057,"Essex County, VA",Dec-22 p,5390,5211,179,3.30000000
CN5105900000000,51,059,"Fairfax County, VA",Dec-22 p,622798,609267,13531,2.20000000
CN5106100000000,51,061,"Fauquier County, VA",Dec-22 p,36910,36101,809,2.20000000
CN5106300000000,51,063,"Floyd County, VA",Dec-22 p,8531,8328,203,2.40000000
CN5106500000000,51,065,"Fluvanna County, VA",Dec-22 p,13903,13581,322,2.30000000
CN5106700000000,51,067,"Franklin County, VA",Dec-22 p,25920,25231,689,2.70000000
CN5106900000000,51,069,"Frederick County, VA",Dec-22 p,50312,49201,1111,2.20000000
CN5107100000000,51,071,"Giles County, VA",Dec-22 p,8134,7904,230,2.80000000
CN5107300000000,51,073,"Gloucester County, VA",Dec-22 p,19186,18705,481,2.50000000
CN5107500000000,51,075,"Goochland County, VA",Dec-22 p,11359,11077,282,2.50000000
CN5107700000000,51,077,"Grayson County, VA",Dec-22 p,9261,9056,205,2.20000000
CN5107900000000,51,079,"Greene County, VA",Dec-22 p,10427,10191,236,2.30000000
CN5108100000000,51,081,"Greensville County, VA",Dec-22 p,4652,4491,161,3.50000000
CN5108300000000,51,083,"Halifax County, VA",Dec-22 p,16127,15553,574,3.60000000
CN5108500000000,51,085,"Hanover County, VA",Dec-22 p,57632,56348,1284,2.20000000
CN5108700000000,51,087,"Henrico County, VA",Dec-22 p,177803,173058,4745,2.70000000
CN5108900000000,51,089,"Henry County, VA",Dec-22 p,26002,25209,793,3.00000000
CN5109100000000,51,091,"Highland County, VA",Dec-22 p,1288,1262,26,2.00000000
CN5109300000000,51,093,"Isle of Wight County, VA",Dec-22 p,19375,18864,511,2.60000000
CN5109500000000,51,095,"James City County, VA",Dec-22 p,36285,35349,936,2.60000000
CN5109700000000,51,097,"King and Queen County, VA",Dec-22 p,4035,3954,81,2.00000000
CN5109900000000,51,099,"King George County, VA",Dec-22 p,14642,14318,324,2.20000000
CN5110100000000,51,101,"King William County, VA",Dec-22 p,9189,8964,225,2.40000000
CN5110300000000,51,103,"Lancaster County, VA",Dec-22 p,5820,5637,183,3.10000000
CN5110500000000,51,105,"Lee County, VA",Dec-22 p,8856,8552,304,3.40000000
CN5110700000000,51,107,"Loudoun County, VA",Dec-22 p,226697,221879,4818,2.10000000
CN5110900000000,51,109,"Louisa County, VA",Dec-22 p,21383,20876,507,2.40000000
CN5111100000000,51,111,"Lunenburg County, VA",Dec-22 p,5383,5212,171,3.20000000
CN5111300000000,51,113,"Madison County, VA",Dec-22 p,7736,7595,141,1.80000000
CN5111500000000,51,115,"Mathews County, VA",Dec-22 p,4008,3913,95,2.40000000
CN5111700000000,51,117,"Mecklenburg County, VA",Dec-22 p,13851,13412,439,3.20000000
CN5111900000000,51,119,"Middlesex County, VA",Dec-22 p,5402,5279,123,2.30000000
CN5112100000000,51,121,"Montgomery County, VA",Dec-22 p,51951,50765,1186,2.30000000
CN5112500000000,51,125,"Nelson County, VA",Dec-22 p,7225,7052,173,2.40000000
CN5112700000000,51,127,"New Kent County, VA",Dec-22 p,12724,12424,300,2.40000000
CN5113100000000,51,131,"Northampton County, VA",Dec-22 p,5663,5442,221,3.90000000
CN5113300000000,51,133,"Northumberland County, VA",Dec-22 p,5944,5747,197,3.30000000
CN5113500000000,51,135,"Nottoway County, VA",Dec-22 p,7447,7262,185,2.50000000
CN5113700000000,51,137,"Orange County, VA",Dec-22 p,17756,17283,473,2.70000000
CN5113900000000,51,139,"Page County, VA",Dec-22 p,12768,12319,449,3.50000000
CN5114100000000,51,141,"Patrick County, VA",Dec-22 p,7447,7228,219,2.90000000
CN5114300000000,51,143,"Pittsylvania County, VA",Dec-22 p,32396,31579,817,2.50000000
CN5114500000000,51,145,"Powhatan County, VA",Dec-22 p,14074,13744,330,2.30000000
CN5114700000000,51,147,"Prince Edward County, VA",Dec-22 p,11211,10871,340,3.00000000
CN5114900000000,51,149,"Prince George County, VA",Dec-22 p,14774,14297,477,3.20000000
CN5115300000000,51,153,"Prince William County, VA",Dec-22 p,244700,238767,5933,2.40000000
CN5115500000000,51,155,"Pulaski County, VA",Dec-22 p,16633,16196,437,2.60000000
CN5115700000000,51,157,"Rappahannock County, VA",Dec-22 p,3623,3547,76,2.10000000
CN5115900000000,51,159,"Richmond County, VA",Dec-22 p,4196,4087,109,2.60000000
CN5116100000000,51,161,"Roanoke County, VA",Dec-22 p,48698,47563,1135,2.30000000
CN5116300000000,51,163,"Rockbridge County, VA",Dec-22 p,11484,11216,268,2.30000000
CN5116500000000,51,165,"Rockingham County, VA",Dec-22 p,42524,41592,932,2.20000000
CN5116700000000,51,167,"Russell County, VA",Dec-22 p,11503,11157,346,3.00000000
CN5116900000000,51,169,"Scott County, VA",Dec-22 p,8985,8703,282,3.10000000
CN5117100000000,51,171,"Shenandoah County, VA",Dec-22 p,23118,22568,550,2.40000000
CN5117300000000,51,173,"Smyth County, VA",Dec-22 p,15796,15399,397,2.50000000
CN5117500000000,51,175,"Southampton County, VA",Dec-22 p,9242,9033,209,2.30000000
CN5117700000000,51,177,"Spotsylvania County, VA",Dec-22 p,67774,65938,1836,2.70000000
CN5117900000000,51,179,"Stafford County, VA",Dec-22 p,73827,71912,1915,2.60000000
CN5118100000000,51,181,"Surry County, VA",Dec-22 p,3615,3534,81,2.20000000
CN5118300000000,51,183,"Sussex County, VA",Dec-22 p,3607,3446,161,4.50000000
CN5118500000000,51,185,"Tazewell County, VA",Dec-22 p,16367,15755,612,3.70000000
CN5118700000000,51,187,"Warren County, VA",Dec-22 p,20229,19726,503,2.50000000
CN5119100000000,51,191,"Washington County, VA",Dec-22 p,25681,24996,685,2.70000000
CN5119300000000,51,193,"Westmoreland County, VA",Dec-22 p,10151,9867,284,2.80000000
CN5119500000000,51,195,"Wise County, VA",Dec-22 p,14849,14366,483,3.30000000
CN5119700000000,51,197,"Wythe County, VA",Dec-22 p,14957,14589,368,2.50000000
CN5119900000000,51,199,"York County, VA",Dec-22 p,32578,31771,807,2.50000000
CN5151000000000,51,510,"Alexandria city, VA",Dec-22 p,98339,96267,2072,2.10000000
CN5152000000000,51,520,"Bristol city, VA",Dec-22 p,7369,7125,244,3.30000000
CN5153000000000,51,530,"Buena Vista city, VA",Dec-22 p,3225,3146,79,2.40000000
CN5154000000000,51,540,"Charlottesville city, VA",Dec-22 p,25146,24574,572,2.30000000
CN5155000000000,51,550,"Chesapeake city, VA",Dec-22 p,121732,118487,3245,2.70000000
CN5157000000000,51,570,"Colonial Heights city, VA",Dec-22 p,8204,7936,268,3.30000000
CN5158000000000,51,580,"Covington city, VA",Dec-22 p,2405,2302,103,4.30000000
CN5159000000000,51,590,"Danville city, VA",Dec-22 p,20250,19338,912,4.50000000
CN5159500000000,51,595,"Emporia city, VA",Dec-22 p,2562,2447,115,4.50000000
CN5160000000000,51,600,"Fairfax city, VA",Dec-22 p,12594,12316,278,2.20000000
CN5161000000000,51,610,"Falls Church city, VA",Dec-22 p,8349,8186,163,2.00000000
CN5162000000000,51,620,"Franklin city, VA",Dec-22 p,3578,3429,149,4.20000000
CN5163000000000,51,630,"Fredericksburg city, VA",Dec-22 p,14020,13585,435,3.10000000
CN5164000000000,51,640,"Galax city, VA",Dec-22 p,3068,2987,81,2.60000000
CN5165000000000,51,650,"Hampton city, VA",Dec-22 p,63395,61009,2386,3.80000000
CN5166000000000,51,660,"Harrisonburg city, VA",Dec-22 p,24557,23870,687,2.80000000
CN5167000000000,51,670,"Hopewell city, VA",Dec-22 p,9312,8853,459,4.90000000
CN5167800000000,51,678,"Lexington city, VA",Dec-22 p,2278,2199,79,3.50000000
CN5168000000000,51,680,"Lynchburg city, VA",Dec-22 p,35245,34021,1224,3.50000000
CN5168300000000,51,683,"Manassas city, VA",Dec-22 p,21209,20710,499,2.40000000
CN5168500000000,51,685,"Manassas Park city, VA",Dec-22 p,9550,9337,213,2.20000000
CN5169000000000,51,690,"Martinsville city, VA",Dec-22 p,6053,5737,316,5.20000000
CN5170000000000,51,700,"Newport News city, VA",Dec-22 p,86984,83926,3058,3.50000000
CN5171000000000,51,710,"Norfolk city, VA",Dec-22 p,108432,104681,3751,3.50000000
CN5172000000000,51,720,"Norton city, VA",Dec-22 p,1826,1766,60,3.30000000
CN5173000000000,51,730,"Petersburg city, VA",Dec-22 p,12276,11445,831,6.80000000
CN5173500000000,51,735,"Poquoson city, VA",Dec-22 p,6265,6128,137,2.20000000
CN5174000000000,51,740,"Portsmouth city, VA",Dec-22 p,43482,41747,1735,4.00000000
CN5175000000000,51,750,"Radford city, VA",Dec-22 p,8977,8713,264,2.90000000
CN5176000000000,51,760,"Richmond city, VA",Dec-22 p,116068,112086,3982,3.40000000
CN5177000000000,51,770,"Roanoke city, VA",Dec-22 p,47937,46493,1444,3.00000000
CN5177500000000,51,775,"Salem city, VA",Dec-22 p,12567,12265,302,2.40000000
CN5179000000000,51,790,"Staunton city, VA",Dec-22 p,12057,11777,280,2.30000000
CN5180000000000,51,800,"Suffolk city, VA",Dec-22 p,44833,43540,1293,2.90000000
CN5181000000000,51,810,"Virginia Beach city, VA",Dec-22 p,227788,221941,5847,2.60000000
CN5182000000000,51,820,"Waynesboro city, VA",Dec-22 p,10483,10205,278,2.70000000
CN5183000000000,51,830,"Williamsburg city, VA",Dec-22 p,6672,6432,240,3.60000000
CN5184000000000,51,840,"Winchester city, VA",Dec-22 p,14766,14402,364,2.50000000
CN5300100000000,53,001,"Adams County, WA",Dec-22 p,9541,8813,728,7.60000000
CN5300300000000,53,003,"Asotin County, WA",Dec-22 p,10720,10293,427,4.00000000
CN5300500000000,53,005,"Benton County, WA",Dec-22 p,107625,101552,6073,5.60000000
CN5300700000000,53,007,"Chelan County, WA",Dec-22 p,43426,40902,2524,5.80000000
CN5300900000000,53,009,"Clallam County, WA",Dec-22 p,30059,28225,1834,6.10000000
CN5301100000000,53,011,"Clark County, WA",Dec-22 p,258828,246899,11929,4.60000000
CN5301300000000,53,013,"Columbia County, WA",Dec-22 p,1822,1728,94,5.20000000
CN5301500000000,53,015,"Cowlitz County, WA",Dec-22 p,49742,46855,2887,5.80000000
CN5301700000000,53,017,"Douglas County, WA",Dec-22 p,21406,19985,1421,6.60000000
CN5301900000000,53,019,"Ferry County, WA",Dec-22 p,2352,2094,258,11.00000000
CN5302100000000,53,021,"Franklin County, WA",Dec-22 p,43917,40526,3391,7.70000000
CN5302300000000,53,023,"Garfield County, WA",Dec-22 p,806,754,52,6.50000000
CN5302500000000,53,025,"Grant County, WA",Dec-22 p,46853,42987,3866,8.30000000
CN5302700000000,53,027,"Grays Harbor County, WA",Dec-22 p,29533,27302,2231,7.60000000
CN5302900000000,53,029,"Island County, WA",Dec-22 p,37150,35367,1783,4.80000000
CN5303100000000,53,031,"Jefferson County, WA",Dec-22 p,12941,12243,698,5.40000000
CN5303300000000,53,033,"King County, WA",Dec-22 p,1309959,1272994,36965,2.80000000
CN5303500000000,53,035,"Kitsap County, WA",Dec-22 p,131380,125690,5690,4.30000000
CN5303700000000,53,037,"Kittitas County, WA",Dec-22 p,21994,20535,1459,6.60000000
CN5303900000000,53,039,"Klickitat County, WA",Dec-22 p,9670,9057,613,6.30000000
CN5304100000000,53,041,"Lewis County, WA",Dec-22 p,35269,33086,2183,6.20000000
CN5304300000000,53,043,"Lincoln County, WA",Dec-22 p,4713,4426,287,6.10000000
CN5304500000000,53,045,"Mason County, WA",Dec-22 p,25793,24131,1662,6.40000000
CN5304700000000,53,047,"Okanogan County, WA",Dec-22 p,18860,17378,1482,7.90000000
CN5304900000000,53,049,"Pacific County, WA",Dec-22 p,8681,8043,638,7.30000000
CN5305100000000,53,051,"Pend Oreille County, WA",Dec-22 p,5312,4888,424,8.00000000
CN5305300000000,53,053,"Pierce County, WA",Dec-22 p,457548,433376,24172,5.30000000
CN5305500000000,53,055,"San Juan County, WA",Dec-22 p,8493,8158,335,3.90000000
CN5305700000000,53,057,"Skagit County, WA",Dec-22 p,62554,59128,3426,5.50000000
CN5305900000000,53,059,"Skamania County, WA",Dec-22 p,5795,5466,329,5.70000000
CN5306100000000,53,061,"Snohomish County, WA",Dec-22 p,446174,432043,14131,3.20000000
CN5306300000000,53,063,"Spokane County, WA",Dec-22 p,268417,254410,14007,5.20000000
CN5306500000000,53,065,"Stevens County, WA",Dec-22 p,19773,18200,1573,8.00000000
CN5306700000000,53,067,"Thurston County, WA",Dec-22 p,148020,141076,6944,4.70000000
CN5306900000000,53,069,"Wahkiakum County, WA",Dec-22 p,1353,1255,98,7.20000000
CN5307100000000,53,071,"Walla Walla County, WA",Dec-22 p,31054,29521,1533,4.90000000
CN5307300000000,53,073,"Whatcom County, WA",Dec-22 p,117580,111758,5822,5.00000000
CN5307500000000,53,075,"Whitman County, WA",Dec-22 p,23541,22474,1067,4.50000000
CN5307700000000,53,077,"Yakima County, WA",Dec-22 p,128425,117132,11293,8.80000000
CN5400100000000,54,001,"Barbour County, WV",Dec-22 p,7164,6877,287,4.00000000
CN5400300000000,54,003,"Berkeley County, WV",Dec-22 p,59971,58497,1474,2.50000000
CN5400500000000,54,005,"Boone County, WV",Dec-22 p,7020,6761,259,3.70000000
CN5400700000000,54,007,"Braxton County, WV",Dec-22 p,4926,4663,263,5.30000000
CN5400900000000,54,009,"Brooke County, WV",Dec-22 p,9667,9304,363,3.80000000
CN5401100000000,54,011,"Cabell County, WV",Dec-22 p,40668,39452,1216,3.00000000
CN5401300000000,54,013,"Calhoun County, WV",Dec-22 p,2614,2387,227,8.70000000
CN5401500000000,54,015,"Clay County, WV",Dec-22 p,2987,2816,171,5.70000000
CN5401700000000,54,017,"Doddridge County, WV",Dec-22 p,3781,3666,115,3.00000000
CN5401900000000,54,019,"Fayette County, WV",Dec-22 p,15985,15309,676,4.20000000
CN5402100000000,54,021,"Gilmer County, WV",Dec-22 p,2384,2261,123,5.20000000
CN5402300000000,54,023,"Grant County, WV",Dec-22 p,5999,5795,204,3.40000000
CN5402500000000,54,025,"Greenbrier County, WV",Dec-22 p,15738,15234,504,3.20000000
CN5402700000000,54,027,"Hampshire County, WV",Dec-22 p,11445,11181,264,2.30000000
CN5402900000000,54,029,"Hancock County, WV",Dec-22 p,12766,12165,601,4.70000000
CN5403100000000,54,031,"Hardy County, WV",Dec-22 p,5974,5761,213,3.60000000
CN5403300000000,54,033,"Harrison County, WV",Dec-22 p,32606,31588,1018,3.10000000
CN5403500000000,54,035,"Jackson County, WV",Dec-22 p,11669,11212,457,3.90000000
CN5403700000000,54,037,"Jefferson County, WV",Dec-22 p,30413,29773,640,2.10000000
CN5403900000000,54,039,"Kanawha County, WV",Dec-22 p,79381,76867,2514,3.20000000
CN5404100000000,54,041,"Lewis County, WV",Dec-22 p,5900,5621,279,4.70000000
CN5404300000000,54,043,"Lincoln County, WV",Dec-22 p,6898,6599,299,4.30000000
CN5404500000000,54,045,"Logan County, WV",Dec-22 p,10848,10424,424,3.90000000
CN5404700000000,54,047,"McDowell County, WV",Dec-22 p,4190,3961,229,5.50000000
CN5404900000000,54,049,"Marion County, WV",Dec-22 p,24601,23695,906,3.70000000
CN5405100000000,54,051,"Marshall County, WV",Dec-22 p,13203,12623,580,4.40000000
CN5405300000000,54,053,"Mason County, WV",Dec-22 p,9991,9612,379,3.80000000
CN5405500000000,54,055,"Mercer County, WV",Dec-22 p,20454,19668,786,3.80000000
CN5405700000000,54,057,"Mineral County, WV",Dec-22 p,12119,11717,402,3.30000000
CN5405900000000,54,059,"Mingo County, WV",Dec-22 p,5959,5653,306,5.10000000
CN5406100000000,54,061,"Monongalia County, WV",Dec-22 p,57059,55539,1520,2.70000000
CN5406300000000,54,063,"Monroe County, WV",Dec-22 p,6331,6186,145,2.30000000
CN5406500000000,54,065,"Morgan County, WV",Dec-22 p,8692,8488,204,2.30000000
CN5406700000000,54,067,"Nicholas County, WV",Dec-22 p,8993,8618,375,4.20000000
CN5406900000000,54,069,"Ohio County, WV",Dec-22 p,20074,19421,653,3.30000000
CN5407100000000,54,071,"Pendleton County, WV",Dec-22 p,3895,3807,88,2.30000000
CN5407300000000,54,073,"Pleasants County, WV",Dec-22 p,2704,2553,151,5.60000000
CN5407500000000,54,075,"Pocahontas County, WV",Dec-22 p,4424,4290,134,3.00000000
CN5407700000000,54,077,"Preston County, WV",Dec-22 p,16199,15690,509,3.10000000
CN5407900000000,54,079,"Putnam County, WV",Dec-22 p,26569,25807,762,2.90000000
CN5408100000000,54,081,"Raleigh County, WV",Dec-22 p,30025,29093,932,3.10000000
CN5408300000000,54,083,"Randolph County, WV",Dec-22 p,11693,11199,494,4.20000000
CN5408500000000,54,085,"Ritchie County, WV",Dec-22 p,4251,4079,172,4.00000000
CN5408700000000,54,087,"Roane County, WV",Dec-22 p,4967,4654,313,6.30000000
CN5408900000000,54,089,"Summers County, WV",Dec-22 p,4458,4323,135,3.00000000
CN5409100000000,54,091,"Taylor County, WV",Dec-22 p,7682,7437,245,3.20000000
CN5409300000000,54,093,"Tucker County, WV",Dec-22 p,3267,3157,110,3.40000000
CN5409500000000,54,095,"Tyler County, WV",Dec-22 p,2918,2755,163,5.60000000
CN5409700000000,54,097,"Upshur County, WV",Dec-22 p,9612,9203,409,4.30000000
CN5409900000000,54,099,"Wayne County, WV",Dec-22 p,15301,14760,541,3.50000000
CN5410100000000,54,101,"Webster County, WV",Dec-22 p,3390,3243,147,4.30000000
CN5410300000000,54,103,"Wetzel County, WV",Dec-22 p,6752,6393,359,5.30000000
CN5410500000000,54,105,"Wirt County, WV",Dec-22 p,2300,2179,121,5.30000000
CN5410700000000,54,107,"Wood County, WV",Dec-22 p,36587,35271,1316,3.60000000
CN5410900000000,54,109,"Wyoming County, WV",Dec-22 p,7192,6930,262,3.60000000
CN5500100000000,55,001,"Adams County, WI",Dec-22 p,7372,7007,365,5.00000000
CN5500300000000,55,003,"Ashland County, WI",Dec-22 p,7096,6876,220,3.10000000
CN5500500000000,55,005,"Barron County, WI",Dec-22 p,23082,22327,755,3.30000000
CN5500700000000,55,007,"Bayfield County, WI",Dec-22 p,7029,6697,332,4.70000000
CN5500900000000,55,009,"Brown County, WI",Dec-22 p,140136,137346,2790,2.00000000
CN5501100000000,55,011,"Buffalo County, WI",Dec-22 p,5867,5657,210,3.60000000
CN5501300000000,55,013,"Burnett County, WI",Dec-22 p,7016,6686,330,4.70000000
CN5501500000000,55,015,"Calumet County, WI",Dec-22 p,27266,26804,462,1.70000000
CN5501700000000,55,017,"Chippewa County, WI",Dec-22 p,32925,31826,1099,3.30000000
CN5501900000000,55,019,"Clark County, WI",Dec-22 p,16876,16495,381,2.30000000
CN5502100000000,55,021,"Columbia County, WI",Dec-22 p,31610,30985,625,2.00000000
CN5502300000000,55,023,"Crawford County, WI",Dec-22 p,6885,6642,243,3.50000000
CN5502500000000,55,025,"Dane County, WI",Dec-22 p,330414,325217,5197,1.60000000
CN5502700000000,55,027,"Dodge County, WI",Dec-22 p,46444,45533,911,2.00000000
CN5502900000000,55,029,"Door County, WI",Dec-22 p,13754,13351,403,2.90000000
CN5503100000000,55,031,"Douglas County, WI",Dec-22 p,22725,21998,727,3.20000000
CN5503300000000,55,033,"Dunn County, WI",Dec-22 p,24112,23467,645,2.70000000
CN5503500000000,55,035,"Eau Claire County, WI",Dec-22 p,58540,57343,1197,2.00000000
CN5503700000000,55,037,"Florence County, WI",Dec-22 p,1948,1885,63,3.20000000
CN5503900000000,55,039,"Fond du Lac County, WI",Dec-22 p,56100,55068,1032,1.80000000
CN5504100000000,55,041,"Forest County, WI",Dec-22 p,3699,3521,178,4.80000000
CN5504300000000,55,043,"Grant County, WI",Dec-22 p,26634,26067,567,2.10000000
CN5504500000000,55,045,"Green County, WI",Dec-22 p,20534,20170,364,1.80000000
CN5504700000000,55,047,"Green Lake County, WI",Dec-22 p,8629,8396,233,2.70000000
CN5504900000000,55,049,"Iowa County, WI",Dec-22 p,13329,13058,271,2.00000000
CN5505100000000,55,051,"Iron County, WI",Dec-22 p,2431,2284,147,6.00000000
CN5505300000000,55,053,"Jackson County, WI",Dec-22 p,9009,8677,332,3.70000000
CN5505500000000,55,055,"Jefferson County, WI",Dec-22 p,45425,44517,908,2.00000000
CN5505700000000,55,057,"Juneau County, WI",Dec-22 p,12845,12490,355,2.80000000
CN5505900000000,55,059,"Kenosha County, WI",Dec-22 p,91709,89520,2189,2.40000000
CN5506100000000,55,061,"Kewaunee County, WI",Dec-22 p,10527,10313,214,2.00000000
CN5506300000000,55,063,"La Crosse County, WI",Dec-22 p,66298,65068,1230,1.90000000
CN5506500000000,55,065,"Lafayette County, WI",Dec-22 p,9917,9728,189,1.90000000
CN5506700000000,55,067,"Langlade County, WI",Dec-22 p,8892,8617,275,3.10000000
CN5506900000000,55,069,"Lincoln County, WI",Dec-22 p,14426,14085,341,2.40000000
CN5507100000000,55,071,"Manitowoc County, WI",Dec-22 p,39685,38761,924,2.30000000
CN5507300000000,55,073,"Marathon County, WI",Dec-22 p,72379,71008,1371,1.90000000
CN5507500000000,55,075,"Marinette County, WI",Dec-22 p,18389,17777,612,3.30000000
CN5507700000000,55,077,"Marquette County, WI",Dec-22 p,7429,7179,250,3.40000000
CN5507800000000,55,078,"Menominee County, WI",Dec-22 p,1448,1383,65,4.50000000
CN5507900000000,55,079,"Milwaukee County, WI",Dec-22 p,454275,441583,12692,2.80000000
CN5508100000000,55,081,"Monroe County, WI",Dec-22 p,22424,21926,498,2.20000000
CN5508300000000,55,083,"Oconto County, WI",Dec-22 p,20296,19749,547,2.70000000
CN5508500000000,55,085,"Oneida County, WI",Dec-22 p,17187,16642,545,3.20000000
CN5508700000000,55,087,"Outagamie County, WI",Dec-22 p,103878,101888,1990,1.90000000
CN5508900000000,55,089,"Ozaukee County, WI",Dec-22 p,48249,47373,876,1.80000000
CN5509100000000,55,091,"Pepin County, WI",Dec-22 p,3876,3757,119,3.10000000
CN5509300000000,55,093,"Pierce County, WI",Dec-22 p,25007,24293,714,2.90000000
CN5509500000000,55,095,"Polk County, WI",Dec-22 p,24400,23432,968,4.00000000
CN5509700000000,55,097,"Portage County, WI",Dec-22 p,37366,36523,843,2.30000000
CN5509900000000,55,099,"Price County, WI",Dec-22 p,6069,5896,173,2.90000000
CN5510100000000,55,101,"Racine County, WI",Dec-22 p,95330,92836,2494,2.60000000
CN5510300000000,55,103,"Richland County, WI",Dec-22 p,8629,8443,186,2.20000000
CN5510500000000,55,105,"Rock County, WI",Dec-22 p,84587,82394,2193,2.60000000
CN5510700000000,55,107,"Rusk County, WI",Dec-22 p,6219,6025,194,3.10000000
CN5510900000000,55,109,"St. Croix County, WI",Dec-22 p,51055,49672,1383,2.70000000
CN5511100000000,55,111,"Sauk County, WI",Dec-22 p,33489,32752,737,2.20000000
CN5511300000000,55,113,"Sawyer County, WI",Dec-22 p,7625,7337,288,3.80000000
CN5511500000000,55,115,"Shawano County, WI",Dec-22 p,19786,19333,453,2.30000000
CN5511700000000,55,117,"Sheboygan County, WI",Dec-22 p,61092,60003,1089,1.80000000
CN5511900000000,55,119,"Taylor County, WI",Dec-22 p,10229,9864,365,3.60000000
CN5512100000000,55,121,"Trempealeau County, WI",Dec-22 p,14368,13949,419,2.90000000
CN5512300000000,55,123,"Vernon County, WI",Dec-22 p,14712,14394,318,2.20000000
CN5512500000000,55,125,"Vilas County, WI",Dec-22 p,9576,9187,389,4.10000000
CN5512700000000,55,127,"Walworth County, WI",Dec-22 p,56683,55444,1239,2.20000000
CN5512900000000,55,129,"Washburn County, WI",Dec-22 p,7344,7099,245,3.30000000
CN5513100000000,55,131,"Washington County, WI",Dec-22 p,75521,74196,1325,1.80000000
CN5513300000000,55,133,"Waukesha County, WI",Dec-22 p,221330,217285,4045,1.80000000
CN5513500000000,55,135,"Waupaca County, WI",Dec-22 p,24396,23851,545,2.20000000
CN5513700000000,55,137,"Waushara County, WI",Dec-22 p,10877,10556,321,3.00000000
CN5513900000000,55,139,"Winnebago County, WI",Dec-22 p,91676,89909,1767,1.90000000
CN5514100000000,55,141,"Wood County, WI",Dec-22 p,32389,31524,865,2.70000000
CN5600100000000,56,001,"Albany County, WY",Dec-22 p,21631,20988,643,3.00000000
CN5600300000000,56,003,"Big Horn County, WY",Dec-22 p,5040,4848,192,3.80000000
CN5600500000000,56,005,"Campbell County, WY",Dec-22 p,22794,22068,726,3.20000000
CN5600700000000,56,007,"Carbon County, WY",Dec-22 p,7191,6918,273,3.80000000
CN5600900000000,56,009,"Converse County, WY",Dec-22 p,7558,7352,206,2.70000000
CN5601100000000,56,011,"Crook County, WY",Dec-22 p,3709,3602,107,2.90000000
CN5601300000000,56,013,"Fremont County, WY",Dec-22 p,18885,18194,691,3.70000000
CN5601500000000,56,015,"Goshen County, WY",Dec-22 p,6342,6159,183,2.90000000
CN5601700000000,56,017,"Hot Springs County, WY",Dec-22 p,2285,2219,66,2.90000000
CN5601900000000,56,019,"Johnson County, WY",Dec-22 p,4103,3959,144,3.50000000
CN5602100000000,56,021,"Laramie County, WY",Dec-22 p,50572,48905,1667,3.30000000
CN5602300000000,56,023,"Lincoln County, WY",Dec-22 p,9734,9424,310,3.20000000
CN5602500000000,56,025,"Natrona County, WY",Dec-22 p,38841,37334,1507,3.90000000
CN5602700000000,56,027,"Niobrara County, WY",Dec-22 p,1175,1138,37,3.10000000
CN5602900000000,56,029,"Park County, WY",Dec-22 p,14651,14111,540,3.70000000
CN5603100000000,56,031,"Platte County, WY",Dec-22 p,4341,4185,156,3.60000000
CN5603300000000,56,033,"Sheridan County, WY",Dec-22 p,15900,15357,543,3.40000000
CN5603500000000,56,035,"Sublette County, WY",Dec-22 p,3717,3563,154,4.10000000
CN5603700000000,56,037,"Sweetwater County, WY",Dec-22 p,19431,18621,810,4.20000000
CN5603900000000,56,039,"Teton County, WY",Dec-22 p,16558,16168,390,2.40000000
CN5604100000000,56,041,"Uinta County, WY",Dec-22 p,8831,8500,331,3.70000000
CN5604300000000,56,043,"Washakie County, WY",Dec-22 p,3809,3668,141,3.70000000
CN5604500000000,56,045,"Weston County, WY",Dec-22 p,3833,3740,93,2.40000000
CN7200100000000,72,001,"Adjuntas Municipio, PR",Dec-22 p,4732,4311,421,8.90000000
CN7200300000000,72,003,"Aguada Municipio, PR",Dec-22 p,13452,12492,960,7.10000000
CN7200500000000,72,005,"Aguadilla Municipio, PR",Dec-22 p,16422,15020,1402,8.50000000
CN7200700000000,72,007,"Aguas Buenas Municipio, PR",Dec-22 p,7381,6939,442,6.00000000
CN7200900000000,72,009,"Aibonito Municipio, PR",Dec-22 p,7157,6663,494,6.90000000
CN7201100000000,72,011,"Anasco Municipio, PR",Dec-22 p,10140,9494,646,6.40000000
CN7201300000000,72,013,"Arecibo Municipio, PR",Dec-22 p,26580,24822,1758,6.60000000
CN7201500000000,72,015,"Arroyo Municipio, PR",Dec-22 p,5264,4835,429,8.10000000
CN7201700000000,72,017,"Barceloneta Municipio, PR",Dec-22 p,6671,6136,535,8.00000000
CN7201900000000,72,019,"Barranquitas Municipio, PR",Dec-22 p,8273,7669,604,7.30000000
CN7202100000000,72,021,"Bayamon Municipio, PR",Dec-22 p,73241,69698,3543,4.80000000
CN7202300000000,72,023,"Cabo Rojo Municipio, PR",Dec-22 p,15722,14671,1051,6.70000000
CN7202500000000,72,025,"Caguas Municipio, PR",Dec-22 p,53794,51323,2471,4.60000000
CN7202700000000,72,027,"Camuy Municipio, PR",Dec-22 p,10718,10027,691,6.40000000
CN7202900000000,72,029,"Canovanas Municipio, PR",Dec-22 p,18487,17551,936,5.10000000
CN7203100000000,72,031,"Carolina Municipio, PR",Dec-22 p,69116,65962,3154,4.60000000
CN7203300000000,72,033,"Catano Municipio, PR",Dec-22 p,8738,8300,438,5.00000000
CN7203500000000,72,035,"Cayey Municipio, PR",Dec-22 p,18197,17364,833,4.60000000
CN7203700000000,72,037,"Ceiba Municipio, PR",Dec-22 p,4031,3770,261,6.50000000
CN7203900000000,72,039,"Ciales Municipio, PR",Dec-22 p,4117,3793,324,7.90000000
CN7204100000000,72,041,"Cidra Municipio, PR",Dec-22 p,17400,16632,768,4.40000000
CN7204300000000,72,043,"Coamo Municipio, PR",Dec-22 p,11590,10707,883,7.60000000
CN7204500000000,72,045,"Comerio Municipio, PR",Dec-22 p,5563,5176,387,7.00000000
CN7204700000000,72,047,"Corozal Municipio, PR",Dec-22 p,9992,9257,735,7.40000000
CN7204900000000,72,049,"Culebra Municipio, PR",Dec-22 p,1052,1030,22,2.10000000
CN7205100000000,72,051,"Dorado Municipio, PR",Dec-22 p,15243,14623,620,4.10000000
CN7205300000000,72,053,"Fajardo Municipio, PR",Dec-22 p,11867,11101,766,6.50000000
CN7205400000000,72,054,"Florida Municipio, PR",Dec-22 p,3688,3396,292,7.90000000
CN7205500000000,72,055,"Guanica Municipio, PR",Dec-22 p,4349,3944,405,9.30000000
CN7205700000000,72,057,"Guayama Municipio, PR",Dec-22 p,12388,11564,824,6.70000000
CN7205900000000,72,059,"Guayanilla Municipio, PR",Dec-22 p,5537,4950,587,10.60000000
CN7206100000000,72,061,"Guaynabo Municipio, PR",Dec-22 p,42800,41627,1173,2.70000000
CN7206300000000,72,063,"Gurabo Municipio, PR",Dec-22 p,21220,20410,810,3.80000000
CN7206500000000,72,065,"Hatillo Municipio, PR",Dec-22 p,15512,14001,1511,9.70000000
CN7206700000000,72,067,"Hormigueros Municipio, PR",Dec-22 p,6067,5749,318,5.20000000
CN7206900000000,72,069,"Humacao Municipio, PR",Dec-22 p,19850,18582,1268,6.40000000
CN7207100000000,72,071,"Isabela Municipio, PR",Dec-22 p,13378,12473,905,6.80000000
CN7207300000000,72,073,"Jayuya Municipio, PR",Dec-22 p,4922,4462,460,9.30000000
CN7207500000000,72,075,"Juana Diaz Municipio, PR",Dec-22 p,17919,16671,1248,7.00000000
CN7207700000000,72,077,"Juncos Municipio, PR",Dec-22 p,14043,13180,863,6.10000000
CN7207900000000,72,079,"Lajas Municipio, PR",Dec-22 p,5912,5367,545,9.20000000
CN7208100000000,72,081,"Lares Municipio, PR",Dec-22 p,8064,7150,914,11.30000000
CN7208300000000,72,083,"Las Marias Municipio, PR",Dec-22 p,3034,2665,369,12.20000000
CN7208500000000,72,085,"Las Piedras Municipio, PR",Dec-22 p,12954,12198,756,5.80000000
CN7208700000000,72,087,"Loiza Municipio, PR",Dec-22 p,9339,8822,517,5.50000000
CN7208900000000,72,089,"Luquillo Municipio, PR",Dec-22 p,6921,6496,425,6.10000000
CN7209100000000,72,091,"Manati Municipio, PR",Dec-22 p,12689,11944,745,5.90000000
CN7209300000000,72,093,"Maricao Municipio, PR",Dec-22 p,2196,1981,215,9.80000000
CN7209500000000,72,095,"Maunabo Municipio, PR",Dec-22 p,3193,2853,340,10.60000000
CN7209700000000,72,097,"Mayaguez Municipio, PR",Dec-22 p,24558,22814,1744,7.10000000
CN7209900000000,72,099,"Moca Municipio, PR",Dec-22 p,11931,10934,997,8.40000000
CN7210100000000,72,101,"Morovis Municipio, PR",Dec-22 p,9113,8481,632,6.90000000
CN7210300000000,72,103,"Naguabo Municipio, PR",Dec-22 p,9319,8772,547,5.90000000
CN7210500000000,72,105,"Naranjito Municipio, PR",Dec-22 p,8009,7430,579,7.20000000
CN7210700000000,72,107,"Orocovis Municipio, PR",Dec-22 p,5500,5024,476,8.70000000
CN7210900000000,72,109,"Patillas Municipio, PR",Dec-22 p,4715,4279,436,9.20000000
CN7211100000000,72,111,"Penuelas Municipio, PR",Dec-22 p,6502,5870,632,9.70000000
CN7211300000000,72,113,"Ponce Municipio, PR",Dec-22 p,51383,47804,3579,7.00000000
CN7211500000000,72,115,"Quebradillas Municipio, PR",Dec-22 p,6765,6236,529,7.80000000
CN7211700000000,72,117,"Rincon Municipio, PR",Dec-22 p,5469,4823,646,11.80000000
CN7211900000000,72,119,"Rio Grande Municipio, PR",Dec-22 p,19167,18148,1019,5.30000000
CN7212100000000,72,121,"Sabana Grande Municipio, PR",Dec-22 p,6649,6122,527,7.90000000
CN7212300000000,72,123,"Salinas Municipio, PR",Dec-22 p,7947,7242,705,8.90000000
CN7212500000000,72,125,"San German Municipio, PR",Dec-22 p,10831,10035,796,7.30000000
CN7212700000000,72,127,"San Juan Municipio, PR",Dec-22 p,150982,144344,6638,4.40000000
CN7212900000000,72,129,"San Lorenzo Municipio, PR",Dec-22 p,13043,12257,786,6.00000000
CN7213100000000,72,131,"San Sebastian Municipio, PR",Dec-22 p,11553,10392,1161,10.00000000
CN7213300000000,72,133,"Santa Isabel Municipio, PR",Dec-22 p,8899,8158,741,8.30000000
CN7213500000000,72,135,"Toa Alta Municipio, PR",Dec-22 p,31465,30124,1341,4.30000000
CN7213700000000,72,137,"Toa Baja Municipio, PR",Dec-22 p,32747,31278,1469,4.50000000
CN7213900000000,72,139,"Trujillo Alto Municipio, PR",Dec-22 p,30494,29562,932,3.10000000
CN7214100000000,72,141,"Utuado Municipio, PR",Dec-22 p,7438,6824,614,8.30000000
CN7214300000000,72,143,"Vega Alta Municipio, PR",Dec-22 p,11093,10345,748,6.70000000
CN7214500000000,72,145,"Vega Baja Municipio, PR",Dec-22 p,14889,13797,1092,7.30000000
CN7214700000000,72,147,"Vieques Municipio, PR",Dec-22 p,2847,2681,166,5.80000000
CN7214900000000,72,149,"Villalba Municipio, PR",Dec-22 p,8262,7354,908,11.00000000
CN7215100000000,72,151,"Yabucoa Municipio, PR",Dec-22 p,9626,8850,776,8.10000000
CN7215300000000,72,153,"Yauco Municipio, PR",Dec-22 p,11061,9848,1213,11.00000000
